"letterChars","numberChars","specialChars","numCharacters","Type","strength"
9,2,0,11,mixedType,1
14,3,0,17,mixedType,2
9,1,0,10,mixedType,1
4,2,0,6,mixedType,0
7,3,0,10,mixedType,1
11,5,0,16,mixedType,2
5,2,0,7,mixedType,0
5,3,0,8,mixedType,1
15,1,0,16,mixedType,2
5,4,0,9,mixedType,1
8,3,0,11,mixedType,1
3,6,0,9,mixedType,1
6,1,0,7,mixedType,0
6,3,0,9,mixedType,1
1,7,0,8,mixedType,1
8,1,0,9,mixedType,1
7,3,0,10,mixedType,1
6,4,0,10,mixedType,1
4,4,0,8,mixedType,1
2,9,0,11,mixedType,1
5,2,0,7,mixedType,0
6,1,0,7,mixedType,0
8,2,0,10,mixedType,1
6,4,0,10,mixedType,1
5,3,0,8,mixedType,1
14,2,0,16,mixedType,2
4,2,0,6,mixedType,0
6,2,0,8,mixedType,1
9,1,0,10,mixedType,1
11,5,0,16,mixedType,2
5,3,0,8,mixedType,1
5,2,0,7,mixedType,0
10,2,0,12,mixedType,1
8,4,0,12,mixedType,1
7,4,0,11,mixedType,1
3,7,0,10,mixedType,1
8,1,0,9,mixedType,1
7,3,0,10,mixedType,1
7,1,0,8,mixedType,1
8,4,0,12,mixedType,1
8,1,0,9,mixedType,1
13,1,2,16,mixedType,2
5,4,0,9,mixedType,1
4,5,0,9,mixedType,1
5,3,0,8,mixedType,1
6,2,0,8,mixedType,1
8,2,0,10,mixedType,1
6,2,0,8,mixedType,1
6,3,0,9,mixedType,1
9,2,0,11,mixedType,1
3,6,0,9,mixedType,1
14,2,0,16,mixedType,2
8,2,0,10,mixedType,1
8,2,0,10,mixedType,1
11,1,0,12,mixedType,1
10,3,0,13,mixedType,1
15,1,0,16,mixedType,2
6,4,0,10,mixedType,1
14,2,0,16,mixedType,2
15,1,0,16,mixedType,2
5,2,0,7,mixedType,0
11,4,0,15,mixedType,2
2,4,0,6,mixedType,0
7,2,0,9,mixedType,1
1,8,0,9,mixedType,1
3,3,0,6,mixedType,0
7,3,0,10,mixedType,1
8,3,0,11,mixedType,1
5,3,0,8,mixedType,1
8,3,0,11,mixedType,1
14,2,0,16,mixedType,2
7,2,0,9,mixedType,1
7,4,0,11,mixedType,1
7,2,0,9,mixedType,1
9,1,0,10,mixedType,1
6,2,0,8,mixedType,1
13,3,1,17,mixedType,2
8,2,0,10,mixedType,1
6,4,0,10,mixedType,1
6,1,0,7,mixedType,0
13,3,0,16,mixedType,2
6,2,0,8,mixedType,1
15,1,0,16,mixedType,2
9,1,0,10,mixedType,1
7,4,0,11,mixedType,1
6,1,0,7,mixedType,0
11,1,0,12,mixedType,1
5,4,0,9,mixedType,1
13,3,0,16,mixedType,2
6,3,0,9,mixedType,1
5,1,0,6,mixedType,0
6,4,0,10,mixedType,1
8,3,0,11,mixedType,1
7,1,0,8,mixedType,1
8,3,0,11,mixedType,1
8,2,0,10,mixedType,1
6,2,0,8,mixedType,1
5,4,0,9,mixedType,1
11,3,0,14,mixedType,2
7,3,0,10,mixedType,1
7,2,0,9,mixedType,1
8,1,0,9,mixedType,1
5,3,0,8,mixedType,1
9,4,0,13,mixedType,1
8,4,0,12,mixedType,1
15,1,0,16,mixedType,2
7,1,0,8,mixedType,1
9,2,0,11,mixedType,1
1,5,0,6,mixedType,0
6,2,0,8,mixedType,1
3,6,0,9,mixedType,1
5,1,0,6,mixedType,0
6,1,0,7,mixedType,0
5,4,0,9,mixedType,1
6,3,0,9,mixedType,1
15,1,0,16,mixedType,2
4,6,0,10,mixedType,1
6,0,3,9,mixedType,1
5,3,0,8,mixedType,1
5,2,0,7,mixedType,0
8,2,0,10,mixedType,1
6,2,0,8,mixedType,1
3,6,0,9,mixedType,1
8,2,0,10,mixedType,1
5,1,0,6,mixedType,0
6,2,0,8,mixedType,1
7,2,0,9,mixedType,1
8,4,0,12,mixedType,1
6,2,0,8,mixedType,1
6,0,1,7,mixedType,0
5,3,0,8,mixedType,1
5,2,0,7,mixedType,0
5,2,0,7,mixedType,0
14,2,0,16,mixedType,2
6,1,0,7,mixedType,0
6,3,0,9,mixedType,1
9,4,0,13,mixedType,1
4,4,0,8,mixedType,1
6,4,0,10,mixedType,1
9,1,0,10,mixedType,1
3,8,0,11,mixedType,1
7,6,0,13,mixedType,1
8,2,0,10,mixedType,1
9,1,0,10,mixedType,1
6,2,0,8,mixedType,1
6,3,0,9,mixedType,1
5,2,0,7,mixedType,0
7,3,0,10,mixedType,1
12,4,0,16,mixedType,2
3,7,0,10,mixedType,1
7,1,0,8,mixedType,1
5,4,0,9,mixedType,1
11,2,0,13,mixedType,1
5,6,0,11,mixedType,1
5,3,0,8,mixedType,1
7,3,0,10,mixedType,1
1,8,0,9,mixedType,1
4,2,0,6,mixedType,0
2,6,0,8,mixedType,1
7,4,0,11,mixedType,1
4,12,0,16,mixedType,2
7,3,0,10,mixedType,1
7,3,0,10,mixedType,1
7,2,0,9,mixedType,1
6,3,0,9,mixedType,1
4,4,0,8,mixedType,1
5,2,0,7,mixedType,0
15,1,0,16,mixedType,2
7,2,0,9,mixedType,1
8,2,0,10,mixedType,1
4,6,0,10,mixedType,1
13,3,0,16,mixedType,2
12,3,0,15,mixedType,2
11,3,0,14,mixedType,2
4,2,0,6,mixedType,0
2,8,0,10,mixedType,1
6,1,0,7,mixedType,0
6,3,0,9,mixedType,1
5,3,0,8,mixedType,1
6,3,0,9,mixedType,1
9,2,0,11,mixedType,1
0,8,1,9,mixedType,1
5,3,0,8,mixedType,1
6,3,0,9,mixedType,1
11,3,0,14,mixedType,2
4,4,0,8,mixedType,1
7,3,0,10,mixedType,1
5,2,0,7,mixedType,0
5,3,0,8,mixedType,1
9,1,0,10,mixedType,1
4,2,0,6,mixedType,0
7,3,0,10,mixedType,1
9,4,0,13,mixedType,1
11,2,0,13,mixedType,1
11,1,0,12,mixedType,1
6,4,0,10,mixedType,1
6,4,0,10,mixedType,1
6,2,0,8,mixedType,1
15,1,0,16,mixedType,2
8,2,0,10,mixedType,1
5,2,0,7,mixedType,0
9,3,0,12,mixedType,1
8,3,0,11,mixedType,1
3,5,0,8,mixedType,1
1,9,0,10,mixedType,1
10,2,0,12,mixedType,1
2,8,0,10,mixedType,1
15,1,0,16,mixedType,2
5,4,0,9,mixedType,1
5,6,0,11,mixedType,1
2,6,0,8,mixedType,1
8,4,0,12,mixedType,1
7,1,0,8,mixedType,1
6,3,0,9,mixedType,1
5,5,0,10,mixedType,1
8,2,0,10,mixedType,1
14,2,0,16,mixedType,2
7,3,0,10,mixedType,1
7,2,0,9,mixedType,1
5,3,0,8,mixedType,1
4,6,0,10,mixedType,1
7,1,0,8,mixedType,1
5,2,0,7,mixedType,0
4,9,0,13,mixedType,1
12,3,0,15,mixedType,2
4,9,0,13,mixedType,1
4,2,0,6,mixedType,0
7,4,0,11,mixedType,1
4,6,0,10,mixedType,1
5,2,0,7,mixedType,0
5,4,0,9,mixedType,1
10,3,0,13,mixedType,1
4,2,0,6,mixedType,0
6,1,0,7,mixedType,0
6,4,0,10,mixedType,1
6,3,0,9,mixedType,1
8,1,0,9,mixedType,1
6,3,0,9,mixedType,1
4,4,0,8,mixedType,1
6,1,0,7,mixedType,0
6,3,0,9,mixedType,1
5,3,0,8,mixedType,1
3,5,0,8,mixedType,1
6,3,0,9,mixedType,1
10,1,0,11,mixedType,1
7,1,0,8,mixedType,1
12,4,0,16,mixedType,2
12,3,0,15,mixedType,2
8,3,0,11,mixedType,1
7,4,0,11,mixedType,1
5,3,0,8,mixedType,1
5,2,0,7,mixedType,0
5,1,0,6,mixedType,0
8,4,0,12,mixedType,1
7,3,0,10,mixedType,1
5,2,0,7,mixedType,0
8,1,0,9,mixedType,1
6,1,0,7,mixedType,0
6,3,0,9,mixedType,1
3,9,0,12,mixedType,1
11,3,0,14,mixedType,2
7,1,0,8,mixedType,1
8,3,0,11,mixedType,1
6,2,0,8,mixedType,1
7,5,0,12,mixedType,1
6,1,0,7,mixedType,0
7,1,0,8,mixedType,1
14,2,0,16,mixedType,2
8,2,0,10,mixedType,1
8,2,0,10,mixedType,1
6,4,0,10,mixedType,1
8,1,0,9,mixedType,1
15,1,0,16,mixedType,2
1,7,0,8,mixedType,1
13,3,0,16,mixedType,2
6,2,0,8,mixedType,1
3,7,0,10,mixedType,1
3,8,0,11,mixedType,1
7,6,0,13,mixedType,1
7,1,0,8,mixedType,1
0,6,2,8,mixedType,1
3,7,0,10,mixedType,1
9,3,0,12,mixedType,1
2,7,0,9,mixedType,1
6,2,0,8,mixedType,1
6,1,0,7,mixedType,0
1,8,0,9,mixedType,1
7,1,0,8,mixedType,1
8,2,0,10,mixedType,1
5,2,0,7,mixedType,0
7,1,0,8,mixedType,1
3,6,0,9,mixedType,1
2,6,0,8,mixedType,1
5,4,0,9,mixedType,1
3,3,0,6,mixedType,0
6,3,0,9,mixedType,1
7,2,0,9,mixedType,1
6,2,0,8,mixedType,1
10,2,0,12,mixedType,1
4,2,0,6,mixedType,0
6,4,0,10,mixedType,1
6,2,0,8,mixedType,1
6,4,0,10,mixedType,1
15,1,0,16,mixedType,2
9,3,0,12,mixedType,1
5,2,0,7,mixedType,0
7,2,0,9,mixedType,1
6,6,0,12,mixedType,1
5,1,0,6,mixedType,0
6,2,0,8,mixedType,1
6,3,0,9,mixedType,1
5,1,0,6,mixedType,0
13,3,0,16,mixedType,2
5,4,0,9,mixedType,1
4,4,0,8,mixedType,1
5,3,0,8,mixedType,1
6,1,0,7,mixedType,0
5,7,0,12,mixedType,1
12,1,0,13,mixedType,1
6,2,0,8,mixedType,1
4,7,0,11,mixedType,1
6,4,0,10,mixedType,1
5,4,0,9,mixedType,1
13,3,0,16,mixedType,2
11,3,0,14,mixedType,2
6,3,0,9,mixedType,1
10,1,0,11,mixedType,1
4,2,0,6,mixedType,0
8,5,0,13,mixedType,1
7,3,0,10,mixedType,1
7,3,0,10,mixedType,1
7,3,0,10,mixedType,1
8,2,0,10,mixedType,1
12,4,0,16,mixedType,2
3,5,0,8,mixedType,1
6,3,0,9,mixedType,1
5,1,0,6,mixedType,0
7,3,0,10,mixedType,1
4,2,0,6,mixedType,0
10,3,0,13,mixedType,1
9,1,0,10,mixedType,1
8,3,0,11,mixedType,1
5,2,0,7,mixedType,0
7,4,0,11,mixedType,1
9,1,0,10,mixedType,1
15,1,0,16,mixedType,2
14,2,0,16,mixedType,2
5,3,0,8,mixedType,1
4,2,0,6,mixedType,0
8,1,0,9,mixedType,1
5,2,0,7,mixedType,0
13,3,0,16,mixedType,2
9,5,0,14,mixedType,2
6,3,0,9,mixedType,1
4,2,0,6,mixedType,0
8,4,0,12,mixedType,1
7,1,0,8,mixedType,1
10,3,0,13,mixedType,1
5,7,0,12,mixedType,1
8,2,0,10,mixedType,1
8,4,0,12,mixedType,1
6,3,0,9,mixedType,1
5,3,0,8,mixedType,1
5,6,0,11,mixedType,1
7,2,0,9,mixedType,1
6,4,0,10,mixedType,1
14,2,0,16,mixedType,2
3,8,0,11,mixedType,1
5,1,0,6,mixedType,0
7,3,0,10,mixedType,1
5,2,0,7,mixedType,0
5,3,0,8,mixedType,1
4,2,0,6,mixedType,0
9,1,0,10,mixedType,1
7,3,0,10,mixedType,1
8,1,0,9,mixedType,1
5,2,0,7,mixedType,0
11,3,0,14,mixedType,2
9,2,0,11,mixedType,1
4,2,0,6,mixedType,0
7,1,0,8,mixedType,1
4,6,0,10,mixedType,1
7,4,0,11,mixedType,1
7,3,0,10,mixedType,1
8,4,0,12,mixedType,1
11,3,0,14,mixedType,2
5,2,0,7,mixedType,0
3,6,0,9,mixedType,1
6,1,0,7,mixedType,0
5,3,0,8,mixedType,1
4,4,0,8,mixedType,1
4,5,0,9,mixedType,1
7,2,0,9,mixedType,1
6,2,0,8,mixedType,1
6,2,0,8,mixedType,1
6,1,0,7,mixedType,0
15,1,0,16,mixedType,2
4,4,0,8,mixedType,1
8,4,0,12,mixedType,1
4,2,0,6,mixedType,0
8,3,0,11,mixedType,1
1,8,0,9,mixedType,1
3,6,0,9,mixedType,1
6,2,0,8,mixedType,1
8,3,0,11,mixedType,1
7,3,0,10,mixedType,1
6,1,0,7,mixedType,0
7,1,0,8,mixedType,1
9,4,0,13,mixedType,1
5,2,0,7,mixedType,0
6,4,0,10,mixedType,1
5,3,0,8,mixedType,1
7,3,0,10,mixedType,1
4,6,0,10,mixedType,1
6,3,0,9,mixedType,1
7,2,0,9,mixedType,1
5,5,0,10,mixedType,1
7,5,0,12,mixedType,1
13,3,0,16,mixedType,2
8,1,0,9,mixedType,1
1,8,0,9,mixedType,1
5,4,0,9,mixedType,1
7,2,0,9,mixedType,1
6,2,0,8,mixedType,1
4,8,0,12,mixedType,1
8,3,0,11,mixedType,1
6,2,0,8,mixedType,1
5,3,0,8,mixedType,1
13,2,0,15,mixedType,2
7,2,0,9,mixedType,1
14,2,0,16,mixedType,2
13,3,0,16,mixedType,2
6,2,0,8,mixedType,1
11,1,0,12,mixedType,1
7,1,0,8,mixedType,1
2,8,0,10,mixedType,1
9,2,0,11,mixedType,1
5,2,0,7,mixedType,0
4,2,0,6,mixedType,0
8,1,0,9,mixedType,1
5,5,0,10,mixedType,1
7,2,0,9,mixedType,1
6,3,0,9,mixedType,1
6,6,0,12,mixedType,1
5,2,0,7,mixedType,0
7,2,0,9,mixedType,1
7,3,0,10,mixedType,1
10,2,0,12,mixedType,1
7,1,0,8,mixedType,1
2,6,0,8,mixedType,1
5,4,0,9,mixedType,1
7,3,0,10,mixedType,1
4,4,0,8,mixedType,1
8,2,0,10,mixedType,1
9,2,0,11,mixedType,1
5,3,0,8,mixedType,1
10,1,0,11,mixedType,1
1,8,0,9,mixedType,1
7,2,0,9,mixedType,1
11,0,1,12,mixedType,1
4,4,0,8,mixedType,1
8,1,0,9,mixedType,1
13,3,0,16,mixedType,2
6,2,0,8,mixedType,1
10,2,0,12,mixedType,1
8,3,0,11,mixedType,1
6,3,0,9,mixedType,1
13,3,0,16,mixedType,2
4,2,0,6,mixedType,0
8,2,0,10,mixedType,1
4,4,0,8,mixedType,1
6,3,0,9,mixedType,1
5,4,0,9,mixedType,1
6,4,0,10,mixedType,1
7,3,0,10,mixedType,1
6,3,0,9,mixedType,1
1,9,0,10,mixedType,1
5,4,0,9,mixedType,1
9,2,0,11,mixedType,1
7,3,0,10,mixedType,1
9,2,0,11,mixedType,1
6,1,0,7,mixedType,0
6,1,0,7,mixedType,0
3,7,0,10,mixedType,1
14,2,0,16,mixedType,2
6,1,0,7,mixedType,0
3,3,0,6,mixedType,0
9,1,0,10,mixedType,1
6,2,0,8,mixedType,1
8,3,0,11,mixedType,1
6,2,0,8,mixedType,1
9,1,0,10,mixedType,1
8,1,0,9,mixedType,1
7,2,0,9,mixedType,1
6,4,0,10,mixedType,1
8,1,0,9,mixedType,1
7,2,0,9,mixedType,1
8,1,0,9,mixedType,1
7,3,0,10,mixedType,1
6,4,0,10,mixedType,1
1,8,0,9,mixedType,1
7,4,0,11,mixedType,1
8,1,0,9,mixedType,1
9,1,0,10,mixedType,1
9,2,0,11,mixedType,1
11,4,0,15,mixedType,2
5,8,1,14,mixedType,2
5,2,0,7,mixedType,0
8,1,0,9,mixedType,1
6,2,0,8,mixedType,1
11,1,0,12,mixedType,1
6,4,0,10,mixedType,1
6,2,0,8,mixedType,1
5,1,0,6,mixedType,0
5,3,0,8,mixedType,1
8,1,0,9,mixedType,1
8,1,0,9,mixedType,1
5,3,0,8,mixedType,1
6,1,0,7,mixedType,0
9,1,0,10,mixedType,1
6,2,0,8,mixedType,1
7,2,0,9,mixedType,1
8,2,0,10,mixedType,1
9,2,0,11,mixedType,1
5,3,0,8,mixedType,1
9,1,0,10,mixedType,1
9,1,0,10,mixedType,1
7,2,0,9,mixedType,1
9,1,0,10,mixedType,1
7,2,0,9,mixedType,1
1,8,0,9,mixedType,1
1,6,0,7,mixedType,0
7,3,0,10,mixedType,1
5,3,0,8,mixedType,1
14,2,0,16,mixedType,2
2,4,0,6,mixedType,0
7,1,0,8,mixedType,1
6,2,0,8,mixedType,1
6,2,0,8,mixedType,1
6,5,0,11,mixedType,1
4,4,0,8,mixedType,1
13,3,0,16,mixedType,2
15,1,0,16,mixedType,2
8,4,0,12,mixedType,1
12,3,0,15,mixedType,2
6,4,0,10,mixedType,1
10,3,0,13,mixedType,1
5,2,0,7,mixedType,0
14,2,0,16,mixedType,2
7,3,0,10,mixedType,1
14,2,0,16,mixedType,2
9,1,0,10,mixedType,1
2,6,0,8,mixedType,1
7,3,0,10,mixedType,1
14,2,0,16,mixedType,2
15,1,0,16,mixedType,2
4,2,0,6,mixedType,0
8,2,0,10,mixedType,1
8,4,0,12,mixedType,1
6,4,0,10,mixedType,1
4,4,0,8,mixedType,1
10,1,0,11,mixedType,1
5,2,0,7,mixedType,0
1,10,0,11,mixedType,1
9,2,0,11,mixedType,1
7,2,0,9,mixedType,1
6,2,0,8,mixedType,1
4,2,0,6,mixedType,0
6,2,0,8,mixedType,1
12,3,0,15,mixedType,2
5,3,0,8,mixedType,1
4,2,0,6,mixedType,0
7,3,0,10,mixedType,1
6,3,0,9,mixedType,1
7,3,0,10,mixedType,1
4,6,0,10,mixedType,1
6,3,0,9,mixedType,1
6,3,0,9,mixedType,1
7,3,0,10,mixedType,1
9,3,0,12,mixedType,1
4,2,0,6,mixedType,0
8,1,0,9,mixedType,1
6,2,0,8,mixedType,1
9,3,0,12,mixedType,1
2,8,0,10,mixedType,1
8,1,0,9,mixedType,1
8,1,0,9,mixedType,1
1,10,0,11,mixedType,1
3,10,0,13,mixedType,1
5,3,0,8,mixedType,1
2,7,0,9,mixedType,1
12,4,0,16,mixedType,2
13,3,0,16,mixedType,2
6,4,0,10,mixedType,1
7,2,0,9,mixedType,1
8,1,0,9,mixedType,1
12,3,0,15,mixedType,2
8,2,0,10,mixedType,1
14,2,0,16,mixedType,2
8,1,0,9,mixedType,1
5,4,0,9,mixedType,1
2,10,0,12,mixedType,1
6,6,0,12,mixedType,1
6,4,0,10,mixedType,1
4,2,0,6,mixedType,0
6,3,0,9,mixedType,1
3,3,0,6,mixedType,0
1,11,0,12,mixedType,1
7,0,3,10,mixedType,1
5,3,0,8,mixedType,1
6,1,0,7,mixedType,0
6,3,0,9,mixedType,1
6,3,0,9,mixedType,1
5,2,0,7,mixedType,0
5,3,0,8,mixedType,1
8,2,0,10,mixedType,1
16,1,1,18,mixedType,2
11,2,0,13,mixedType,1
8,3,0,11,mixedType,1
5,3,0,8,mixedType,1
6,2,0,8,mixedType,1
5,4,0,9,mixedType,1
6,4,0,10,mixedType,1
7,2,0,9,mixedType,1
8,2,0,10,mixedType,1
5,3,0,8,mixedType,1
5,2,0,7,mixedType,0
6,2,0,8,mixedType,1
8,1,0,9,mixedType,1
3,9,0,12,mixedType,1
5,2,0,7,mixedType,0
5,3,0,8,mixedType,1
14,2,0,16,mixedType,2
6,3,0,9,mixedType,1
6,6,0,12,mixedType,1
6,4,0,10,mixedType,1
6,2,0,8,mixedType,1
2,4,0,6,mixedType,0
6,4,0,10,mixedType,1
4,4,0,8,mixedType,1
7,3,0,10,mixedType,1
5,4,0,9,mixedType,1
1,7,0,8,mixedType,1
8,1,0,9,mixedType,1
5,2,0,7,mixedType,0
5,1,0,6,mixedType,0
4,2,0,6,mixedType,0
7,2,0,9,mixedType,1
6,2,0,8,mixedType,1
12,3,0,15,mixedType,2
7,2,0,9,mixedType,1
7,3,0,10,mixedType,1
1,9,0,10,mixedType,1
8,2,0,10,mixedType,1
5,3,0,8,mixedType,1
9,1,0,10,mixedType,1
7,3,0,10,mixedType,1
6,2,0,8,mixedType,1
2,6,0,8,mixedType,1
10,3,0,13,mixedType,1
10,2,0,12,mixedType,1
2,4,0,6,mixedType,0
7,3,0,10,mixedType,1
8,1,0,9,mixedType,1
5,2,0,7,mixedType,0
14,2,0,16,mixedType,2
3,6,0,9,mixedType,1
1,8,0,9,mixedType,1
19,3,2,24,mixedType,2
8,1,0,9,mixedType,1
5,3,0,8,mixedType,1
6,2,0,8,mixedType,1
7,1,0,8,mixedType,1
7,3,0,10,mixedType,1
5,2,0,7,mixedType,0
5,3,0,8,mixedType,1
5,3,0,8,mixedType,1
5,3,0,8,mixedType,1
1,8,0,9,mixedType,1
1,8,0,9,mixedType,1
4,6,0,10,mixedType,1
8,4,0,12,mixedType,1
11,3,0,14,mixedType,2
7,5,0,12,mixedType,1
5,2,0,7,mixedType,0
9,1,0,10,mixedType,1
8,3,0,11,mixedType,1
7,3,0,10,mixedType,1
2,4,0,6,mixedType,0
9,1,0,10,mixedType,1
7,2,0,9,mixedType,1
7,1,0,8,mixedType,1
4,2,0,6,mixedType,0
6,10,0,16,mixedType,2
6,1,0,7,mixedType,0
7,2,0,9,mixedType,1
5,6,0,11,mixedType,1
3,7,0,10,mixedType,1
8,2,0,10,mixedType,1
14,2,0,16,mixedType,2
6,2,0,8,mixedType,1
14,2,0,16,mixedType,2
15,1,0,16,mixedType,2
7,2,0,9,mixedType,1
3,6,0,9,mixedType,1
2,7,0,9,mixedType,1
2,10,0,12,mixedType,1
9,3,0,12,mixedType,1
1,12,0,13,mixedType,1
11,0,2,13,mixedType,1
14,2,0,16,mixedType,2
10,1,0,11,mixedType,1
7,1,0,8,mixedType,1
4,2,0,6,mixedType,0
12,4,0,16,mixedType,2
6,4,0,10,mixedType,1
10,0,1,11,mixedType,1
8,1,0,9,mixedType,1
2,6,0,8,mixedType,1
6,3,0,9,mixedType,1
1,9,0,10,mixedType,1
1,7,0,8,mixedType,1
6,3,0,9,mixedType,1
2,7,0,9,mixedType,1
6,2,0,8,mixedType,1
4,2,0,6,mixedType,0
15,1,0,16,mixedType,2
1,8,0,9,mixedType,1
3,8,0,11,mixedType,1
1,6,0,7,mixedType,0
13,3,0,16,mixedType,2
14,2,0,16,mixedType,2
11,5,0,16,mixedType,2
1,8,0,9,mixedType,1
5,4,0,9,mixedType,1
5,3,0,8,mixedType,1
5,1,0,6,mixedType,0
6,2,0,8,mixedType,1
6,1,0,7,mixedType,0
3,10,0,13,mixedType,1
7,4,0,11,mixedType,1
7,3,0,10,mixedType,1
7,3,0,10,mixedType,1
6,3,0,9,mixedType,1
5,3,0,8,mixedType,1
3,3,0,6,mixedType,0
6,4,0,10,mixedType,1
13,3,0,16,mixedType,2
7,1,0,8,mixedType,1
5,3,0,8,mixedType,1
3,8,0,11,mixedType,1
5,3,0,8,mixedType,1
7,3,0,10,mixedType,1
7,3,0,10,mixedType,1
7,1,0,8,mixedType,1
8,2,0,10,mixedType,1
8,2,0,10,mixedType,1
6,2,0,8,mixedType,1
9,1,0,10,mixedType,1
4,2,0,6,mixedType,0
9,1,0,10,mixedType,1
1,7,0,8,mixedType,1
12,4,0,16,mixedType,2
6,3,0,9,mixedType,1
11,3,0,14,mixedType,2
7,3,0,10,mixedType,1
7,3,0,10,mixedType,1
4,4,0,8,mixedType,1
1,7,0,8,mixedType,1
7,3,0,10,mixedType,1
7,2,0,9,mixedType,1
5,3,0,8,mixedType,1
1,9,0,10,mixedType,1
9,1,0,10,mixedType,1
9,1,0,10,mixedType,1
4,5,0,9,mixedType,1
6,3,0,9,mixedType,1
14,2,0,16,mixedType,2
7,1,0,8,mixedType,1
9,4,0,13,mixedType,1
9,3,0,12,mixedType,1
5,4,0,9,mixedType,1
6,1,0,7,mixedType,0
11,0,1,12,mixedType,1
6,1,0,7,mixedType,0
3,6,0,9,mixedType,1
5,1,0,6,mixedType,0
10,1,0,11,mixedType,1
5,3,0,8,mixedType,1
14,4,0,18,mixedType,2
5,3,0,8,mixedType,1
5,1,0,6,mixedType,0
6,2,0,8,mixedType,1
7,2,0,9,mixedType,1
5,3,0,8,mixedType,1
4,2,0,6,mixedType,0
1,11,0,12,mixedType,1
4,6,0,10,mixedType,1
7,2,0,9,mixedType,1
6,2,0,8,mixedType,1
6,3,0,9,mixedType,1
7,3,0,10,mixedType,1
6,3,0,9,mixedType,1
4,5,0,9,mixedType,1
7,3,0,10,mixedType,1
10,1,0,11,mixedType,1
3,8,0,11,mixedType,1
4,2,0,6,mixedType,0
6,6,0,12,mixedType,1
4,4,0,8,mixedType,1
7,3,0,10,mixedType,1
7,2,0,9,mixedType,1
8,1,0,9,mixedType,1
8,1,0,9,mixedType,1
8,4,0,12,mixedType,1
8,4,0,12,mixedType,1
12,3,0,15,mixedType,2
5,1,0,6,mixedType,0
9,2,0,11,mixedType,1
8,1,0,9,mixedType,1
5,5,0,10,mixedType,1
6,6,0,12,mixedType,1
9,1,0,10,mixedType,1
8,1,0,9,mixedType,1
8,2,0,10,mixedType,1
3,7,0,10,mixedType,1
6,4,0,10,mixedType,1
4,6,0,10,mixedType,1
8,1,0,9,mixedType,1
6,3,0,9,mixedType,1
6,2,0,8,mixedType,1
4,2,0,6,mixedType,0
11,5,0,16,mixedType,2
5,2,0,7,mixedType,0
4,2,0,6,mixedType,0
6,2,0,8,mixedType,1
5,4,0,9,mixedType,1
3,5,0,8,mixedType,1
5,6,0,11,mixedType,1
6,3,0,9,mixedType,1
12,4,0,16,mixedType,2
7,2,0,9,mixedType,1
5,1,0,6,mixedType,0
6,4,0,10,mixedType,1
14,2,0,16,mixedType,2
1,8,0,9,mixedType,1
8,2,0,10,mixedType,1
5,2,0,7,mixedType,0
5,4,0,9,mixedType,1
11,2,0,13,mixedType,1
7,1,0,8,mixedType,1
8,1,0,9,mixedType,1
6,2,0,8,mixedType,1
6,1,0,7,mixedType,0
4,8,0,12,mixedType,1
5,3,0,8,mixedType,1
6,2,0,8,mixedType,1
8,1,0,9,mixedType,1
7,2,0,9,mixedType,1
5,4,0,9,mixedType,1
4,4,0,8,mixedType,1
7,3,0,10,mixedType,1
7,3,0,10,mixedType,1
12,4,0,16,mixedType,2
9,1,0,10,mixedType,1
5,3,0,8,mixedType,1
8,1,0,9,mixedType,1
4,6,0,10,mixedType,1
8,1,0,9,mixedType,1
1,9,0,10,mixedType,1
5,4,0,9,mixedType,1
1,0,7,8,mixedType,1
5,4,0,9,mixedType,1
5,3,0,8,mixedType,1
11,2,0,13,mixedType,1
5,3,0,8,mixedType,1
2,7,0,9,mixedType,1
5,4,0,9,mixedType,1
8,3,0,11,mixedType,1
7,3,0,10,mixedType,1
5,4,0,9,mixedType,1
7,3,0,10,mixedType,1
8,2,0,10,mixedType,1
7,3,0,10,mixedType,1
1,8,0,9,mixedType,1
6,4,0,10,mixedType,1
6,1,0,7,mixedType,0
5,3,0,8,mixedType,1
7,6,1,14,mixedType,2
14,2,0,16,mixedType,2
13,3,0,16,mixedType,2
5,1,0,6,mixedType,0
13,3,0,16,mixedType,2
6,2,0,8,mixedType,1
7,3,0,10,mixedType,1
4,4,0,8,mixedType,1
7,2,0,9,mixedType,1
7,2,0,9,mixedType,1
8,3,0,11,mixedType,1
13,3,0,16,mixedType,2
7,2,0,9,mixedType,1
7,3,0,10,mixedType,1
11,3,0,14,mixedType,2
1,11,0,12,mixedType,1
15,1,0,16,mixedType,2
9,3,0,12,mixedType,1
5,3,0,8,mixedType,1
4,2,0,6,mixedType,0
5,1,0,6,mixedType,0
7,3,0,10,mixedType,1
8,1,0,9,mixedType,1
7,1,0,8,mixedType,1
6,1,0,7,mixedType,0
7,1,0,8,mixedType,1
10,3,0,13,mixedType,1
9,4,0,13,mixedType,1
9,1,0,10,mixedType,1
6,3,0,9,mixedType,1
1,7,0,8,mixedType,1
1,8,0,9,mixedType,1
4,2,0,6,mixedType,0
7,3,0,10,mixedType,1
8,1,0,9,mixedType,1
12,3,0,15,mixedType,2
2,8,0,10,mixedType,1
6,2,0,8,mixedType,1
6,2,0,8,mixedType,1
8,3,0,11,mixedType,1
4,4,0,8,mixedType,1
7,3,0,10,mixedType,1
6,3,0,9,mixedType,1
8,3,0,11,mixedType,1
5,4,0,9,mixedType,1
5,4,0,9,mixedType,1
5,1,0,6,mixedType,0
5,2,0,7,mixedType,0
9,1,0,10,mixedType,1
7,3,0,10,mixedType,1
15,1,0,16,mixedType,2
8,3,0,11,mixedType,1
5,3,0,8,mixedType,1
8,2,0,10,mixedType,1
4,6,0,10,mixedType,1
6,1,0,7,mixedType,0
6,5,0,11,mixedType,1
7,1,7,15,mixedType,2
5,3,0,8,mixedType,1
7,5,0,12,mixedType,1
6,2,0,8,mixedType,1
8,2,0,10,mixedType,1
8,1,0,9,mixedType,1
9,1,0,10,mixedType,1
6,4,0,10,mixedType,1
6,3,0,9,mixedType,1
8,3,0,11,mixedType,1
4,0,4,8,mixedType,1
15,1,0,16,mixedType,2
6,3,0,9,mixedType,1
4,2,0,6,mixedType,0
6,4,0,10,mixedType,1
2,9,0,11,mixedType,1
7,3,0,10,mixedType,1
6,2,0,8,mixedType,1
7,2,0,9,mixedType,1
6,3,0,9,mixedType,1
6,4,0,10,mixedType,1
10,5,0,15,mixedType,2
6,4,0,10,mixedType,1
12,3,0,15,mixedType,2
5,2,0,7,mixedType,0
5,2,0,7,mixedType,0
4,5,0,9,mixedType,1
14,2,0,16,mixedType,2
6,3,0,9,mixedType,1
4,4,0,8,mixedType,1
10,1,0,11,mixedType,1
13,3,0,16,mixedType,2
9,4,0,13,mixedType,1
2,6,0,8,mixedType,1
4,2,0,6,mixedType,0
8,4,0,12,mixedType,1
6,1,0,7,mixedType,0
7,2,0,9,mixedType,1
7,3,0,10,mixedType,1
6,3,0,9,mixedType,1
5,2,0,7,mixedType,0
3,7,0,10,mixedType,1
7,4,0,11,mixedType,1
7,4,0,11,mixedType,1
8,1,0,9,mixedType,1
9,2,0,11,mixedType,1
4,4,0,8,mixedType,1
7,2,0,9,mixedType,1
12,4,0,16,mixedType,2
17,3,0,20,mixedType,2
1,9,0,10,mixedType,1
5,7,0,12,mixedType,1
4,2,0,6,mixedType,0
14,2,0,16,mixedType,2
6,3,0,9,mixedType,1
6,2,0,8,mixedType,1
11,3,0,14,mixedType,2
4,2,0,6,mixedType,0
7,2,0,9,mixedType,1
11,1,0,12,mixedType,1
7,4,0,11,mixedType,1
4,2,0,6,mixedType,0
5,6,0,11,mixedType,1
3,10,0,13,mixedType,1
9,2,0,11,mixedType,1
9,1,0,10,mixedType,1
6,3,0,9,mixedType,1
4,4,0,8,mixedType,1
6,4,0,10,mixedType,1
14,2,0,16,mixedType,2
9,1,0,10,mixedType,1
6,2,0,8,mixedType,1
1,8,0,9,mixedType,1
9,2,0,11,mixedType,1
2,8,0,10,mixedType,1
9,2,0,11,mixedType,1
4,5,0,9,mixedType,1
8,1,0,9,mixedType,1
7,2,0,9,mixedType,1
1,10,0,11,mixedType,1
3,3,0,6,mixedType,0
13,3,1,17,mixedType,2
9,1,0,10,mixedType,1
6,3,0,9,mixedType,1
4,6,0,10,mixedType,1
9,1,0,10,mixedType,1
15,1,0,16,mixedType,2
5,2,0,7,mixedType,0
8,2,0,10,mixedType,1
7,2,0,9,mixedType,1
2,4,0,6,mixedType,0
9,2,0,11,mixedType,1
12,4,0,16,mixedType,2
7,2,0,9,mixedType,1
4,7,0,11,mixedType,1
9,3,0,12,mixedType,1
7,3,0,10,mixedType,1
2,6,0,8,mixedType,1
3,6,0,9,mixedType,1
5,4,0,9,mixedType,1
13,3,0,16,mixedType,2
5,3,0,8,mixedType,1
6,1,0,7,mixedType,0
6,2,0,8,mixedType,1
5,3,0,8,mixedType,1
7,4,0,11,mixedType,1
13,3,0,16,mixedType,2
5,3,0,8,mixedType,1
7,12,0,19,mixedType,2
7,3,0,10,mixedType,1
8,2,0,10,mixedType,1
14,2,0,16,mixedType,2
7,3,0,10,mixedType,1
11,2,2,15,mixedType,2
4,2,0,6,mixedType,0
2,7,0,9,mixedType,1
2,9,0,11,mixedType,1
4,2,0,6,mixedType,0
10,4,0,14,mixedType,2
6,4,0,10,mixedType,1
5,3,0,8,mixedType,1
7,2,0,9,mixedType,1
9,2,0,11,mixedType,1
6,2,0,8,mixedType,1
6,3,0,9,mixedType,1
4,4,0,8,mixedType,1
7,3,0,10,mixedType,1
6,6,0,12,mixedType,1
7,3,0,10,mixedType,1
4,2,0,6,mixedType,0
6,2,0,8,mixedType,1
12,1,0,13,mixedType,1
4,2,0,6,mixedType,0
6,3,0,9,mixedType,1
9,6,0,15,mixedType,2
7,3,0,10,mixedType,1
3,6,0,9,mixedType,1
13,3,0,16,mixedType,2
7,6,0,13,mixedType,1
9,5,0,14,mixedType,2
5,3,0,8,mixedType,1
5,4,0,9,mixedType,1
1,8,0,9,mixedType,1
5,2,0,7,mixedType,0
3,6,0,9,mixedType,1
13,3,0,16,mixedType,2
8,4,0,12,mixedType,1
3,6,0,9,mixedType,1
5,4,0,9,mixedType,1
9,2,0,11,mixedType,1
12,3,0,15,mixedType,2
6,4,0,10,mixedType,1
7,6,0,13,mixedType,1
3,5,0,8,mixedType,1
13,3,1,17,mixedType,2
2,8,0,10,mixedType,1
10,6,0,16,mixedType,2
5,2,0,7,mixedType,0
9,1,0,10,mixedType,1
9,3,0,12,mixedType,1
11,3,0,14,mixedType,2
7,1,0,8,mixedType,1
1,7,0,8,mixedType,1
9,1,0,10,mixedType,1
7,1,0,8,mixedType,1
9,1,0,10,mixedType,1
6,3,0,9,mixedType,1
7,3,0,10,mixedType,1
7,2,0,9,mixedType,1
2,6,0,8,mixedType,1
7,2,0,9,mixedType,1
6,3,0,9,mixedType,1
6,2,0,8,mixedType,1
8,1,0,9,mixedType,1
6,4,0,10,mixedType,1
7,3,0,10,mixedType,1
5,3,0,8,mixedType,1
7,2,0,9,mixedType,1
4,4,0,8,mixedType,1
7,1,0,8,mixedType,1
9,4,0,13,mixedType,1
15,1,0,16,mixedType,2
7,3,0,10,mixedType,1
5,1,0,6,mixedType,0
2,4,0,6,mixedType,0
5,3,0,8,mixedType,1
2,6,0,8,mixedType,1
11,1,0,12,mixedType,1
6,3,0,9,mixedType,1
2,6,0,8,mixedType,1
6,4,0,10,mixedType,1
5,2,0,7,mixedType,0
5,2,0,7,mixedType,0
11,1,0,12,mixedType,1
3,6,0,9,mixedType,1
7,3,0,10,mixedType,1
4,4,0,8,mixedType,1
7,3,0,10,mixedType,1
7,3,0,10,mixedType,1
3,6,0,9,mixedType,1
7,3,0,10,mixedType,1
5,2,0,7,mixedType,0
13,3,0,16,mixedType,2
7,2,0,9,mixedType,1
15,2,1,18,mixedType,2
8,1,0,9,mixedType,1
11,5,0,16,mixedType,2
8,2,0,10,mixedType,1
0,7,1,8,mixedType,1
5,2,0,7,mixedType,0
6,4,0,10,mixedType,1
8,2,0,10,mixedType,1
8,2,0,10,mixedType,1
7,2,0,9,mixedType,1
8,4,0,12,mixedType,1
6,2,0,8,mixedType,1
4,2,0,6,mixedType,0
9,1,0,10,mixedType,1
8,1,0,9,mixedType,1
5,3,0,8,mixedType,1
3,9,0,12,mixedType,1
15,1,1,17,mixedType,2
4,6,0,10,mixedType,1
6,2,0,8,mixedType,1
7,2,0,9,mixedType,1
6,3,0,9,mixedType,1
14,2,0,16,mixedType,2
6,3,0,9,mixedType,1
10,1,0,11,mixedType,1
15,1,0,16,mixedType,2
13,3,0,16,mixedType,2
4,4,0,8,mixedType,1
8,2,0,10,mixedType,1
5,3,0,8,mixedType,1
14,1,0,15,mixedType,2
5,4,0,9,mixedType,1
5,1,0,6,mixedType,0
8,2,0,10,mixedType,1
5,3,0,8,mixedType,1
6,2,0,8,mixedType,1
5,2,0,7,mixedType,0
2,8,0,10,mixedType,1
7,4,0,11,mixedType,1
9,1,0,10,mixedType,1
6,3,0,9,mixedType,1
4,4,0,8,mixedType,1
5,1,0,6,mixedType,0
11,3,0,14,mixedType,2
5,2,0,7,mixedType,0
6,4,0,10,mixedType,1
11,6,0,17,mixedType,2
3,8,0,11,mixedType,1
9,1,0,10,mixedType,1
5,4,0,9,mixedType,1
6,3,0,9,mixedType,1
7,4,0,11,mixedType,1
8,1,0,9,mixedType,1
4,4,0,8,mixedType,1
2,6,0,8,mixedType,1
2,6,0,8,mixedType,1
6,1,0,7,mixedType,0
5,1,0,6,mixedType,0
13,3,0,16,mixedType,2
11,5,0,16,mixedType,2
7,3,0,10,mixedType,1
6,4,0,10,mixedType,1
2,6,0,8,mixedType,1
10,1,0,11,mixedType,1
8,1,0,9,mixedType,1
4,2,0,6,mixedType,0
10,4,0,14,mixedType,2
3,9,0,12,mixedType,1
7,3,0,10,mixedType,1
15,1,0,16,mixedType,2
12,3,0,15,mixedType,2
7,1,0,8,mixedType,1
6,6,0,12,mixedType,1
13,3,0,16,mixedType,2
5,2,0,7,mixedType,0
13,2,0,15,mixedType,2
6,4,0,10,mixedType,1
6,3,0,9,mixedType,1
5,2,0,7,mixedType,0
9,1,0,10,mixedType,1
4,2,0,6,mixedType,0
7,3,0,10,mixedType,1
4,4,0,8,mixedType,1
9,7,0,16,mixedType,2
8,5,0,13,mixedType,1
1,7,0,8,mixedType,1
4,2,0,6,mixedType,0
3,3,0,6,mixedType,0
1,9,0,10,mixedType,1
9,3,0,12,mixedType,1
8,2,0,10,mixedType,1
5,4,0,9,mixedType,1
19,1,1,21,mixedType,2
5,2,0,7,mixedType,0
15,1,0,16,mixedType,2
7,3,0,10,mixedType,1
15,1,0,16,mixedType,2
8,2,0,10,mixedType,1
6,3,0,9,mixedType,1
7,3,0,10,mixedType,1
6,2,0,8,mixedType,1
6,3,0,9,mixedType,1
14,2,0,16,mixedType,2
14,2,0,16,mixedType,2
8,1,0,9,mixedType,1
6,3,0,9,mixedType,1
5,3,0,8,mixedType,1
11,5,0,16,mixedType,2
5,1,0,6,mixedType,0
7,3,0,10,mixedType,1
12,4,0,16,mixedType,2
1,12,0,13,mixedType,1
4,2,0,6,mixedType,0
6,1,0,7,mixedType,0
10,3,0,13,mixedType,1
4,6,0,10,mixedType,1
6,3,0,9,mixedType,1
5,4,0,9,mixedType,1
14,2,0,16,mixedType,2
5,1,0,6,mixedType,0
5,3,0,8,mixedType,1
9,1,0,10,mixedType,1
2,6,0,8,mixedType,1
5,2,0,7,mixedType,0
8,2,0,10,mixedType,1
3,7,0,10,mixedType,1
6,3,0,9,mixedType,1
11,5,0,16,mixedType,2
6,3,0,9,mixedType,1
5,4,0,9,mixedType,1
5,1,0,6,mixedType,0
4,2,0,6,mixedType,0
5,3,0,8,mixedType,1
7,2,0,9,mixedType,1
7,2,0,9,mixedType,1
6,3,0,9,mixedType,1
5,4,0,9,mixedType,1
8,2,0,10,mixedType,1
8,2,0,10,mixedType,1
8,3,0,11,mixedType,1
6,3,0,9,mixedType,1
6,1,0,7,mixedType,0
8,1,0,9,mixedType,1
6,2,0,8,mixedType,1
10,1,0,11,mixedType,1
3,6,0,9,mixedType,1
4,2,0,6,mixedType,0
7,3,0,10,mixedType,1
13,3,0,16,mixedType,2
15,1,0,16,mixedType,2
2,6,0,8,mixedType,1
7,2,0,9,mixedType,1
6,4,0,10,mixedType,1
11,3,0,14,mixedType,2
7,3,0,10,mixedType,1
6,1,0,7,mixedType,0
7,2,0,9,mixedType,1
4,2,0,6,mixedType,0
7,3,0,10,mixedType,1
5,4,0,9,mixedType,1
13,3,0,16,mixedType,2
5,4,0,9,mixedType,1
6,3,0,9,mixedType,1
9,4,0,13,mixedType,1
6,4,0,10,mixedType,1
13,3,0,16,mixedType,2
5,2,0,7,mixedType,0
7,1,0,8,mixedType,1
7,2,0,9,mixedType,1
7,1,0,8,mixedType,1
6,1,0,7,mixedType,0
9,1,0,10,mixedType,1
9,3,0,12,mixedType,1
6,2,0,8,mixedType,1
5,2,0,7,mixedType,0
4,4,0,8,mixedType,1
3,8,0,11,mixedType,1
3,6,0,9,mixedType,1
7,4,0,11,mixedType,1
6,3,0,9,mixedType,1
6,3,0,9,mixedType,1
11,5,0,16,mixedType,2
4,4,0,8,mixedType,1
8,2,0,10,mixedType,1
7,3,0,10,mixedType,1
15,1,0,16,mixedType,2
5,2,0,7,mixedType,0
7,3,0,10,mixedType,1
9,1,0,10,mixedType,1
6,3,0,9,mixedType,1
7,2,0,9,mixedType,1
3,6,0,9,mixedType,1
9,1,0,10,mixedType,1
5,3,0,8,mixedType,1
4,2,0,6,mixedType,0
6,1,0,7,mixedType,0
8,1,0,9,mixedType,1
6,2,0,8,mixedType,1
13,3,0,16,mixedType,2
5,3,0,8,mixedType,1
5,4,0,9,mixedType,1
1,6,0,7,mixedType,0
6,2,0,8,mixedType,1
2,4,0,6,mixedType,0
4,2,0,6,mixedType,0
4,2,0,6,mixedType,0
7,3,0,10,mixedType,1
8,1,0,9,mixedType,1
3,6,0,9,mixedType,1
5,3,0,8,mixedType,1
7,2,0,9,mixedType,1
14,2,0,16,mixedType,2
15,3,2,20,mixedType,2
11,3,0,14,mixedType,2
5,2,0,7,mixedType,0
9,3,0,12,mixedType,1
3,3,0,6,mixedType,0
7,3,0,10,mixedType,1
1,7,0,8,mixedType,1
6,4,0,10,mixedType,1
14,2,0,16,mixedType,2
7,3,0,10,mixedType,1
6,4,0,10,mixedType,1
7,2,0,9,mixedType,1
2,6,0,8,mixedType,1
13,3,0,16,mixedType,2
0,6,2,8,mixedType,1
7,1,0,8,mixedType,1
12,3,0,15,mixedType,2
1,8,0,9,mixedType,1
6,4,0,10,mixedType,1
1,9,0,10,mixedType,1
8,1,0,9,mixedType,1
5,4,0,9,mixedType,1
7,2,0,9,mixedType,1
9,4,0,13,mixedType,1
9,2,0,11,mixedType,1
7,3,0,10,mixedType,1
6,2,0,8,mixedType,1
3,6,0,9,mixedType,1
8,3,0,11,mixedType,1
13,3,0,16,mixedType,2
10,3,0,13,mixedType,1
7,2,0,9,mixedType,1
8,3,0,11,mixedType,1
8,2,0,10,mixedType,1
4,4,0,8,mixedType,1
7,3,0,10,mixedType,1
4,4,0,8,mixedType,1
7,3,0,10,mixedType,1
6,1,0,7,mixedType,0
7,2,0,9,mixedType,1
12,4,0,16,mixedType,2
5,1,0,6,mixedType,0
3,6,0,9,mixedType,1
2,6,0,8,mixedType,1
6,4,0,10,mixedType,1
5,3,0,8,mixedType,1
5,4,0,9,mixedType,1
11,5,0,16,mixedType,2
8,3,0,11,mixedType,1
5,1,0,6,mixedType,0
6,1,0,7,mixedType,0
13,3,0,16,mixedType,2
5,1,0,6,mixedType,0
6,2,0,8,mixedType,1
7,2,0,9,mixedType,1
5,3,0,8,mixedType,1
5,8,0,13,mixedType,1
15,3,1,19,mixedType,2
3,6,0,9,mixedType,1
4,6,0,10,mixedType,1
7,3,0,10,mixedType,1
4,4,0,8,mixedType,1
6,2,0,8,mixedType,1
7,3,0,10,mixedType,1
6,2,0,8,mixedType,1
6,2,0,8,mixedType,1
5,4,0,9,mixedType,1
3,6,0,9,mixedType,1
2,6,0,8,mixedType,1
2,8,0,10,mixedType,1
7,4,0,11,mixedType,1
8,1,0,9,mixedType,1
5,3,0,8,mixedType,1
10,1,0,11,mixedType,1
7,6,0,13,mixedType,1
4,2,0,6,mixedType,0
6,4,0,10,mixedType,1
11,1,0,12,mixedType,1
4,4,0,8,mixedType,1
19,1,1,21,mixedType,2
5,2,0,7,mixedType,0
7,1,0,8,mixedType,1
6,2,0,8,mixedType,1
5,1,0,6,mixedType,0
7,3,0,10,mixedType,1
8,2,0,10,mixedType,1
4,5,0,9,mixedType,1
8,2,0,10,mixedType,1
13,3,0,16,mixedType,2
6,2,0,8,mixedType,1
6,5,0,11,mixedType,1
8,1,0,9,mixedType,1
5,3,0,8,mixedType,1
6,3,0,9,mixedType,1
6,3,0,9,mixedType,1
5,3,0,8,mixedType,1
6,4,0,10,mixedType,1
6,3,0,9,mixedType,1
12,3,0,15,mixedType,2
4,6,0,10,mixedType,1
6,2,0,8,mixedType,1
2,7,0,9,mixedType,1
8,1,0,9,mixedType,1
7,1,0,8,mixedType,1
9,1,0,10,mixedType,1
7,2,0,9,mixedType,1
9,1,0,10,mixedType,1
13,3,0,16,mixedType,2
13,3,0,16,mixedType,2
4,2,0,6,mixedType,0
7,2,0,9,mixedType,1
5,1,0,6,mixedType,0
6,2,0,8,mixedType,1
7,1,0,8,mixedType,1
5,3,0,8,mixedType,1
6,1,0,7,mixedType,0
13,3,0,16,mixedType,2
4,2,0,6,mixedType,0
7,1,0,8,mixedType,1
5,1,0,6,mixedType,0
7,3,0,10,mixedType,1
5,3,0,8,mixedType,1
9,1,0,10,mixedType,1
4,2,0,6,mixedType,0
6,3,0,9,mixedType,1
7,2,0,9,mixedType,1
7,2,0,9,mixedType,1
4,8,0,12,mixedType,1
6,3,0,9,mixedType,1
4,4,0,8,mixedType,1
11,2,0,13,mixedType,1
6,1,0,7,mixedType,0
5,3,0,8,mixedType,1
6,2,0,8,mixedType,1
4,2,0,6,mixedType,0
6,3,0,9,mixedType,1
8,2,0,10,mixedType,1
4,2,0,6,mixedType,0
6,4,0,10,mixedType,1
8,4,0,12,mixedType,1
7,2,0,9,mixedType,1
9,3,0,12,mixedType,1
7,1,0,8,mixedType,1
3,3,0,6,mixedType,0
6,2,0,8,mixedType,1
7,1,0,8,mixedType,1
9,3,0,12,mixedType,1
15,1,0,16,mixedType,2
6,2,0,8,mixedType,1
5,2,0,7,mixedType,0
7,2,0,9,mixedType,1
7,1,0,8,mixedType,1
10,4,2,16,mixedType,2
3,5,0,8,mixedType,1
4,4,0,8,mixedType,1
8,4,0,12,mixedType,1
7,2,0,9,mixedType,1
7,3,0,10,mixedType,1
7,3,0,10,mixedType,1
8,3,0,11,mixedType,1
7,3,0,10,mixedType,1
4,4,0,8,mixedType,1
6,3,0,9,mixedType,1
6,2,0,8,mixedType,1
7,3,0,10,mixedType,1
6,3,0,9,mixedType,1
8,3,0,11,mixedType,1
5,3,0,8,mixedType,1
6,4,0,10,mixedType,1
6,2,0,8,mixedType,1
5,2,0,7,mixedType,0
5,3,0,8,mixedType,1
10,2,0,12,mixedType,1
2,7,0,9,mixedType,1
6,2,0,8,mixedType,1
7,3,0,10,mixedType,1
5,1,0,6,mixedType,0
7,1,0,8,mixedType,1
6,1,0,7,mixedType,0
5,7,0,12,mixedType,1
1,5,0,6,mixedType,0
12,1,0,13,mixedType,1
4,4,0,8,mixedType,1
6,4,0,10,mixedType,1
7,3,0,10,mixedType,1
4,2,0,6,mixedType,0
7,1,0,8,mixedType,1
5,1,0,6,mixedType,0
7,3,0,10,mixedType,1
5,6,0,11,mixedType,1
9,2,0,11,mixedType,1
5,2,0,7,mixedType,0
4,4,0,8,mixedType,1
7,2,0,9,mixedType,1
17,1,1,19,mixedType,2
5,2,0,7,mixedType,0
7,4,0,11,mixedType,1
5,7,0,12,mixedType,1
7,1,0,8,mixedType,1
6,2,0,8,mixedType,1
2,6,0,8,mixedType,1
6,4,0,10,mixedType,1
4,7,0,11,mixedType,1
4,4,0,8,mixedType,1
6,3,0,9,mixedType,1
9,2,0,11,mixedType,1
7,4,0,11,mixedType,1
5,3,0,8,mixedType,1
12,3,0,15,mixedType,2
5,1,0,6,mixedType,0
8,2,0,10,mixedType,1
4,8,0,12,mixedType,1
9,2,0,11,mixedType,1
4,7,0,11,mixedType,1
7,2,0,9,mixedType,1
7,3,0,10,mixedType,1
6,2,0,8,mixedType,1
5,2,0,7,mixedType,0
8,3,0,11,mixedType,1
6,3,0,9,mixedType,1
4,4,0,8,mixedType,1
3,7,0,10,mixedType,1
2,8,0,10,mixedType,1
6,3,0,9,mixedType,1
5,3,0,8,mixedType,1
14,1,0,15,mixedType,2
6,4,0,10,mixedType,1
8,1,0,9,mixedType,1
11,3,0,14,mixedType,2
6,3,0,9,mixedType,1
7,2,0,9,mixedType,1
3,3,0,6,mixedType,0
8,2,0,10,mixedType,1
6,2,0,8,mixedType,1
6,3,0,9,mixedType,1
9,3,0,12,mixedType,1
6,3,0,9,mixedType,1
9,2,0,11,mixedType,1
6,2,0,8,mixedType,1
13,3,0,16,mixedType,2
12,1,0,13,mixedType,1
6,4,0,10,mixedType,1
6,4,0,10,mixedType,1
7,2,0,9,mixedType,1
9,2,0,11,mixedType,1
7,4,0,11,mixedType,1
7,2,0,9,mixedType,1
7,1,0,8,mixedType,1
7,1,0,8,mixedType,1
9,2,0,11,mixedType,1
8,2,0,10,mixedType,1
8,2,0,10,mixedType,1
12,4,0,16,mixedType,2
2,7,0,9,mixedType,1
4,4,0,8,mixedType,1
14,2,0,16,mixedType,2
6,3,0,9,mixedType,1
7,3,0,10,mixedType,1
13,3,0,16,mixedType,2
7,3,0,10,mixedType,1
4,5,0,9,mixedType,1
5,4,0,9,mixedType,1
3,6,0,9,mixedType,1
8,2,0,10,mixedType,1
7,3,0,10,mixedType,1
6,2,0,8,mixedType,1
4,2,0,6,mixedType,0
5,2,0,7,mixedType,0
6,3,0,9,mixedType,1
8,1,0,9,mixedType,1
5,3,0,8,mixedType,1
2,8,0,10,mixedType,1
4,2,0,6,mixedType,0
7,3,0,10,mixedType,1
12,3,0,15,mixedType,2
8,2,0,10,mixedType,1
4,2,0,6,mixedType,0
5,3,0,8,mixedType,1
7,2,0,9,mixedType,1
9,1,0,10,mixedType,1
8,1,0,9,mixedType,1
5,2,0,7,mixedType,0
7,2,0,9,mixedType,1
5,3,0,8,mixedType,1
9,1,0,10,mixedType,1
6,2,0,8,mixedType,1
7,2,0,9,mixedType,1
3,3,0,6,mixedType,0
5,1,0,6,mixedType,0
6,3,0,9,mixedType,1
9,1,0,10,mixedType,1
6,3,0,9,mixedType,1
13,3,0,16,mixedType,2
9,4,0,13,mixedType,1
10,2,0,12,mixedType,1
3,5,0,8,mixedType,1
3,5,0,8,mixedType,1
8,2,0,10,mixedType,1
4,4,0,8,mixedType,1
2,6,0,8,mixedType,1
14,2,0,16,mixedType,2
4,4,0,8,mixedType,1
8,6,0,14,mixedType,2
8,4,0,12,mixedType,1
6,4,0,10,mixedType,1
9,3,0,12,mixedType,1
14,2,0,16,mixedType,2
7,2,0,9,mixedType,1
13,3,0,16,mixedType,2
8,4,0,12,mixedType,1
6,3,0,9,mixedType,1
7,1,0,8,mixedType,1
5,3,0,8,mixedType,1
7,10,0,17,mixedType,2
7,3,0,10,mixedType,1
7,2,0,9,mixedType,1
13,3,0,16,mixedType,2
7,1,0,8,mixedType,1
6,2,0,8,mixedType,1
9,4,0,13,mixedType,1
7,1,0,8,mixedType,1
7,1,0,8,mixedType,1
6,3,0,9,mixedType,1
4,2,0,6,mixedType,0
10,4,0,14,mixedType,2
11,5,0,16,mixedType,2
7,3,0,10,mixedType,1
5,3,0,8,mixedType,1
4,5,0,9,mixedType,1
4,2,0,6,mixedType,0
6,2,0,8,mixedType,1
10,3,0,13,mixedType,1
13,3,0,16,mixedType,2
9,1,0,10,mixedType,1
9,2,0,11,mixedType,1
3,6,0,9,mixedType,1
6,3,0,9,mixedType,1
6,2,0,8,mixedType,1
2,7,0,9,mixedType,1
2,3,0,5,mixedType,0
6,1,0,7,mixedType,0
3,5,0,8,mixedType,1
5,3,0,8,mixedType,1
8,2,0,10,mixedType,1
5,1,0,6,mixedType,0
14,2,0,16,mixedType,2
6,2,0,8,mixedType,1
6,3,0,9,mixedType,1
6,3,0,9,mixedType,1
11,3,0,14,mixedType,2
6,3,0,9,mixedType,1
7,4,0,11,mixedType,1
7,3,0,10,mixedType,1
8,2,0,10,mixedType,1
6,4,0,10,mixedType,1
6,3,0,9,mixedType,1
8,1,0,9,mixedType,1
8,1,0,9,mixedType,1
6,2,0,8,mixedType,1
7,3,0,10,mixedType,1
8,1,0,9,mixedType,1
4,5,0,9,mixedType,1
8,2,0,10,mixedType,1
4,2,0,6,mixedType,0
4,4,0,8,mixedType,1
8,2,0,10,mixedType,1
5,3,0,8,mixedType,1
7,3,0,10,mixedType,1
5,3,0,8,mixedType,1
7,3,0,10,mixedType,1
7,1,0,8,mixedType,1
8,1,0,9,mixedType,1
7,3,0,10,mixedType,1
7,3,0,10,mixedType,1
3,6,0,9,mixedType,1
2,8,0,10,mixedType,1
7,1,0,8,mixedType,1
6,3,0,9,mixedType,1
6,2,0,8,mixedType,1
1,8,0,9,mixedType,1
12,4,0,16,mixedType,2
2,6,0,8,mixedType,1
7,2,0,9,mixedType,1
6,4,0,10,mixedType,1
5,1,0,6,mixedType,0
11,3,0,14,mixedType,2
8,1,0,9,mixedType,1
8,2,0,10,mixedType,1
7,2,0,9,mixedType,1
5,3,0,8,mixedType,1
6,1,0,7,mixedType,0
6,2,0,8,mixedType,1
9,4,0,13,mixedType,1
3,6,0,9,mixedType,1
8,1,0,9,mixedType,1
4,6,0,10,mixedType,1
9,3,0,12,mixedType,1
8,2,0,10,mixedType,1
6,3,0,9,mixedType,1
1,8,0,9,mixedType,1
6,3,0,9,mixedType,1
9,2,0,11,mixedType,1
9,1,0,10,mixedType,1
16,1,0,17,mixedType,2
15,1,0,16,mixedType,2
5,5,0,10,mixedType,1
8,4,0,12,mixedType,1
5,3,0,8,mixedType,1
2,9,0,11,mixedType,1
6,3,0,9,mixedType,1
5,1,0,6,mixedType,0
6,2,0,8,mixedType,1
6,2,0,8,mixedType,1
15,1,0,16,mixedType,2
6,2,0,8,mixedType,1
5,2,0,7,mixedType,0
5,5,0,10,mixedType,1
9,1,0,10,mixedType,1
5,3,0,8,mixedType,1
5,4,0,9,mixedType,1
5,2,0,7,mixedType,0
1,9,0,10,mixedType,1
6,4,0,10,mixedType,1
8,1,0,9,mixedType,1
1,11,0,12,mixedType,1
8,2,0,10,mixedType,1
6,6,0,12,mixedType,1
7,3,0,10,mixedType,1
13,3,0,16,mixedType,2
2,6,0,8,mixedType,1
6,1,0,7,mixedType,0
14,2,0,16,mixedType,2
9,1,0,10,mixedType,1
10,2,0,12,mixedType,1
7,5,0,12,mixedType,1
6,3,0,9,mixedType,1
13,3,0,16,mixedType,2
14,2,0,16,mixedType,2
3,10,0,13,mixedType,1
6,4,0,10,mixedType,1
6,1,0,7,mixedType,0
7,3,0,10,mixedType,1
5,3,0,8,mixedType,1
5,3,0,8,mixedType,1
7,3,0,10,mixedType,1
7,2,0,9,mixedType,1
1,10,0,11,mixedType,1
7,1,0,8,mixedType,1
8,1,0,9,mixedType,1
7,3,0,10,mixedType,1
7,3,0,10,mixedType,1
7,1,0,8,mixedType,1
6,1,0,7,mixedType,0
4,2,0,6,mixedType,0
5,4,0,9,mixedType,1
13,3,0,16,mixedType,2
1,10,0,11,mixedType,1
8,2,0,10,mixedType,1
7,2,0,9,mixedType,1
6,2,0,8,mixedType,1
2,9,0,11,mixedType,1
7,1,0,8,mixedType,1
9,1,0,10,mixedType,1
6,2,0,8,mixedType,1
6,4,0,10,mixedType,1
4,2,0,6,mixedType,0
6,1,0,7,mixedType,0
4,2,0,6,mixedType,0
7,1,0,8,mixedType,1
7,3,0,10,mixedType,1
8,2,0,10,mixedType,1
5,2,0,7,mixedType,0
8,2,0,10,mixedType,1
13,3,0,16,mixedType,2
8,1,0,9,mixedType,1
8,4,0,12,mixedType,1
6,5,0,11,mixedType,1
6,2,0,8,mixedType,1
6,3,0,9,mixedType,1
5,3,0,8,mixedType,1
5,3,0,8,mixedType,1
14,2,0,16,mixedType,2
7,3,0,10,mixedType,1
7,3,0,10,mixedType,1
6,3,0,9,mixedType,1
1,6,0,7,mixedType,0
7,3,0,10,mixedType,1
6,1,0,7,mixedType,0
12,3,0,15,mixedType,2
9,4,0,13,mixedType,1
5,4,0,9,mixedType,1
6,3,0,9,mixedType,1
4,4,0,8,mixedType,1
12,4,0,16,mixedType,2
6,4,0,10,mixedType,1
6,3,0,9,mixedType,1
12,3,0,15,mixedType,2
8,4,0,12,mixedType,1
7,3,0,10,mixedType,1
7,2,0,9,mixedType,1
9,4,2,15,mixedType,2
6,2,0,8,mixedType,1
1,8,0,9,mixedType,1
5,2,0,7,mixedType,0
1,8,0,9,mixedType,1
6,4,0,10,mixedType,1
4,4,0,8,mixedType,1
11,3,0,14,mixedType,2
7,3,0,10,mixedType,1
5,1,0,6,mixedType,0
2,6,0,8,mixedType,1
4,6,0,10,mixedType,1
8,1,0,9,mixedType,1
13,3,0,16,mixedType,2
7,1,0,8,mixedType,1
6,1,0,7,mixedType,0
15,1,0,16,mixedType,2
5,1,0,6,mixedType,0
6,1,0,7,mixedType,0
6,2,0,8,mixedType,1
5,1,0,6,mixedType,0
5,4,0,9,mixedType,1
8,2,0,10,mixedType,1
6,3,0,9,mixedType,1
7,2,0,9,mixedType,1
11,5,0,16,mixedType,2
4,4,0,8,mixedType,1
8,3,0,11,mixedType,1
4,6,0,10,mixedType,1
9,1,0,10,mixedType,1
6,4,0,10,mixedType,1
5,0,1,6,mixedType,0
7,2,0,9,mixedType,1
15,1,0,16,mixedType,2
4,4,0,8,mixedType,1
7,2,0,9,mixedType,1
6,2,0,8,mixedType,1
1,7,0,8,mixedType,1
8,2,0,10,mixedType,1
11,3,0,14,mixedType,2
8,3,0,11,mixedType,1
5,3,0,8,mixedType,1
6,3,0,9,mixedType,1
4,6,0,10,mixedType,1
5,2,0,7,mixedType,0
4,5,0,9,mixedType,1
14,2,0,16,mixedType,2
9,1,0,10,mixedType,1
8,1,0,9,mixedType,1
6,4,0,10,mixedType,1
4,6,0,10,mixedType,1
8,2,0,10,mixedType,1
5,8,0,13,mixedType,1
6,4,0,10,mixedType,1
5,1,0,6,mixedType,0
6,7,0,13,mixedType,1
3,6,0,9,mixedType,1
8,4,0,12,mixedType,1
5,5,0,10,mixedType,1
5,3,0,8,mixedType,1
5,3,0,8,mixedType,1
8,1,0,9,mixedType,1
15,1,0,16,mixedType,2
5,4,0,9,mixedType,1
9,1,0,10,mixedType,1
6,3,0,9,mixedType,1
5,3,0,8,mixedType,1
14,2,0,16,mixedType,2
7,0,2,9,mixedType,1
15,1,0,16,mixedType,2
6,3,0,9,mixedType,1
7,2,0,9,mixedType,1
5,8,0,13,mixedType,1
7,2,0,9,mixedType,1
11,1,0,12,mixedType,1
1,8,0,9,mixedType,1
5,8,0,13,mixedType,1
8,1,0,9,mixedType,1
7,2,0,9,mixedType,1
7,3,0,10,mixedType,1
5,1,0,6,mixedType,0
6,2,0,8,mixedType,1
6,1,0,7,mixedType,0
4,8,0,12,mixedType,1
7,3,0,10,mixedType,1
11,3,0,14,mixedType,2
8,1,0,9,mixedType,1
6,2,0,8,mixedType,1
9,2,0,11,mixedType,1
7,3,0,10,mixedType,1
7,2,0,9,mixedType,1
5,1,0,6,mixedType,0
8,3,0,11,mixedType,1
4,4,0,8,mixedType,1
5,3,0,8,mixedType,1
5,3,0,8,mixedType,1
5,1,0,6,mixedType,0
6,2,0,8,mixedType,1
6,2,0,8,mixedType,1
6,1,0,7,mixedType,0
5,3,0,8,mixedType,1
7,2,0,9,mixedType,1
7,2,0,9,mixedType,1
9,3,0,12,mixedType,1
5,4,0,9,mixedType,1
5,1,0,6,mixedType,0
6,3,0,9,mixedType,1
4,2,0,6,mixedType,0
6,3,0,9,mixedType,1
5,4,0,9,mixedType,1
13,3,0,16,mixedType,2
7,3,0,10,mixedType,1
5,1,0,6,mixedType,0
6,3,0,9,mixedType,1
8,1,0,9,mixedType,1
8,2,0,10,mixedType,1
6,4,0,10,mixedType,1
7,2,0,9,mixedType,1
16,1,1,18,mixedType,2
3,6,0,9,mixedType,1
7,2,0,9,mixedType,1
12,3,0,15,mixedType,2
5,6,0,11,mixedType,1
6,3,0,9,mixedType,1
4,2,0,6,mixedType,0
3,9,0,12,mixedType,1
6,4,0,10,mixedType,1
2,9,0,11,mixedType,1
8,1,0,9,mixedType,1
6,4,0,10,mixedType,1
9,2,0,11,mixedType,1
7,3,0,10,mixedType,1
7,3,0,10,mixedType,1
12,1,0,13,mixedType,1
2,9,0,11,mixedType,1
7,6,0,13,mixedType,1
7,5,0,12,mixedType,1
12,3,0,15,mixedType,2
5,4,0,9,mixedType,1
7,1,0,8,mixedType,1
6,1,0,7,mixedType,0
8,4,0,12,mixedType,1
7,4,0,11,mixedType,1
5,6,0,11,mixedType,1
4,5,0,9,mixedType,1
15,1,0,16,mixedType,2
4,2,0,6,mixedType,0
15,1,0,16,mixedType,2
6,2,0,8,mixedType,1
9,1,0,10,mixedType,1
4,2,0,6,mixedType,0
8,2,0,10,mixedType,1
5,4,0,9,mixedType,1
6,2,0,8,mixedType,1
15,1,0,16,mixedType,2
1,7,0,8,mixedType,1
2,8,0,10,mixedType,1
7,2,0,9,mixedType,1
9,3,0,12,mixedType,1
8,2,0,10,mixedType,1
6,2,0,8,mixedType,1
5,3,0,8,mixedType,1
11,1,0,12,mixedType,1
3,5,0,8,mixedType,1
4,2,0,6,mixedType,0
12,3,0,15,mixedType,2
6,2,0,8,mixedType,1
10,3,0,13,mixedType,1
5,2,0,7,mixedType,0
6,2,0,8,mixedType,1
2,6,0,8,mixedType,1
10,2,2,14,mixedType,2
6,3,0,9,mixedType,1
2,4,0,6,mixedType,0
8,2,0,10,mixedType,1
13,3,0,16,mixedType,2
6,2,0,8,mixedType,1
11,3,0,14,mixedType,2
8,4,0,12,mixedType,1
6,4,0,10,mixedType,1
6,3,0,9,mixedType,1
13,3,0,16,mixedType,2
11,2,0,13,mixedType,1
6,4,0,10,mixedType,1
8,4,0,12,mixedType,1
13,3,0,16,mixedType,2
1,8,0,9,mixedType,1
4,6,0,10,mixedType,1
7,1,0,8,mixedType,1
4,2,0,6,mixedType,0
7,3,0,10,mixedType,1
4,2,0,6,mixedType,0
7,1,0,8,mixedType,1
4,4,0,8,mixedType,1
9,2,0,11,mixedType,1
7,3,0,10,mixedType,1
5,3,0,8,mixedType,1
6,4,0,10,mixedType,1
5,4,0,9,mixedType,1
5,2,0,7,mixedType,0
8,3,0,11,mixedType,1
6,4,0,10,mixedType,1
4,4,0,8,mixedType,1
5,6,0,11,mixedType,1
10,3,0,13,mixedType,1
14,2,0,16,mixedType,2
6,3,0,9,mixedType,1
6,3,0,9,mixedType,1
7,3,0,10,mixedType,1
5,3,0,8,mixedType,1
7,3,0,10,mixedType,1
5,0,1,6,mixedType,0
14,2,0,16,mixedType,2
5,3,0,8,mixedType,1
7,2,0,9,mixedType,1
7,6,0,13,mixedType,1
6,2,0,8,mixedType,1
14,2,0,16,mixedType,2
14,2,0,16,mixedType,2
6,3,0,9,mixedType,1
7,3,0,10,mixedType,1
6,3,0,9,mixedType,1
10,3,0,13,mixedType,1
7,2,0,9,mixedType,1
10,2,0,12,mixedType,1
4,2,0,6,mixedType,0
8,1,0,9,mixedType,1
5,3,0,8,mixedType,1
13,3,0,16,mixedType,2
8,2,0,10,mixedType,1
8,2,0,10,mixedType,1
15,1,0,16,mixedType,2
4,4,0,8,mixedType,1
5,4,0,9,mixedType,1
6,1,0,7,mixedType,0
7,3,0,10,mixedType,1
6,2,0,8,mixedType,1
5,3,0,8,mixedType,1
8,1,0,9,mixedType,1
7,3,0,10,mixedType,1
7,6,0,13,mixedType,1
7,3,0,10,mixedType,1
6,1,0,7,mixedType,0
15,1,0,16,mixedType,2
8,3,0,11,mixedType,1
6,2,0,8,mixedType,1
10,2,0,12,mixedType,1
8,2,0,10,mixedType,1
6,4,0,10,mixedType,1
6,3,0,9,mixedType,1
4,2,0,6,mixedType,0
4,4,0,8,mixedType,1
8,1,0,9,mixedType,1
3,10,0,13,mixedType,1
7,3,0,10,mixedType,1
7,2,0,9,mixedType,1
10,3,0,13,mixedType,1
10,1,0,11,mixedType,1
8,2,0,10,mixedType,1
10,3,0,13,mixedType,1
8,2,0,10,mixedType,1
4,4,0,8,mixedType,1
5,2,0,7,mixedType,0
6,4,0,10,mixedType,1
4,9,0,13,mixedType,1
6,4,0,10,mixedType,1
4,4,0,8,mixedType,1
8,1,0,9,mixedType,1
4,6,0,10,mixedType,1
5,4,0,9,mixedType,1
11,2,0,13,mixedType,1
5,2,0,7,mixedType,0
7,1,0,8,mixedType,1
7,2,0,9,mixedType,1
8,2,0,10,mixedType,1
4,2,0,6,mixedType,0
5,3,0,8,mixedType,1
2,10,0,12,mixedType,1
8,1,0,9,mixedType,1
7,1,0,8,mixedType,1
10,1,0,11,mixedType,1
8,4,0,12,mixedType,1
6,3,0,9,mixedType,1
5,2,0,7,mixedType,0
4,4,0,8,mixedType,1
7,2,0,9,mixedType,1
8,2,0,10,mixedType,1
6,3,0,9,mixedType,1
10,4,0,14,mixedType,2
4,6,0,10,mixedType,1
6,1,0,7,mixedType,0
4,2,0,6,mixedType,0
6,2,0,8,mixedType,1
5,2,0,7,mixedType,0
8,1,0,9,mixedType,1
9,1,0,10,mixedType,1
3,7,0,10,mixedType,1
1,8,0,9,mixedType,1
6,4,0,10,mixedType,1
4,4,0,8,mixedType,1
5,2,0,7,mixedType,0
15,1,0,16,mixedType,2
6,6,0,12,mixedType,1
7,3,0,10,mixedType,1
7,3,0,10,mixedType,1
5,3,0,8,mixedType,1
2,6,0,8,mixedType,1
5,3,0,8,mixedType,1
7,2,0,9,mixedType,1
6,1,0,7,mixedType,0
7,4,0,11,mixedType,1
4,2,0,6,mixedType,0
3,6,0,9,mixedType,1
12,4,0,16,mixedType,2
9,2,0,11,mixedType,1
3,6,0,9,mixedType,1
15,1,0,16,mixedType,2
3,3,0,6,mixedType,0
5,4,0,9,mixedType,1
14,2,0,16,mixedType,2
2,7,0,9,mixedType,1
14,2,0,16,mixedType,2
11,2,0,13,mixedType,1
6,1,0,7,mixedType,0
8,6,0,14,mixedType,2
5,5,0,10,mixedType,1
5,4,0,9,mixedType,1
8,3,0,11,mixedType,1
0,7,0,7,sameType,1
14,2,0,16,mixedType,2
4,2,0,6,mixedType,0
8,2,0,10,mixedType,1
7,3,0,10,mixedType,1
6,4,0,10,mixedType,1
5,2,0,7,mixedType,0
6,4,0,10,mixedType,1
6,3,0,9,mixedType,1
6,1,0,7,mixedType,0
8,2,0,10,mixedType,1
5,1,0,6,mixedType,0
6,3,0,9,mixedType,1
8,4,3,15,mixedType,2
6,3,0,9,mixedType,1
15,1,1,17,mixedType,2
7,4,0,11,mixedType,1
1,9,0,10,mixedType,1
8,2,0,10,mixedType,1
6,3,0,9,mixedType,1
5,5,0,10,mixedType,1
15,1,0,16,mixedType,2
4,4,0,8,mixedType,1
4,4,0,8,mixedType,1
6,2,0,8,mixedType,1
7,3,0,10,mixedType,1
1,10,0,11,mixedType,1
5,2,0,7,mixedType,0
6,3,0,9,mixedType,1
4,2,0,6,mixedType,0
7,4,0,11,mixedType,1
4,2,0,6,mixedType,0
3,5,0,8,mixedType,1
5,2,0,7,mixedType,0
6,1,0,7,mixedType,0
9,1,0,10,mixedType,1
6,4,0,10,mixedType,1
3,10,0,13,mixedType,1
2,7,0,9,mixedType,1
5,1,0,6,mixedType,0
6,6,0,12,mixedType,1
12,4,0,16,mixedType,2
8,2,0,10,mixedType,1
8,2,0,10,mixedType,1
7,1,0,8,mixedType,1
5,2,0,7,mixedType,0
7,2,0,9,mixedType,1
7,3,0,10,mixedType,1
5,2,0,7,mixedType,0
6,7,0,13,mixedType,1
6,3,0,9,mixedType,1
6,3,0,9,mixedType,1
6,3,0,9,mixedType,1
6,2,0,8,mixedType,1
6,2,0,8,mixedType,1
6,3,0,9,mixedType,1
14,2,0,16,mixedType,2
15,1,0,16,mixedType,2
7,3,0,10,mixedType,1
1,9,0,10,mixedType,1
8,2,0,10,mixedType,1
6,3,0,9,mixedType,1
6,4,0,10,mixedType,1
1,10,0,11,mixedType,1
9,2,0,11,mixedType,1
5,3,0,8,mixedType,1
6,3,0,9,mixedType,1
6,3,0,9,mixedType,1
1,7,0,8,mixedType,1
13,3,0,16,mixedType,2
1,6,0,7,mixedType,0
10,1,0,11,mixedType,1
6,4,0,10,mixedType,1
9,5,0,14,mixedType,2
3,10,0,13,mixedType,1
4,2,0,6,mixedType,0
1,8,0,9,mixedType,1
3,6,0,9,mixedType,1
5,6,0,11,mixedType,1
6,3,0,9,mixedType,1
8,2,0,10,mixedType,1
5,3,0,8,mixedType,1
6,3,0,9,mixedType,1
7,6,0,13,mixedType,1
6,2,0,8,mixedType,1
5,3,0,8,mixedType,1
1,10,0,11,mixedType,1
9,1,0,10,mixedType,1
1,6,0,7,mixedType,0
13,3,0,16,mixedType,2
5,5,0,10,mixedType,1
7,5,0,12,mixedType,1
7,3,0,10,mixedType,1
5,2,0,7,mixedType,0
5,3,0,8,mixedType,1
7,4,0,11,mixedType,1
4,4,0,8,mixedType,1
8,1,0,9,mixedType,1
6,3,0,9,mixedType,1
7,1,0,8,mixedType,1
8,2,0,10,mixedType,1
11,2,0,13,mixedType,1
8,1,0,9,mixedType,1
5,2,0,7,mixedType,0
7,2,0,9,mixedType,1
4,6,0,10,mixedType,1
6,4,0,10,mixedType,1
5,4,0,9,mixedType,1
5,5,0,10,mixedType,1
9,3,0,12,mixedType,1
10,5,0,15,mixedType,2
5,3,0,8,mixedType,1
6,2,0,8,mixedType,1
7,1,0,8,mixedType,1
8,2,0,10,mixedType,1
6,3,0,9,mixedType,1
9,1,0,10,mixedType,1
7,3,0,10,mixedType,1
7,1,0,8,mixedType,1
3,6,0,9,mixedType,1
4,5,0,9,mixedType,1
6,3,0,9,mixedType,1
7,4,0,11,mixedType,1
5,1,0,6,mixedType,0
9,4,0,13,mixedType,1
1,8,0,9,mixedType,1
7,3,0,10,mixedType,1
5,1,0,6,mixedType,0
5,2,0,7,mixedType,0
5,2,0,7,mixedType,0
5,3,0,8,mixedType,1
9,3,0,12,mixedType,1
4,4,0,8,mixedType,1
7,1,0,8,mixedType,1
7,1,0,8,mixedType,1
3,10,0,13,mixedType,1
11,3,0,14,mixedType,2
2,9,0,11,mixedType,1
6,2,0,8,mixedType,1
10,3,0,13,mixedType,1
10,3,0,13,mixedType,1
5,2,0,7,mixedType,0
6,6,0,12,mixedType,1
6,6,0,12,mixedType,1
5,3,0,8,mixedType,1
11,3,0,14,mixedType,2
8,2,0,10,mixedType,1
5,4,0,9,mixedType,1
6,1,0,7,mixedType,0
6,3,0,9,mixedType,1
15,1,0,16,mixedType,2
5,2,0,7,mixedType,0
8,2,0,10,mixedType,1
8,3,0,11,mixedType,1
6,4,0,10,mixedType,1
8,3,0,11,mixedType,1
8,1,0,9,mixedType,1
6,3,0,9,mixedType,1
1,8,0,9,mixedType,1
6,4,0,10,mixedType,1
4,4,0,8,mixedType,1
9,3,0,12,mixedType,1
13,3,0,16,mixedType,2
5,1,0,6,mixedType,0
4,2,0,6,mixedType,0
6,2,0,8,mixedType,1
8,4,0,12,mixedType,1
3,5,0,8,mixedType,1
9,1,0,10,mixedType,1
6,3,0,9,mixedType,1
9,4,0,13,mixedType,1
5,1,0,6,mixedType,0
5,4,0,9,mixedType,1
8,2,0,10,mixedType,1
14,2,0,16,mixedType,2
12,4,0,16,mixedType,2
4,2,0,6,mixedType,0
12,4,0,16,mixedType,2
10,1,0,11,mixedType,1
13,3,0,16,mixedType,2
7,3,0,10,mixedType,1
7,3,0,10,mixedType,1
11,5,0,16,mixedType,2
9,1,0,10,mixedType,1
4,2,0,6,mixedType,0
4,4,0,8,mixedType,1
5,6,0,11,mixedType,1
5,4,0,9,mixedType,1
11,2,0,13,mixedType,1
5,4,0,9,mixedType,1
7,1,0,8,mixedType,1
15,1,0,16,mixedType,2
9,4,0,13,mixedType,1
7,3,0,10,mixedType,1
1,8,0,9,mixedType,1
1,8,0,9,mixedType,1
4,4,0,8,mixedType,1
12,4,0,16,mixedType,2
12,3,0,15,mixedType,2
4,5,0,9,mixedType,1
7,2,0,9,mixedType,1
6,4,0,10,mixedType,1
5,2,0,7,mixedType,0
6,3,0,9,mixedType,1
11,3,0,14,mixedType,2
15,1,0,16,mixedType,2
4,6,0,10,mixedType,1
6,3,0,9,mixedType,1
6,2,0,8,mixedType,1
10,1,0,11,mixedType,1
3,6,0,9,mixedType,1
2,6,0,8,mixedType,1
3,6,0,9,mixedType,1
4,4,0,8,mixedType,1
6,4,0,10,mixedType,1
5,3,0,8,mixedType,1
14,2,0,16,mixedType,2
5,3,0,8,mixedType,1
7,3,0,10,mixedType,1
7,2,0,9,mixedType,1
6,3,0,9,mixedType,1
5,2,0,7,mixedType,0
5,2,0,7,mixedType,0
12,3,0,15,mixedType,2
8,2,0,10,mixedType,1
6,3,0,9,mixedType,1
6,4,0,10,mixedType,1
6,4,0,10,mixedType,1
4,2,0,6,mixedType,0
6,1,0,7,mixedType,0
5,1,0,6,mixedType,0
9,2,0,11,mixedType,1
3,10,0,13,mixedType,1
7,2,0,9,mixedType,1
6,2,0,8,mixedType,1
7,1,0,8,mixedType,1
4,2,0,6,mixedType,0
6,6,0,12,mixedType,1
8,2,0,10,mixedType,1
9,2,0,11,mixedType,1
8,1,0,9,mixedType,1
7,2,0,9,mixedType,1
6,2,0,8,mixedType,1
13,3,0,16,mixedType,2
9,1,0,10,mixedType,1
7,1,0,8,mixedType,1
4,5,0,9,mixedType,1
8,2,0,10,mixedType,1
7,3,0,10,mixedType,1
0,7,0,7,sameType,1
6,2,0,8,mixedType,1
8,2,0,10,mixedType,1
4,6,0,10,mixedType,1
5,4,0,9,mixedType,1
6,4,0,10,mixedType,1
6,3,0,9,mixedType,1
5,7,0,12,mixedType,1
5,3,0,8,mixedType,1
6,3,0,9,mixedType,1
3,8,0,11,mixedType,1
6,4,0,10,mixedType,1
14,2,0,16,mixedType,2
8,3,0,11,mixedType,1
8,4,0,12,mixedType,1
5,2,0,7,mixedType,0
3,6,0,9,mixedType,1
8,3,0,11,mixedType,1
11,4,0,15,mixedType,2
13,3,0,16,mixedType,2
9,1,0,10,mixedType,1
4,6,0,10,mixedType,1
5,2,0,7,mixedType,0
5,3,0,8,mixedType,1
8,4,0,12,mixedType,1
6,3,0,9,mixedType,1
6,2,0,8,mixedType,1
1,8,0,9,mixedType,1
5,2,0,7,mixedType,0
9,1,0,10,mixedType,1
3,7,0,10,mixedType,1
7,2,0,9,mixedType,1
1,8,0,9,mixedType,1
8,1,0,9,mixedType,1
8,1,0,9,mixedType,1
8,1,0,9,mixedType,1
8,2,0,10,mixedType,1
8,2,0,10,mixedType,1
8,1,0,9,mixedType,1
5,6,0,11,mixedType,1
6,3,0,9,mixedType,1
5,3,0,8,mixedType,1
6,3,0,9,mixedType,1
13,3,0,16,mixedType,2
5,2,0,7,mixedType,0
13,3,0,16,mixedType,2
6,2,0,8,mixedType,1
1,5,0,6,mixedType,0
6,2,0,8,mixedType,1
7,4,0,11,mixedType,1
7,3,0,10,mixedType,1
9,1,0,10,mixedType,1
8,0,1,9,mixedType,1
7,2,0,9,mixedType,1
3,10,0,13,mixedType,1
6,3,0,9,mixedType,1
9,1,0,10,mixedType,1
15,1,0,16,mixedType,2
12,4,0,16,mixedType,2
1,8,0,9,mixedType,1
7,1,0,8,mixedType,1
7,1,0,8,mixedType,1
14,2,0,16,mixedType,2
11,3,0,14,mixedType,2
8,2,0,10,mixedType,1
7,3,0,10,mixedType,1
9,1,0,10,mixedType,1
6,3,0,9,mixedType,1
6,2,0,8,mixedType,1
7,2,0,9,mixedType,1
13,3,0,16,mixedType,2
5,1,0,6,mixedType,0
2,6,0,8,mixedType,1
7,2,0,9,mixedType,1
6,3,0,9,mixedType,1
6,4,0,10,mixedType,1
5,2,0,7,mixedType,0
6,2,0,8,mixedType,1
7,1,0,8,mixedType,1
6,1,0,7,mixedType,0
8,1,0,9,mixedType,1
8,3,0,11,mixedType,1
4,2,0,6,mixedType,0
8,2,0,10,mixedType,1
8,3,0,11,mixedType,1
6,3,0,9,mixedType,1
6,3,0,9,mixedType,1
1,10,0,11,mixedType,1
6,3,0,9,mixedType,1
7,4,0,11,mixedType,1
6,3,0,9,mixedType,1
6,2,0,8,mixedType,1
6,11,0,17,mixedType,2
7,1,0,8,mixedType,1
7,4,0,11,mixedType,1
10,3,1,14,mixedType,2
6,3,0,9,mixedType,1
8,2,0,10,mixedType,1
9,2,0,11,mixedType,1
2,6,0,8,mixedType,1
8,5,0,13,mixedType,1
8,2,0,10,mixedType,1
9,2,0,11,mixedType,1
6,4,0,10,mixedType,1
7,3,0,10,mixedType,1
5,3,0,8,mixedType,1
6,8,1,15,mixedType,2
6,1,0,7,mixedType,0
7,1,0,8,mixedType,1
14,2,0,16,mixedType,2
8,1,0,9,mixedType,1
6,4,0,10,mixedType,1
4,4,0,8,mixedType,1
5,3,0,8,mixedType,1
6,1,0,7,mixedType,0
11,5,0,16,mixedType,2
14,2,0,16,mixedType,2
8,3,0,11,mixedType,1
6,6,0,12,mixedType,1
4,4,0,8,mixedType,1
8,2,0,10,mixedType,1
13,3,0,16,mixedType,2
7,3,0,10,mixedType,1
7,3,0,10,mixedType,1
5,2,0,7,mixedType,0
7,3,0,10,mixedType,1
6,1,0,7,mixedType,0
5,3,0,8,mixedType,1
5,4,0,9,mixedType,1
14,2,0,16,mixedType,2
3,3,0,6,mixedType,0
8,4,2,14,mixedType,2
2,6,0,8,mixedType,1
10,2,0,12,mixedType,1
6,1,0,7,mixedType,0
15,1,0,16,mixedType,2
4,7,0,11,mixedType,1
15,1,0,16,mixedType,2
2,4,0,6,mixedType,0
15,1,0,16,mixedType,2
12,1,0,13,mixedType,1
7,2,0,9,mixedType,1
5,1,0,6,mixedType,0
6,3,0,9,mixedType,1
15,1,0,16,mixedType,2
8,1,0,9,mixedType,1
4,6,0,10,mixedType,1
14,2,0,16,mixedType,2
6,3,0,9,mixedType,1
5,3,0,8,mixedType,1
2,8,0,10,mixedType,1
7,3,0,10,mixedType,1
9,1,0,10,mixedType,1
6,3,0,9,mixedType,1
6,2,0,8,mixedType,1
8,4,0,12,mixedType,1
6,2,0,8,mixedType,1
7,2,0,9,mixedType,1
6,4,0,10,mixedType,1
7,3,0,10,mixedType,1
10,4,0,14,mixedType,2
3,7,0,10,mixedType,1
7,3,0,10,mixedType,1
8,1,0,9,mixedType,1
6,3,0,9,mixedType,1
6,3,0,9,mixedType,1
5,2,0,7,mixedType,0
5,3,0,8,mixedType,1
4,6,0,10,mixedType,1
7,3,0,10,mixedType,1
7,1,0,8,mixedType,1
6,6,3,15,mixedType,2
9,2,2,13,mixedType,1
5,4,0,9,mixedType,1
7,3,0,10,mixedType,1
2,6,0,8,mixedType,1
6,4,0,10,mixedType,1
6,2,0,8,mixedType,1
8,3,0,11,mixedType,1
19,1,1,21,mixedType,2
6,2,0,8,mixedType,1
6,3,0,9,mixedType,1
8,1,0,9,mixedType,1
11,3,0,14,mixedType,2
6,1,0,7,mixedType,0
8,2,0,10,mixedType,1
4,2,0,6,mixedType,0
6,1,0,7,mixedType,0
1,7,0,8,mixedType,1
8,2,0,10,mixedType,1
7,2,0,9,mixedType,1
8,2,0,10,mixedType,1
2,8,0,10,mixedType,1
9,4,0,13,mixedType,1
12,4,0,16,mixedType,2
6,4,0,10,mixedType,1
6,3,0,9,mixedType,1
13,3,0,16,mixedType,2
7,2,0,9,mixedType,1
7,1,0,8,mixedType,1
14,2,0,16,mixedType,2
8,2,0,10,mixedType,1
9,1,0,10,mixedType,1
15,1,0,16,mixedType,2
2,6,0,8,mixedType,1
5,7,0,12,mixedType,1
6,2,0,8,mixedType,1
4,4,0,8,mixedType,1
4,6,0,10,mixedType,1
3,3,0,6,mixedType,0
4,6,0,10,mixedType,1
5,3,0,8,mixedType,1
6,2,0,8,mixedType,1
7,3,0,10,mixedType,1
8,3,0,11,mixedType,1
7,1,0,8,mixedType,1
9,3,0,12,mixedType,1
9,2,0,11,mixedType,1
9,1,0,10,mixedType,1
4,4,0,8,mixedType,1
8,1,0,9,mixedType,1
2,8,0,10,mixedType,1
5,2,0,7,mixedType,0
8,2,0,10,mixedType,1
12,3,0,15,mixedType,2
5,3,0,8,mixedType,1
2,6,0,8,mixedType,1
4,4,0,8,mixedType,1
14,2,0,16,mixedType,2
5,3,0,8,mixedType,1
8,1,0,9,mixedType,1
5,2,0,7,mixedType,0
6,3,0,9,mixedType,1
9,3,0,12,mixedType,1
5,3,0,8,mixedType,1
1,8,0,9,mixedType,1
5,3,0,8,mixedType,1
13,3,0,16,mixedType,2
5,1,0,6,mixedType,0
6,4,0,10,mixedType,1
12,3,0,15,mixedType,2
6,4,0,10,mixedType,1
5,2,0,7,mixedType,0
1,10,0,11,mixedType,1
1,7,0,8,mixedType,1
15,1,0,16,mixedType,2
6,1,0,7,mixedType,0
9,2,3,14,mixedType,2
8,3,0,11,mixedType,1
4,6,0,10,mixedType,1
7,4,0,11,mixedType,1
3,8,0,11,mixedType,1
8,1,0,9,mixedType,1
6,3,0,9,mixedType,1
7,2,0,9,mixedType,1
4,6,0,10,mixedType,1
3,6,0,9,mixedType,1
9,1,0,10,mixedType,1
5,3,0,8,mixedType,1
14,2,0,16,mixedType,2
8,2,0,10,mixedType,1
9,1,0,10,mixedType,1
12,4,0,16,mixedType,2
8,3,0,11,mixedType,1
4,4,0,8,mixedType,1
6,6,0,12,mixedType,1
4,5,0,9,mixedType,1
6,4,0,10,mixedType,1
7,3,0,10,mixedType,1
6,4,0,10,mixedType,1
6,4,0,10,mixedType,1
9,2,0,11,mixedType,1
6,6,0,12,mixedType,1
10,1,0,11,mixedType,1
3,3,0,6,mixedType,0
5,3,0,8,mixedType,1
8,6,0,14,mixedType,2
9,1,0,10,mixedType,1
4,2,0,6,mixedType,0
14,2,0,16,mixedType,2
3,10,0,13,mixedType,1
6,3,0,9,mixedType,1
5,2,0,7,mixedType,0
1,10,0,11,mixedType,1
12,3,0,15,mixedType,2
17,3,2,22,mixedType,2
1,9,0,10,mixedType,1
4,4,0,8,mixedType,1
1,8,0,9,mixedType,1
11,5,0,16,mixedType,2
7,1,0,8,mixedType,1
9,2,0,11,mixedType,1
4,6,0,10,mixedType,1
4,4,0,8,mixedType,1
9,1,0,10,mixedType,1
8,1,0,9,mixedType,1
8,4,0,12,mixedType,1
7,3,0,10,mixedType,1
4,2,0,6,mixedType,0
6,3,0,9,mixedType,1
8,3,0,11,mixedType,1
6,3,0,9,mixedType,1
6,2,0,8,mixedType,1
5,2,0,7,mixedType,0
6,6,0,12,mixedType,1
8,4,2,14,mixedType,2
7,3,0,10,mixedType,1
5,2,0,7,mixedType,0
6,2,0,8,mixedType,1
6,3,0,9,mixedType,1
6,1,0,7,mixedType,0
7,1,0,8,mixedType,1
6,3,0,9,mixedType,1
6,3,0,9,mixedType,1
14,2,0,16,mixedType,2
9,1,0,10,mixedType,1
10,2,0,12,mixedType,1
15,1,0,16,mixedType,2
6,2,0,8,mixedType,1
5,4,0,9,mixedType,1
5,4,0,9,mixedType,1
7,1,0,8,mixedType,1
6,3,0,9,mixedType,1
8,2,0,10,mixedType,1
6,3,0,9,mixedType,1
6,3,0,9,mixedType,1
5,5,0,10,mixedType,1
7,2,0,9,mixedType,1
7,2,0,9,mixedType,1
8,2,0,10,mixedType,1
8,2,2,12,mixedType,1
6,3,0,9,mixedType,1
13,3,0,16,mixedType,2
7,4,0,11,mixedType,1
4,4,0,8,mixedType,1
4,6,0,10,mixedType,1
5,2,0,7,mixedType,0
5,4,0,9,mixedType,1
6,2,0,8,mixedType,1
7,1,0,8,mixedType,1
6,1,0,7,mixedType,0
15,1,0,16,mixedType,2
8,2,0,10,mixedType,1
4,4,0,8,mixedType,1
1,10,0,11,mixedType,1
12,3,0,15,mixedType,2
1,9,0,10,mixedType,1
12,4,0,16,mixedType,2
6,8,0,14,mixedType,2
4,6,0,10,mixedType,1
5,4,0,9,mixedType,1
5,4,0,9,mixedType,1
7,2,0,9,mixedType,1
9,1,0,10,mixedType,1
7,3,0,10,mixedType,1
4,6,0,10,mixedType,1
6,4,0,10,mixedType,1
5,2,0,7,mixedType,0
4,6,0,10,mixedType,1
8,2,0,10,mixedType,1
3,8,0,11,mixedType,1
8,3,0,11,mixedType,1
6,2,0,8,mixedType,1
6,1,0,7,mixedType,0
5,2,0,7,mixedType,0
6,3,0,9,mixedType,1
15,1,0,16,mixedType,2
5,3,0,8,mixedType,1
5,5,0,10,mixedType,1
9,1,0,10,mixedType,1
6,3,0,9,mixedType,1
6,4,0,10,mixedType,1
5,4,0,9,mixedType,1
8,2,0,10,mixedType,1
6,2,0,8,mixedType,1
8,1,0,9,mixedType,1
5,2,0,7,mixedType,0
8,2,0,10,mixedType,1
13,3,0,16,mixedType,2
6,3,0,9,mixedType,1
8,2,0,10,mixedType,1
9,1,0,10,mixedType,1
4,4,0,8,mixedType,1
6,3,0,9,mixedType,1
4,2,0,6,mixedType,0
6,3,0,9,mixedType,1
1,7,0,8,mixedType,1
6,4,0,10,mixedType,1
6,2,0,8,mixedType,1
6,3,0,9,mixedType,1
2,8,0,10,mixedType,1
2,6,0,8,mixedType,1
3,8,0,11,mixedType,1
8,1,0,9,mixedType,1
7,3,0,10,mixedType,1
9,3,0,12,mixedType,1
5,3,0,8,mixedType,1
5,3,0,8,mixedType,1
6,4,0,10,mixedType,1
5,1,0,6,mixedType,0
8,1,0,9,mixedType,1
2,6,0,8,mixedType,1
7,3,0,10,mixedType,1
4,2,0,6,mixedType,0
6,4,0,10,mixedType,1
8,2,0,10,mixedType,1
5,3,0,8,mixedType,1
7,3,0,10,mixedType,1
8,2,0,10,mixedType,1
6,5,0,11,mixedType,1
5,3,0,8,mixedType,1
9,1,0,10,mixedType,1
7,3,0,10,mixedType,1
1,7,0,8,mixedType,1
2,6,0,8,mixedType,1
4,4,0,8,mixedType,1
8,1,0,9,mixedType,1
1,8,0,9,mixedType,1
7,1,0,8,mixedType,1
6,4,0,10,mixedType,1
6,4,0,10,mixedType,1
7,3,0,10,mixedType,1
6,2,0,8,mixedType,1
5,4,0,9,mixedType,1
5,3,0,8,mixedType,1
6,2,0,8,mixedType,1
7,3,0,10,mixedType,1
5,2,0,7,mixedType,0
7,1,0,8,mixedType,1
6,3,0,9,mixedType,1
3,5,0,8,mixedType,1
2,8,0,10,mixedType,1
2,6,0,8,mixedType,1
9,2,0,11,mixedType,1
6,2,0,8,mixedType,1
1,7,0,8,mixedType,1
1,8,0,9,mixedType,1
14,2,0,16,mixedType,2
4,8,0,12,mixedType,1
13,3,0,16,mixedType,2
8,1,0,9,mixedType,1
9,1,0,10,mixedType,1
8,6,0,14,mixedType,2
7,3,0,10,mixedType,1
5,3,0,8,mixedType,1
5,3,0,8,mixedType,1
9,4,0,13,mixedType,1
8,1,0,9,mixedType,1
8,3,0,11,mixedType,1
5,10,0,15,mixedType,2
10,6,0,16,mixedType,2
6,1,0,7,mixedType,0
5,3,0,8,mixedType,1
6,2,0,8,mixedType,1
6,4,0,10,mixedType,1
7,1,0,8,mixedType,1
7,1,0,8,mixedType,1
5,3,0,8,mixedType,1
5,2,0,7,mixedType,0
6,4,0,10,mixedType,1
3,3,0,6,mixedType,0
7,4,0,11,mixedType,1
6,3,0,9,mixedType,1
6,4,0,10,mixedType,1
6,4,0,10,mixedType,1
7,3,0,10,mixedType,1
9,4,0,13,mixedType,1
6,1,0,7,mixedType,0
6,4,0,10,mixedType,1
10,3,0,13,mixedType,1
8,3,0,11,mixedType,1
5,4,0,9,mixedType,1
1,9,0,10,mixedType,1
5,1,0,6,mixedType,0
2,6,0,8,mixedType,1
8,1,0,9,mixedType,1
5,1,0,6,mixedType,0
12,3,0,15,mixedType,2
2,7,0,9,mixedType,1
7,4,0,11,mixedType,1
8,2,0,10,mixedType,1
4,2,0,6,mixedType,0
7,2,0,9,mixedType,1
5,4,0,9,mixedType,1
7,3,0,10,mixedType,1
9,4,0,13,mixedType,1
4,4,0,8,mixedType,1
6,6,0,12,mixedType,1
12,3,0,15,mixedType,2
4,2,0,6,mixedType,0
6,3,0,9,mixedType,1
9,2,0,11,mixedType,1
7,3,0,10,mixedType,1
7,3,0,10,mixedType,1
2,8,0,10,mixedType,1
9,4,0,13,mixedType,1
7,3,0,10,mixedType,1
7,1,0,8,mixedType,1
7,3,0,10,mixedType,1
5,1,0,6,mixedType,0
8,1,0,9,mixedType,1
5,5,0,10,mixedType,1
5,2,0,7,mixedType,0
1,8,0,9,mixedType,1
7,1,0,8,mixedType,1
6,2,0,8,mixedType,1
15,1,0,16,mixedType,2
7,3,0,10,mixedType,1
10,2,0,12,mixedType,1
19,2,0,21,mixedType,2
4,2,0,6,mixedType,0
9,3,0,12,mixedType,1
6,5,0,11,mixedType,1
8,2,0,10,mixedType,1
5,2,0,7,mixedType,0
14,2,0,16,mixedType,2
4,2,0,6,mixedType,0
7,3,0,10,mixedType,1
6,3,0,9,mixedType,1
3,5,0,8,mixedType,1
5,4,0,9,mixedType,1
5,3,0,8,mixedType,1
6,3,0,9,mixedType,1
12,3,0,15,mixedType,2
10,6,0,16,mixedType,2
7,3,0,10,mixedType,1
11,1,0,12,mixedType,1
12,4,0,16,mixedType,2
13,3,0,16,mixedType,2
12,3,0,15,mixedType,2
5,6,0,11,mixedType,1
8,2,0,10,mixedType,1
9,1,0,10,mixedType,1
8,2,0,10,mixedType,1
6,3,0,9,mixedType,1
7,2,0,9,mixedType,1
5,3,0,8,mixedType,1
12,4,0,16,mixedType,2
6,1,0,7,mixedType,0
4,2,0,6,mixedType,0
4,2,0,6,mixedType,0
6,3,0,9,mixedType,1
7,3,0,10,mixedType,1
6,2,0,8,mixedType,1
6,4,0,10,mixedType,1
7,3,0,10,mixedType,1
9,1,0,10,mixedType,1
6,4,0,10,mixedType,1
8,2,0,10,mixedType,1
8,2,0,10,mixedType,1
7,3,0,10,mixedType,1
4,4,0,8,mixedType,1
9,1,0,10,mixedType,1
4,6,0,10,mixedType,1
7,6,0,13,mixedType,1
10,3,0,13,mixedType,1
1,9,0,10,mixedType,1
7,2,0,9,mixedType,1
9,4,0,13,mixedType,1
1,8,0,9,mixedType,1
2,6,0,8,mixedType,1
13,0,4,17,mixedType,2
5,4,0,9,mixedType,1
4,2,0,6,mixedType,0
10,4,0,14,mixedType,2
6,2,0,8,mixedType,1
6,2,0,8,mixedType,1
4,2,0,6,mixedType,0
7,3,0,10,mixedType,1
9,1,0,10,mixedType,1
6,3,0,9,mixedType,1
5,3,0,8,mixedType,1
7,2,0,9,mixedType,1
7,1,0,8,mixedType,1
6,4,0,10,mixedType,1
5,2,0,7,mixedType,0
6,2,0,8,mixedType,1
5,3,0,8,mixedType,1
6,3,0,9,mixedType,1
8,1,0,9,mixedType,1
8,1,0,9,mixedType,1
7,2,0,9,mixedType,1
6,1,0,7,mixedType,0
7,2,0,9,mixedType,1
8,3,0,11,mixedType,1
6,2,0,8,mixedType,1
8,3,0,11,mixedType,1
7,3,0,10,mixedType,1
5,1,0,6,mixedType,0
6,2,0,8,mixedType,1
6,4,0,10,mixedType,1
6,1,0,7,mixedType,0
6,3,0,9,mixedType,1
5,4,0,9,mixedType,1
7,1,0,8,mixedType,1
10,2,0,12,mixedType,1
6,3,0,9,mixedType,1
5,2,0,7,mixedType,0
3,6,0,9,mixedType,1
10,2,0,12,mixedType,1
6,5,0,11,mixedType,1
6,4,0,10,mixedType,1
8,1,0,9,mixedType,1
8,2,0,10,mixedType,1
5,3,0,8,mixedType,1
3,6,0,9,mixedType,1
6,2,0,8,mixedType,1
8,4,0,12,mixedType,1
6,4,0,10,mixedType,1
7,4,0,11,mixedType,1
1,8,0,9,mixedType,1
6,1,0,7,mixedType,0
5,2,0,7,mixedType,0
6,2,0,8,mixedType,1
8,2,0,10,mixedType,1
2,4,0,6,mixedType,0
6,4,0,10,mixedType,1
7,2,0,9,mixedType,1
7,3,0,10,mixedType,1
8,1,0,9,mixedType,1
7,1,0,8,mixedType,1
8,1,0,9,mixedType,1
13,3,0,16,mixedType,2
4,2,0,6,mixedType,0
6,2,0,8,mixedType,1
5,2,0,7,mixedType,0
7,3,0,10,mixedType,1
9,3,0,12,mixedType,1
4,6,0,10,mixedType,1
4,2,0,6,mixedType,0
5,1,0,6,mixedType,0
8,2,0,10,mixedType,1
7,0,1,8,mixedType,1
14,2,0,16,mixedType,2
13,3,0,16,mixedType,2
11,3,0,14,mixedType,2
6,4,0,10,mixedType,1
5,3,0,8,mixedType,1
13,3,0,16,mixedType,2
5,3,0,8,mixedType,1
4,2,0,6,mixedType,0
5,4,0,9,mixedType,1
2,6,0,8,mixedType,1
5,3,0,8,mixedType,1
3,8,0,11,mixedType,1
4,2,0,6,mixedType,0
11,1,0,12,mixedType,1
1,8,0,9,mixedType,1
8,1,0,9,mixedType,1
6,2,0,8,mixedType,1
7,2,0,9,mixedType,1
9,3,0,12,mixedType,1
5,1,0,6,mixedType,0
6,1,0,7,mixedType,0
5,4,0,9,mixedType,1
5,4,0,9,mixedType,1
4,4,0,8,mixedType,1
5,2,0,7,mixedType,0
6,3,0,9,mixedType,1
7,3,0,10,mixedType,1
11,1,0,12,mixedType,1
5,2,0,7,mixedType,0
1,8,0,9,mixedType,1
5,4,0,9,mixedType,1
8,2,0,10,mixedType,1
5,3,0,8,mixedType,1
5,2,0,7,mixedType,0
3,5,0,8,mixedType,1
5,5,0,10,mixedType,1
12,4,1,17,mixedType,2
5,2,0,7,mixedType,0
7,2,0,9,mixedType,1
5,6,0,11,mixedType,1
5,3,0,8,mixedType,1
5,4,0,9,mixedType,1
1,8,0,9,mixedType,1
6,4,0,10,mixedType,1
5,3,0,8,mixedType,1
9,4,0,13,mixedType,1
4,4,0,8,mixedType,1
5,4,0,9,mixedType,1
8,2,0,10,mixedType,1
9,3,0,12,mixedType,1
8,2,0,10,mixedType,1
7,2,0,9,mixedType,1
7,3,0,10,mixedType,1
9,4,0,13,mixedType,1
4,9,0,13,mixedType,1
14,2,0,16,mixedType,2
12,3,0,15,mixedType,2
9,3,0,12,mixedType,1
7,3,0,10,mixedType,1
8,1,0,9,mixedType,1
7,6,0,13,mixedType,1
6,2,0,8,mixedType,1
6,3,0,9,mixedType,1
1,8,0,9,mixedType,1
6,3,0,9,mixedType,1
5,2,0,7,mixedType,0
9,4,0,13,mixedType,1
4,4,0,8,mixedType,1
8,3,0,11,mixedType,1
6,2,0,8,mixedType,1
7,2,0,9,mixedType,1
14,1,0,15,mixedType,2
5,3,0,8,mixedType,1
14,2,0,16,mixedType,2
8,1,0,9,mixedType,1
14,2,0,16,mixedType,2
6,2,0,8,mixedType,1
4,2,0,6,mixedType,0
15,1,0,16,mixedType,2
7,1,0,8,mixedType,1
6,3,0,9,mixedType,1
9,2,0,11,mixedType,1
13,3,0,16,mixedType,2
5,3,0,8,mixedType,1
5,4,0,9,mixedType,1
5,2,0,7,mixedType,0
5,3,0,8,mixedType,1
9,3,0,12,mixedType,1
6,3,0,9,mixedType,1
9,1,0,10,mixedType,1
5,5,0,10,mixedType,1
6,2,0,8,mixedType,1
2,4,0,6,mixedType,0
6,3,0,9,mixedType,1
10,2,0,12,mixedType,1
6,3,0,9,mixedType,1
4,4,0,8,mixedType,1
5,2,0,7,mixedType,0
5,2,0,7,mixedType,0
4,4,0,8,mixedType,1
7,2,0,9,mixedType,1
10,3,0,13,mixedType,1
9,4,0,13,mixedType,1
6,1,0,7,mixedType,0
12,3,0,15,mixedType,2
1,9,0,10,mixedType,1
9,4,0,13,mixedType,1
1,9,0,10,mixedType,1
0,8,3,11,mixedType,1
23,1,1,25,mixedType,2
6,1,0,7,mixedType,0
6,2,0,8,mixedType,1
6,1,0,7,mixedType,0
5,2,0,7,mixedType,0
7,3,0,10,mixedType,1
13,3,0,16,mixedType,2
9,1,0,10,mixedType,1
7,2,0,9,mixedType,1
7,2,0,9,mixedType,1
12,4,0,16,mixedType,2
7,2,0,9,mixedType,1
7,4,0,11,mixedType,1
9,2,0,11,mixedType,1
8,2,0,10,mixedType,1
9,3,0,12,mixedType,1
7,2,0,9,mixedType,1
4,2,0,6,mixedType,0
6,2,0,8,mixedType,1
6,3,0,9,mixedType,1
3,6,0,9,mixedType,1
7,1,0,8,mixedType,1
7,1,0,8,mixedType,1
5,3,0,8,mixedType,1
5,3,0,8,mixedType,1
4,2,0,6,mixedType,0
5,8,0,13,mixedType,1
14,2,0,16,mixedType,2
10,2,0,12,mixedType,1
6,3,0,9,mixedType,1
7,2,0,9,mixedType,1
13,3,0,16,mixedType,2
6,4,0,10,mixedType,1
2,7,0,9,mixedType,1
7,3,0,10,mixedType,1
5,3,0,8,mixedType,1
3,6,0,9,mixedType,1
10,2,0,12,mixedType,1
7,3,0,10,mixedType,1
5,3,0,8,mixedType,1
8,1,0,9,mixedType,1
8,3,0,11,mixedType,1
6,3,0,9,mixedType,1
4,4,0,8,mixedType,1
5,2,0,7,mixedType,0
5,2,0,7,mixedType,0
2,6,0,8,mixedType,1
10,3,0,13,mixedType,1
6,3,0,9,mixedType,1
4,4,0,8,mixedType,1
7,2,0,9,mixedType,1
5,4,0,9,mixedType,1
8,2,0,10,mixedType,1
5,3,0,8,mixedType,1
6,4,0,10,mixedType,1
8,3,0,11,mixedType,1
9,1,0,10,mixedType,1
6,3,0,9,mixedType,1
3,5,0,8,mixedType,1
4,2,0,6,mixedType,0
4,2,0,6,mixedType,0
5,2,0,7,mixedType,0
6,2,0,8,mixedType,1
8,3,0,11,mixedType,1
10,1,0,11,mixedType,1
7,2,0,9,mixedType,1
10,3,0,13,mixedType,1
7,4,0,11,mixedType,1
4,8,0,12,mixedType,1
7,2,0,9,mixedType,1
7,3,0,10,mixedType,1
6,1,0,7,mixedType,0
5,3,0,8,mixedType,1
1,8,0,9,mixedType,1
9,1,0,10,mixedType,1
8,6,0,14,mixedType,2
7,3,0,10,mixedType,1
8,2,0,10,mixedType,1
8,1,1,10,mixedType,1
8,1,0,9,mixedType,1
6,4,0,10,mixedType,1
11,3,0,14,mixedType,2
9,4,0,13,mixedType,1
7,2,0,9,mixedType,1
2,8,0,10,mixedType,1
5,2,0,7,mixedType,0
6,1,0,7,mixedType,0
6,4,0,10,mixedType,1
8,2,0,10,mixedType,1
6,1,0,7,mixedType,0
6,3,0,9,mixedType,1
2,8,0,10,mixedType,1
4,6,0,10,mixedType,1
8,2,0,10,mixedType,1
11,3,0,14,mixedType,2
7,3,0,10,mixedType,1
6,2,0,8,mixedType,1
7,3,0,10,mixedType,1
4,4,0,8,mixedType,1
6,2,0,8,mixedType,1
6,3,0,9,mixedType,1
7,4,0,11,mixedType,1
15,1,0,16,mixedType,2
3,6,0,9,mixedType,1
7,3,0,10,mixedType,1
14,2,0,16,mixedType,2
13,3,0,16,mixedType,2
17,3,1,21,mixedType,2
6,2,0,8,mixedType,1
9,2,0,11,mixedType,1
6,2,0,8,mixedType,1
14,2,0,16,mixedType,2
5,4,0,9,mixedType,1
7,4,0,11,mixedType,1
14,1,0,15,mixedType,2
7,3,0,10,mixedType,1
8,2,0,10,mixedType,1
0,4,1,5,mixedType,0
9,1,0,10,mixedType,1
5,4,0,9,mixedType,1
4,6,0,10,mixedType,1
6,2,0,8,mixedType,1
8,1,0,9,mixedType,1
6,4,0,10,mixedType,1
6,3,0,9,mixedType,1
4,5,0,9,mixedType,1
11,1,0,12,mixedType,1
7,1,0,8,mixedType,1
5,4,0,9,mixedType,1
1,7,0,8,mixedType,1
4,2,0,6,mixedType,0
6,3,0,9,mixedType,1
8,1,0,9,mixedType,1
10,0,1,11,mixedType,1
5,2,0,7,mixedType,0
5,3,0,8,mixedType,1
4,2,0,6,mixedType,0
5,3,0,8,mixedType,1
6,2,0,8,mixedType,1
9,2,0,11,mixedType,1
6,1,0,7,mixedType,0
14,2,0,16,mixedType,2
7,3,0,10,mixedType,1
3,8,0,11,mixedType,1
4,2,0,6,mixedType,0
6,2,0,8,mixedType,1
7,3,0,10,mixedType,1
2,4,0,6,mixedType,0
9,1,0,10,mixedType,1
11,2,0,13,mixedType,1
4,4,0,8,mixedType,1
7,2,0,9,mixedType,1
1,8,0,9,mixedType,1
6,3,0,9,mixedType,1
5,4,0,9,mixedType,1
6,4,0,10,mixedType,1
4,6,0,10,mixedType,1
8,2,0,10,mixedType,1
2,6,0,8,mixedType,1
4,2,0,6,mixedType,0
6,4,0,10,mixedType,1
6,1,0,7,mixedType,0
11,1,0,12,mixedType,1
5,3,0,8,mixedType,1
7,3,0,10,mixedType,1
6,3,0,9,mixedType,1
4,2,0,6,mixedType,0
6,4,0,10,mixedType,1
6,1,0,7,mixedType,0
5,2,0,7,mixedType,0
6,6,0,12,mixedType,1
7,3,0,10,mixedType,1
6,3,0,9,mixedType,1
7,2,0,9,mixedType,1
15,1,0,16,mixedType,2
10,3,0,13,mixedType,1
6,3,0,9,mixedType,1
6,7,0,13,mixedType,1
7,3,0,10,mixedType,1
8,3,0,11,mixedType,1
5,2,0,7,mixedType,0
8,2,0,10,mixedType,1
5,3,0,8,mixedType,1
15,1,0,16,mixedType,2
8,3,0,11,mixedType,1
5,2,0,7,mixedType,0
5,1,0,6,mixedType,0
13,3,0,16,mixedType,2
6,3,0,9,mixedType,1
7,1,0,8,mixedType,1
8,2,0,10,mixedType,1
8,3,0,11,mixedType,1
8,2,0,10,mixedType,1
7,1,0,8,mixedType,1
1,8,0,9,mixedType,1
19,3,0,22,mixedType,2
14,7,0,21,mixedType,2
7,3,0,10,mixedType,1
4,6,0,10,mixedType,1
7,2,0,9,mixedType,1
7,2,0,9,mixedType,1
3,5,0,8,mixedType,1
13,3,0,16,mixedType,2
7,1,0,8,mixedType,1
7,3,0,10,mixedType,1
5,2,0,7,mixedType,0
6,1,0,7,mixedType,0
6,2,0,8,mixedType,1
5,2,0,7,mixedType,0
3,10,0,13,mixedType,1
12,4,0,16,mixedType,2
7,2,0,9,mixedType,1
5,3,0,8,mixedType,1
5,3,0,8,mixedType,1
8,3,0,11,mixedType,1
7,4,0,11,mixedType,1
9,2,0,11,mixedType,1
3,5,0,8,mixedType,1
6,3,0,9,mixedType,1
7,4,0,11,mixedType,1
6,2,0,8,mixedType,1
6,4,0,10,mixedType,1
4,2,0,6,mixedType,0
6,1,0,7,mixedType,0
8,3,0,11,mixedType,1
6,3,0,9,mixedType,1
4,2,0,6,mixedType,0
7,3,0,10,mixedType,1
8,1,0,9,mixedType,1
8,2,0,10,mixedType,1
6,2,0,8,mixedType,1
3,5,0,8,mixedType,1
13,3,0,16,mixedType,2
5,3,0,8,mixedType,1
13,3,0,16,mixedType,2
6,4,0,10,mixedType,1
9,1,0,10,mixedType,1
6,2,0,8,mixedType,1
15,1,0,16,mixedType,2
7,3,0,10,mixedType,1
6,3,0,9,mixedType,1
6,4,0,10,mixedType,1
6,3,0,9,mixedType,1
7,3,0,10,mixedType,1
14,2,0,16,mixedType,2
3,6,0,9,mixedType,1
4,6,0,10,mixedType,1
5,4,0,9,mixedType,1
15,1,0,16,mixedType,2
8,1,0,9,mixedType,1
4,2,0,6,mixedType,0
11,3,0,14,mixedType,2
5,4,0,9,mixedType,1
2,6,0,8,mixedType,1
8,4,0,12,mixedType,1
6,3,0,9,mixedType,1
11,3,0,14,mixedType,2
1,7,0,8,mixedType,1
4,2,0,6,mixedType,0
6,2,0,8,mixedType,1
6,5,0,11,mixedType,1
3,5,0,8,mixedType,1
7,3,0,10,mixedType,1
6,3,0,9,mixedType,1
7,2,0,9,mixedType,1
5,3,0,8,mixedType,1
6,3,0,9,mixedType,1
6,2,0,8,mixedType,1
7,1,0,8,mixedType,1
6,2,0,8,mixedType,1
8,2,0,10,mixedType,1
7,3,0,10,mixedType,1
6,10,0,16,mixedType,2
8,5,0,13,mixedType,1
10,1,0,11,mixedType,1
2,6,0,8,mixedType,1
4,2,0,6,mixedType,0
7,3,0,10,mixedType,1
7,2,0,9,mixedType,1
7,2,0,9,mixedType,1
2,4,0,6,mixedType,0
6,3,0,9,mixedType,1
1,11,0,12,mixedType,1
3,6,0,9,mixedType,1
11,3,0,14,mixedType,2
4,4,0,8,mixedType,1
6,1,0,7,mixedType,0
5,2,0,7,mixedType,0
6,2,0,8,mixedType,1
6,4,0,10,mixedType,1
4,2,0,6,mixedType,0
10,3,1,14,mixedType,2
5,3,0,8,mixedType,1
6,2,0,8,mixedType,1
7,4,0,11,mixedType,1
6,2,0,8,mixedType,1
13,3,0,16,mixedType,2
7,2,0,9,mixedType,1
3,3,0,6,mixedType,0
9,4,0,13,mixedType,1
7,2,0,9,mixedType,1
7,3,0,10,mixedType,1
5,1,0,6,mixedType,0
5,2,0,7,mixedType,0
9,2,0,11,mixedType,1
1,8,0,9,mixedType,1
7,2,0,9,mixedType,1
14,2,0,16,mixedType,2
4,6,0,10,mixedType,1
6,1,0,7,mixedType,0
1,8,0,9,mixedType,1
6,3,0,9,mixedType,1
7,1,0,8,mixedType,1
13,3,0,16,mixedType,2
8,1,0,9,mixedType,1
6,4,0,10,mixedType,1
6,2,0,8,mixedType,1
5,3,0,8,mixedType,1
6,4,0,10,mixedType,1
14,2,0,16,mixedType,2
5,4,0,9,mixedType,1
5,4,0,9,mixedType,1
5,4,0,9,mixedType,1
9,1,0,10,mixedType,1
13,3,0,16,mixedType,2
6,1,0,7,mixedType,0
6,1,0,7,mixedType,0
9,2,0,11,mixedType,1
7,7,6,20,mixedType,2
14,2,0,16,mixedType,2
6,3,0,9,mixedType,1
9,2,0,11,mixedType,1
8,1,0,9,mixedType,1
6,3,0,9,mixedType,1
4,5,0,9,mixedType,1
5,1,0,6,mixedType,0
7,3,0,10,mixedType,1
15,1,0,16,mixedType,2
13,3,0,16,mixedType,2
5,3,0,8,mixedType,1
8,4,0,12,mixedType,1
11,3,0,14,mixedType,2
2,4,0,6,mixedType,0
4,4,0,8,mixedType,1
7,1,0,8,mixedType,1
14,2,0,16,mixedType,2
2,6,0,8,mixedType,1
7,3,0,10,mixedType,1
7,3,0,10,mixedType,1
6,6,0,12,mixedType,1
5,4,0,9,mixedType,1
4,2,0,6,mixedType,0
4,6,0,10,mixedType,1
4,4,0,8,mixedType,1
6,3,0,9,mixedType,1
11,5,0,16,mixedType,2
5,3,0,8,mixedType,1
4,2,0,6,mixedType,0
5,4,0,9,mixedType,1
9,1,0,10,mixedType,1
5,5,0,10,mixedType,1
11,2,0,13,mixedType,1
6,2,0,8,mixedType,1
7,3,0,10,mixedType,1
0,5,1,6,mixedType,0
4,4,0,8,mixedType,1
8,2,0,10,mixedType,1
5,4,0,9,mixedType,1
1,10,0,11,mixedType,1
3,7,0,10,mixedType,1
4,4,0,8,mixedType,1
12,0,1,13,mixedType,1
12,4,0,16,mixedType,2
8,4,0,12,mixedType,1
8,1,0,9,mixedType,1
14,2,0,16,mixedType,2
4,2,0,6,mixedType,0
9,1,0,10,mixedType,1
8,0,2,10,mixedType,1
7,3,0,10,mixedType,1
7,4,0,11,mixedType,1
1,7,0,8,mixedType,1
6,3,0,9,mixedType,1
7,2,0,9,mixedType,1
5,2,0,7,mixedType,0
7,3,0,10,mixedType,1
3,3,0,6,mixedType,0
2,8,0,10,mixedType,1
5,2,0,7,mixedType,0
7,2,0,9,mixedType,1
4,2,0,6,mixedType,0
7,2,0,9,mixedType,1
5,3,0,8,mixedType,1
9,2,0,11,mixedType,1
10,1,0,11,mixedType,1
3,3,0,6,mixedType,0
6,4,0,10,mixedType,1
6,3,0,9,mixedType,1
7,2,0,9,mixedType,1
5,3,0,8,mixedType,1
4,4,0,8,mixedType,1
7,5,0,12,mixedType,1
2,9,0,11,mixedType,1
1,10,0,11,mixedType,1
7,2,0,9,mixedType,1
8,3,0,11,mixedType,1
9,2,0,11,mixedType,1
10,2,0,12,mixedType,1
12,4,0,16,mixedType,2
11,3,0,14,mixedType,2
6,1,0,7,mixedType,0
7,3,0,10,mixedType,1
7,2,0,9,mixedType,1
2,8,0,10,mixedType,1
5,3,0,8,mixedType,1
7,1,0,8,mixedType,1
2,6,0,8,mixedType,1
2,6,0,8,mixedType,1
5,3,0,8,mixedType,1
5,2,0,7,mixedType,0
8,1,0,9,mixedType,1
4,4,0,8,mixedType,1
8,3,0,11,mixedType,1
8,2,0,10,mixedType,1
5,1,0,6,mixedType,0
6,2,0,8,mixedType,1
5,3,0,8,mixedType,1
6,1,0,7,mixedType,0
8,1,0,9,mixedType,1
8,1,0,9,mixedType,1
5,1,0,6,mixedType,0
11,2,0,13,mixedType,1
4,6,0,10,mixedType,1
4,4,0,8,mixedType,1
13,1,1,15,mixedType,2
6,3,0,9,mixedType,1
7,2,0,9,mixedType,1
8,2,0,10,mixedType,1
5,3,0,8,mixedType,1
4,2,0,6,mixedType,0
9,1,0,10,mixedType,1
12,3,0,15,mixedType,2
4,4,0,8,mixedType,1
8,2,0,10,mixedType,1
6,4,0,10,mixedType,1
1,9,0,10,mixedType,1
7,4,0,11,mixedType,1
5,1,0,6,mixedType,0
8,1,0,9,mixedType,1
7,3,0,10,mixedType,1
5,2,0,7,mixedType,0
5,2,0,7,mixedType,0
4,2,0,6,mixedType,0
6,1,0,7,mixedType,0
5,3,0,8,mixedType,1
5,3,0,8,mixedType,1
5,3,0,8,mixedType,1
8,1,0,9,mixedType,1
1,10,0,11,mixedType,1
8,1,0,9,mixedType,1
6,3,0,9,mixedType,1
5,2,0,7,mixedType,0
6,6,0,12,mixedType,1
1,7,0,8,mixedType,1
1,7,0,8,mixedType,1
14,2,0,16,mixedType,2
3,5,0,8,mixedType,1
5,0,6,11,mixedType,1
5,3,0,8,mixedType,1
8,2,0,10,mixedType,1
6,3,0,9,mixedType,1
5,5,0,10,mixedType,1
7,2,0,9,mixedType,1
7,2,0,9,mixedType,1
3,7,0,10,mixedType,1
5,2,0,7,mixedType,0
7,2,0,9,mixedType,1
2,4,0,6,mixedType,0
7,1,0,8,mixedType,1
9,3,0,12,mixedType,1
8,2,0,10,mixedType,1
7,3,0,10,mixedType,1
6,2,0,8,mixedType,1
8,3,0,11,mixedType,1
5,4,0,9,mixedType,1
14,2,0,16,mixedType,2
7,2,0,9,mixedType,1
8,2,0,10,mixedType,1
3,5,0,8,mixedType,1
6,4,0,10,mixedType,1
8,1,0,9,mixedType,1
1,5,0,6,mixedType,0
3,3,0,6,mixedType,0
6,4,0,10,mixedType,1
5,1,0,6,mixedType,0
6,3,0,9,mixedType,1
3,6,0,9,mixedType,1
5,2,0,7,mixedType,0
1,8,0,9,mixedType,1
6,1,0,7,mixedType,0
7,2,0,9,mixedType,1
9,3,0,12,mixedType,1
6,2,0,8,mixedType,1
5,10,1,16,mixedType,2
5,3,0,8,mixedType,1
9,1,0,10,mixedType,1
8,1,0,9,mixedType,1
12,4,0,16,mixedType,2
8,4,0,12,mixedType,1
6,3,0,9,mixedType,1
5,2,0,7,mixedType,0
6,1,0,7,mixedType,0
10,2,0,12,mixedType,1
9,1,0,10,mixedType,1
2,7,0,9,mixedType,1
7,1,0,8,mixedType,1
9,1,0,10,mixedType,1
6,4,0,10,mixedType,1
13,3,0,16,mixedType,2
5,4,0,9,mixedType,1
7,2,0,9,mixedType,1
5,6,0,11,mixedType,1
6,3,0,9,mixedType,1
5,6,0,11,mixedType,1
2,10,0,12,mixedType,1
9,1,0,10,mixedType,1
15,1,0,16,mixedType,2
10,3,0,13,mixedType,1
5,4,0,9,mixedType,1
6,2,0,8,mixedType,1
7,4,0,11,mixedType,1
5,3,0,8,mixedType,1
6,3,0,9,mixedType,1
6,1,0,7,mixedType,0
8,1,0,9,mixedType,1
6,4,0,10,mixedType,1
7,3,0,10,mixedType,1
6,4,0,10,mixedType,1
5,4,0,9,mixedType,1
14,2,0,16,mixedType,2
8,2,0,10,mixedType,1
13,3,0,16,mixedType,2
0,5,2,7,mixedType,0
6,3,0,9,mixedType,1
6,1,0,7,mixedType,0
6,1,0,7,mixedType,0
5,1,0,6,mixedType,0
6,3,0,9,mixedType,1
4,2,0,6,mixedType,0
6,2,0,8,mixedType,1
7,3,0,10,mixedType,1
6,4,0,10,mixedType,1
7,1,0,8,mixedType,1
8,2,0,10,mixedType,1
4,5,0,9,mixedType,1
6,3,0,9,mixedType,1
7,4,0,11,mixedType,1
7,3,0,10,mixedType,1
5,1,0,6,mixedType,0
7,3,0,10,mixedType,1
12,4,0,16,mixedType,2
4,4,0,8,mixedType,1
3,10,1,14,mixedType,2
7,3,0,10,mixedType,1
17,2,3,22,mixedType,2
12,1,0,13,mixedType,1
9,3,0,12,mixedType,1
5,4,0,9,mixedType,1
5,4,0,9,mixedType,1
6,3,0,9,mixedType,1
4,2,0,6,mixedType,0
5,4,0,9,mixedType,1
4,2,0,6,mixedType,0
0,6,0,6,sameType,0
6,4,0,10,mixedType,1
9,2,0,11,mixedType,1
9,1,0,10,mixedType,1
5,3,0,8,mixedType,1
7,2,0,9,mixedType,1
9,2,0,11,mixedType,1
2,8,0,10,mixedType,1
9,3,0,12,mixedType,1
1,8,0,9,mixedType,1
8,4,0,12,mixedType,1
4,7,0,11,mixedType,1
4,6,0,10,mixedType,1
7,3,0,10,mixedType,1
6,6,0,12,mixedType,1
2,6,0,8,mixedType,1
5,4,0,9,mixedType,1
9,1,0,10,mixedType,1
5,4,0,9,mixedType,1
11,5,0,16,mixedType,2
4,7,0,11,mixedType,1
7,2,0,9,mixedType,1
2,7,0,9,mixedType,1
4,4,0,8,mixedType,1
9,1,0,10,mixedType,1
7,3,0,10,mixedType,1
3,3,0,6,mixedType,0
6,4,0,10,mixedType,1
6,3,0,9,mixedType,1
6,3,0,9,mixedType,1
13,3,0,16,mixedType,2
7,1,0,8,mixedType,1
7,1,0,8,mixedType,1
8,2,0,10,mixedType,1
6,3,0,9,mixedType,1
7,3,0,10,mixedType,1
10,2,0,12,mixedType,1
7,2,0,9,mixedType,1
7,3,0,10,mixedType,1
4,4,0,8,mixedType,1
9,1,0,10,mixedType,1
6,4,0,10,mixedType,1
9,1,0,10,mixedType,1
5,9,0,14,mixedType,2
14,2,0,16,mixedType,2
7,3,0,10,mixedType,1
8,1,0,9,mixedType,1
8,4,0,12,mixedType,1
13,3,0,16,mixedType,2
7,3,0,10,mixedType,1
6,2,0,8,mixedType,1
7,2,0,9,mixedType,1
7,2,0,9,mixedType,1
8,1,0,9,mixedType,1
6,4,0,10,mixedType,1
6,3,0,9,mixedType,1
6,3,0,9,mixedType,1
3,5,0,8,mixedType,1
15,1,0,16,mixedType,2
6,4,0,10,mixedType,1
6,4,0,10,mixedType,1
4,4,0,8,mixedType,1
8,1,0,9,mixedType,1
5,2,0,7,mixedType,0
7,3,0,10,mixedType,1
8,2,0,10,mixedType,1
4,2,0,6,mixedType,0
14,2,0,16,mixedType,2
3,3,0,6,mixedType,0
6,3,0,9,mixedType,1
8,3,0,11,mixedType,1
7,3,0,10,mixedType,1
7,2,0,9,mixedType,1
7,1,0,8,mixedType,1
10,0,1,11,mixedType,1
14,2,0,16,mixedType,2
5,4,0,9,mixedType,1
8,3,0,11,mixedType,1
11,5,0,16,mixedType,2
4,6,0,10,mixedType,1
5,2,0,7,mixedType,0
5,4,0,9,mixedType,1
7,3,0,10,mixedType,1
1,8,0,9,mixedType,1
1,7,0,8,mixedType,1
9,2,0,11,mixedType,1
6,4,0,10,mixedType,1
7,3,0,10,mixedType,1
5,2,0,7,mixedType,0
6,4,0,10,mixedType,1
4,6,0,10,mixedType,1
15,1,0,16,mixedType,2
9,1,0,10,mixedType,1
7,2,0,9,mixedType,1
16,2,0,18,mixedType,2
7,2,0,9,mixedType,1
15,1,0,16,mixedType,2
6,3,0,9,mixedType,1
8,1,0,9,mixedType,1
6,2,0,8,mixedType,1
4,4,0,8,mixedType,1
10,1,0,11,mixedType,1
12,4,0,16,mixedType,2
5,2,0,7,mixedType,0
4,4,0,8,mixedType,1
7,2,0,9,mixedType,1
7,3,0,10,mixedType,1
7,2,0,9,mixedType,1
8,4,0,12,mixedType,1
14,2,0,16,mixedType,2
10,2,0,12,mixedType,1
5,6,0,11,mixedType,1
7,2,0,9,mixedType,1
8,2,0,10,mixedType,1
11,3,0,14,mixedType,2
6,1,0,7,mixedType,0
9,2,0,11,mixedType,1
6,3,0,9,mixedType,1
12,4,0,16,mixedType,2
7,2,0,9,mixedType,1
6,3,0,9,mixedType,1
9,3,0,12,mixedType,1
14,2,0,16,mixedType,2
6,3,0,9,mixedType,1
5,4,0,9,mixedType,1
8,2,0,10,mixedType,1
2,11,0,13,mixedType,1
7,1,0,8,mixedType,1
6,1,0,7,mixedType,0
3,5,0,8,mixedType,1
8,3,0,11,mixedType,1
1,9,0,10,mixedType,1
7,3,0,10,mixedType,1
6,3,0,9,mixedType,1
7,2,0,9,mixedType,1
6,4,0,10,mixedType,1
6,1,0,7,mixedType,0
6,3,0,9,mixedType,1
4,2,0,6,mixedType,0
8,2,0,10,mixedType,1
9,4,0,13,mixedType,1
10,2,0,12,mixedType,1
5,4,0,9,mixedType,1
6,1,0,7,mixedType,0
7,4,0,11,mixedType,1
3,3,0,6,mixedType,0
10,3,0,13,mixedType,1
6,2,0,8,mixedType,1
7,6,0,13,mixedType,1
9,3,0,12,mixedType,1
6,3,0,9,mixedType,1
9,2,0,11,mixedType,1
6,3,0,9,mixedType,1
7,2,0,9,mixedType,1
10,4,1,15,mixedType,2
10,5,0,15,mixedType,2
0,8,0,8,sameType,1
7,3,0,10,mixedType,1
5,8,0,13,mixedType,1
6,3,0,9,mixedType,1
8,2,0,10,mixedType,1
14,2,0,16,mixedType,2
4,2,0,6,mixedType,0
8,2,0,10,mixedType,1
15,1,0,16,mixedType,2
7,3,0,10,mixedType,1
9,4,0,13,mixedType,1
5,3,0,8,mixedType,1
8,1,0,9,mixedType,1
7,1,0,8,mixedType,1
10,2,0,12,mixedType,1
5,3,0,8,mixedType,1
8,1,0,9,mixedType,1
5,4,0,9,mixedType,1
6,2,0,8,mixedType,1
6,1,0,7,mixedType,0
2,6,0,8,mixedType,1
11,2,0,13,mixedType,1
8,1,0,9,mixedType,1
6,3,0,9,mixedType,1
9,3,0,12,mixedType,1
5,3,0,8,mixedType,1
3,8,0,11,mixedType,1
6,1,0,7,mixedType,0
8,5,0,13,mixedType,1
8,4,0,12,mixedType,1
9,3,0,12,mixedType,1
8,4,0,12,mixedType,1
11,2,0,13,mixedType,1
7,2,0,9,mixedType,1
5,1,0,6,mixedType,0
8,3,0,11,mixedType,1
8,2,0,10,mixedType,1
5,2,0,7,mixedType,0
7,2,0,9,mixedType,1
1,5,0,6,mixedType,0
11,0,2,13,mixedType,1
5,5,0,10,mixedType,1
4,2,0,6,mixedType,0
9,1,0,10,mixedType,1
5,1,0,6,mixedType,0
10,2,0,12,mixedType,1
6,2,0,8,mixedType,1
13,3,0,16,mixedType,2
15,1,0,16,mixedType,2
8,2,0,10,mixedType,1
5,4,0,9,mixedType,1
14,2,0,16,mixedType,2
7,3,0,10,mixedType,1
4,6,0,10,mixedType,1
11,2,0,13,mixedType,1
14,2,0,16,mixedType,2
8,1,0,9,mixedType,1
6,2,0,8,mixedType,1
6,4,0,10,mixedType,1
9,1,0,10,mixedType,1
6,2,0,8,mixedType,1
7,4,0,11,mixedType,1
5,2,0,7,mixedType,0
7,2,0,9,mixedType,1
11,2,0,13,mixedType,1
4,2,0,6,mixedType,0
7,3,0,10,mixedType,1
9,3,0,12,mixedType,1
3,6,0,9,mixedType,1
15,1,0,16,mixedType,2
7,3,0,10,mixedType,1
6,2,0,8,mixedType,1
7,1,0,8,mixedType,1
11,3,1,15,mixedType,2
4,6,0,10,mixedType,1
8,1,0,9,mixedType,1
5,4,0,9,mixedType,1
7,6,0,13,mixedType,1
8,1,0,9,mixedType,1
6,2,0,8,mixedType,1
5,8,0,13,mixedType,1
5,5,0,10,mixedType,1
6,3,0,9,mixedType,1
3,7,0,10,mixedType,1
6,1,0,7,mixedType,0
6,2,0,8,mixedType,1
12,3,0,15,mixedType,2
3,5,0,8,mixedType,1
2,8,0,10,mixedType,1
3,5,0,8,mixedType,1
5,4,0,9,mixedType,1
4,5,0,9,mixedType,1
1,10,0,11,mixedType,1
5,2,0,7,mixedType,0
6,4,0,10,mixedType,1
8,3,0,11,mixedType,1
8,2,0,10,mixedType,1
6,3,0,9,mixedType,1
7,3,0,10,mixedType,1
4,4,0,8,mixedType,1
12,4,0,16,mixedType,2
3,5,0,8,mixedType,1
5,3,0,8,mixedType,1
4,2,0,6,mixedType,0
7,3,0,10,mixedType,1
14,2,0,16,mixedType,2
2,4,0,6,mixedType,0
15,1,0,16,mixedType,2
5,3,0,8,mixedType,1
4,6,0,10,mixedType,1
10,3,0,13,mixedType,1
6,3,0,9,mixedType,1
5,3,0,8,mixedType,1
5,3,0,8,mixedType,1
5,3,0,8,mixedType,1
6,2,0,8,mixedType,1
2,8,0,10,mixedType,1
6,1,0,7,mixedType,0
4,4,0,8,mixedType,1
9,3,0,12,mixedType,1
15,1,0,16,mixedType,2
6,4,0,10,mixedType,1
6,3,0,9,mixedType,1
4,2,0,6,mixedType,0
7,2,0,9,mixedType,1
9,1,0,10,mixedType,1
14,2,0,16,mixedType,2
5,1,0,6,mixedType,0
9,1,0,10,mixedType,1
9,1,0,10,mixedType,1
5,3,0,8,mixedType,1
6,3,0,9,mixedType,1
5,3,0,8,mixedType,1
6,3,0,9,mixedType,1
1,10,0,11,mixedType,1
6,3,0,9,mixedType,1
5,3,0,8,mixedType,1
11,3,0,14,mixedType,2
6,4,0,10,mixedType,1
9,2,0,11,mixedType,1
8,1,0,9,mixedType,1
6,2,0,8,mixedType,1
14,2,0,16,mixedType,2
14,2,0,16,mixedType,2
8,2,0,10,mixedType,1
13,3,0,16,mixedType,2
8,1,0,9,mixedType,1
10,2,0,12,mixedType,1
8,0,1,9,mixedType,1
12,3,0,15,mixedType,2
10,6,0,16,mixedType,2
9,3,0,12,mixedType,1
6,6,0,12,mixedType,1
8,4,0,12,mixedType,1
7,3,0,10,mixedType,1
6,1,0,7,mixedType,0
6,2,0,8,mixedType,1
3,7,0,10,mixedType,1
7,3,0,10,mixedType,1
12,3,0,15,mixedType,2
4,4,0,8,mixedType,1
1,10,0,11,mixedType,1
4,6,0,10,mixedType,1
5,8,0,13,mixedType,1
3,7,0,10,mixedType,1
12,1,0,13,mixedType,1
8,2,0,10,mixedType,1
5,3,0,8,mixedType,1
7,3,0,10,mixedType,1
8,1,0,9,mixedType,1
7,3,0,10,mixedType,1
6,3,0,9,mixedType,1
7,3,0,10,mixedType,1
6,6,0,12,mixedType,1
12,4,0,16,mixedType,2
8,4,0,12,mixedType,1
7,3,0,10,mixedType,1
6,3,0,9,mixedType,1
6,3,0,9,mixedType,1
7,3,0,10,mixedType,1
7,1,0,8,mixedType,1
4,7,0,11,mixedType,1
9,1,0,10,mixedType,1
4,4,0,8,mixedType,1
5,3,0,8,mixedType,1
8,1,0,9,mixedType,1
6,2,0,8,mixedType,1
4,6,0,10,mixedType,1
7,3,0,10,mixedType,1
14,2,0,16,mixedType,2
7,3,0,10,mixedType,1
10,3,0,13,mixedType,1
5,2,0,7,mixedType,0
4,0,2,6,mixedType,0
8,2,0,10,mixedType,1
11,1,0,12,mixedType,1
3,8,0,11,mixedType,1
8,2,0,10,mixedType,1
5,2,0,7,mixedType,0
6,1,0,7,mixedType,0
8,0,2,10,mixedType,1
10,3,0,13,mixedType,1
2,6,0,8,mixedType,1
5,2,0,7,mixedType,0
8,2,0,10,mixedType,1
6,1,0,7,mixedType,0
8,3,0,11,mixedType,1
1,9,0,10,mixedType,1
7,4,0,11,mixedType,1
7,3,0,10,mixedType,1
6,3,0,9,mixedType,1
2,4,0,6,mixedType,0
3,5,0,8,mixedType,1
11,1,0,12,mixedType,1
13,3,0,16,mixedType,2
5,1,0,6,mixedType,0
6,3,0,9,mixedType,1
13,3,0,16,mixedType,2
5,3,0,8,mixedType,1
5,4,0,9,mixedType,1
7,3,0,10,mixedType,1
5,3,0,8,mixedType,1
13,3,0,16,mixedType,2
4,6,0,10,mixedType,1
1,5,0,6,mixedType,0
5,3,0,8,mixedType,1
2,4,0,6,mixedType,0
8,4,0,12,mixedType,1
2,9,0,11,mixedType,1
3,9,0,12,mixedType,1
1,8,0,9,mixedType,1
2,4,0,6,mixedType,0
6,6,0,12,mixedType,1
7,1,0,8,mixedType,1
13,3,0,16,mixedType,2
6,3,0,9,mixedType,1
8,1,0,9,mixedType,1
5,4,0,9,mixedType,1
6,3,0,9,mixedType,1
8,2,0,10,mixedType,1
6,3,0,9,mixedType,1
5,1,0,6,mixedType,0
15,1,0,16,mixedType,2
8,3,0,11,mixedType,1
5,2,0,7,mixedType,0
6,6,0,12,mixedType,1
9,3,0,12,mixedType,1
6,4,0,10,mixedType,1
6,4,0,10,mixedType,1
6,3,0,9,mixedType,1
8,2,0,10,mixedType,1
3,8,0,11,mixedType,1
1,9,0,10,mixedType,1
9,1,0,10,mixedType,1
6,1,0,7,mixedType,0
8,2,0,10,mixedType,1
3,5,0,8,mixedType,1
7,2,0,9,mixedType,1
6,2,0,8,mixedType,1
7,2,0,9,mixedType,1
15,1,0,16,mixedType,2
6,3,0,9,mixedType,1
7,2,0,9,mixedType,1
3,7,0,10,mixedType,1
15,1,1,17,mixedType,2
9,2,0,11,mixedType,1
7,3,0,10,mixedType,1
14,2,0,16,mixedType,2
13,3,0,16,mixedType,2
14,2,0,16,mixedType,2
5,3,0,8,mixedType,1
12,3,0,15,mixedType,2
7,1,0,8,mixedType,1
6,3,0,9,mixedType,1
4,2,0,6,mixedType,0
5,2,0,7,mixedType,0
14,2,0,16,mixedType,2
6,3,0,9,mixedType,1
6,4,0,10,mixedType,1
9,2,0,11,mixedType,1
1,8,0,9,mixedType,1
4,4,0,8,mixedType,1
11,3,0,14,mixedType,2
7,3,0,10,mixedType,1
5,0,1,6,mixedType,0
6,3,0,9,mixedType,1
2,6,0,8,mixedType,1
6,3,0,9,mixedType,1
4,4,0,8,mixedType,1
5,3,0,8,mixedType,1
2,9,0,11,mixedType,1
6,2,0,8,mixedType,1
1,8,0,9,mixedType,1
7,3,0,10,mixedType,1
14,2,0,16,mixedType,2
11,3,0,14,mixedType,2
2,6,0,8,mixedType,1
4,5,0,9,mixedType,1
4,6,0,10,mixedType,1
5,3,0,8,mixedType,1
13,3,0,16,mixedType,2
6,2,0,8,mixedType,1
8,4,0,12,mixedType,1
11,5,0,16,mixedType,2
10,6,0,16,mixedType,2
16,4,0,20,mixedType,2
1,8,0,9,mixedType,1
10,1,0,11,mixedType,1
9,3,0,12,mixedType,1
6,4,0,10,mixedType,1
8,1,0,9,mixedType,1
1,8,0,9,mixedType,1
6,2,0,8,mixedType,1
7,1,0,8,mixedType,1
13,3,0,16,mixedType,2
6,3,0,9,mixedType,1
1,9,0,10,mixedType,1
14,2,0,16,mixedType,2
7,3,0,10,mixedType,1
6,4,0,10,mixedType,1
6,3,0,9,mixedType,1
5,2,0,7,mixedType,0
6,8,0,14,mixedType,2
12,4,0,16,mixedType,2
14,2,0,16,mixedType,2
5,4,0,9,mixedType,1
6,2,0,8,mixedType,1
12,3,0,15,mixedType,2
9,2,0,11,mixedType,1
14,2,0,16,mixedType,2
3,3,0,6,mixedType,0
8,2,0,10,mixedType,1
6,2,0,8,mixedType,1
8,2,0,10,mixedType,1
7,3,0,10,mixedType,1
2,7,0,9,mixedType,1
6,2,0,8,mixedType,1
8,3,0,11,mixedType,1
7,3,0,10,mixedType,1
2,8,0,10,mixedType,1
15,2,1,18,mixedType,2
5,4,0,9,mixedType,1
4,4,0,8,mixedType,1
13,1,1,15,mixedType,2
5,2,0,7,mixedType,0
7,1,0,8,mixedType,1
6,2,0,8,mixedType,1
9,1,0,10,mixedType,1
8,1,0,9,mixedType,1
4,4,0,8,mixedType,1
7,1,0,8,mixedType,1
10,2,0,12,mixedType,1
6,4,0,10,mixedType,1
4,2,0,6,mixedType,0
7,3,0,10,mixedType,1
8,1,0,9,mixedType,1
9,2,0,11,mixedType,1
2,4,0,6,mixedType,0
14,2,0,16,mixedType,2
8,2,0,10,mixedType,1
7,1,0,8,mixedType,1
14,2,0,16,mixedType,2
7,4,0,11,mixedType,1
6,3,0,9,mixedType,1
6,3,0,9,mixedType,1
5,3,0,8,mixedType,1
2,6,0,8,mixedType,1
7,3,0,10,mixedType,1
6,1,0,7,mixedType,0
12,3,0,15,mixedType,2
3,6,0,9,mixedType,1
2,4,0,6,mixedType,0
8,1,0,9,mixedType,1
5,3,0,8,mixedType,1
4,2,0,6,mixedType,0
8,2,0,10,mixedType,1
10,1,0,11,mixedType,1
5,6,0,11,mixedType,1
7,3,0,10,mixedType,1
7,3,0,10,mixedType,1
6,6,0,12,mixedType,1
9,3,0,12,mixedType,1
6,2,0,8,mixedType,1
4,6,0,10,mixedType,1
5,2,0,7,mixedType,0
6,4,0,10,mixedType,1
4,4,0,8,mixedType,1
6,3,0,9,mixedType,1
6,2,0,8,mixedType,1
8,2,0,10,mixedType,1
9,1,0,10,mixedType,1
14,2,0,16,mixedType,2
5,2,0,7,mixedType,0
9,1,0,10,mixedType,1
4,8,0,12,mixedType,1
4,2,0,6,mixedType,0
7,2,0,9,mixedType,1
6,3,0,9,mixedType,1
6,3,0,9,mixedType,1
9,2,0,11,mixedType,1
5,1,0,6,mixedType,0
7,2,0,9,mixedType,1
6,4,0,10,mixedType,1
7,3,0,10,mixedType,1
9,2,0,11,mixedType,1
6,5,0,11,mixedType,1
5,2,0,7,mixedType,0
12,4,0,16,mixedType,2
5,1,0,6,mixedType,0
8,2,0,10,mixedType,1
6,3,0,9,mixedType,1
5,4,0,9,mixedType,1
6,4,0,10,mixedType,1
8,3,0,11,mixedType,1
8,2,0,10,mixedType,1
6,3,0,9,mixedType,1
6,3,0,9,mixedType,1
2,8,0,10,mixedType,1
6,3,0,9,mixedType,1
7,3,0,10,mixedType,1
5,2,0,7,mixedType,0
1,9,0,10,mixedType,1
6,1,0,7,mixedType,0
6,4,0,10,mixedType,1
3,6,0,9,mixedType,1
4,6,0,10,mixedType,1
14,2,0,16,mixedType,2
4,6,0,10,mixedType,1
5,3,0,8,mixedType,1
6,4,0,10,mixedType,1
7,2,0,9,mixedType,1
12,3,0,15,mixedType,2
5,5,0,10,mixedType,1
10,3,0,13,mixedType,1
5,5,0,10,mixedType,1
9,2,0,11,mixedType,1
4,4,0,8,mixedType,1
6,3,0,9,mixedType,1
9,3,0,12,mixedType,1
6,4,0,10,mixedType,1
5,4,0,9,mixedType,1
4,2,0,6,mixedType,0
7,3,0,10,mixedType,1
9,2,0,11,mixedType,1
6,1,0,7,mixedType,0
6,3,0,9,mixedType,1
7,3,0,10,mixedType,1
7,2,0,9,mixedType,1
15,1,0,16,mixedType,2
7,1,0,8,mixedType,1
5,2,0,7,mixedType,0
9,1,0,10,mixedType,1
13,3,0,16,mixedType,2
1,8,0,9,mixedType,1
3,5,0,8,mixedType,1
5,6,0,11,mixedType,1
6,2,0,8,mixedType,1
5,4,0,9,mixedType,1
5,3,0,8,mixedType,1
4,4,0,8,mixedType,1
5,2,0,7,mixedType,0
7,3,0,10,mixedType,1
12,3,0,15,mixedType,2
2,7,0,9,mixedType,1
8,3,0,11,mixedType,1
2,6,0,8,mixedType,1
7,3,0,10,mixedType,1
1,11,0,12,mixedType,1
5,2,0,7,mixedType,0
1,8,0,9,mixedType,1
8,1,0,9,mixedType,1
12,1,0,13,mixedType,1
1,11,0,12,mixedType,1
7,4,0,11,mixedType,1
6,6,0,12,mixedType,1
10,2,0,12,mixedType,1
5,4,0,9,mixedType,1
14,2,0,16,mixedType,2
6,3,0,9,mixedType,1
9,4,0,13,mixedType,1
8,4,0,12,mixedType,1
5,2,0,7,mixedType,0
5,4,0,9,mixedType,1
6,2,0,8,mixedType,1
5,3,0,8,mixedType,1
2,8,0,10,mixedType,1
9,2,0,11,mixedType,1
5,2,0,7,mixedType,0
5,1,0,6,mixedType,0
5,2,0,7,mixedType,0
6,2,0,8,mixedType,1
6,3,0,9,mixedType,1
6,3,0,9,mixedType,1
5,8,0,13,mixedType,1
7,2,0,9,mixedType,1
5,2,0,7,mixedType,0
7,1,0,8,mixedType,1
5,3,0,8,mixedType,1
13,3,0,16,mixedType,2
8,1,0,9,mixedType,1
7,2,0,9,mixedType,1
9,1,0,10,mixedType,1
7,1,0,8,mixedType,1
8,2,0,10,mixedType,1
5,4,0,9,mixedType,1
2,7,0,9,mixedType,1
14,2,0,16,mixedType,2
8,2,0,10,mixedType,1
9,2,0,11,mixedType,1
3,3,0,6,mixedType,0
9,4,0,13,mixedType,1
6,3,0,9,mixedType,1
2,7,0,9,mixedType,1
14,3,3,20,mixedType,2
7,5,0,12,mixedType,1
4,2,0,6,mixedType,0
4,2,0,6,mixedType,0
5,1,0,6,mixedType,0
9,1,0,10,mixedType,1
5,3,0,8,mixedType,1
6,3,0,9,mixedType,1
4,4,0,8,mixedType,1
7,3,0,10,mixedType,1
4,4,0,8,mixedType,1
8,1,0,9,mixedType,1
9,2,0,11,mixedType,1
1,8,0,9,mixedType,1
7,1,0,8,mixedType,1
2,8,0,10,mixedType,1
6,2,0,8,mixedType,1
7,4,0,11,mixedType,1
5,4,0,9,mixedType,1
7,2,0,9,mixedType,1
10,2,0,12,mixedType,1
2,6,0,8,mixedType,1
6,3,0,9,mixedType,1
7,3,0,10,mixedType,1
8,3,0,11,mixedType,1
7,3,0,10,mixedType,1
5,1,0,6,mixedType,0
9,2,0,11,mixedType,1
2,6,0,8,mixedType,1
7,1,0,8,mixedType,1
2,6,0,8,mixedType,1
7,4,0,11,mixedType,1
7,1,0,8,mixedType,1
6,6,0,12,mixedType,1
5,5,0,10,mixedType,1
6,4,0,10,mixedType,1
5,6,0,11,mixedType,1
7,6,0,13,mixedType,1
7,2,0,9,mixedType,1
5,3,0,8,mixedType,1
7,2,0,9,mixedType,1
7,2,0,9,mixedType,1
14,2,0,16,mixedType,2
10,3,0,13,mixedType,1
7,1,0,8,mixedType,1
6,3,0,9,mixedType,1
6,3,0,9,mixedType,1
4,2,0,6,mixedType,0
8,8,0,16,mixedType,2
5,2,0,7,mixedType,0
12,4,0,16,mixedType,2
5,4,0,9,mixedType,1
4,6,0,10,mixedType,1
1,7,0,8,mixedType,1
9,3,0,12,mixedType,1
8,1,0,9,mixedType,1
4,4,0,8,mixedType,1
9,1,0,10,mixedType,1
7,2,0,9,mixedType,1
9,2,0,11,mixedType,1
4,6,0,10,mixedType,1
8,2,0,10,mixedType,1
2,8,0,10,mixedType,1
5,4,0,9,mixedType,1
5,4,0,9,mixedType,1
2,4,0,6,mixedType,0
2,6,0,8,mixedType,1
6,3,0,9,mixedType,1
6,1,0,7,mixedType,0
4,6,0,10,mixedType,1
4,4,0,8,mixedType,1
10,1,0,11,mixedType,1
5,2,0,7,mixedType,0
7,1,0,8,mixedType,1
7,2,0,9,mixedType,1
6,5,0,11,mixedType,1
4,4,0,8,mixedType,1
7,3,0,10,mixedType,1
7,2,0,9,mixedType,1
6,3,0,9,mixedType,1
6,2,0,8,mixedType,1
7,1,0,8,mixedType,1
15,1,0,16,mixedType,2
5,1,0,6,mixedType,0
5,2,0,7,mixedType,0
1,8,0,9,mixedType,1
6,6,0,12,mixedType,1
11,3,0,14,mixedType,2
5,1,0,6,mixedType,0
3,5,0,8,mixedType,1
12,4,0,16,mixedType,2
3,8,0,11,mixedType,1
6,2,0,8,mixedType,1
3,6,0,9,mixedType,1
8,2,0,10,mixedType,1
7,2,0,9,mixedType,1
9,1,0,10,mixedType,1
15,1,0,16,mixedType,2
7,1,0,8,mixedType,1
12,3,0,15,mixedType,2
4,7,0,11,mixedType,1
13,3,0,16,mixedType,2
7,2,0,9,mixedType,1
6,3,0,9,mixedType,1
6,4,0,10,mixedType,1
12,3,0,15,mixedType,2
6,4,0,10,mixedType,1
8,1,0,9,mixedType,1
10,6,0,16,mixedType,2
8,2,0,10,mixedType,1
5,2,0,7,mixedType,0
7,3,0,10,mixedType,1
8,1,0,9,mixedType,1
5,1,0,6,mixedType,0
5,4,0,9,mixedType,1
7,3,0,10,mixedType,1
5,2,0,7,mixedType,0
7,2,0,9,mixedType,1
7,2,0,9,mixedType,1
5,1,0,6,mixedType,0
3,6,0,9,mixedType,1
8,2,0,10,mixedType,1
9,1,0,10,mixedType,1
13,3,0,16,mixedType,2
15,1,0,16,mixedType,2
9,2,0,11,mixedType,1
8,4,0,12,mixedType,1
5,2,0,7,mixedType,0
8,2,0,10,mixedType,1
6,1,0,7,mixedType,0
5,2,0,7,mixedType,0
4,2,0,6,mixedType,0
2,7,0,9,mixedType,1
12,4,0,16,mixedType,2
4,2,0,6,mixedType,0
5,5,0,10,mixedType,1
6,3,0,9,mixedType,1
6,1,0,7,mixedType,0
15,1,0,16,mixedType,2
7,3,0,10,mixedType,1
5,4,0,9,mixedType,1
6,3,0,9,mixedType,1
8,3,0,11,mixedType,1
7,1,0,8,mixedType,1
6,3,0,9,mixedType,1
6,3,0,9,mixedType,1
8,1,0,9,mixedType,1
15,1,0,16,mixedType,2
5,5,0,10,mixedType,1
7,4,0,11,mixedType,1
9,1,0,10,mixedType,1
8,1,0,9,mixedType,1
6,3,0,9,mixedType,1
8,4,0,12,mixedType,1
10,4,0,14,mixedType,2
8,1,0,9,mixedType,1
5,2,0,7,mixedType,0
6,1,0,7,mixedType,0
7,3,0,10,mixedType,1
14,2,0,16,mixedType,2
7,2,0,9,mixedType,1
8,1,0,9,mixedType,1
9,2,0,11,mixedType,1
6,3,0,9,mixedType,1
9,2,0,11,mixedType,1
5,2,0,7,mixedType,0
6,3,0,9,mixedType,1
5,2,0,7,mixedType,0
4,2,0,6,mixedType,0
1,9,0,10,mixedType,1
7,1,0,8,mixedType,1
10,3,0,13,mixedType,1
3,8,0,11,mixedType,1
5,7,0,12,mixedType,1
11,2,0,13,mixedType,1
6,3,0,9,mixedType,1
5,3,0,8,mixedType,1
6,3,0,9,mixedType,1
6,2,0,8,mixedType,1
4,2,0,6,mixedType,0
5,3,0,8,mixedType,1
1,8,0,9,mixedType,1
7,1,0,8,mixedType,1
8,3,0,11,mixedType,1
5,1,0,6,mixedType,0
9,4,0,13,mixedType,1
1,7,0,8,mixedType,1
7,4,0,11,mixedType,1
6,2,0,8,mixedType,1
6,1,0,7,mixedType,0
8,1,0,9,mixedType,1
4,4,0,8,mixedType,1
5,1,0,6,mixedType,0
7,1,0,8,mixedType,1
12,3,0,15,mixedType,2
5,3,0,8,mixedType,1
7,2,0,9,mixedType,1
11,2,0,13,mixedType,1
6,1,0,7,mixedType,0
6,2,0,8,mixedType,1
6,1,0,7,mixedType,0
15,1,0,16,mixedType,2
6,4,0,10,mixedType,1
12,3,0,15,mixedType,2
2,8,0,10,mixedType,1
7,3,0,10,mixedType,1
7,1,0,8,mixedType,1
5,1,0,6,mixedType,0
2,4,0,6,mixedType,0
7,3,0,10,mixedType,1
7,2,0,9,mixedType,1
8,1,0,9,mixedType,1
4,2,0,6,mixedType,0
5,1,0,6,mixedType,0
8,1,0,9,mixedType,1
6,4,0,10,mixedType,1
8,2,0,10,mixedType,1
6,4,0,10,mixedType,1
7,3,0,10,mixedType,1
6,1,0,7,mixedType,0
6,3,0,9,mixedType,1
4,4,0,8,mixedType,1
6,2,0,8,mixedType,1
3,8,0,11,mixedType,1
6,3,0,9,mixedType,1
5,3,0,8,mixedType,1
8,1,0,9,mixedType,1
8,2,0,10,mixedType,1
4,2,0,6,mixedType,0
9,4,0,13,mixedType,1
8,4,0,12,mixedType,1
6,1,0,7,mixedType,0
4,2,0,6,mixedType,0
6,4,0,10,mixedType,1
9,4,0,13,mixedType,1
5,1,0,6,mixedType,0
8,1,0,9,mixedType,1
6,3,0,9,mixedType,1
6,3,0,9,mixedType,1
8,1,0,9,mixedType,1
8,4,0,12,mixedType,1
13,3,0,16,mixedType,2
3,6,0,9,mixedType,1
7,1,0,8,mixedType,1
5,1,0,6,mixedType,0
12,4,0,16,mixedType,2
5,2,0,7,mixedType,0
15,1,0,16,mixedType,2
5,8,0,13,mixedType,1
1,5,0,6,mixedType,0
4,4,0,8,mixedType,1
7,3,0,10,mixedType,1
4,5,0,9,mixedType,1
6,4,0,10,mixedType,1
13,3,0,16,mixedType,2
7,1,0,8,mixedType,1
7,3,0,10,mixedType,1
5,4,0,9,mixedType,1
4,2,0,6,mixedType,0
4,6,0,10,mixedType,1
9,2,0,11,mixedType,1
8,1,0,9,mixedType,1
7,4,0,11,mixedType,1
6,2,0,8,mixedType,1
5,4,0,9,mixedType,1
5,4,0,9,mixedType,1
5,4,0,9,mixedType,1
5,5,0,10,mixedType,1
7,2,0,9,mixedType,1
4,6,0,10,mixedType,1
8,1,0,9,mixedType,1
6,7,0,13,mixedType,1
2,4,0,6,mixedType,0
6,3,0,9,mixedType,1
4,4,0,8,mixedType,1
10,8,1,19,mixedType,2
7,1,0,8,mixedType,1
8,4,0,12,mixedType,1
7,3,0,10,mixedType,1
7,1,0,8,mixedType,1
8,2,0,10,mixedType,1
5,4,0,9,mixedType,1
6,3,0,9,mixedType,1
7,3,0,10,mixedType,1
2,6,0,8,mixedType,1
4,4,0,8,mixedType,1
6,3,0,9,mixedType,1
2,8,0,10,mixedType,1
8,2,0,10,mixedType,1
2,6,0,8,mixedType,1
3,10,0,13,mixedType,1
7,2,0,9,mixedType,1
4,6,0,10,mixedType,1
10,2,0,12,mixedType,1
6,1,0,7,mixedType,0
7,2,0,9,mixedType,1
2,9,0,11,mixedType,1
6,3,0,9,mixedType,1
1,8,0,9,mixedType,1
14,2,0,16,mixedType,2
7,6,0,13,mixedType,1
4,6,0,10,mixedType,1
6,4,0,10,mixedType,1
1,7,0,8,mixedType,1
13,3,0,16,mixedType,2
7,1,0,8,mixedType,1
5,2,0,7,mixedType,0
6,5,0,11,mixedType,1
5,4,0,9,mixedType,1
5,3,0,8,mixedType,1
6,4,0,10,mixedType,1
7,1,0,8,mixedType,1
6,4,0,10,mixedType,1
3,6,0,9,mixedType,1
7,2,0,9,mixedType,1
5,2,0,7,mixedType,0
6,2,0,8,mixedType,1
5,2,0,7,mixedType,0
11,3,0,14,mixedType,2
1,8,0,9,mixedType,1
6,4,0,10,mixedType,1
16,1,1,18,mixedType,2
5,2,0,7,mixedType,0
6,3,0,9,mixedType,1
6,1,0,7,mixedType,0
9,3,0,12,mixedType,1
3,8,0,11,mixedType,1
5,2,0,7,mixedType,0
4,4,0,8,mixedType,1
6,3,0,9,mixedType,1
5,3,0,8,mixedType,1
7,0,1,8,mixedType,1
9,1,0,10,mixedType,1
5,4,0,9,mixedType,1
6,2,0,8,mixedType,1
1,8,0,9,mixedType,1
7,3,0,10,mixedType,1
12,3,0,15,mixedType,2
6,4,0,10,mixedType,1
5,7,0,12,mixedType,1
2,8,0,10,mixedType,1
6,3,0,9,mixedType,1
8,1,0,9,mixedType,1
4,4,0,8,mixedType,1
7,1,0,8,mixedType,1
1,10,0,11,mixedType,1
7,1,0,8,mixedType,1
5,4,0,9,mixedType,1
7,2,0,9,mixedType,1
9,4,0,13,mixedType,1
13,3,0,16,mixedType,2
6,1,0,7,mixedType,0
8,3,0,11,mixedType,1
9,2,0,11,mixedType,1
11,3,0,14,mixedType,2
7,4,0,11,mixedType,1
3,5,0,8,mixedType,1
5,4,0,9,mixedType,1
5,6,0,11,mixedType,1
13,3,0,16,mixedType,2
5,3,0,8,mixedType,1
8,3,0,11,mixedType,1
5,2,0,7,mixedType,0
9,1,0,10,mixedType,1
6,2,0,8,mixedType,1
8,2,0,10,mixedType,1
5,2,0,7,mixedType,0
6,1,0,7,mixedType,0
6,2,0,8,mixedType,1
4,7,0,11,mixedType,1
7,4,0,11,mixedType,1
6,4,0,10,mixedType,1
5,1,0,6,mixedType,0
7,2,0,9,mixedType,1
9,3,0,12,mixedType,1
8,2,0,10,mixedType,1
7,3,0,10,mixedType,1
4,2,0,6,mixedType,0
10,2,0,12,mixedType,1
2,8,0,10,mixedType,1
6,6,0,12,mixedType,1
7,1,0,8,mixedType,1
7,2,0,9,mixedType,1
5,7,2,14,mixedType,2
6,4,0,10,mixedType,1
8,1,0,9,mixedType,1
6,3,0,9,mixedType,1
13,3,0,16,mixedType,2
6,4,0,10,mixedType,1
5,3,0,8,mixedType,1
6,4,0,10,mixedType,1
8,1,0,9,mixedType,1
10,2,0,12,mixedType,1
7,2,0,9,mixedType,1
6,3,0,9,mixedType,1
6,2,0,8,mixedType,1
14,2,0,16,mixedType,2
1,11,0,12,mixedType,1
15,1,0,16,mixedType,2
2,6,0,8,mixedType,1
1,7,0,8,mixedType,1
5,6,0,11,mixedType,1
12,3,0,15,mixedType,2
3,3,0,6,mixedType,0
9,1,0,10,mixedType,1
7,3,0,10,mixedType,1
8,4,0,12,mixedType,1
2,8,0,10,mixedType,1
10,2,0,12,mixedType,1
9,3,0,12,mixedType,1
7,2,0,9,mixedType,1
7,3,0,10,mixedType,1
7,1,0,8,mixedType,1
5,4,0,9,mixedType,1
3,6,0,9,mixedType,1
7,4,0,11,mixedType,1
4,4,0,8,mixedType,1
3,9,0,12,mixedType,1
8,1,0,9,mixedType,1
6,4,0,10,mixedType,1
14,2,0,16,mixedType,2
9,3,0,12,mixedType,1
6,3,0,9,mixedType,1
6,3,0,9,mixedType,1
6,5,0,11,mixedType,1
3,7,0,10,mixedType,1
7,2,0,9,mixedType,1
5,6,0,11,mixedType,1
4,4,0,8,mixedType,1
4,2,0,6,mixedType,0
5,1,0,6,mixedType,0
5,3,0,8,mixedType,1
4,4,0,8,mixedType,1
9,0,1,10,mixedType,1
7,2,0,9,mixedType,1
6,3,0,9,mixedType,1
10,1,0,11,mixedType,1
5,3,0,8,mixedType,1
15,1,0,16,mixedType,2
13,3,0,16,mixedType,2
1,7,0,8,mixedType,1
6,1,0,7,mixedType,0
7,3,0,10,mixedType,1
7,2,0,9,mixedType,1
7,2,0,9,mixedType,1
4,6,0,10,mixedType,1
9,1,0,10,mixedType,1
7,3,0,10,mixedType,1
14,2,0,16,mixedType,2
12,3,0,15,mixedType,2
15,1,0,16,mixedType,2
7,2,0,9,mixedType,1
7,3,0,10,mixedType,1
8,2,0,10,mixedType,1
15,1,0,16,mixedType,2
5,4,0,9,mixedType,1
6,3,0,9,mixedType,1
14,2,0,16,mixedType,2
13,3,0,16,mixedType,2
13,3,0,16,mixedType,2
6,1,0,7,mixedType,0
2,10,0,12,mixedType,1
14,2,0,16,mixedType,2
6,4,0,10,mixedType,1
6,3,0,9,mixedType,1
7,4,0,11,mixedType,1
4,4,0,8,mixedType,1
7,5,0,12,mixedType,1
13,3,0,16,mixedType,2
10,1,0,11,mixedType,1
4,5,0,9,mixedType,1
4,6,0,10,mixedType,1
7,2,0,9,mixedType,1
6,4,0,10,mixedType,1
15,1,0,16,mixedType,2
6,3,0,9,mixedType,1
8,1,0,9,mixedType,1
4,2,0,6,mixedType,0
6,5,0,11,mixedType,1
6,4,0,10,mixedType,1
6,3,0,9,mixedType,1
5,1,0,6,mixedType,0
5,3,0,8,mixedType,1
8,2,0,10,mixedType,1
6,1,0,7,mixedType,0
2,8,0,10,mixedType,1
0,12,1,13,mixedType,1
4,4,0,8,mixedType,1
6,4,0,10,mixedType,1
6,1,0,7,mixedType,0
5,5,0,10,mixedType,1
6,4,0,10,mixedType,1
5,4,0,9,mixedType,1
7,2,0,9,mixedType,1
8,2,0,10,mixedType,1
8,1,0,9,mixedType,1
6,2,0,8,mixedType,1
5,3,0,8,mixedType,1
7,2,0,9,mixedType,1
9,3,0,12,mixedType,1
4,9,1,14,mixedType,2
4,6,0,10,mixedType,1
6,3,0,9,mixedType,1
9,1,0,10,mixedType,1
6,2,0,8,mixedType,1
5,4,0,9,mixedType,1
2,6,0,8,mixedType,1
6,3,0,9,mixedType,1
7,2,0,9,mixedType,1
15,1,0,16,mixedType,2
6,2,0,8,mixedType,1
5,2,0,7,mixedType,0
7,1,0,8,mixedType,1
8,1,0,9,mixedType,1
5,3,0,8,mixedType,1
6,2,0,8,mixedType,1
7,2,0,9,mixedType,1
2,4,0,6,mixedType,0
8,1,0,9,mixedType,1
5,2,0,7,mixedType,0
6,2,0,8,mixedType,1
1,11,0,12,mixedType,1
7,2,0,9,mixedType,1
5,3,0,8,mixedType,1
6,2,0,8,mixedType,1
6,1,0,7,mixedType,0
8,2,0,10,mixedType,1
9,4,0,13,mixedType,1
7,1,0,8,mixedType,1
6,2,0,8,mixedType,1
11,3,0,14,mixedType,2
4,4,0,8,mixedType,1
8,6,0,14,mixedType,2
9,1,0,10,mixedType,1
2,6,0,8,mixedType,1
8,1,0,9,mixedType,1
6,2,0,8,mixedType,1
5,1,0,6,mixedType,0
9,3,0,12,mixedType,1
5,4,0,9,mixedType,1
6,3,0,9,mixedType,1
4,4,0,8,mixedType,1
14,2,0,16,mixedType,2
5,3,0,8,mixedType,1
8,2,0,10,mixedType,1
9,3,0,12,mixedType,1
6,3,0,9,mixedType,1
6,2,0,8,mixedType,1
6,3,0,9,mixedType,1
6,3,0,9,mixedType,1
11,3,0,14,mixedType,2
9,1,0,10,mixedType,1
5,3,0,8,mixedType,1
8,2,0,10,mixedType,1
6,1,0,7,mixedType,0
7,3,0,10,mixedType,1
6,4,0,10,mixedType,1
6,2,0,8,mixedType,1
3,5,0,8,mixedType,1
6,4,0,10,mixedType,1
5,1,0,6,mixedType,0
8,4,0,12,mixedType,1
2,8,0,10,mixedType,1
11,3,2,16,mixedType,2
4,2,0,6,mixedType,0
3,9,0,12,mixedType,1
8,2,0,10,mixedType,1
6,1,0,7,mixedType,0
8,4,0,12,mixedType,1
11,2,0,13,mixedType,1
7,2,0,9,mixedType,1
7,3,0,10,mixedType,1
22,3,0,25,mixedType,2
5,3,0,8,mixedType,1
5,4,0,9,mixedType,1
4,4,0,8,mixedType,1
6,2,0,8,mixedType,1
9,2,0,11,mixedType,1
9,4,0,13,mixedType,1
6,1,0,7,mixedType,0
9,1,0,10,mixedType,1
4,2,0,6,mixedType,0
7,2,0,9,mixedType,1
4,2,0,6,mixedType,0
7,2,0,9,mixedType,1
9,4,0,13,mixedType,1
4,4,0,8,mixedType,1
9,1,0,10,mixedType,1
10,1,0,11,mixedType,1
14,2,0,16,mixedType,2
5,3,0,8,mixedType,1
4,2,0,6,mixedType,0
5,2,0,7,mixedType,0
6,4,0,10,mixedType,1
1,9,0,10,mixedType,1
2,6,0,8,mixedType,1
6,1,0,7,mixedType,0
6,4,0,10,mixedType,1
9,1,0,10,mixedType,1
14,2,0,16,mixedType,2
7,1,0,8,mixedType,1
14,2,0,16,mixedType,2
4,5,0,9,mixedType,1
5,1,0,6,mixedType,0
7,4,0,11,mixedType,1
4,2,0,6,mixedType,0
5,4,0,9,mixedType,1
8,2,0,10,mixedType,1
9,1,0,10,mixedType,1
5,3,0,8,mixedType,1
4,2,0,6,mixedType,0
8,2,0,10,mixedType,1
11,3,0,14,mixedType,2
5,3,0,8,mixedType,1
2,4,0,6,mixedType,0
15,1,0,16,mixedType,2
8,1,0,9,mixedType,1
15,1,0,16,mixedType,2
7,3,0,10,mixedType,1
7,2,0,9,mixedType,1
6,1,0,7,mixedType,0
9,1,0,10,mixedType,1
6,6,0,12,mixedType,1
6,3,0,9,mixedType,1
6,1,0,7,mixedType,0
7,1,0,8,mixedType,1
7,1,0,8,mixedType,1
2,8,0,10,mixedType,1
6,1,0,7,mixedType,0
3,6,0,9,mixedType,1
4,2,0,6,mixedType,0
8,4,0,12,mixedType,1
4,6,0,10,mixedType,1
7,2,0,9,mixedType,1
14,2,0,16,mixedType,2
4,4,0,8,mixedType,1
6,1,0,7,mixedType,0
4,4,0,8,mixedType,1
5,2,0,7,mixedType,0
5,3,0,8,mixedType,1
6,3,0,9,mixedType,1
8,1,0,9,mixedType,1
5,2,0,7,mixedType,0
6,3,0,9,mixedType,1
7,4,0,11,mixedType,1
6,3,0,9,mixedType,1
5,2,0,7,mixedType,0
6,3,0,9,mixedType,1
9,1,0,10,mixedType,1
6,3,0,9,mixedType,1
6,3,0,9,mixedType,1
14,2,0,16,mixedType,2
8,1,0,9,mixedType,1
6,3,0,9,mixedType,1
18,4,0,22,mixedType,2
13,3,0,16,mixedType,2
8,2,0,10,mixedType,1
6,6,0,12,mixedType,1
8,1,0,9,mixedType,1
5,3,0,8,mixedType,1
6,3,0,9,mixedType,1
14,2,0,16,mixedType,2
8,3,0,11,mixedType,1
6,4,0,10,mixedType,1
8,2,0,10,mixedType,1
6,3,0,9,mixedType,1
2,8,0,10,mixedType,1
4,4,0,8,mixedType,1
7,1,0,8,mixedType,1
3,3,0,6,mixedType,0
5,3,0,8,mixedType,1
6,3,0,9,mixedType,1
5,3,0,8,mixedType,1
5,4,0,9,mixedType,1
5,3,0,8,mixedType,1
3,6,0,9,mixedType,1
7,2,0,9,mixedType,1
4,4,0,8,mixedType,1
11,2,0,13,mixedType,1
1,5,0,6,mixedType,0
7,2,0,9,mixedType,1
12,4,0,16,mixedType,2
5,2,0,7,mixedType,0
7,2,0,9,mixedType,1
9,3,0,12,mixedType,1
3,5,0,8,mixedType,1
7,19,0,26,mixedType,2
8,3,0,11,mixedType,1
6,4,0,10,mixedType,1
7,2,0,9,mixedType,1
5,2,0,7,mixedType,0
7,2,0,9,mixedType,1
10,1,0,11,mixedType,1
6,4,0,10,mixedType,1
6,1,0,7,mixedType,0
6,1,0,7,mixedType,0
7,2,0,9,mixedType,1
7,3,0,10,mixedType,1
15,1,0,16,mixedType,2
5,3,0,8,mixedType,1
6,4,0,10,mixedType,1
4,9,0,13,mixedType,1
7,3,0,10,mixedType,1
4,6,0,10,mixedType,1
6,1,0,7,mixedType,0
7,3,0,10,mixedType,1
5,3,0,8,mixedType,1
4,6,0,10,mixedType,1
5,3,0,8,mixedType,1
7,3,0,10,mixedType,1
6,4,0,10,mixedType,1
12,4,0,16,mixedType,2
9,3,0,12,mixedType,1
7,2,0,9,mixedType,1
7,3,0,10,mixedType,1
6,1,0,7,mixedType,0
6,3,0,9,mixedType,1
6,1,0,7,mixedType,0
4,8,0,12,mixedType,1
0,4,0,4,sameType,0
1,8,0,9,mixedType,1
6,3,0,9,mixedType,1
6,2,0,8,mixedType,1
9,2,0,11,mixedType,1
11,3,0,14,mixedType,2
7,3,0,10,mixedType,1
8,4,0,12,mixedType,1
8,3,0,11,mixedType,1
3,5,0,8,mixedType,1
4,4,0,8,mixedType,1
6,3,0,9,mixedType,1
8,4,0,12,mixedType,1
5,2,0,7,mixedType,0
10,8,1,19,mixedType,2
11,1,0,12,mixedType,1
3,7,0,10,mixedType,1
23,2,0,25,mixedType,2
6,1,0,7,mixedType,0
7,2,0,9,mixedType,1
15,1,0,16,mixedType,2
6,2,0,8,mixedType,1
8,2,0,10,mixedType,1
15,1,1,17,mixedType,2
6,2,0,8,mixedType,1
14,2,0,16,mixedType,2
4,4,0,8,mixedType,1
6,2,0,8,mixedType,1
4,2,0,6,mixedType,0
7,2,0,9,mixedType,1
5,3,0,8,mixedType,1
11,2,0,13,mixedType,1
8,2,0,10,mixedType,1
9,2,0,11,mixedType,1
7,3,0,10,mixedType,1
2,6,0,8,mixedType,1
6,3,0,9,mixedType,1
8,4,0,12,mixedType,1
2,7,0,9,mixedType,1
9,2,0,11,mixedType,1
9,4,0,13,mixedType,1
7,2,0,9,mixedType,1
11,5,0,16,mixedType,2
7,2,0,9,mixedType,1
8,2,0,10,mixedType,1
12,4,0,16,mixedType,2
7,2,0,9,mixedType,1
4,6,0,10,mixedType,1
8,1,0,9,mixedType,1
8,4,0,12,mixedType,1
13,3,0,16,mixedType,2
5,4,0,9,mixedType,1
6,1,0,7,mixedType,0
14,2,0,16,mixedType,2
5,1,0,6,mixedType,0
15,1,0,16,mixedType,2
10,2,0,12,mixedType,1
4,4,0,8,mixedType,1
5,1,0,6,mixedType,0
9,4,0,13,mixedType,1
8,4,0,12,mixedType,1
15,1,0,16,mixedType,2
9,1,0,10,mixedType,1
6,4,0,10,mixedType,1
5,3,0,8,mixedType,1
7,3,0,10,mixedType,1
8,4,0,12,mixedType,1
3,5,0,8,mixedType,1
6,3,0,9,mixedType,1
6,4,0,10,mixedType,1
5,4,0,9,mixedType,1
5,2,0,7,mixedType,0
7,3,0,10,mixedType,1
7,3,0,10,mixedType,1
10,4,0,14,mixedType,2
6,7,0,13,mixedType,1
6,3,0,9,mixedType,1
4,2,0,6,mixedType,0
7,1,0,8,mixedType,1
12,4,0,16,mixedType,2
7,2,0,9,mixedType,1
3,6,0,9,mixedType,1
5,5,0,10,mixedType,1
7,3,0,10,mixedType,1
6,4,0,10,mixedType,1
8,2,0,10,mixedType,1
2,6,0,8,mixedType,1
9,2,0,11,mixedType,1
7,4,0,11,mixedType,1
8,1,0,9,mixedType,1
4,2,0,6,mixedType,0
7,2,0,9,mixedType,1
8,1,0,9,mixedType,1
4,4,0,8,mixedType,1
9,3,0,12,mixedType,1
6,1,0,7,mixedType,0
5,4,0,9,mixedType,1
6,2,0,8,mixedType,1
6,2,0,8,mixedType,1
10,1,0,11,mixedType,1
6,4,0,10,mixedType,1
3,5,0,8,mixedType,1
8,3,0,11,mixedType,1
8,1,0,9,mixedType,1
15,1,0,16,mixedType,2
6,1,0,7,mixedType,0
6,3,0,9,mixedType,1
5,2,0,7,mixedType,0
6,3,0,9,mixedType,1
3,10,0,13,mixedType,1
9,1,0,10,mixedType,1
6,2,0,8,mixedType,1
5,4,0,9,mixedType,1
7,3,0,10,mixedType,1
7,1,0,8,mixedType,1
8,3,0,11,mixedType,1
11,3,0,14,mixedType,2
6,3,0,9,mixedType,1
8,2,0,10,mixedType,1
7,2,0,9,mixedType,1
7,1,0,8,mixedType,1
6,4,0,10,mixedType,1
5,3,0,8,mixedType,1
2,7,0,9,mixedType,1
15,1,0,16,mixedType,2
7,3,0,10,mixedType,1
7,1,0,8,mixedType,1
14,2,0,16,mixedType,2
4,6,0,10,mixedType,1
6,3,0,9,mixedType,1
7,3,0,10,mixedType,1
6,4,0,10,mixedType,1
6,3,0,9,mixedType,1
6,2,0,8,mixedType,1
6,1,0,7,mixedType,0
7,1,0,8,mixedType,1
5,4,0,9,mixedType,1
7,1,0,8,mixedType,1
8,2,0,10,mixedType,1
3,6,0,9,mixedType,1
8,2,0,10,mixedType,1
5,2,0,7,mixedType,0
14,2,0,16,mixedType,2
6,4,0,10,mixedType,1
4,2,0,6,mixedType,0
7,3,0,10,mixedType,1
8,3,0,11,mixedType,1
15,1,0,16,mixedType,2
9,3,0,12,mixedType,1
11,5,0,16,mixedType,2
13,3,0,16,mixedType,2
3,6,0,9,mixedType,1
6,1,0,7,mixedType,0
10,3,0,13,mixedType,1
6,2,0,8,mixedType,1
2,7,0,9,mixedType,1
7,1,0,8,mixedType,1
8,2,0,10,mixedType,1
8,2,0,10,mixedType,1
7,3,0,10,mixedType,1
7,2,0,9,mixedType,1
10,2,0,12,mixedType,1
5,5,0,10,mixedType,1
3,8,0,11,mixedType,1
12,4,0,16,mixedType,2
7,3,0,10,mixedType,1
6,0,2,8,mixedType,1
6,2,0,8,mixedType,1
7,4,0,11,mixedType,1
4,7,0,11,mixedType,1
1,8,0,9,mixedType,1
13,3,0,16,mixedType,2
6,3,0,9,mixedType,1
15,1,0,16,mixedType,2
4,6,0,10,mixedType,1
2,6,0,8,mixedType,1
3,8,0,11,mixedType,1
1,9,0,10,mixedType,1
5,4,0,9,mixedType,1
6,4,0,10,mixedType,1
7,3,0,10,mixedType,1
7,2,0,9,mixedType,1
5,4,0,9,mixedType,1
1,7,0,8,mixedType,1
1,9,0,10,mixedType,1
9,1,0,10,mixedType,1
7,2,0,9,mixedType,1
4,4,0,8,mixedType,1
7,2,0,9,mixedType,1
13,3,0,16,mixedType,2
5,2,0,7,mixedType,0
5,2,0,7,mixedType,0
9,3,0,12,mixedType,1
8,2,0,10,mixedType,1
11,3,0,14,mixedType,2
7,3,0,10,mixedType,1
5,2,0,7,mixedType,0
6,1,0,7,mixedType,0
5,2,0,7,mixedType,0
4,7,0,11,mixedType,1
7,3,0,10,mixedType,1
7,2,0,9,mixedType,1
8,4,0,12,mixedType,1
8,2,0,10,mixedType,1
8,4,0,12,mixedType,1
9,0,1,10,mixedType,1
7,1,0,8,mixedType,1
9,2,0,11,mixedType,1
8,2,0,10,mixedType,1
8,1,0,9,mixedType,1
8,2,0,10,mixedType,1
5,4,0,9,mixedType,1
8,2,0,10,mixedType,1
15,1,0,16,mixedType,2
8,2,0,10,mixedType,1
11,3,0,14,mixedType,2
4,8,0,12,mixedType,1
6,4,0,10,mixedType,1
8,3,0,11,mixedType,1
5,4,0,9,mixedType,1
5,1,0,6,mixedType,0
4,2,0,6,mixedType,0
7,3,0,10,mixedType,1
5,3,0,8,mixedType,1
11,3,0,14,mixedType,2
6,3,0,9,mixedType,1
7,2,0,9,mixedType,1
5,3,0,8,mixedType,1
15,1,1,17,mixedType,2
6,4,0,10,mixedType,1
11,5,0,16,mixedType,2
2,4,0,6,mixedType,0
3,7,0,10,mixedType,1
13,3,0,16,mixedType,2
10,2,0,12,mixedType,1
8,1,0,9,mixedType,1
9,4,0,13,mixedType,1
7,3,0,10,mixedType,1
15,1,0,16,mixedType,2
3,3,0,6,mixedType,0
5,2,0,7,mixedType,0
4,6,0,10,mixedType,1
6,3,0,9,mixedType,1
8,1,0,9,mixedType,1
5,2,0,7,mixedType,0
8,2,0,10,mixedType,1
8,4,0,12,mixedType,1
5,4,0,9,mixedType,1
5,3,0,8,mixedType,1
6,6,0,12,mixedType,1
6,3,0,9,mixedType,1
3,6,0,9,mixedType,1
15,1,0,16,mixedType,2
11,2,0,13,mixedType,1
6,3,0,9,mixedType,1
6,2,0,8,mixedType,1
11,5,0,16,mixedType,2
5,4,0,9,mixedType,1
4,2,0,6,mixedType,0
5,4,0,9,mixedType,1
7,2,0,9,mixedType,1
4,6,0,10,mixedType,1
7,4,0,11,mixedType,1
7,4,0,11,mixedType,1
7,2,0,9,mixedType,1
12,3,0,15,mixedType,2
2,6,0,8,mixedType,1
9,1,0,10,mixedType,1
6,7,0,13,mixedType,1
5,3,0,8,mixedType,1
2,4,0,6,mixedType,0
7,3,0,10,mixedType,1
3,5,0,8,mixedType,1
6,4,0,10,mixedType,1
11,3,0,14,mixedType,2
5,1,0,6,mixedType,0
3,5,0,8,mixedType,1
6,3,0,9,mixedType,1
7,3,0,10,mixedType,1
5,3,0,8,mixedType,1
19,8,3,30,mixedType,2
5,4,0,9,mixedType,1
10,1,0,11,mixedType,1
9,2,0,11,mixedType,1
9,3,0,12,mixedType,1
6,4,0,10,mixedType,1
1,10,0,11,mixedType,1
14,2,0,16,mixedType,2
1,8,0,9,mixedType,1
6,1,0,7,mixedType,0
7,1,0,8,mixedType,1
6,4,0,10,mixedType,1
7,4,0,11,mixedType,1
5,2,0,7,mixedType,0
7,3,0,10,mixedType,1
15,1,0,16,mixedType,2
6,4,0,10,mixedType,1
6,4,0,10,mixedType,1
1,8,0,9,mixedType,1
12,1,0,13,mixedType,1
9,3,0,12,mixedType,1
6,4,0,10,mixedType,1
7,2,0,9,mixedType,1
7,3,0,10,mixedType,1
13,3,0,16,mixedType,2
7,2,0,9,mixedType,1
7,3,0,10,mixedType,1
6,2,0,8,mixedType,1
7,2,0,9,mixedType,1
9,1,0,10,mixedType,1
9,1,0,10,mixedType,1
5,3,0,8,mixedType,1
8,1,0,9,mixedType,1
5,3,0,8,mixedType,1
7,1,0,8,mixedType,1
5,3,0,8,mixedType,1
3,6,0,9,mixedType,1
7,3,0,10,mixedType,1
5,1,0,6,mixedType,0
7,2,0,9,mixedType,1
4,6,0,10,mixedType,1
9,4,0,13,mixedType,1
1,9,0,10,mixedType,1
8,4,0,12,mixedType,1
5,3,0,8,mixedType,1
9,2,0,11,mixedType,1
7,3,0,10,mixedType,1
8,1,0,9,mixedType,1
15,1,0,16,mixedType,2
4,6,0,10,mixedType,1
6,4,0,10,mixedType,1
8,6,0,14,mixedType,2
8,4,0,12,mixedType,1
4,8,0,12,mixedType,1
9,4,0,13,mixedType,1
6,6,0,12,mixedType,1
6,3,0,9,mixedType,1
1,7,0,8,mixedType,1
8,1,0,9,mixedType,1
12,3,0,15,mixedType,2
9,2,0,11,mixedType,1
5,3,0,8,mixedType,1
2,10,0,12,mixedType,1
9,1,0,10,mixedType,1
2,6,0,8,mixedType,1
4,4,0,8,mixedType,1
7,1,0,8,mixedType,1
8,3,0,11,mixedType,1
8,1,0,9,mixedType,1
6,2,0,8,mixedType,1
5,4,0,9,mixedType,1
9,1,0,10,mixedType,1
2,11,0,13,mixedType,1
7,3,0,10,mixedType,1
5,3,0,8,mixedType,1
8,2,0,10,mixedType,1
4,2,0,6,mixedType,0
8,2,0,10,mixedType,1
6,1,0,7,mixedType,0
14,2,0,16,mixedType,2
5,6,0,11,mixedType,1
8,2,0,10,mixedType,1
5,4,0,9,mixedType,1
8,3,0,11,mixedType,1
9,1,0,10,mixedType,1
4,6,0,10,mixedType,1
8,2,0,10,mixedType,1
6,2,0,8,mixedType,1
4,4,0,8,mixedType,1
12,4,0,16,mixedType,2
8,1,0,9,mixedType,1
9,1,0,10,mixedType,1
8,1,0,9,mixedType,1
6,3,0,9,mixedType,1
9,5,0,14,mixedType,2
7,3,0,10,mixedType,1
6,3,0,9,mixedType,1
6,4,0,10,mixedType,1
3,9,0,12,mixedType,1
5,5,0,10,mixedType,1
6,2,0,8,mixedType,1
6,1,0,7,mixedType,0
9,1,0,10,mixedType,1
3,5,0,8,mixedType,1
12,4,0,16,mixedType,2
7,2,0,9,mixedType,1
5,2,0,7,mixedType,0
8,1,0,9,mixedType,1
9,1,0,10,mixedType,1
8,3,0,11,mixedType,1
2,8,0,10,mixedType,1
8,2,0,10,mixedType,1
7,3,0,10,mixedType,1
8,3,0,11,mixedType,1
6,3,0,9,mixedType,1
9,3,0,12,mixedType,1
8,1,0,9,mixedType,1
11,3,0,14,mixedType,2
8,2,0,10,mixedType,1
4,2,0,6,mixedType,0
8,2,0,10,mixedType,1
5,4,0,9,mixedType,1
7,3,0,10,mixedType,1
14,2,0,16,mixedType,2
6,3,0,9,mixedType,1
10,2,0,12,mixedType,1
7,3,0,10,mixedType,1
1,7,0,8,mixedType,1
5,4,0,9,mixedType,1
12,4,0,16,mixedType,2
5,1,0,6,mixedType,0
9,2,0,11,mixedType,1
6,2,0,8,mixedType,1
5,4,0,9,mixedType,1
14,2,0,16,mixedType,2
8,2,0,10,mixedType,1
5,2,0,7,mixedType,0
6,3,0,9,mixedType,1
14,2,0,16,mixedType,2
6,2,0,8,mixedType,1
11,5,0,16,mixedType,2
8,1,0,9,mixedType,1
7,3,0,10,mixedType,1
13,3,0,16,mixedType,2
8,3,0,11,mixedType,1
5,3,0,8,mixedType,1
6,2,0,8,mixedType,1
8,1,0,9,mixedType,1
8,1,0,9,mixedType,1
6,4,0,10,mixedType,1
7,2,0,9,mixedType,1
5,6,0,11,mixedType,1
7,4,0,11,mixedType,1
7,3,0,10,mixedType,1
6,3,0,9,mixedType,1
4,5,0,9,mixedType,1
7,3,0,10,mixedType,1
8,4,0,12,mixedType,1
3,8,0,11,mixedType,1
3,5,0,8,mixedType,1
4,4,0,8,mixedType,1
9,1,0,10,mixedType,1
1,7,0,8,mixedType,1
4,2,0,6,mixedType,0
4,4,0,8,mixedType,1
6,3,0,9,mixedType,1
7,3,0,10,mixedType,1
6,3,0,9,mixedType,1
1,9,0,10,mixedType,1
6,3,0,9,mixedType,1
6,0,1,7,mixedType,0
5,4,0,9,mixedType,1
1,10,0,11,mixedType,1
6,3,0,9,mixedType,1
8,1,0,9,mixedType,1
6,3,0,9,mixedType,1
5,2,0,7,mixedType,0
3,6,0,9,mixedType,1
5,3,0,8,mixedType,1
6,4,0,10,mixedType,1
7,4,0,11,mixedType,1
6,3,0,9,mixedType,1
12,4,0,16,mixedType,2
7,2,0,9,mixedType,1
5,3,0,8,mixedType,1
7,3,0,10,mixedType,1
7,2,0,9,mixedType,1
6,1,0,7,mixedType,0
7,3,0,10,mixedType,1
3,6,0,9,mixedType,1
7,2,0,9,mixedType,1
3,7,0,10,mixedType,1
6,3,0,9,mixedType,1
5,4,0,9,mixedType,1
4,2,0,6,mixedType,0
9,1,0,10,mixedType,1
9,1,0,10,mixedType,1
7,1,0,8,mixedType,1
7,2,0,9,mixedType,1
7,1,0,8,mixedType,1
3,6,0,9,mixedType,1
1,7,0,8,mixedType,1
6,4,0,10,mixedType,1
15,1,0,16,mixedType,2
4,6,0,10,mixedType,1
7,3,0,10,mixedType,1
3,11,0,14,mixedType,2
7,3,0,10,mixedType,1
7,3,0,10,mixedType,1
8,4,0,12,mixedType,1
11,5,0,16,mixedType,2
3,6,0,9,mixedType,1
12,8,0,20,mixedType,2
5,3,0,8,mixedType,1
5,3,0,8,mixedType,1
6,2,0,8,mixedType,1
5,2,0,7,mixedType,0
7,2,0,9,mixedType,1
7,2,0,9,mixedType,1
6,1,0,7,mixedType,0
9,1,0,10,mixedType,1
3,10,0,13,mixedType,1
5,3,0,8,mixedType,1
10,1,0,11,mixedType,1
4,5,0,9,mixedType,1
2,9,0,11,mixedType,1
15,1,0,16,mixedType,2
7,3,0,10,mixedType,1
7,6,0,13,mixedType,1
11,1,0,12,mixedType,1
8,1,0,9,mixedType,1
5,4,0,9,mixedType,1
4,2,0,6,mixedType,0
4,4,0,8,mixedType,1
10,2,0,12,mixedType,1
6,6,6,18,mixedType,2
6,3,0,9,mixedType,1
4,4,0,8,mixedType,1
6,3,0,9,mixedType,1
7,3,0,10,mixedType,1
6,2,0,8,mixedType,1
9,1,0,10,mixedType,1
6,3,0,9,mixedType,1
7,3,0,10,mixedType,1
6,3,0,9,mixedType,1
13,3,0,16,mixedType,2
6,4,0,10,mixedType,1
3,3,0,6,mixedType,0
6,3,0,9,mixedType,1
3,6,0,9,mixedType,1
6,1,0,7,mixedType,0
4,4,0,8,mixedType,1
6,3,0,9,mixedType,1
1,8,0,9,mixedType,1
5,3,0,8,mixedType,1
4,4,0,8,mixedType,1
6,1,0,7,mixedType,0
7,1,0,8,mixedType,1
8,1,0,9,mixedType,1
7,2,0,9,mixedType,1
5,3,0,8,mixedType,1
7,3,0,10,mixedType,1
2,6,0,8,mixedType,1
8,2,0,10,mixedType,1
3,3,0,6,mixedType,0
13,3,0,16,mixedType,2
8,1,0,9,mixedType,1
6,4,0,10,mixedType,1
8,2,0,10,mixedType,1
8,1,0,9,mixedType,1
8,2,0,10,mixedType,1
11,1,0,12,mixedType,1
6,3,0,9,mixedType,1
13,3,0,16,mixedType,2
6,2,0,8,mixedType,1
6,2,0,8,mixedType,1
4,2,0,6,mixedType,0
6,2,0,8,mixedType,1
4,2,0,6,mixedType,0
7,3,0,10,mixedType,1
4,4,0,8,mixedType,1
4,4,0,8,mixedType,1
13,2,0,15,mixedType,2
5,2,0,7,mixedType,0
6,4,0,10,mixedType,1
8,2,0,10,mixedType,1
5,2,0,7,mixedType,0
7,4,3,14,mixedType,2
14,2,0,16,mixedType,2
9,6,0,15,mixedType,2
7,3,0,10,mixedType,1
7,2,0,9,mixedType,1
7,6,0,13,mixedType,1
2,8,0,10,mixedType,1
7,3,0,10,mixedType,1
8,2,0,10,mixedType,1
7,1,0,8,mixedType,1
3,6,0,9,mixedType,1
8,2,0,10,mixedType,1
12,3,0,15,mixedType,2
4,4,0,8,mixedType,1
9,2,0,11,mixedType,1
8,1,0,9,mixedType,1
7,3,0,10,mixedType,1
6,1,0,7,mixedType,0
5,2,0,7,mixedType,0
7,2,0,9,mixedType,1
14,2,0,16,mixedType,2
8,1,0,9,mixedType,1
10,2,0,12,mixedType,1
7,1,0,8,mixedType,1
5,3,0,8,mixedType,1
8,2,0,10,mixedType,1
7,6,0,13,mixedType,1
2,10,0,12,mixedType,1
13,3,0,16,mixedType,2
11,1,0,12,mixedType,1
3,6,0,9,mixedType,1
11,4,0,15,mixedType,2
7,3,0,10,mixedType,1
9,2,0,11,mixedType,1
6,3,0,9,mixedType,1
7,3,0,10,mixedType,1
7,2,0,9,mixedType,1
14,2,0,16,mixedType,2
3,8,0,11,mixedType,1
7,1,0,8,mixedType,1
2,7,0,9,mixedType,1
4,2,0,6,mixedType,0
3,6,0,9,mixedType,1
10,3,0,13,mixedType,1
4,4,0,8,mixedType,1
5,3,0,8,mixedType,1
5,2,0,7,mixedType,0
6,1,0,7,mixedType,0
5,3,0,8,mixedType,1
5,4,0,9,mixedType,1
6,3,0,9,mixedType,1
1,8,0,9,mixedType,1
7,1,0,8,mixedType,1
7,2,0,9,mixedType,1
7,3,0,10,mixedType,1
6,6,0,12,mixedType,1
6,2,0,8,mixedType,1
9,2,0,11,mixedType,1
8,1,0,9,mixedType,1
7,3,0,10,mixedType,1
9,4,0,13,mixedType,1
14,2,0,16,mixedType,2
7,2,0,9,mixedType,1
7,3,0,10,mixedType,1
18,2,0,20,mixedType,2
15,1,0,16,mixedType,2
4,2,0,6,mixedType,0
6,2,0,8,mixedType,1
6,1,0,7,mixedType,0
4,2,0,6,mixedType,0
4,4,0,8,mixedType,1
3,3,0,6,mixedType,0
6,4,0,10,mixedType,1
7,3,0,10,mixedType,1
9,3,0,12,mixedType,1
3,6,0,9,mixedType,1
8,2,0,10,mixedType,1
10,2,0,12,mixedType,1
8,2,0,10,mixedType,1
4,2,0,6,mixedType,0
12,4,0,16,mixedType,2
4,4,0,8,mixedType,1
11,5,0,16,mixedType,2
6,4,0,10,mixedType,1
3,6,0,9,mixedType,1
7,3,0,10,mixedType,1
9,2,0,11,mixedType,1
15,1,0,16,mixedType,2
11,3,0,14,mixedType,2
8,1,0,9,mixedType,1
6,6,0,12,mixedType,1
14,2,0,16,mixedType,2
5,6,0,11,mixedType,1
3,7,0,10,mixedType,1
12,3,0,15,mixedType,2
4,4,0,8,mixedType,1
6,3,0,9,mixedType,1
6,3,0,9,mixedType,1
7,5,0,12,mixedType,1
6,1,0,7,mixedType,0
4,6,0,10,mixedType,1
5,3,0,8,mixedType,1
6,1,0,7,mixedType,0
9,2,0,11,mixedType,1
5,3,0,8,mixedType,1
7,1,0,8,mixedType,1
6,2,0,8,mixedType,1
7,6,0,13,mixedType,1
10,4,0,14,mixedType,2
6,3,0,9,mixedType,1
8,1,0,9,mixedType,1
15,1,0,16,mixedType,2
7,2,0,9,mixedType,1
5,3,0,8,mixedType,1
4,2,0,6,mixedType,0
6,1,0,7,mixedType,0
5,3,0,8,mixedType,1
6,3,0,9,mixedType,1
7,3,0,10,mixedType,1
5,4,0,9,mixedType,1
6,2,0,8,mixedType,1
7,3,0,10,mixedType,1
10,2,0,12,mixedType,1
7,3,0,10,mixedType,1
12,3,0,15,mixedType,2
13,3,0,16,mixedType,2
9,1,0,10,mixedType,1
2,8,0,10,mixedType,1
12,3,0,15,mixedType,2
5,4,0,9,mixedType,1
9,2,0,11,mixedType,1
6,1,0,7,mixedType,0
6,3,0,9,mixedType,1
8,0,1,9,mixedType,1
4,6,0,10,mixedType,1
6,2,0,8,mixedType,1
5,2,0,7,mixedType,0
11,1,0,12,mixedType,1
8,3,0,11,mixedType,1
8,2,0,10,mixedType,1
5,2,0,7,mixedType,0
7,2,0,9,mixedType,1
6,3,0,9,mixedType,1
10,3,1,14,mixedType,2
5,1,0,6,mixedType,0
4,2,0,6,mixedType,0
8,2,0,10,mixedType,1
6,6,0,12,mixedType,1
4,4,0,8,mixedType,1
7,3,0,10,mixedType,1
7,2,0,9,mixedType,1
9,1,0,10,mixedType,1
5,2,0,7,mixedType,0
13,3,0,16,mixedType,2
4,5,0,9,mixedType,1
4,2,0,6,mixedType,0
6,2,0,8,mixedType,1
7,2,0,9,mixedType,1
13,3,0,16,mixedType,2
4,6,0,10,mixedType,1
2,6,0,8,mixedType,1
6,3,0,9,mixedType,1
5,6,0,11,mixedType,1
7,3,0,10,mixedType,1
6,10,0,16,mixedType,2
4,2,0,6,mixedType,0
6,3,0,9,mixedType,1
6,1,0,7,mixedType,0
5,1,0,6,mixedType,0
6,4,0,10,mixedType,1
13,3,0,16,mixedType,2
6,3,0,9,mixedType,1
6,3,0,9,mixedType,1
8,3,0,11,mixedType,1
6,2,0,8,mixedType,1
6,4,0,10,mixedType,1
4,4,0,8,mixedType,1
12,3,0,15,mixedType,2
9,2,0,11,mixedType,1
8,2,0,10,mixedType,1
10,3,0,13,mixedType,1
9,2,0,11,mixedType,1
7,2,0,9,mixedType,1
8,2,0,10,mixedType,1
6,6,0,12,mixedType,1
6,3,0,9,mixedType,1
7,3,0,10,mixedType,1
7,3,0,10,mixedType,1
8,2,0,10,mixedType,1
9,2,0,11,mixedType,1
6,3,0,9,mixedType,1
8,4,0,12,mixedType,1
8,2,0,10,mixedType,1
6,2,0,8,mixedType,1
10,1,0,11,mixedType,1
8,3,0,11,mixedType,1
6,2,0,8,mixedType,1
6,3,0,9,mixedType,1
3,10,0,13,mixedType,1
14,2,0,16,mixedType,2
7,3,0,10,mixedType,1
7,2,0,9,mixedType,1
7,3,0,10,mixedType,1
5,2,0,7,mixedType,0
12,1,0,13,mixedType,1
6,1,0,7,mixedType,0
6,1,0,7,mixedType,0
2,6,0,8,mixedType,1
4,2,0,6,mixedType,0
5,2,0,7,mixedType,0
5,4,0,9,mixedType,1
5,3,0,8,mixedType,1
5,3,0,8,mixedType,1
5,3,0,8,mixedType,1
8,1,0,9,mixedType,1
7,2,0,9,mixedType,1
7,2,0,9,mixedType,1
6,3,0,9,mixedType,1
6,2,0,8,mixedType,1
8,4,0,12,mixedType,1
7,5,0,12,mixedType,1
8,2,0,10,mixedType,1
7,1,0,8,mixedType,1
6,3,0,9,mixedType,1
6,3,0,9,mixedType,1
9,1,0,10,mixedType,1
7,3,0,10,mixedType,1
8,1,0,9,mixedType,1
3,7,0,10,mixedType,1
0,6,2,8,mixedType,1
8,2,0,10,mixedType,1
4,8,0,12,mixedType,1
7,2,0,9,mixedType,1
5,2,0,7,mixedType,0
6,2,0,8,mixedType,1
6,12,1,19,mixedType,2
5,3,0,8,mixedType,1
9,3,0,12,mixedType,1
3,7,0,10,mixedType,1
10,1,0,11,mixedType,1
5,3,0,8,mixedType,1
7,2,0,9,mixedType,1
11,4,0,15,mixedType,2
7,1,0,8,mixedType,1
6,2,0,8,mixedType,1
9,3,0,12,mixedType,1
3,3,0,6,mixedType,0
15,1,0,16,mixedType,2
6,0,1,7,mixedType,0
5,2,0,7,mixedType,0
9,1,0,10,mixedType,1
5,3,0,8,mixedType,1
14,2,0,16,mixedType,2
9,2,0,11,mixedType,1
7,3,0,10,mixedType,1
7,1,0,8,mixedType,1
5,4,0,9,mixedType,1
6,4,0,10,mixedType,1
8,2,0,10,mixedType,1
7,3,0,10,mixedType,1
8,2,0,10,mixedType,1
6,1,0,7,mixedType,0
9,1,0,10,mixedType,1
5,2,0,7,mixedType,0
11,1,0,12,mixedType,1
7,3,0,10,mixedType,1
5,2,0,7,mixedType,0
8,2,0,10,mixedType,1
7,3,0,10,mixedType,1
10,2,0,12,mixedType,1
3,6,0,9,mixedType,1
6,6,0,12,mixedType,1
5,3,0,8,mixedType,1
2,6,0,8,mixedType,1
6,1,0,7,mixedType,0
8,2,0,10,mixedType,1
4,2,0,6,mixedType,0
6,4,0,10,mixedType,1
7,6,0,13,mixedType,1
7,3,0,10,mixedType,1
2,6,0,8,mixedType,1
6,2,0,8,mixedType,1
4,4,0,8,mixedType,1
6,3,0,9,mixedType,1
6,2,0,8,mixedType,1
7,2,0,9,mixedType,1
7,3,0,10,mixedType,1
5,0,4,9,mixedType,1
13,3,0,16,mixedType,2
7,3,0,10,mixedType,1
1,8,0,9,mixedType,1
7,3,0,10,mixedType,1
6,3,0,9,mixedType,1
8,2,0,10,mixedType,1
6,3,0,9,mixedType,1
5,4,0,9,mixedType,1
11,3,0,14,mixedType,2
7,3,0,10,mixedType,1
7,1,0,8,mixedType,1
6,4,0,10,mixedType,1
7,4,0,11,mixedType,1
6,2,0,8,mixedType,1
8,3,0,11,mixedType,1
4,6,0,10,mixedType,1
2,6,0,8,mixedType,1
4,2,0,6,mixedType,0
15,1,0,16,mixedType,2
2,8,0,10,mixedType,1
8,2,0,10,mixedType,1
12,4,0,16,mixedType,2
7,3,0,10,mixedType,1
6,2,0,8,mixedType,1
5,4,0,9,mixedType,1
8,1,0,9,mixedType,1
1,8,0,9,mixedType,1
5,4,0,9,mixedType,1
7,2,0,9,mixedType,1
6,3,0,9,mixedType,1
2,8,0,10,mixedType,1
15,1,0,16,mixedType,2
6,3,0,9,mixedType,1
7,3,0,10,mixedType,1
4,6,0,10,mixedType,1
4,4,0,8,mixedType,1
8,2,0,10,mixedType,1
1,8,0,9,mixedType,1
7,2,0,9,mixedType,1
7,3,0,10,mixedType,1
7,2,0,9,mixedType,1
12,1,3,16,mixedType,2
7,2,0,9,mixedType,1
7,2,0,9,mixedType,1
5,4,0,9,mixedType,1
6,5,0,11,mixedType,1
7,3,0,10,mixedType,1
15,1,0,16,mixedType,2
8,2,0,10,mixedType,1
8,2,0,10,mixedType,1
10,4,0,14,mixedType,2
4,4,0,8,mixedType,1
12,4,0,16,mixedType,2
8,2,0,10,mixedType,1
1,8,0,9,mixedType,1
9,2,0,11,mixedType,1
2,7,0,9,mixedType,1
6,3,0,9,mixedType,1
4,2,0,6,mixedType,0
12,3,0,15,mixedType,2
4,9,0,13,mixedType,1
5,2,0,7,mixedType,0
9,2,0,11,mixedType,1
4,6,0,10,mixedType,1
10,2,0,12,mixedType,1
2,6,0,8,mixedType,1
7,2,0,9,mixedType,1
7,1,0,8,mixedType,1
5,4,0,9,mixedType,1
7,3,0,10,mixedType,1
6,2,0,8,mixedType,1
7,3,0,10,mixedType,1
6,1,0,7,mixedType,0
6,4,0,10,mixedType,1
7,1,0,8,mixedType,1
10,3,0,13,mixedType,1
5,1,0,6,mixedType,0
7,3,0,10,mixedType,1
6,2,0,8,mixedType,1
6,2,0,8,mixedType,1
5,2,0,7,mixedType,0
8,2,0,10,mixedType,1
14,2,0,16,mixedType,2
7,1,0,8,mixedType,1
8,1,0,9,mixedType,1
4,2,0,6,mixedType,0
7,2,0,9,mixedType,1
7,3,0,10,mixedType,1
7,2,0,9,mixedType,1
5,3,0,8,mixedType,1
6,2,0,8,mixedType,1
8,1,0,9,mixedType,1
14,2,0,16,mixedType,2
5,4,0,9,mixedType,1
5,3,0,8,mixedType,1
6,2,0,8,mixedType,1
7,3,0,10,mixedType,1
8,1,0,9,mixedType,1
6,1,0,7,mixedType,0
6,4,0,10,mixedType,1
12,4,0,16,mixedType,2
6,3,0,9,mixedType,1
5,3,0,8,mixedType,1
4,8,0,12,mixedType,1
5,3,0,8,mixedType,1
1,7,0,8,mixedType,1
6,3,0,9,mixedType,1
8,2,0,10,mixedType,1
6,3,0,9,mixedType,1
8,2,0,10,mixedType,1
5,3,0,8,mixedType,1
4,2,0,6,mixedType,0
2,6,0,8,mixedType,1
6,1,0,7,mixedType,0
5,3,0,8,mixedType,1
4,2,0,6,mixedType,0
5,1,0,6,mixedType,0
4,2,0,6,mixedType,0
12,3,0,15,mixedType,2
6,1,0,7,mixedType,0
4,4,0,8,mixedType,1
6,1,0,7,mixedType,0
14,2,0,16,mixedType,2
11,5,0,16,mixedType,2
4,4,0,8,mixedType,1
3,5,0,8,mixedType,1
6,1,0,7,mixedType,0
12,1,0,13,mixedType,1
8,2,0,10,mixedType,1
5,1,0,6,mixedType,0
5,2,0,7,mixedType,0
2,7,0,9,mixedType,1
8,3,0,11,mixedType,1
2,7,0,9,mixedType,1
7,1,0,8,mixedType,1
7,1,0,8,mixedType,1
5,7,0,12,mixedType,1
5,3,0,8,mixedType,1
3,6,0,9,mixedType,1
7,3,0,10,mixedType,1
7,1,0,8,mixedType,1
5,2,0,7,mixedType,0
6,3,0,9,mixedType,1
8,4,0,12,mixedType,1
4,2,0,6,mixedType,0
5,4,0,9,mixedType,1
4,2,0,6,mixedType,0
4,4,0,8,mixedType,1
4,4,0,8,mixedType,1
9,1,0,10,mixedType,1
6,4,0,10,mixedType,1
8,3,0,11,mixedType,1
1,10,0,11,mixedType,1
8,1,0,9,mixedType,1
5,4,0,9,mixedType,1
4,5,0,9,mixedType,1
11,2,0,13,mixedType,1
4,4,0,8,mixedType,1
9,3,0,12,mixedType,1
2,4,0,6,mixedType,0
8,3,0,11,mixedType,1
6,4,0,10,mixedType,1
6,1,0,7,mixedType,0
6,3,0,9,mixedType,1
10,2,0,12,mixedType,1
6,3,0,9,mixedType,1
6,4,0,10,mixedType,1
5,2,0,7,mixedType,0
1,6,0,7,mixedType,0
7,4,0,11,mixedType,1
6,3,0,9,mixedType,1
8,3,0,11,mixedType,1
1,8,0,9,mixedType,1
6,4,0,10,mixedType,1
3,6,0,9,mixedType,1
4,4,0,8,mixedType,1
13,3,0,16,mixedType,2
12,3,0,15,mixedType,2
8,4,0,12,mixedType,1
4,6,0,10,mixedType,1
6,3,0,9,mixedType,1
7,1,0,8,mixedType,1
3,6,0,9,mixedType,1
12,4,0,16,mixedType,2
4,6,0,10,mixedType,1
6,3,0,9,mixedType,1
6,2,0,8,mixedType,1
6,3,0,9,mixedType,1
7,3,0,10,mixedType,1
14,1,1,16,mixedType,2
7,3,0,10,mixedType,1
6,1,0,7,mixedType,0
5,3,0,8,mixedType,1
15,1,0,16,mixedType,2
7,2,0,9,mixedType,1
5,3,0,8,mixedType,1
8,2,0,10,mixedType,1
9,2,0,11,mixedType,1
7,5,0,12,mixedType,1
10,1,0,11,mixedType,1
2,8,0,10,mixedType,1
5,1,0,6,mixedType,0
15,1,0,16,mixedType,2
7,1,0,8,mixedType,1
7,1,0,8,mixedType,1
5,4,0,9,mixedType,1
6,2,0,8,mixedType,1
6,4,0,10,mixedType,1
13,3,0,16,mixedType,2
5,5,0,10,mixedType,1
10,2,0,12,mixedType,1
7,1,0,8,mixedType,1
7,1,0,8,mixedType,1
8,2,0,10,mixedType,1
8,4,0,12,mixedType,1
2,8,0,10,mixedType,1
5,2,0,7,mixedType,0
6,3,0,9,mixedType,1
15,2,0,17,mixedType,2
8,3,0,11,mixedType,1
3,6,0,9,mixedType,1
4,7,0,11,mixedType,1
5,4,0,9,mixedType,1
12,4,0,16,mixedType,2
8,2,0,10,mixedType,1
6,3,0,9,mixedType,1
4,6,0,10,mixedType,1
5,3,0,8,mixedType,1
5,2,0,7,mixedType,0
6,1,0,7,mixedType,0
7,1,0,8,mixedType,1
7,3,0,10,mixedType,1
9,0,1,10,mixedType,1
8,2,0,10,mixedType,1
6,3,0,9,mixedType,1
7,3,0,10,mixedType,1
4,4,0,8,mixedType,1
7,1,0,8,mixedType,1
6,3,0,9,mixedType,1
6,2,0,8,mixedType,1
7,2,0,9,mixedType,1
13,3,0,16,mixedType,2
5,7,0,12,mixedType,1
7,3,0,10,mixedType,1
7,2,0,9,mixedType,1
5,7,0,12,mixedType,1
7,3,0,10,mixedType,1
5,3,0,8,mixedType,1
4,2,0,6,mixedType,0
15,1,0,16,mixedType,2
5,3,0,8,mixedType,1
4,4,0,8,mixedType,1
15,1,0,16,mixedType,2
9,2,0,11,mixedType,1
7,2,0,9,mixedType,1
7,3,0,10,mixedType,1
7,5,0,12,mixedType,1
8,1,0,9,mixedType,1
7,3,0,10,mixedType,1
3,7,0,10,mixedType,1
6,3,0,9,mixedType,1
6,4,0,10,mixedType,1
15,1,0,16,mixedType,2
2,8,0,10,mixedType,1
6,1,0,7,mixedType,0
15,1,0,16,mixedType,2
2,8,0,10,mixedType,1
9,2,0,11,mixedType,1
8,4,0,12,mixedType,1
7,2,0,9,mixedType,1
5,2,0,7,mixedType,0
8,2,0,10,mixedType,1
6,4,0,10,mixedType,1
8,2,0,10,mixedType,1
7,3,0,10,mixedType,1
10,2,0,12,mixedType,1
8,2,0,10,mixedType,1
6,4,0,10,mixedType,1
9,1,0,10,mixedType,1
8,4,0,12,mixedType,1
5,3,0,8,mixedType,1
6,3,0,9,mixedType,1
13,3,0,16,mixedType,2
15,1,0,16,mixedType,2
3,3,0,6,mixedType,0
1,8,0,9,mixedType,1
4,4,0,8,mixedType,1
13,3,0,16,mixedType,2
7,4,0,11,mixedType,1
6,2,0,8,mixedType,1
0,6,1,7,mixedType,0
7,1,0,8,mixedType,1
7,2,0,9,mixedType,1
7,1,0,8,mixedType,1
1,11,0,12,mixedType,1
4,2,0,6,mixedType,0
7,1,0,8,mixedType,1
6,4,0,10,mixedType,1
5,4,0,9,mixedType,1
6,2,0,8,mixedType,1
2,8,0,10,mixedType,1
7,4,0,11,mixedType,1
6,3,0,9,mixedType,1
10,1,0,11,mixedType,1
9,4,0,13,mixedType,1
7,3,0,10,mixedType,1
15,6,1,22,mixedType,2
6,3,0,9,mixedType,1
7,1,0,8,mixedType,1
13,3,0,16,mixedType,2
4,4,0,8,mixedType,1
5,4,0,9,mixedType,1
3,3,0,6,mixedType,0
8,1,0,9,mixedType,1
2,8,0,10,mixedType,1
7,4,0,11,mixedType,1
2,7,0,9,mixedType,1
16,1,1,18,mixedType,2
11,5,0,16,mixedType,2
2,4,0,6,mixedType,0
12,3,0,15,mixedType,2
15,1,0,16,mixedType,2
11,2,0,13,mixedType,1
5,6,0,11,mixedType,1
12,4,0,16,mixedType,2
7,2,0,9,mixedType,1
14,2,0,16,mixedType,2
13,3,0,16,mixedType,2
10,1,0,11,mixedType,1
6,6,0,12,mixedType,1
2,10,0,12,mixedType,1
6,4,0,10,mixedType,1
3,6,0,9,mixedType,1
6,2,0,8,mixedType,1
2,8,0,10,mixedType,1
13,3,0,16,mixedType,2
6,1,0,7,mixedType,0
10,3,0,13,mixedType,1
7,1,0,8,mixedType,1
3,6,0,9,mixedType,1
6,4,0,10,mixedType,1
4,4,0,8,mixedType,1
9,1,0,10,mixedType,1
5,2,0,7,mixedType,0
6,2,0,8,mixedType,1
7,2,0,9,mixedType,1
4,6,0,10,mixedType,1
5,3,0,8,mixedType,1
7,3,0,10,mixedType,1
13,3,0,16,mixedType,2
10,1,0,11,mixedType,1
8,2,0,10,mixedType,1
6,2,0,8,mixedType,1
3,5,0,8,mixedType,1
8,4,0,12,mixedType,1
8,1,0,9,mixedType,1
5,1,0,6,mixedType,0
8,2,0,10,mixedType,1
7,3,0,10,mixedType,1
9,3,0,12,mixedType,1
8,1,0,9,mixedType,1
7,2,0,9,mixedType,1
5,2,0,7,mixedType,0
6,4,0,10,mixedType,1
9,2,0,11,mixedType,1
6,4,0,10,mixedType,1
7,4,0,11,mixedType,1
8,2,0,10,mixedType,1
7,2,0,9,mixedType,1
5,2,0,7,mixedType,0
3,6,0,9,mixedType,1
9,4,0,13,mixedType,1
5,6,0,11,mixedType,1
4,2,0,6,mixedType,0
5,6,0,11,mixedType,1
6,4,0,10,mixedType,1
8,1,0,9,mixedType,1
8,3,0,11,mixedType,1
4,5,0,9,mixedType,1
5,4,0,9,mixedType,1
4,2,0,6,mixedType,0
4,4,0,8,mixedType,1
8,2,0,10,mixedType,1
6,2,0,8,mixedType,1
5,7,0,12,mixedType,1
6,3,0,9,mixedType,1
4,4,0,8,mixedType,1
2,6,0,8,mixedType,1
5,3,0,8,mixedType,1
5,3,0,8,mixedType,1
8,2,0,10,mixedType,1
4,2,0,6,mixedType,0
6,1,0,7,mixedType,0
5,7,0,12,mixedType,1
13,3,0,16,mixedType,2
6,3,0,9,mixedType,1
4,5,0,9,mixedType,1
8,2,0,10,mixedType,1
1,9,0,10,mixedType,1
2,6,0,8,mixedType,1
7,2,0,9,mixedType,1
6,4,0,10,mixedType,1
1,8,0,9,mixedType,1
8,1,0,9,mixedType,1
7,1,0,8,mixedType,1
7,1,0,8,mixedType,1
5,1,0,6,mixedType,0
7,2,0,9,mixedType,1
5,3,0,8,mixedType,1
9,1,0,10,mixedType,1
5,2,0,7,mixedType,0
6,2,0,8,mixedType,1
4,6,0,10,mixedType,1
3,5,0,8,mixedType,1
9,1,0,10,mixedType,1
4,2,0,6,mixedType,0
15,1,0,16,mixedType,2
6,3,0,9,mixedType,1
1,8,0,9,mixedType,1
6,4,0,10,mixedType,1
8,1,0,9,mixedType,1
8,2,0,10,mixedType,1
10,1,4,15,mixedType,2
8,1,0,9,mixedType,1
7,3,0,10,mixedType,1
7,3,0,10,mixedType,1
11,1,0,12,mixedType,1
6,3,0,9,mixedType,1
2,7,0,9,mixedType,1
6,4,0,10,mixedType,1
9,1,0,10,mixedType,1
13,3,0,16,mixedType,2
6,1,0,7,mixedType,0
5,2,0,7,mixedType,0
6,4,0,10,mixedType,1
6,3,0,9,mixedType,1
13,3,0,16,mixedType,2
14,2,0,16,mixedType,2
7,3,0,10,mixedType,1
8,2,0,10,mixedType,1
6,1,0,7,mixedType,0
8,3,0,11,mixedType,1
7,3,0,10,mixedType,1
4,2,0,6,mixedType,0
5,8,0,13,mixedType,1
7,3,0,10,mixedType,1
11,4,0,15,mixedType,2
5,3,0,8,mixedType,1
7,4,0,11,mixedType,1
6,3,0,9,mixedType,1
6,4,0,10,mixedType,1
8,1,0,9,mixedType,1
12,4,0,16,mixedType,2
12,4,0,16,mixedType,2
5,2,0,7,mixedType,0
6,3,0,9,mixedType,1
5,3,0,8,mixedType,1
5,4,0,9,mixedType,1
9,2,0,11,mixedType,1
8,3,0,11,mixedType,1
7,1,0,8,mixedType,1
6,2,1,9,mixedType,1
3,7,0,10,mixedType,1
14,2,0,16,mixedType,2
4,8,4,16,mixedType,2
7,3,0,10,mixedType,1
7,1,0,8,mixedType,1
4,9,0,13,mixedType,1
9,1,0,10,mixedType,1
7,3,0,10,mixedType,1
4,4,0,8,mixedType,1
7,1,0,8,mixedType,1
2,8,0,10,mixedType,1
6,1,0,7,mixedType,0
10,2,0,12,mixedType,1
4,4,0,8,mixedType,1
6,3,0,9,mixedType,1
3,6,0,9,mixedType,1
8,1,0,9,mixedType,1
8,2,0,10,mixedType,1
6,3,0,9,mixedType,1
12,4,0,16,mixedType,2
4,2,0,6,mixedType,0
10,2,0,12,mixedType,1
7,4,0,11,mixedType,1
7,3,0,10,mixedType,1
6,4,0,10,mixedType,1
7,2,0,9,mixedType,1
5,4,0,9,mixedType,1
4,4,0,8,mixedType,1
6,4,0,10,mixedType,1
4,2,0,6,mixedType,0
8,1,0,9,mixedType,1
4,4,0,8,mixedType,1
9,6,0,15,mixedType,2
5,2,0,7,mixedType,0
6,2,0,8,mixedType,1
4,6,0,10,mixedType,1
5,2,0,7,mixedType,0
5,4,0,9,mixedType,1
7,3,0,10,mixedType,1
6,3,0,9,mixedType,1
8,2,0,10,mixedType,1
6,1,0,7,mixedType,0
6,2,0,8,mixedType,1
7,6,0,13,mixedType,1
7,1,0,8,mixedType,1
6,3,0,9,mixedType,1
7,1,0,8,mixedType,1
10,3,0,13,mixedType,1
4,2,0,6,mixedType,0
7,3,0,10,mixedType,1
7,3,0,10,mixedType,1
1,8,0,9,mixedType,1
6,4,0,10,mixedType,1
4,2,0,6,mixedType,0
4,2,0,6,mixedType,0
3,6,0,9,mixedType,1
6,4,0,10,mixedType,1
5,2,0,7,mixedType,0
6,3,0,9,mixedType,1
8,1,0,9,mixedType,1
6,4,0,10,mixedType,1
6,4,0,10,mixedType,1
14,2,0,16,mixedType,2
2,7,0,9,mixedType,1
11,3,0,14,mixedType,2
1,8,0,9,mixedType,1
2,4,0,6,mixedType,0
2,7,0,9,mixedType,1
5,3,0,8,mixedType,1
6,3,0,9,mixedType,1
2,7,0,9,mixedType,1
8,4,0,12,mixedType,1
10,3,0,13,mixedType,1
7,3,0,10,mixedType,1
7,1,0,8,mixedType,1
5,2,0,7,mixedType,0
6,2,0,8,mixedType,1
6,3,0,9,mixedType,1
6,4,0,10,mixedType,1
8,3,0,11,mixedType,1
6,1,0,7,mixedType,0
5,3,0,8,mixedType,1
11,5,0,16,mixedType,2
15,1,0,16,mixedType,2
9,2,0,11,mixedType,1
6,2,0,8,mixedType,1
10,2,0,12,mixedType,1
5,3,0,8,mixedType,1
6,2,0,8,mixedType,1
7,2,0,9,mixedType,1
6,1,0,7,mixedType,0
10,2,0,12,mixedType,1
6,3,0,9,mixedType,1
4,6,0,10,mixedType,1
7,3,0,10,mixedType,1
9,1,0,10,mixedType,1
7,3,0,10,mixedType,1
5,3,0,8,mixedType,1
6,4,0,10,mixedType,1
1,8,0,9,mixedType,1
4,4,0,8,mixedType,1
7,2,0,9,mixedType,1
4,2,0,6,mixedType,0
14,2,0,16,mixedType,2
4,2,0,6,mixedType,0
9,2,0,11,mixedType,1
7,3,0,10,mixedType,1
8,2,0,10,mixedType,1
6,5,0,11,mixedType,1
13,3,0,16,mixedType,2
7,1,0,8,mixedType,1
3,6,0,9,mixedType,1
6,3,0,9,mixedType,1
8,5,1,14,mixedType,2
6,5,0,11,mixedType,1
8,3,0,11,mixedType,1
8,4,0,12,mixedType,1
10,2,0,12,mixedType,1
12,3,0,15,mixedType,2
4,4,0,8,mixedType,1
6,3,0,9,mixedType,1
6,3,0,9,mixedType,1
2,12,0,14,mixedType,2
1,8,0,9,mixedType,1
15,1,0,16,mixedType,2
12,4,0,16,mixedType,2
9,1,0,10,mixedType,1
12,3,0,15,mixedType,2
2,6,0,8,mixedType,1
4,4,0,8,mixedType,1
6,3,0,9,mixedType,1
6,2,0,8,mixedType,1
12,1,0,13,mixedType,1
9,1,0,10,mixedType,1
8,1,0,9,mixedType,1
3,3,0,6,mixedType,0
3,4,0,7,mixedType,0
5,3,0,8,mixedType,1
2,6,0,8,mixedType,1
5,1,0,6,mixedType,0
7,3,0,10,mixedType,1
6,2,0,8,mixedType,1
6,4,0,10,mixedType,1
4,6,0,10,mixedType,1
15,1,0,16,mixedType,2
6,1,0,7,mixedType,0
14,2,0,16,mixedType,2
4,4,0,8,mixedType,1
0,7,1,8,mixedType,1
11,5,0,16,mixedType,2
7,2,0,9,mixedType,1
11,5,0,16,mixedType,2
7,2,0,9,mixedType,1
7,3,0,10,mixedType,1
6,1,0,7,mixedType,0
15,1,0,16,mixedType,2
7,3,0,10,mixedType,1
10,1,0,11,mixedType,1
7,3,0,10,mixedType,1
6,6,0,12,mixedType,1
6,1,0,7,mixedType,0
8,3,0,11,mixedType,1
6,1,0,7,mixedType,0
5,1,0,6,mixedType,0
7,1,0,8,mixedType,1
7,3,0,10,mixedType,1
2,6,0,8,mixedType,1
4,8,0,12,mixedType,1
5,4,0,9,mixedType,1
7,1,0,8,mixedType,1
4,4,0,8,mixedType,1
4,2,0,6,mixedType,0
12,4,0,16,mixedType,2
5,3,0,8,mixedType,1
3,9,0,12,mixedType,1
5,2,0,7,mixedType,0
7,3,0,10,mixedType,1
15,1,0,16,mixedType,2
7,3,0,10,mixedType,1
8,1,0,9,mixedType,1
7,3,0,10,mixedType,1
6,2,0,8,mixedType,1
2,8,0,10,mixedType,1
6,1,0,7,mixedType,0
3,6,0,9,mixedType,1
7,3,0,10,mixedType,1
3,8,0,11,mixedType,1
4,6,0,10,mixedType,1
10,2,0,12,mixedType,1
10,2,0,12,mixedType,1
8,2,0,10,mixedType,1
7,2,0,9,mixedType,1
10,1,0,11,mixedType,1
7,2,0,9,mixedType,1
6,3,0,9,mixedType,1
7,1,0,8,mixedType,1
7,4,4,15,mixedType,2
4,6,0,10,mixedType,1
7,2,0,9,mixedType,1
7,3,0,10,mixedType,1
7,1,0,8,mixedType,1
8,1,0,9,mixedType,1
13,3,0,16,mixedType,2
5,1,0,6,mixedType,0
4,4,0,8,mixedType,1
15,5,0,20,mixedType,2
6,4,0,10,mixedType,1
6,1,0,7,mixedType,0
8,1,0,9,mixedType,1
5,3,0,8,mixedType,1
5,3,0,8,mixedType,1
13,3,0,16,mixedType,2
6,6,0,12,mixedType,1
8,2,0,10,mixedType,1
2,7,0,9,mixedType,1
6,5,0,11,mixedType,1
11,1,0,12,mixedType,1
3,6,0,9,mixedType,1
8,1,0,9,mixedType,1
10,2,0,12,mixedType,1
7,3,0,10,mixedType,1
13,2,0,15,mixedType,2
11,1,0,12,mixedType,1
4,2,0,6,mixedType,0
9,1,0,10,mixedType,1
7,1,0,8,mixedType,1
6,3,0,9,mixedType,1
11,3,0,14,mixedType,2
7,3,0,10,mixedType,1
7,2,0,9,mixedType,1
4,4,0,8,mixedType,1
7,1,0,8,mixedType,1
6,4,0,10,mixedType,1
7,3,0,10,mixedType,1
7,1,0,8,mixedType,1
9,3,0,12,mixedType,1
4,7,0,11,mixedType,1
5,3,0,8,mixedType,1
5,3,0,8,mixedType,1
7,1,0,8,mixedType,1
5,3,0,8,mixedType,1
4,4,0,8,mixedType,1
7,3,0,10,mixedType,1
5,0,3,8,mixedType,1
2,9,0,11,mixedType,1
3,6,0,9,mixedType,1
8,2,0,10,mixedType,1
6,1,0,7,mixedType,0
5,3,0,8,mixedType,1
6,2,0,8,mixedType,1
15,4,0,19,mixedType,2
4,4,0,8,mixedType,1
5,2,0,7,mixedType,0
9,1,0,10,mixedType,1
12,4,0,16,mixedType,2
1,8,0,9,mixedType,1
5,1,0,6,mixedType,0
5,2,0,7,mixedType,0
10,4,0,14,mixedType,2
12,4,0,16,mixedType,2
7,3,0,10,mixedType,1
7,3,0,10,mixedType,1
7,4,0,11,mixedType,1
13,3,0,16,mixedType,2
8,7,0,15,mixedType,2
8,1,0,9,mixedType,1
8,2,0,10,mixedType,1
8,6,0,14,mixedType,2
8,2,0,10,mixedType,1
5,1,0,6,mixedType,0
11,2,0,13,mixedType,1
6,4,0,10,mixedType,1
13,3,0,16,mixedType,2
7,1,0,8,mixedType,1
6,3,0,9,mixedType,1
5,2,0,7,mixedType,0
10,3,0,13,mixedType,1
5,3,0,8,mixedType,1
2,8,0,10,mixedType,1
10,3,0,13,mixedType,1
6,1,0,7,mixedType,0
13,3,0,16,mixedType,2
9,2,0,11,mixedType,1
5,2,0,7,mixedType,0
7,3,0,10,mixedType,1
6,1,0,7,mixedType,0
11,2,0,13,mixedType,1
6,1,0,7,mixedType,0
2,4,0,6,mixedType,0
15,1,0,16,mixedType,2
2,8,0,10,mixedType,1
8,2,0,10,mixedType,1
14,2,0,16,mixedType,2
8,2,0,10,mixedType,1
6,2,0,8,mixedType,1
7,4,0,11,mixedType,1
10,3,0,13,mixedType,1
7,1,0,8,mixedType,1
1,5,0,6,mixedType,0
7,3,0,10,mixedType,1
8,4,0,12,mixedType,1
13,3,0,16,mixedType,2
4,5,0,9,mixedType,1
2,6,0,8,mixedType,1
6,1,0,7,mixedType,0
15,1,0,16,mixedType,2
7,2,0,9,mixedType,1
8,1,0,9,mixedType,1
6,3,0,9,mixedType,1
6,2,0,8,mixedType,1
6,3,0,9,mixedType,1
6,2,0,8,mixedType,1
6,4,0,10,mixedType,1
5,3,0,8,mixedType,1
4,4,0,8,mixedType,1
4,4,0,8,mixedType,1
4,4,0,8,mixedType,1
7,2,0,9,mixedType,1
2,9,0,11,mixedType,1
10,1,0,11,mixedType,1
5,3,0,8,mixedType,1
4,10,2,16,mixedType,2
2,4,0,6,mixedType,0
5,1,0,6,mixedType,0
7,3,0,10,mixedType,1
7,1,0,8,mixedType,1
3,8,0,11,mixedType,1
10,4,0,14,mixedType,2
6,3,0,9,mixedType,1
9,3,0,12,mixedType,1
7,2,0,9,mixedType,1
6,2,0,8,mixedType,1
6,1,0,7,mixedType,0
8,1,0,9,mixedType,1
2,8,0,10,mixedType,1
15,1,0,16,mixedType,2
8,3,0,11,mixedType,1
6,2,0,8,mixedType,1
14,2,0,16,mixedType,2
3,3,0,6,mixedType,0
5,4,0,9,mixedType,1
4,2,0,6,mixedType,0
8,1,0,9,mixedType,1
13,3,0,16,mixedType,2
5,4,0,9,mixedType,1
15,1,0,16,mixedType,2
11,3,0,14,mixedType,2
5,4,0,9,mixedType,1
5,2,0,7,mixedType,0
2,8,0,10,mixedType,1
9,1,0,10,mixedType,1
5,3,0,8,mixedType,1
6,2,0,8,mixedType,1
6,2,0,8,mixedType,1
8,1,0,9,mixedType,1
8,2,0,10,mixedType,1
6,3,0,9,mixedType,1
7,3,0,10,mixedType,1
5,5,0,10,mixedType,1
6,2,0,8,mixedType,1
14,2,0,16,mixedType,2
6,3,0,9,mixedType,1
14,2,0,16,mixedType,2
5,1,0,6,mixedType,0
4,6,0,10,mixedType,1
7,2,0,9,mixedType,1
7,3,0,10,mixedType,1
7,1,0,8,mixedType,1
7,1,0,8,mixedType,1
14,2,0,16,mixedType,2
6,4,0,10,mixedType,1
14,2,0,16,mixedType,2
8,2,0,10,mixedType,1
6,4,0,10,mixedType,1
7,3,0,10,mixedType,1
12,3,0,15,mixedType,2
7,3,0,10,mixedType,1
7,3,0,10,mixedType,1
6,1,0,7,mixedType,0
3,6,0,9,mixedType,1
6,1,0,7,mixedType,0
5,2,0,7,mixedType,0
6,3,0,9,mixedType,1
5,1,0,6,mixedType,0
6,3,0,9,mixedType,1
10,1,0,11,mixedType,1
5,3,0,8,mixedType,1
15,1,0,16,mixedType,2
8,3,0,11,mixedType,1
13,3,0,16,mixedType,2
9,2,0,11,mixedType,1
5,2,0,7,mixedType,0
6,3,0,9,mixedType,1
7,2,0,9,mixedType,1
7,2,0,9,mixedType,1
8,1,0,9,mixedType,1
5,2,0,7,mixedType,0
6,2,0,8,mixedType,1
4,2,0,6,mixedType,0
6,2,0,8,mixedType,1
6,1,0,7,mixedType,0
11,1,0,12,mixedType,1
8,1,0,9,mixedType,1
3,6,0,9,mixedType,1
7,3,0,10,mixedType,1
7,1,0,8,mixedType,1
4,2,0,6,mixedType,0
7,3,0,10,mixedType,1
8,1,0,9,mixedType,1
8,1,0,9,mixedType,1
7,2,0,9,mixedType,1
6,2,0,8,mixedType,1
5,8,0,13,mixedType,1
8,2,0,10,mixedType,1
6,3,0,9,mixedType,1
4,2,0,6,mixedType,0
4,6,0,10,mixedType,1
8,4,0,12,mixedType,1
7,3,0,10,mixedType,1
9,1,0,10,mixedType,1
6,1,0,7,mixedType,0
4,2,0,6,mixedType,0
5,5,0,10,mixedType,1
7,2,0,9,mixedType,1
7,3,0,10,mixedType,1
1,8,0,9,mixedType,1
5,4,0,9,mixedType,1
1,7,0,8,mixedType,1
7,2,0,9,mixedType,1
12,3,0,15,mixedType,2
7,3,0,10,mixedType,1
5,3,0,8,mixedType,1
8,3,0,11,mixedType,1
9,1,0,10,mixedType,1
4,6,0,10,mixedType,1
7,2,0,9,mixedType,1
6,2,0,8,mixedType,1
7,3,0,10,mixedType,1
9,1,0,10,mixedType,1
6,2,0,8,mixedType,1
12,4,0,16,mixedType,2
8,2,0,10,mixedType,1
2,4,0,6,mixedType,0
5,2,0,7,mixedType,0
13,3,0,16,mixedType,2
2,8,0,10,mixedType,1
6,3,0,9,mixedType,1
2,8,0,10,mixedType,1
4,6,0,10,mixedType,1
12,4,0,16,mixedType,2
9,1,0,10,mixedType,1
6,3,0,9,mixedType,1
3,3,0,6,mixedType,0
1,7,0,8,mixedType,1
4,4,0,8,mixedType,1
4,2,0,6,mixedType,0
5,7,0,12,mixedType,1
13,3,0,16,mixedType,2
8,1,0,9,mixedType,1
5,6,0,11,mixedType,1
2,7,0,9,mixedType,1
15,1,0,16,mixedType,2
4,8,0,12,mixedType,1
13,3,0,16,mixedType,2
5,4,0,9,mixedType,1
5,1,0,6,mixedType,0
4,6,0,10,mixedType,1
5,2,0,7,mixedType,0
6,3,0,9,mixedType,1
5,2,0,7,mixedType,0
3,6,0,9,mixedType,1
2,7,0,9,mixedType,1
2,9,0,11,mixedType,1
6,2,0,8,mixedType,1
4,2,0,6,mixedType,0
6,0,0,6,sameType,0
6,3,0,9,mixedType,1
6,2,0,8,mixedType,1
3,5,0,8,mixedType,1
7,2,0,9,mixedType,1
9,1,0,10,mixedType,1
6,3,0,9,mixedType,1
4,4,0,8,mixedType,1
4,4,0,8,mixedType,1
9,3,0,12,mixedType,1
7,1,0,8,mixedType,1
4,2,0,6,mixedType,0
7,2,0,9,mixedType,1
5,3,0,8,mixedType,1
6,3,0,9,mixedType,1
7,2,0,9,mixedType,1
9,1,0,10,mixedType,1
6,2,0,8,mixedType,1
8,2,0,10,mixedType,1
6,4,0,10,mixedType,1
10,3,0,13,mixedType,1
2,8,0,10,mixedType,1
6,3,0,9,mixedType,1
6,3,0,9,mixedType,1
4,8,0,12,mixedType,1
7,2,0,9,mixedType,1
0,7,1,8,mixedType,1
6,2,0,8,mixedType,1
4,2,0,6,mixedType,0
5,3,0,8,mixedType,1
6,1,0,7,mixedType,0
6,1,0,7,mixedType,0
5,3,0,8,mixedType,1
4,4,0,8,mixedType,1
8,5,0,13,mixedType,1
7,3,0,10,mixedType,1
6,3,0,9,mixedType,1
13,3,0,16,mixedType,2
8,1,0,9,mixedType,1
6,1,0,7,mixedType,0
8,1,0,9,mixedType,1
6,1,0,7,mixedType,0
4,4,0,8,mixedType,1
7,2,0,9,mixedType,1
5,2,0,7,mixedType,0
6,2,0,8,mixedType,1
6,1,0,7,mixedType,0
12,3,0,15,mixedType,2
6,2,0,8,mixedType,1
7,2,0,9,mixedType,1
11,1,0,12,mixedType,1
10,3,3,16,mixedType,2
6,1,0,7,mixedType,0
5,2,0,7,mixedType,0
6,4,0,10,mixedType,1
1,8,0,9,mixedType,1
5,2,0,7,mixedType,0
2,4,0,6,mixedType,0
8,1,0,9,mixedType,1
5,2,0,7,mixedType,0
7,3,0,10,mixedType,1
7,3,0,10,mixedType,1
6,2,0,8,mixedType,1
4,2,0,6,mixedType,0
5,1,0,6,mixedType,0
2,6,0,8,mixedType,1
7,2,0,9,mixedType,1
7,2,0,9,mixedType,1
6,4,0,10,mixedType,1
6,3,0,9,mixedType,1
4,4,0,8,mixedType,1
2,4,0,6,mixedType,0
4,4,0,8,mixedType,1
9,2,0,11,mixedType,1
5,4,0,9,mixedType,1
7,3,0,10,mixedType,1
5,3,0,8,mixedType,1
7,3,0,10,mixedType,1
5,3,0,8,mixedType,1
12,1,0,13,mixedType,1
6,2,0,8,mixedType,1
7,2,0,9,mixedType,1
5,4,0,9,mixedType,1
6,3,0,9,mixedType,1
6,3,0,9,mixedType,1
5,3,0,8,mixedType,1
12,4,0,16,mixedType,2
5,4,0,9,mixedType,1
2,8,0,10,mixedType,1
8,1,0,9,mixedType,1
4,4,0,8,mixedType,1
10,3,0,13,mixedType,1
8,2,0,10,mixedType,1
8,2,0,10,mixedType,1
13,3,0,16,mixedType,2
5,4,0,9,mixedType,1
3,3,0,6,mixedType,0
6,3,0,9,mixedType,1
4,4,0,8,mixedType,1
4,4,0,8,mixedType,1
7,6,0,13,mixedType,1
6,6,0,12,mixedType,1
8,1,0,9,mixedType,1
1,11,3,15,mixedType,2
8,2,0,10,mixedType,1
7,2,0,9,mixedType,1
6,3,0,9,mixedType,1
13,3,0,16,mixedType,2
6,3,0,9,mixedType,1
7,1,0,8,mixedType,1
15,1,0,16,mixedType,2
5,3,0,8,mixedType,1
5,3,0,8,mixedType,1
2,9,0,11,mixedType,1
5,4,0,9,mixedType,1
6,3,0,9,mixedType,1
1,8,0,9,mixedType,1
9,2,0,11,mixedType,1
6,6,0,12,mixedType,1
5,6,0,11,mixedType,1
13,3,0,16,mixedType,2
5,1,0,6,mixedType,0
5,1,0,6,mixedType,0
6,1,0,7,mixedType,0
1,8,0,9,mixedType,1
9,1,0,10,mixedType,1
6,1,0,7,mixedType,0
2,8,0,10,mixedType,1
6,1,0,7,mixedType,0
6,2,0,8,mixedType,1
6,1,0,7,mixedType,0
9,1,0,10,mixedType,1
10,3,0,13,mixedType,1
3,8,0,11,mixedType,1
6,2,0,8,mixedType,1
2,7,0,9,mixedType,1
6,1,0,7,mixedType,0
5,3,0,8,mixedType,1
5,2,0,7,mixedType,0
6,1,0,7,mixedType,0
5,3,0,8,mixedType,1
0,11,1,12,mixedType,1
6,3,0,9,mixedType,1
13,3,0,16,mixedType,2
7,2,0,9,mixedType,1
7,2,0,9,mixedType,1
6,6,0,12,mixedType,1
3,6,0,9,mixedType,1
3,3,0,6,mixedType,0
6,3,0,9,mixedType,1
14,2,0,16,mixedType,2
6,1,0,7,mixedType,0
4,4,0,8,mixedType,1
6,1,0,7,mixedType,0
14,2,0,16,mixedType,2
19,1,0,20,mixedType,2
8,4,0,12,mixedType,1
7,1,0,8,mixedType,1
9,4,0,13,mixedType,1
4,4,0,8,mixedType,1
3,8,0,11,mixedType,1
5,2,0,7,mixedType,0
9,1,0,10,mixedType,1
12,4,0,16,mixedType,2
7,2,0,9,mixedType,1
4,2,0,6,mixedType,0
5,3,0,8,mixedType,1
6,2,0,8,mixedType,1
7,1,0,8,mixedType,1
8,2,0,10,mixedType,1
13,3,0,16,mixedType,2
6,4,0,10,mixedType,1
3,8,0,11,mixedType,1
2,9,0,11,mixedType,1
8,4,0,12,mixedType,1
8,4,0,12,mixedType,1
6,4,0,10,mixedType,1
8,1,0,9,mixedType,1
4,4,0,8,mixedType,1
8,1,0,9,mixedType,1
3,6,0,9,mixedType,1
5,3,0,8,mixedType,1
5,3,0,8,mixedType,1
7,3,0,10,mixedType,1
6,2,0,8,mixedType,1
4,6,0,10,mixedType,1
3,9,0,12,mixedType,1
4,2,0,6,mixedType,0
6,3,0,9,mixedType,1
12,4,0,16,mixedType,2
5,1,0,6,mixedType,0
6,1,0,7,mixedType,0
6,2,0,8,mixedType,1
8,2,0,10,mixedType,1
5,2,0,7,mixedType,0
4,4,0,8,mixedType,1
8,1,0,9,mixedType,1
7,3,0,10,mixedType,1
5,4,0,9,mixedType,1
9,3,0,12,mixedType,1
6,2,0,8,mixedType,1
7,2,0,9,mixedType,1
5,3,0,8,mixedType,1
5,5,0,10,mixedType,1
9,2,0,11,mixedType,1
1,8,0,9,mixedType,1
6,2,0,8,mixedType,1
11,2,0,13,mixedType,1
5,4,0,9,mixedType,1
6,1,0,7,mixedType,0
5,2,0,7,mixedType,0
5,3,0,8,mixedType,1
6,4,0,10,mixedType,1
3,6,0,9,mixedType,1
7,3,0,10,mixedType,1
11,3,0,14,mixedType,2
6,3,0,9,mixedType,1
4,2,0,6,mixedType,0
13,4,0,17,mixedType,2
8,1,0,9,mixedType,1
11,3,0,14,mixedType,2
6,1,0,7,mixedType,0
9,1,0,10,mixedType,1
8,3,0,11,mixedType,1
4,2,0,6,mixedType,0
9,1,0,10,mixedType,1
5,8,0,13,mixedType,1
12,4,0,16,mixedType,2
13,3,0,16,mixedType,2
6,3,0,9,mixedType,1
9,1,0,10,mixedType,1
5,4,0,9,mixedType,1
7,3,0,10,mixedType,1
5,3,0,8,mixedType,1
13,3,0,16,mixedType,2
5,4,0,9,mixedType,1
8,2,0,10,mixedType,1
4,7,0,11,mixedType,1
4,0,6,10,mixedType,1
6,3,0,9,mixedType,1
14,2,0,16,mixedType,2
5,1,0,6,mixedType,0
3,3,0,6,mixedType,0
11,3,0,14,mixedType,2
5,2,0,7,mixedType,0
7,2,0,9,mixedType,1
5,4,0,9,mixedType,1
5,4,0,9,mixedType,1
8,2,0,10,mixedType,1
15,1,0,16,mixedType,2
6,3,0,9,mixedType,1
7,3,0,10,mixedType,1
5,2,0,7,mixedType,0
6,3,0,9,mixedType,1
5,5,0,10,mixedType,1
5,2,0,7,mixedType,0
1,11,0,12,mixedType,1
6,3,0,9,mixedType,1
3,5,0,8,mixedType,1
11,1,0,12,mixedType,1
9,1,0,10,mixedType,1
6,4,0,10,mixedType,1
8,1,0,9,mixedType,1
7,2,0,9,mixedType,1
9,4,0,13,mixedType,1
9,2,0,11,mixedType,1
3,6,0,9,mixedType,1
8,4,0,12,mixedType,1
12,4,0,16,mixedType,2
7,2,0,9,mixedType,1
4,2,0,6,mixedType,0
2,4,0,6,mixedType,0
7,3,0,10,mixedType,1
12,0,1,13,mixedType,1
8,2,0,10,mixedType,1
8,2,0,10,mixedType,1
4,2,0,6,mixedType,0
8,1,0,9,mixedType,1
5,3,0,8,mixedType,1
13,3,0,16,mixedType,2
8,2,0,10,mixedType,1
4,2,0,6,mixedType,0
8,2,0,10,mixedType,1
6,2,0,8,mixedType,1
3,5,0,8,mixedType,1
2,6,0,8,mixedType,1
2,9,0,11,mixedType,1
7,3,0,10,mixedType,1
6,2,0,8,mixedType,1
2,4,0,6,mixedType,0
7,6,0,13,mixedType,1
5,2,0,7,mixedType,0
7,4,0,11,mixedType,1
8,1,0,9,mixedType,1
4,2,0,6,mixedType,0
6,4,0,10,mixedType,1
4,4,0,8,mixedType,1
7,2,0,9,mixedType,1
7,3,0,10,mixedType,1
7,3,0,10,mixedType,1
9,2,0,11,mixedType,1
5,2,0,7,mixedType,0
7,3,0,10,mixedType,1
14,2,0,16,mixedType,2
5,2,0,7,mixedType,0
5,3,0,8,mixedType,1
5,2,0,7,mixedType,0
3,7,0,10,mixedType,1
7,2,0,9,mixedType,1
9,3,0,12,mixedType,1
8,2,0,10,mixedType,1
7,4,0,11,mixedType,1
8,1,0,9,mixedType,1
13,3,0,16,mixedType,2
7,2,0,9,mixedType,1
5,4,0,9,mixedType,1
6,2,0,8,mixedType,1
5,5,0,10,mixedType,1
7,2,0,9,mixedType,1
8,4,0,12,mixedType,1
7,1,0,8,mixedType,1
7,3,0,10,mixedType,1
5,2,0,7,mixedType,0
6,3,0,9,mixedType,1
4,5,0,9,mixedType,1
9,1,0,10,mixedType,1
6,2,0,8,mixedType,1
13,3,0,16,mixedType,2
5,1,0,6,mixedType,0
5,11,0,16,mixedType,2
12,4,0,16,mixedType,2
15,1,0,16,mixedType,2
5,3,0,8,mixedType,1
7,6,0,13,mixedType,1
10,2,0,12,mixedType,1
8,2,0,10,mixedType,1
2,7,0,9,mixedType,1
6,4,0,10,mixedType,1
3,6,0,9,mixedType,1
15,1,0,16,mixedType,2
12,1,0,13,mixedType,1
6,6,0,12,mixedType,1
8,1,0,9,mixedType,1
7,4,0,11,mixedType,1
10,6,0,16,mixedType,2
5,4,0,9,mixedType,1
7,4,0,11,mixedType,1
10,3,0,13,mixedType,1
2,4,0,6,mixedType,0
7,3,0,10,mixedType,1
7,2,0,9,mixedType,1
0,6,1,7,mixedType,0
5,2,0,7,mixedType,0
6,3,0,9,mixedType,1
6,3,0,9,mixedType,1
4,2,0,6,mixedType,0
6,1,0,7,mixedType,0
11,4,1,16,mixedType,2
8,3,0,11,mixedType,1
2,8,0,10,mixedType,1
8,2,0,10,mixedType,1
7,4,0,11,mixedType,1
7,1,0,8,mixedType,1
9,1,0,10,mixedType,1
6,2,0,8,mixedType,1
14,2,0,16,mixedType,2
8,3,0,11,mixedType,1
8,3,0,11,mixedType,1
11,3,0,14,mixedType,2
9,1,0,10,mixedType,1
7,2,0,9,mixedType,1
10,2,0,12,mixedType,1
6,3,0,9,mixedType,1
9,1,0,10,mixedType,1
6,1,0,7,mixedType,0
4,9,0,13,mixedType,1
13,3,0,16,mixedType,2
3,10,0,13,mixedType,1
11,1,0,12,mixedType,1
7,1,0,8,mixedType,1
9,1,0,10,mixedType,1
4,4,0,8,mixedType,1
7,3,0,10,mixedType,1
16,1,0,17,mixedType,2
6,2,0,8,mixedType,1
4,2,0,6,mixedType,0
2,8,0,10,mixedType,1
4,2,0,6,mixedType,0
9,1,0,10,mixedType,1
6,3,0,9,mixedType,1
6,1,0,7,mixedType,0
8,3,0,11,mixedType,1
5,3,0,8,mixedType,1
3,3,0,6,mixedType,0
7,4,0,11,mixedType,1
7,2,0,9,mixedType,1
5,3,0,8,mixedType,1
6,3,0,9,mixedType,1
3,6,0,9,mixedType,1
2,11,0,13,mixedType,1
13,3,0,16,mixedType,2
6,1,0,7,mixedType,0
6,2,0,8,mixedType,1
6,1,0,7,mixedType,0
4,4,0,8,mixedType,1
6,2,0,8,mixedType,1
5,4,0,9,mixedType,1
11,0,1,12,mixedType,1
10,4,0,14,mixedType,2
7,2,0,9,mixedType,1
9,3,0,12,mixedType,1
6,3,0,9,mixedType,1
8,1,0,9,mixedType,1
11,4,0,15,mixedType,2
5,1,0,6,mixedType,0
4,4,0,8,mixedType,1
11,5,0,16,mixedType,2
2,11,0,13,mixedType,1
11,2,0,13,mixedType,1
6,3,0,9,mixedType,1
8,2,0,10,mixedType,1
3,6,0,9,mixedType,1
5,4,0,9,mixedType,1
2,6,0,8,mixedType,1
7,3,0,10,mixedType,1
2,8,0,10,mixedType,1
6,2,0,8,mixedType,1
6,2,0,8,mixedType,1
4,5,0,9,mixedType,1
7,3,0,10,mixedType,1
3,6,0,9,mixedType,1
11,5,0,16,mixedType,2
8,2,0,10,mixedType,1
7,1,0,8,mixedType,1
3,3,0,6,mixedType,0
15,1,0,16,mixedType,2
8,4,0,12,mixedType,1
5,2,0,7,mixedType,0
13,3,0,16,mixedType,2
5,1,0,6,mixedType,0
13,3,0,16,mixedType,2
8,2,0,10,mixedType,1
6,3,0,9,mixedType,1
9,1,0,10,mixedType,1
7,4,0,11,mixedType,1
5,1,0,6,mixedType,0
8,1,0,9,mixedType,1
5,6,0,11,mixedType,1
6,4,0,10,mixedType,1
8,2,0,10,mixedType,1
7,2,0,9,mixedType,1
6,6,0,12,mixedType,1
1,7,0,8,mixedType,1
4,2,0,6,mixedType,0
2,6,0,8,mixedType,1
12,4,0,16,mixedType,2
12,4,0,16,mixedType,2
5,3,0,8,mixedType,1
4,5,0,9,mixedType,1
11,2,0,13,mixedType,1
12,0,1,13,mixedType,1
8,2,0,10,mixedType,1
7,2,0,9,mixedType,1
5,2,0,7,mixedType,0
11,3,0,14,mixedType,2
8,3,0,11,mixedType,1
7,2,0,9,mixedType,1
7,3,0,10,mixedType,1
9,2,0,11,mixedType,1
13,3,0,16,mixedType,2
5,4,0,9,mixedType,1
6,4,0,10,mixedType,1
5,3,0,8,mixedType,1
5,5,0,10,mixedType,1
5,4,0,9,mixedType,1
6,4,0,10,mixedType,1
9,1,0,10,mixedType,1
6,3,0,9,mixedType,1
13,3,0,16,mixedType,2
4,2,0,6,mixedType,0
7,2,0,9,mixedType,1
5,2,0,7,mixedType,0
9,3,0,12,mixedType,1
8,2,0,10,mixedType,1
8,2,0,10,mixedType,1
8,2,0,10,mixedType,1
7,2,0,9,mixedType,1
6,3,0,9,mixedType,1
14,2,0,16,mixedType,2
5,4,0,9,mixedType,1
9,2,0,11,mixedType,1
8,2,0,10,mixedType,1
4,2,0,6,mixedType,0
5,5,0,10,mixedType,1
9,2,0,11,mixedType,1
3,6,0,9,mixedType,1
15,1,0,16,mixedType,2
5,2,0,7,mixedType,0
6,2,0,8,mixedType,1
4,2,0,6,mixedType,0
6,3,0,9,mixedType,1
4,2,0,6,mixedType,0
5,1,0,6,mixedType,0
7,3,0,10,mixedType,1
8,2,0,10,mixedType,1
6,6,0,12,mixedType,1
6,6,0,12,mixedType,1
7,3,0,10,mixedType,1
6,5,0,11,mixedType,1
9,1,0,10,mixedType,1
7,2,0,9,mixedType,1
12,4,0,16,mixedType,2
5,2,0,7,mixedType,0
6,1,0,7,mixedType,0
15,1,0,16,mixedType,2
3,3,0,6,mixedType,0
2,8,0,10,mixedType,1
7,2,0,9,mixedType,1
1,6,0,7,mixedType,0
14,2,0,16,mixedType,2
8,3,0,11,mixedType,1
5,5,0,10,mixedType,1
9,1,0,10,mixedType,1
4,4,0,8,mixedType,1
3,3,0,6,mixedType,0
12,3,0,15,mixedType,2
15,1,0,16,mixedType,2
7,3,0,10,mixedType,1
7,3,0,10,mixedType,1
6,3,0,9,mixedType,1
6,4,0,10,mixedType,1
8,4,0,12,mixedType,1
4,2,0,6,mixedType,0
7,2,0,9,mixedType,1
3,5,0,8,mixedType,1
9,3,0,12,mixedType,1
4,2,0,6,mixedType,0
8,2,0,10,mixedType,1
6,2,0,8,mixedType,1
5,3,0,8,mixedType,1
5,6,0,11,mixedType,1
8,2,0,10,mixedType,1
6,4,0,10,mixedType,1
14,2,0,16,mixedType,2
11,2,0,13,mixedType,1
8,2,0,10,mixedType,1
7,1,0,8,mixedType,1
5,2,0,7,mixedType,0
4,7,0,11,mixedType,1
8,3,0,11,mixedType,1
7,4,0,11,mixedType,1
9,2,0,11,mixedType,1
13,3,0,16,mixedType,2
8,3,0,11,mixedType,1
11,1,0,12,mixedType,1
8,1,0,9,mixedType,1
6,1,0,7,mixedType,0
7,2,0,9,mixedType,1
10,1,0,11,mixedType,1
6,1,0,7,mixedType,0
2,6,0,8,mixedType,1
6,2,0,8,mixedType,1
5,1,0,6,mixedType,0
7,4,0,11,mixedType,1
5,3,0,8,mixedType,1
5,2,0,7,mixedType,0
12,3,0,15,mixedType,2
10,2,0,12,mixedType,1
8,4,0,12,mixedType,1
6,1,0,7,mixedType,0
10,2,0,12,mixedType,1
5,4,0,9,mixedType,1
7,1,0,8,mixedType,1
14,2,0,16,mixedType,2
5,2,0,7,mixedType,0
6,4,0,10,mixedType,1
4,2,0,6,mixedType,0
5,2,0,7,mixedType,0
9,3,0,12,mixedType,1
5,4,0,9,mixedType,1
5,5,0,10,mixedType,1
12,3,0,15,mixedType,2
8,2,0,10,mixedType,1
6,1,0,7,mixedType,0
6,1,0,7,mixedType,0
4,2,0,6,mixedType,0
6,6,0,12,mixedType,1
15,1,0,16,mixedType,2
6,4,0,10,mixedType,1
7,2,0,9,mixedType,1
6,5,0,11,mixedType,1
4,2,0,6,mixedType,0
7,3,0,10,mixedType,1
6,3,0,9,mixedType,1
15,1,0,16,mixedType,2
7,1,0,8,mixedType,1
5,4,0,9,mixedType,1
2,8,0,10,mixedType,1
13,3,0,16,mixedType,2
8,1,0,9,mixedType,1
7,1,0,8,mixedType,1
14,2,0,16,mixedType,2
3,6,0,9,mixedType,1
2,6,0,8,mixedType,1
9,1,0,10,mixedType,1
14,2,0,16,mixedType,2
7,3,0,10,mixedType,1
12,3,0,15,mixedType,2
6,2,0,8,mixedType,1
8,3,0,11,mixedType,1
12,4,0,16,mixedType,2
13,1,1,15,mixedType,2
15,1,0,16,mixedType,2
6,3,0,9,mixedType,1
9,3,0,12,mixedType,1
9,1,0,10,mixedType,1
11,1,0,12,mixedType,1
5,3,0,8,mixedType,1
6,4,0,10,mixedType,1
2,7,0,9,mixedType,1
9,3,0,12,mixedType,1
6,4,0,10,mixedType,1
8,1,0,9,mixedType,1
5,2,0,7,mixedType,0
7,3,0,10,mixedType,1
11,1,0,12,mixedType,1
6,3,0,9,mixedType,1
4,4,0,8,mixedType,1
8,2,0,10,mixedType,1
4,4,0,8,mixedType,1
1,8,0,9,mixedType,1
1,9,0,10,mixedType,1
5,2,0,7,mixedType,0
9,1,0,10,mixedType,1
5,3,0,8,mixedType,1
7,3,0,10,mixedType,1
8,3,0,11,mixedType,1
7,3,0,10,mixedType,1
6,4,0,10,mixedType,1
8,2,0,10,mixedType,1
8,2,0,10,mixedType,1
8,2,0,10,mixedType,1
14,2,0,16,mixedType,2
5,1,0,6,mixedType,0
4,2,0,6,mixedType,0
3,3,0,6,mixedType,0
6,1,0,7,mixedType,0
1,7,0,8,mixedType,1
6,6,0,12,mixedType,1
5,3,0,8,mixedType,1
9,2,0,11,mixedType,1
4,6,0,10,mixedType,1
7,1,0,8,mixedType,1
6,1,0,7,mixedType,0
5,1,0,6,mixedType,0
7,2,0,9,mixedType,1
5,2,0,7,mixedType,0
6,3,0,9,mixedType,1
5,5,0,10,mixedType,1
4,4,0,8,mixedType,1
7,3,0,10,mixedType,1
4,6,0,10,mixedType,1
2,6,0,8,mixedType,1
6,3,0,9,mixedType,1
4,2,0,6,mixedType,0
7,3,0,10,mixedType,1
12,4,0,16,mixedType,2
5,4,0,9,mixedType,1
4,5,0,9,mixedType,1
13,3,0,16,mixedType,2
7,4,0,11,mixedType,1
1,7,0,8,mixedType,1
6,2,0,8,mixedType,1
8,3,0,11,mixedType,1
15,1,0,16,mixedType,2
8,2,0,10,mixedType,1
6,3,0,9,mixedType,1
7,3,0,10,mixedType,1
6,3,0,9,mixedType,1
6,2,0,8,mixedType,1
14,2,0,16,mixedType,2
5,5,0,10,mixedType,1
5,4,0,9,mixedType,1
14,2,0,16,mixedType,2
6,2,0,8,mixedType,1
6,4,0,10,mixedType,1
5,2,0,7,mixedType,0
8,2,0,10,mixedType,1
4,4,0,8,mixedType,1
8,4,0,12,mixedType,1
4,2,0,6,mixedType,0
8,1,0,9,mixedType,1
3,6,0,9,mixedType,1
5,5,0,10,mixedType,1
8,1,0,9,mixedType,1
6,2,0,8,mixedType,1
6,5,0,11,mixedType,1
12,4,0,16,mixedType,2
4,2,0,6,mixedType,0
4,4,0,8,mixedType,1
6,4,0,10,mixedType,1
5,3,0,8,mixedType,1
1,7,0,8,mixedType,1
11,2,0,13,mixedType,1
6,3,0,9,mixedType,1
5,3,0,8,mixedType,1
8,2,0,10,mixedType,1
11,1,0,12,mixedType,1
6,2,0,8,mixedType,1
8,2,0,10,mixedType,1
15,1,0,16,mixedType,2
8,4,0,12,mixedType,1
6,3,0,9,mixedType,1
7,2,0,9,mixedType,1
15,1,0,16,mixedType,2
7,3,0,10,mixedType,1
7,3,0,10,mixedType,1
13,3,0,16,mixedType,2
8,1,0,9,mixedType,1
2,6,0,8,mixedType,1
6,3,0,9,mixedType,1
7,3,0,10,mixedType,1
11,5,0,16,mixedType,2
8,1,0,9,mixedType,1
7,3,0,10,mixedType,1
5,1,0,6,mixedType,0
8,2,0,10,mixedType,1
5,5,0,10,mixedType,1
13,3,0,16,mixedType,2
5,2,0,7,mixedType,0
7,2,0,9,mixedType,1
2,4,0,6,mixedType,0
6,2,0,8,mixedType,1
6,4,0,10,mixedType,1
5,3,0,8,mixedType,1
8,1,0,9,mixedType,1
4,4,0,8,mixedType,1
7,3,0,10,mixedType,1
7,1,0,8,mixedType,1
4,2,0,6,mixedType,0
7,3,0,10,mixedType,1
6,2,0,8,mixedType,1
6,4,0,10,mixedType,1
2,6,0,8,mixedType,1
10,2,0,12,mixedType,1
5,2,0,7,mixedType,0
6,3,0,9,mixedType,1
5,2,0,7,mixedType,0
7,2,0,9,mixedType,1
7,2,0,9,mixedType,1
8,3,0,11,mixedType,1
7,2,0,9,mixedType,1
11,1,0,12,mixedType,1
11,5,0,16,mixedType,2
8,3,0,11,mixedType,1
8,4,0,12,mixedType,1
5,4,0,9,mixedType,1
7,2,0,9,mixedType,1
8,4,0,12,mixedType,1
5,4,0,9,mixedType,1
7,1,0,8,mixedType,1
8,1,0,9,mixedType,1
5,1,0,6,mixedType,0
6,2,0,8,mixedType,1
4,5,0,9,mixedType,1
4,4,0,8,mixedType,1
5,3,0,8,mixedType,1
5,6,0,11,mixedType,1
5,3,0,8,mixedType,1
14,2,0,16,mixedType,2
13,3,0,16,mixedType,2
9,1,0,10,mixedType,1
7,3,0,10,mixedType,1
6,3,0,9,mixedType,1
4,2,0,6,mixedType,0
6,2,0,8,mixedType,1
11,3,0,14,mixedType,2
2,8,0,10,mixedType,1
7,1,0,8,mixedType,1
9,2,0,11,mixedType,1
13,3,0,16,mixedType,2
7,2,0,9,mixedType,1
6,3,0,9,mixedType,1
7,3,0,10,mixedType,1
8,2,0,10,mixedType,1
3,6,0,9,mixedType,1
5,2,0,7,mixedType,0
8,2,0,10,mixedType,1
6,3,0,9,mixedType,1
8,2,0,10,mixedType,1
8,1,0,9,mixedType,1
3,8,0,11,mixedType,1
7,1,0,8,mixedType,1
7,4,0,11,mixedType,1
1,8,0,9,mixedType,1
6,4,0,10,mixedType,1
5,3,0,8,mixedType,1
7,3,0,10,mixedType,1
10,1,0,11,mixedType,1
4,2,0,6,mixedType,0
7,3,0,10,mixedType,1
7,1,0,8,mixedType,1
5,4,0,9,mixedType,1
3,8,0,11,mixedType,1
6,3,0,9,mixedType,1
6,3,0,9,mixedType,1
8,1,0,9,mixedType,1
13,3,0,16,mixedType,2
5,4,0,9,mixedType,1
6,1,0,7,mixedType,0
4,4,0,8,mixedType,1
3,6,0,9,mixedType,1
4,8,0,12,mixedType,1
11,3,0,14,mixedType,2
5,1,0,6,mixedType,0
8,1,0,9,mixedType,1
10,1,0,11,mixedType,1
15,1,0,16,mixedType,2
6,3,0,9,mixedType,1
9,1,0,10,mixedType,1
4,2,0,6,mixedType,0
7,2,0,9,mixedType,1
3,3,0,6,mixedType,0
10,2,0,12,mixedType,1
6,2,0,8,mixedType,1
6,3,0,9,mixedType,1
6,3,0,9,mixedType,1
5,2,0,7,mixedType,0
7,6,0,13,mixedType,1
5,6,0,11,mixedType,1
6,4,0,10,mixedType,1
8,3,0,11,mixedType,1
6,4,0,10,mixedType,1
7,1,0,8,mixedType,1
9,3,0,12,mixedType,1
17,1,3,21,mixedType,2
1,8,0,9,mixedType,1
7,3,0,10,mixedType,1
7,2,0,9,mixedType,1
13,3,0,16,mixedType,2
5,2,0,7,mixedType,0
9,1,0,10,mixedType,1
11,1,0,12,mixedType,1
7,2,0,9,mixedType,1
6,3,0,9,mixedType,1
7,3,0,10,mixedType,1
15,1,0,16,mixedType,2
5,3,0,8,mixedType,1
6,0,1,7,mixedType,0
5,2,0,7,mixedType,0
4,4,0,8,mixedType,1
9,1,0,10,mixedType,1
7,0,2,9,mixedType,1
8,1,0,9,mixedType,1
8,1,0,9,mixedType,1
7,3,0,10,mixedType,1
5,6,0,11,mixedType,1
5,3,0,8,mixedType,1
3,6,0,9,mixedType,1
8,2,0,10,mixedType,1
7,4,0,11,mixedType,1
8,2,0,10,mixedType,1
5,4,0,9,mixedType,1
6,1,0,7,mixedType,0
14,2,0,16,mixedType,2
8,2,0,10,mixedType,1
8,2,0,10,mixedType,1
6,1,0,7,mixedType,0
9,4,0,13,mixedType,1
9,4,0,13,mixedType,1
7,4,0,11,mixedType,1
5,4,0,9,mixedType,1
3,6,0,9,mixedType,1
1,9,0,10,mixedType,1
6,3,0,9,mixedType,1
4,6,0,10,mixedType,1
3,5,0,8,mixedType,1
6,4,0,10,mixedType,1
8,2,0,10,mixedType,1
8,2,0,10,mixedType,1
5,1,0,6,mixedType,0
10,4,2,16,mixedType,2
1,8,0,9,mixedType,1
5,3,0,8,mixedType,1
7,4,0,11,mixedType,1
4,2,0,6,mixedType,0
10,2,0,12,mixedType,1
6,3,0,9,mixedType,1
8,2,0,10,mixedType,1
5,1,0,6,mixedType,0
7,1,0,8,mixedType,1
7,3,0,10,mixedType,1
6,2,0,8,mixedType,1
5,4,0,9,mixedType,1
6,8,0,14,mixedType,2
6,2,0,8,mixedType,1
5,2,0,7,mixedType,0
5,3,0,8,mixedType,1
7,4,0,11,mixedType,1
6,2,0,8,mixedType,1
6,2,0,8,mixedType,1
8,2,0,10,mixedType,1
8,3,0,11,mixedType,1
6,3,0,9,mixedType,1
10,2,0,12,mixedType,1
8,2,0,10,mixedType,1
11,4,1,16,mixedType,2
12,3,0,15,mixedType,2
5,2,0,7,mixedType,0
4,4,0,8,mixedType,1
7,3,0,10,mixedType,1
6,1,0,7,mixedType,0
8,1,0,9,mixedType,1
5,5,0,10,mixedType,1
6,4,0,10,mixedType,1
5,3,0,8,mixedType,1
5,6,0,11,mixedType,1
5,3,0,8,mixedType,1
6,4,0,10,mixedType,1
6,5,0,11,mixedType,1
6,3,0,9,mixedType,1
7,3,0,10,mixedType,1
6,2,0,8,mixedType,1
8,4,0,12,mixedType,1
6,4,0,10,mixedType,1
4,2,0,6,mixedType,0
3,7,0,10,mixedType,1
13,3,0,16,mixedType,2
8,2,0,10,mixedType,1
7,2,0,9,mixedType,1
2,10,0,12,mixedType,1
8,4,0,12,mixedType,1
8,2,0,10,mixedType,1
5,4,0,9,mixedType,1
15,1,0,16,mixedType,2
5,2,0,7,mixedType,0
5,4,0,9,mixedType,1
7,3,0,10,mixedType,1
7,4,0,11,mixedType,1
9,2,0,11,mixedType,1
0,8,1,9,mixedType,1
7,3,0,10,mixedType,1
9,1,0,10,mixedType,1
10,2,0,12,mixedType,1
5,4,0,9,mixedType,1
6,1,0,7,mixedType,0
7,3,0,10,mixedType,1
7,2,0,9,mixedType,1
6,4,0,10,mixedType,1
2,4,0,6,mixedType,0
7,6,0,13,mixedType,1
3,6,0,9,mixedType,1
2,4,0,6,mixedType,0
5,4,0,9,mixedType,1
7,3,0,10,mixedType,1
5,3,0,8,mixedType,1
15,1,0,16,mixedType,2
7,2,0,9,mixedType,1
4,7,0,11,mixedType,1
6,4,0,10,mixedType,1
7,3,0,10,mixedType,1
5,2,0,7,mixedType,0
6,3,0,9,mixedType,1
6,4,0,10,mixedType,1
7,1,0,8,mixedType,1
6,4,0,10,mixedType,1
6,1,0,7,mixedType,0
6,1,0,7,mixedType,0
5,1,0,6,mixedType,0
4,4,0,8,mixedType,1
7,2,0,9,mixedType,1
3,6,0,9,mixedType,1
7,3,0,10,mixedType,1
15,1,0,16,mixedType,2
6,2,0,8,mixedType,1
11,3,0,14,mixedType,2
8,2,0,10,mixedType,1
9,1,0,10,mixedType,1
4,4,0,8,mixedType,1
3,10,1,14,mixedType,2
11,5,0,16,mixedType,2
5,1,0,6,mixedType,0
11,3,0,14,mixedType,2
5,4,0,9,mixedType,1
5,1,0,6,mixedType,0
7,3,0,10,mixedType,1
8,1,0,9,mixedType,1
5,5,0,10,mixedType,1
2,4,0,6,mixedType,0
6,3,0,9,mixedType,1
3,7,0,10,mixedType,1
9,1,0,10,mixedType,1
7,1,0,8,mixedType,1
6,4,0,10,mixedType,1
11,3,0,14,mixedType,2
14,2,0,16,mixedType,2
8,2,0,10,mixedType,1
11,1,0,12,mixedType,1
8,1,0,9,mixedType,1
5,4,0,9,mixedType,1
5,3,0,8,mixedType,1
9,1,0,10,mixedType,1
10,7,0,17,mixedType,2
8,1,0,9,mixedType,1
0,6,0,6,sameType,0
6,3,0,9,mixedType,1
7,3,0,10,mixedType,1
5,6,0,11,mixedType,1
6,7,1,14,mixedType,2
5,0,1,6,mixedType,0
9,4,0,13,mixedType,1
5,2,0,7,mixedType,0
9,6,0,15,mixedType,2
8,1,0,9,mixedType,1
8,2,0,10,mixedType,1
6,2,0,8,mixedType,1
6,2,0,8,mixedType,1
12,3,0,15,mixedType,2
7,1,0,8,mixedType,1
6,3,0,9,mixedType,1
5,1,0,6,mixedType,0
9,4,0,13,mixedType,1
6,4,0,10,mixedType,1
8,3,0,11,mixedType,1
5,2,0,7,mixedType,0
1,9,0,10,mixedType,1
1,10,0,11,mixedType,1
6,7,0,13,mixedType,1
9,4,0,13,mixedType,1
5,1,0,6,mixedType,0
11,5,0,16,mixedType,2
7,2,0,9,mixedType,1
4,2,0,6,mixedType,0
3,6,0,9,mixedType,1
7,1,0,8,mixedType,1
10,3,0,13,mixedType,1
7,2,0,9,mixedType,1
7,3,0,10,mixedType,1
6,1,0,7,mixedType,0
4,2,0,6,mixedType,0
5,2,0,7,mixedType,0
8,1,0,9,mixedType,1
7,3,0,10,mixedType,1
6,4,0,10,mixedType,1
6,6,0,12,mixedType,1
7,5,0,12,mixedType,1
7,4,0,11,mixedType,1
5,4,0,9,mixedType,1
7,2,0,9,mixedType,1
7,3,0,10,mixedType,1
7,4,0,11,mixedType,1
3,7,0,10,mixedType,1
5,1,0,6,mixedType,0
7,1,0,8,mixedType,1
1,8,0,9,mixedType,1
3,6,0,9,mixedType,1
5,2,0,7,mixedType,0
3,5,0,8,mixedType,1
7,3,0,10,mixedType,1
7,2,0,9,mixedType,1
6,3,0,9,mixedType,1
4,5,0,9,mixedType,1
4,6,0,10,mixedType,1
6,1,0,7,mixedType,0
1,8,0,9,mixedType,1
4,2,0,6,mixedType,0
8,1,0,9,mixedType,1
5,4,0,9,mixedType,1
6,1,0,7,mixedType,0
4,2,0,6,mixedType,0
2,7,0,9,mixedType,1
6,1,0,7,mixedType,0
12,3,0,15,mixedType,2
1,8,0,9,mixedType,1
6,3,0,9,mixedType,1
5,1,0,6,mixedType,0
2,10,0,12,mixedType,1
6,3,0,9,mixedType,1
4,4,0,8,mixedType,1
7,3,0,10,mixedType,1
1,7,0,8,mixedType,1
6,4,0,10,mixedType,1
9,2,0,11,mixedType,1
6,4,0,10,mixedType,1
6,3,0,9,mixedType,1
6,3,0,9,mixedType,1
10,6,0,16,mixedType,2
3,6,0,9,mixedType,1
9,3,0,12,mixedType,1
11,2,0,13,mixedType,1
7,3,0,10,mixedType,1
5,8,0,13,mixedType,1
1,8,0,9,mixedType,1
12,4,0,16,mixedType,2
6,6,0,12,mixedType,1
6,2,0,8,mixedType,1
5,1,0,6,mixedType,0
6,4,0,10,mixedType,1
4,4,0,8,mixedType,1
8,4,0,12,mixedType,1
3,8,1,12,mixedType,1
15,1,0,16,mixedType,2
7,3,0,10,mixedType,1
14,2,0,16,mixedType,2
6,3,0,9,mixedType,1
9,1,0,10,mixedType,1
5,1,0,6,mixedType,0
6,2,0,8,mixedType,1
7,3,0,10,mixedType,1
12,4,0,16,mixedType,2
7,2,0,9,mixedType,1
14,2,0,16,mixedType,2
7,2,0,9,mixedType,1
7,2,0,9,mixedType,1
13,3,0,16,mixedType,2
8,1,0,9,mixedType,1
9,1,0,10,mixedType,1
4,2,0,6,mixedType,0
2,6,0,8,mixedType,1
7,3,0,10,mixedType,1
8,2,0,10,mixedType,1
2,6,0,8,mixedType,1
6,6,0,12,mixedType,1
6,3,0,9,mixedType,1
2,6,0,8,mixedType,1
7,2,0,9,mixedType,1
8,2,0,10,mixedType,1
2,4,0,6,mixedType,0
5,3,0,8,mixedType,1
8,1,0,9,mixedType,1
14,2,0,16,mixedType,2
11,5,0,16,mixedType,2
11,1,0,12,mixedType,1
7,3,0,10,mixedType,1
5,1,0,6,mixedType,0
6,4,0,10,mixedType,1
7,2,0,9,mixedType,1
10,1,0,11,mixedType,1
7,3,0,10,mixedType,1
6,3,0,9,mixedType,1
6,4,0,10,mixedType,1
7,2,0,9,mixedType,1
5,2,0,7,mixedType,0
4,5,0,9,mixedType,1
9,2,0,11,mixedType,1
8,4,0,12,mixedType,1
8,4,0,12,mixedType,1
10,2,0,12,mixedType,1
9,1,0,10,mixedType,1
5,1,0,6,mixedType,0
4,6,0,10,mixedType,1
7,3,0,10,mixedType,1
5,2,0,7,mixedType,0
8,1,0,9,mixedType,1
4,2,0,6,mixedType,0
4,4,0,8,mixedType,1
7,3,0,10,mixedType,1
8,2,0,10,mixedType,1
9,1,0,10,mixedType,1
9,1,0,10,mixedType,1
8,1,0,9,mixedType,1
6,2,0,8,mixedType,1
5,1,0,6,mixedType,0
7,2,0,9,mixedType,1
6,2,0,8,mixedType,1
8,3,0,11,mixedType,1
8,1,0,9,mixedType,1
9,2,0,11,mixedType,1
8,1,0,9,mixedType,1
6,3,0,9,mixedType,1
5,2,0,7,mixedType,0
3,9,0,12,mixedType,1
7,3,0,10,mixedType,1
1,7,0,8,mixedType,1
5,1,0,6,mixedType,0
1,9,0,10,mixedType,1
3,7,0,10,mixedType,1
6,6,0,12,mixedType,1
6,1,0,7,mixedType,0
7,2,0,9,mixedType,1
6,1,0,7,mixedType,0
6,1,0,7,mixedType,0
13,3,0,16,mixedType,2
7,2,0,9,mixedType,1
6,1,0,7,mixedType,0
11,3,0,14,mixedType,2
14,2,0,16,mixedType,2
6,1,0,7,mixedType,0
6,2,0,8,mixedType,1
1,8,0,9,mixedType,1
10,3,0,13,mixedType,1
8,1,0,9,mixedType,1
5,4,0,9,mixedType,1
6,3,0,9,mixedType,1
6,3,0,9,mixedType,1
7,4,0,11,mixedType,1
9,2,0,11,mixedType,1
7,1,0,8,mixedType,1
6,1,0,7,mixedType,0
11,1,0,12,mixedType,1
8,1,0,9,mixedType,1
12,1,0,13,mixedType,1
6,1,0,7,mixedType,0
6,2,0,8,mixedType,1
8,2,0,10,mixedType,1
7,2,0,9,mixedType,1
6,3,0,9,mixedType,1
5,3,0,8,mixedType,1
6,3,0,9,mixedType,1
7,1,0,8,mixedType,1
7,1,0,8,mixedType,1
2,8,0,10,mixedType,1
7,2,0,9,mixedType,1
8,1,0,9,mixedType,1
5,3,0,8,mixedType,1
3,10,0,13,mixedType,1
6,0,1,7,mixedType,0
5,1,0,6,mixedType,0
5,7,0,12,mixedType,1
6,3,0,9,mixedType,1
7,3,0,10,mixedType,1
9,2,0,11,mixedType,1
9,1,0,10,mixedType,1
9,2,0,11,mixedType,1
13,3,0,16,mixedType,2
7,1,0,8,mixedType,1
8,3,0,11,mixedType,1
5,2,0,7,mixedType,0
14,2,0,16,mixedType,2
8,2,0,10,mixedType,1
3,10,0,13,mixedType,1
4,2,0,6,mixedType,0
7,4,0,11,mixedType,1
2,6,0,8,mixedType,1
9,2,0,11,mixedType,1
9,3,0,12,mixedType,1
6,4,0,10,mixedType,1
15,1,0,16,mixedType,2
6,2,0,8,mixedType,1
7,3,0,10,mixedType,1
4,4,0,8,mixedType,1
6,4,0,10,mixedType,1
8,2,0,10,mixedType,1
5,2,0,7,mixedType,0
8,4,0,12,mixedType,1
7,3,0,10,mixedType,1
6,3,0,9,mixedType,1
8,1,0,9,mixedType,1
8,2,0,10,mixedType,1
11,2,0,13,mixedType,1
5,3,0,8,mixedType,1
2,6,0,8,mixedType,1
4,6,0,10,mixedType,1
8,3,0,11,mixedType,1
7,3,0,10,mixedType,1
8,3,0,11,mixedType,1
5,2,0,7,mixedType,0
4,2,0,6,mixedType,0
7,2,0,9,mixedType,1
8,2,0,10,mixedType,1
11,2,0,13,mixedType,1
4,6,0,10,mixedType,1
7,4,0,11,mixedType,1
8,1,0,9,mixedType,1
8,2,0,10,mixedType,1
6,2,0,8,mixedType,1
2,7,0,9,mixedType,1
12,4,0,16,mixedType,2
5,4,0,9,mixedType,1
7,1,0,8,mixedType,1
5,3,0,8,mixedType,1
7,3,0,10,mixedType,1
3,6,0,9,mixedType,1
4,2,0,6,mixedType,0
1,7,0,8,mixedType,1
8,4,0,12,mixedType,1
8,2,0,10,mixedType,1
7,5,0,12,mixedType,1
7,3,0,10,mixedType,1
7,3,0,10,mixedType,1
5,2,0,7,mixedType,0
3,6,0,9,mixedType,1
5,3,0,8,mixedType,1
7,2,0,9,mixedType,1
12,4,0,16,mixedType,2
6,2,0,8,mixedType,1
7,2,0,9,mixedType,1
6,3,0,9,mixedType,1
6,3,0,9,mixedType,1
7,1,0,8,mixedType,1
6,3,0,9,mixedType,1
13,3,0,16,mixedType,2
2,7,0,9,mixedType,1
6,4,0,10,mixedType,1
6,2,0,8,mixedType,1
9,1,0,10,mixedType,1
9,2,0,11,mixedType,1
6,4,0,10,mixedType,1
6,1,0,7,mixedType,0
5,3,0,8,mixedType,1
8,4,0,12,mixedType,1
8,2,0,10,mixedType,1
2,4,0,6,mixedType,0
6,4,0,10,mixedType,1
5,4,0,9,mixedType,1
8,4,0,12,mixedType,1
5,2,0,7,mixedType,0
9,1,0,10,mixedType,1
10,3,0,13,mixedType,1
4,7,0,11,mixedType,1
8,1,0,9,mixedType,1
9,1,0,10,mixedType,1
5,2,0,7,mixedType,0
8,1,0,9,mixedType,1
2,11,0,13,mixedType,1
7,2,0,9,mixedType,1
6,6,0,12,mixedType,1
7,2,0,9,mixedType,1
15,1,0,16,mixedType,2
4,4,0,8,mixedType,1
6,3,0,9,mixedType,1
6,2,0,8,mixedType,1
5,4,0,9,mixedType,1
4,2,0,6,mixedType,0
12,4,0,16,mixedType,2
9,1,0,10,mixedType,1
7,3,0,10,mixedType,1
1,11,0,12,mixedType,1
14,2,0,16,mixedType,2
6,3,0,9,mixedType,1
13,3,0,16,mixedType,2
5,5,0,10,mixedType,1
10,1,0,11,mixedType,1
5,6,0,11,mixedType,1
9,3,0,12,mixedType,1
8,1,0,9,mixedType,1
7,2,0,9,mixedType,1
6,2,0,8,mixedType,1
4,6,0,10,mixedType,1
5,6,0,11,mixedType,1
6,1,0,7,mixedType,0
11,5,0,16,mixedType,2
8,2,0,10,mixedType,1
4,4,0,8,mixedType,1
2,7,0,9,mixedType,1
9,3,0,12,mixedType,1
8,4,0,12,mixedType,1
11,3,0,14,mixedType,2
10,1,0,11,mixedType,1
9,3,0,12,mixedType,1
7,7,3,17,mixedType,2
15,1,0,16,mixedType,2
8,5,0,13,mixedType,1
7,2,0,9,mixedType,1
2,6,0,8,mixedType,1
5,1,0,6,mixedType,0
8,3,0,11,mixedType,1
7,2,0,9,mixedType,1
8,1,0,9,mixedType,1
6,3,0,9,mixedType,1
6,4,0,10,mixedType,1
8,1,0,9,mixedType,1
3,6,0,9,mixedType,1
6,0,2,8,mixedType,1
1,8,0,9,mixedType,1
7,4,0,11,mixedType,1
8,2,0,10,mixedType,1
5,2,0,7,mixedType,0
2,6,0,8,mixedType,1
8,2,0,10,mixedType,1
9,3,0,12,mixedType,1
6,2,0,8,mixedType,1
4,4,0,8,mixedType,1
5,3,0,8,mixedType,1
3,3,0,6,mixedType,0
8,1,0,9,mixedType,1
15,1,0,16,mixedType,2
6,2,0,8,mixedType,1
4,4,0,8,mixedType,1
4,4,0,8,mixedType,1
12,3,0,15,mixedType,2
5,1,0,6,mixedType,0
6,4,0,10,mixedType,1
9,1,0,10,mixedType,1
5,1,0,6,mixedType,0
4,2,0,6,mixedType,0
6,1,0,7,mixedType,0
2,8,0,10,mixedType,1
5,3,0,8,mixedType,1
5,3,0,8,mixedType,1
5,2,0,7,mixedType,0
7,2,0,9,mixedType,1
6,3,0,9,mixedType,1
5,4,0,9,mixedType,1
5,4,0,9,mixedType,1
8,1,0,9,mixedType,1
3,6,0,9,mixedType,1
3,5,0,8,mixedType,1
7,4,0,11,mixedType,1
15,1,0,16,mixedType,2
6,3,0,9,mixedType,1
4,6,0,10,mixedType,1
2,6,0,8,mixedType,1
2,6,0,8,mixedType,1
5,2,0,7,mixedType,0
4,4,0,8,mixedType,1
3,8,0,11,mixedType,1
5,2,0,7,mixedType,0
6,3,0,9,mixedType,1
6,6,0,12,mixedType,1
5,3,0,8,mixedType,1
14,2,0,16,mixedType,2
5,3,0,8,mixedType,1
6,2,0,8,mixedType,1
8,2,0,10,mixedType,1
3,8,0,11,mixedType,1
6,4,0,10,mixedType,1
10,0,1,11,mixedType,1
15,1,0,16,mixedType,2
6,1,0,7,mixedType,0
5,3,0,8,mixedType,1
7,1,0,8,mixedType,1
11,2,0,13,mixedType,1
6,3,0,9,mixedType,1
5,2,0,7,mixedType,0
6,4,0,10,mixedType,1
2,4,0,6,mixedType,0
6,2,0,8,mixedType,1
9,2,0,11,mixedType,1
5,1,0,6,mixedType,0
9,4,0,13,mixedType,1
4,4,0,8,mixedType,1
13,3,0,16,mixedType,2
13,3,0,16,mixedType,2
6,4,0,10,mixedType,1
3,6,0,9,mixedType,1
6,3,0,9,mixedType,1
6,1,0,7,mixedType,0
5,2,0,7,mixedType,0
6,3,0,9,mixedType,1
7,3,0,10,mixedType,1
6,2,0,8,mixedType,1
6,3,0,9,mixedType,1
14,2,0,16,mixedType,2
6,2,0,8,mixedType,1
6,3,0,9,mixedType,1
6,3,0,9,mixedType,1
12,4,0,16,mixedType,2
4,6,0,10,mixedType,1
6,1,0,7,mixedType,0
4,2,0,6,mixedType,0
4,4,0,8,mixedType,1
5,1,0,6,mixedType,0
7,5,0,12,mixedType,1
6,3,0,9,mixedType,1
13,3,0,16,mixedType,2
3,5,0,8,mixedType,1
3,7,0,10,mixedType,1
7,4,0,11,mixedType,1
6,0,6,12,mixedType,1
5,1,0,6,mixedType,0
6,3,0,9,mixedType,1
10,1,0,11,mixedType,1
6,3,0,9,mixedType,1
4,2,0,6,mixedType,0
6,4,0,10,mixedType,1
4,2,0,6,mixedType,0
3,6,0,9,mixedType,1
14,2,0,16,mixedType,2
13,3,0,16,mixedType,2
9,2,0,11,mixedType,1
2,7,0,9,mixedType,1
5,3,0,8,mixedType,1
7,2,0,9,mixedType,1
3,5,0,8,mixedType,1
4,4,0,8,mixedType,1
8,4,0,12,mixedType,1
6,4,0,10,mixedType,1
3,6,0,9,mixedType,1
2,8,0,10,mixedType,1
7,3,0,10,mixedType,1
3,6,0,9,mixedType,1
4,6,0,10,mixedType,1
3,7,0,10,mixedType,1
8,1,0,9,mixedType,1
5,2,0,7,mixedType,0
7,3,0,10,mixedType,1
5,3,0,8,mixedType,1
11,3,0,14,mixedType,2
8,1,0,9,mixedType,1
9,1,0,10,mixedType,1
12,3,0,15,mixedType,2
14,2,0,16,mixedType,2
6,3,0,9,mixedType,1
8,2,0,10,mixedType,1
9,2,0,11,mixedType,1
6,2,0,8,mixedType,1
6,3,0,9,mixedType,1
7,1,0,8,mixedType,1
11,3,0,14,mixedType,2
5,1,0,6,mixedType,0
9,3,0,12,mixedType,1
7,3,0,10,mixedType,1
6,4,0,10,mixedType,1
15,1,0,16,mixedType,2
9,1,0,10,mixedType,1
5,2,0,7,mixedType,0
9,3,0,12,mixedType,1
5,2,0,7,mixedType,0
13,3,0,16,mixedType,2
12,1,0,13,mixedType,1
7,3,0,10,mixedType,1
6,2,0,8,mixedType,1
11,2,0,13,mixedType,1
8,2,0,10,mixedType,1
3,3,0,6,mixedType,0
6,3,0,9,mixedType,1
9,3,0,12,mixedType,1
4,6,0,10,mixedType,1
4,4,0,8,mixedType,1
5,4,0,9,mixedType,1
6,4,0,10,mixedType,1
4,6,0,10,mixedType,1
9,1,0,10,mixedType,1
5,3,0,8,mixedType,1
5,3,0,8,mixedType,1
6,2,0,8,mixedType,1
6,4,0,10,mixedType,1
6,4,0,10,mixedType,1
4,4,0,8,mixedType,1
2,8,0,10,mixedType,1
8,1,0,9,mixedType,1
2,4,0,6,mixedType,0
7,1,0,8,mixedType,1
10,1,0,11,mixedType,1
8,6,0,14,mixedType,2
6,4,0,10,mixedType,1
8,1,0,9,mixedType,1
6,6,0,12,mixedType,1
6,3,0,9,mixedType,1
8,2,0,10,mixedType,1
10,2,0,12,mixedType,1
7,2,0,9,mixedType,1
6,2,0,8,mixedType,1
8,1,0,9,mixedType,1
9,1,0,10,mixedType,1
5,3,0,8,mixedType,1
7,1,0,8,mixedType,1
7,3,0,10,mixedType,1
4,4,0,8,mixedType,1
7,3,0,10,mixedType,1
5,3,0,8,mixedType,1
4,6,0,10,mixedType,1
7,1,0,8,mixedType,1
6,3,0,9,mixedType,1
6,4,0,10,mixedType,1
6,1,0,7,mixedType,0
9,2,0,11,mixedType,1
7,3,0,10,mixedType,1
7,2,0,9,mixedType,1
7,3,0,10,mixedType,1
6,3,0,9,mixedType,1
6,3,0,9,mixedType,1
8,1,0,9,mixedType,1
7,4,0,11,mixedType,1
6,1,0,7,mixedType,0
8,2,0,10,mixedType,1
5,5,0,10,mixedType,1
2,7,0,9,mixedType,1
5,2,0,7,mixedType,0
6,4,0,10,mixedType,1
5,1,0,6,mixedType,0
8,1,0,9,mixedType,1
7,3,0,10,mixedType,1
6,1,0,7,mixedType,0
1,8,0,9,mixedType,1
14,2,0,16,mixedType,2
2,9,0,11,mixedType,1
7,3,0,10,mixedType,1
7,3,0,10,mixedType,1
4,5,0,9,mixedType,1
5,1,0,6,mixedType,0
14,2,0,16,mixedType,2
1,7,0,8,mixedType,1
14,2,0,16,mixedType,2
4,7,0,11,mixedType,1
5,2,0,7,mixedType,0
6,1,0,7,mixedType,0
6,2,0,8,mixedType,1
8,4,0,12,mixedType,1
3,6,0,9,mixedType,1
3,8,0,11,mixedType,1
3,5,0,8,mixedType,1
6,3,0,9,mixedType,1
9,4,0,13,mixedType,1
10,2,0,12,mixedType,1
8,2,0,10,mixedType,1
9,2,0,11,mixedType,1
6,4,0,10,mixedType,1
7,1,0,8,mixedType,1
8,1,0,9,mixedType,1
15,1,0,16,mixedType,2
5,2,0,7,mixedType,0
5,4,0,9,mixedType,1
6,3,0,9,mixedType,1
15,1,0,16,mixedType,2
7,3,0,10,mixedType,1
8,1,0,9,mixedType,1
6,3,0,9,mixedType,1
7,3,0,10,mixedType,1
8,2,0,10,mixedType,1
7,3,0,10,mixedType,1
6,7,0,13,mixedType,1
6,3,0,9,mixedType,1
8,1,0,9,mixedType,1
5,3,0,8,mixedType,1
10,1,0,11,mixedType,1
13,3,0,16,mixedType,2
9,1,0,10,mixedType,1
7,3,0,10,mixedType,1
5,2,0,7,mixedType,0
10,2,0,12,mixedType,1
3,5,0,8,mixedType,1
3,6,0,9,mixedType,1
5,4,0,9,mixedType,1
6,1,0,7,mixedType,0
11,2,0,13,mixedType,1
6,7,0,13,mixedType,1
8,2,0,10,mixedType,1
8,3,0,11,mixedType,1
7,1,0,8,mixedType,1
3,6,0,9,mixedType,1
8,2,0,10,mixedType,1
5,1,0,6,mixedType,0
4,2,0,6,mixedType,0
0,6,1,7,mixedType,0
5,2,0,7,mixedType,0
4,7,0,11,mixedType,1
6,3,0,9,mixedType,1
2,7,0,9,mixedType,1
6,8,1,15,mixedType,2
8,4,0,12,mixedType,1
7,3,0,10,mixedType,1
12,3,0,15,mixedType,2
5,3,0,8,mixedType,1
8,1,0,9,mixedType,1
12,3,0,15,mixedType,2
3,6,0,9,mixedType,1
3,3,0,6,mixedType,0
5,7,0,12,mixedType,1
6,3,0,9,mixedType,1
7,3,0,10,mixedType,1
9,1,0,10,mixedType,1
2,6,0,8,mixedType,1
12,4,0,16,mixedType,2
14,2,0,16,mixedType,2
11,3,0,14,mixedType,2
8,2,0,10,mixedType,1
6,3,0,9,mixedType,1
8,3,0,11,mixedType,1
5,2,0,7,mixedType,0
5,7,0,12,mixedType,1
14,2,0,16,mixedType,2
6,5,0,11,mixedType,1
6,3,0,9,mixedType,1
6,1,0,7,mixedType,0
11,3,0,14,mixedType,2
7,3,0,10,mixedType,1
6,2,0,8,mixedType,1
14,2,0,16,mixedType,2
8,1,0,9,mixedType,1
5,3,0,8,mixedType,1
8,1,0,9,mixedType,1
5,2,0,7,mixedType,0
5,8,0,13,mixedType,1
7,1,0,8,mixedType,1
7,2,0,9,mixedType,1
7,3,0,10,mixedType,1
11,5,0,16,mixedType,2
8,1,0,9,mixedType,1
4,6,0,10,mixedType,1
4,4,0,8,mixedType,1
9,2,0,11,mixedType,1
9,1,0,10,mixedType,1
5,1,0,6,mixedType,0
6,1,0,7,mixedType,0
10,6,0,16,mixedType,2
5,4,0,9,mixedType,1
8,4,0,12,mixedType,1
8,2,0,10,mixedType,1
18,1,1,20,mixedType,2
4,6,0,10,mixedType,1
2,6,0,8,mixedType,1
12,3,0,15,mixedType,2
7,4,0,11,mixedType,1
9,1,0,10,mixedType,1
8,1,0,9,mixedType,1
12,3,0,15,mixedType,2
7,2,0,9,mixedType,1
13,3,0,16,mixedType,2
9,4,0,13,mixedType,1
13,3,0,16,mixedType,2
4,4,0,8,mixedType,1
2,9,0,11,mixedType,1
8,1,0,9,mixedType,1
5,3,0,8,mixedType,1
6,4,0,10,mixedType,1
7,2,0,9,mixedType,1
0,6,0,6,sameType,0
11,1,0,12,mixedType,1
9,1,0,10,mixedType,1
5,2,0,7,mixedType,0
7,3,0,10,mixedType,1
10,3,0,13,mixedType,1
4,4,0,8,mixedType,1
8,2,0,10,mixedType,1
14,2,0,16,mixedType,2
10,2,0,12,mixedType,1
5,3,0,8,mixedType,1
5,7,0,12,mixedType,1
7,2,0,9,mixedType,1
10,3,0,13,mixedType,1
2,8,0,10,mixedType,1
8,1,0,9,mixedType,1
5,5,0,10,mixedType,1
4,2,0,6,mixedType,0
8,1,0,9,mixedType,1
8,2,0,10,mixedType,1
8,4,0,12,mixedType,1
10,3,0,13,mixedType,1
5,2,0,7,mixedType,0
6,4,0,10,mixedType,1
5,7,0,12,mixedType,1
10,3,0,13,mixedType,1
4,4,0,8,mixedType,1
10,1,0,11,mixedType,1
14,2,0,16,mixedType,2
7,3,0,10,mixedType,1
7,2,0,9,mixedType,1
7,3,0,10,mixedType,1
7,3,0,10,mixedType,1
5,3,0,8,mixedType,1
4,4,0,8,mixedType,1
14,3,2,19,mixedType,2
7,2,0,9,mixedType,1
2,4,0,6,mixedType,0
13,3,0,16,mixedType,2
7,3,0,10,mixedType,1
13,3,0,16,mixedType,2
7,3,0,10,mixedType,1
14,2,0,16,mixedType,2
5,4,0,9,mixedType,1
4,6,0,10,mixedType,1
8,3,0,11,mixedType,1
13,3,0,16,mixedType,2
7,2,0,9,mixedType,1
7,2,0,9,mixedType,1
13,3,0,16,mixedType,2
6,4,0,10,mixedType,1
7,1,0,8,mixedType,1
3,3,0,6,mixedType,0
8,4,0,12,mixedType,1
6,3,0,9,mixedType,1
7,5,0,12,mixedType,1
7,2,0,9,mixedType,1
3,7,0,10,mixedType,1
13,3,0,16,mixedType,2
7,2,0,9,mixedType,1
7,2,0,9,mixedType,1
6,2,0,8,mixedType,1
7,1,0,8,mixedType,1
12,1,0,13,mixedType,1
5,3,0,8,mixedType,1
6,3,0,9,mixedType,1
6,3,0,9,mixedType,1
6,3,0,9,mixedType,1
8,1,0,9,mixedType,1
8,3,0,11,mixedType,1
5,4,0,9,mixedType,1
5,4,0,9,mixedType,1
6,1,0,7,mixedType,0
2,8,0,10,mixedType,1
7,3,0,10,mixedType,1
5,2,0,7,mixedType,0
8,2,0,10,mixedType,1
9,1,0,10,mixedType,1
7,2,0,9,mixedType,1
11,5,4,20,mixedType,2
3,3,0,6,mixedType,0
9,4,0,13,mixedType,1
6,1,0,7,mixedType,0
8,4,0,12,mixedType,1
8,4,0,12,mixedType,1
3,8,0,11,mixedType,1
7,3,0,10,mixedType,1
8,2,0,10,mixedType,1
5,4,0,9,mixedType,1
7,3,0,10,mixedType,1
6,3,0,9,mixedType,1
8,5,0,13,mixedType,1
6,3,0,9,mixedType,1
5,2,0,7,mixedType,0
5,2,0,7,mixedType,0
7,3,0,10,mixedType,1
3,3,0,6,mixedType,0
10,3,0,13,mixedType,1
6,3,0,9,mixedType,1
5,3,0,8,mixedType,1
5,1,0,6,mixedType,0
5,3,0,8,mixedType,1
0,6,0,6,sameType,0
6,1,0,7,mixedType,0
5,6,0,11,mixedType,1
7,2,0,9,mixedType,1
6,1,0,7,mixedType,0
6,1,0,7,mixedType,0
5,6,0,11,mixedType,1
8,1,0,9,mixedType,1
9,3,0,12,mixedType,1
4,4,0,8,mixedType,1
8,4,0,12,mixedType,1
10,1,0,11,mixedType,1
14,2,0,16,mixedType,2
6,1,0,7,mixedType,0
9,1,0,10,mixedType,1
6,3,0,9,mixedType,1
6,2,0,8,mixedType,1
5,4,0,9,mixedType,1
7,2,0,9,mixedType,1
12,4,0,16,mixedType,2
4,2,0,6,mixedType,0
9,1,0,10,mixedType,1
5,3,0,8,mixedType,1
6,4,0,10,mixedType,1
15,1,0,16,mixedType,2
9,3,0,12,mixedType,1
1,7,0,8,mixedType,1
6,1,0,7,mixedType,0
4,4,0,8,mixedType,1
8,2,0,10,mixedType,1
7,3,0,10,mixedType,1
5,2,0,7,mixedType,0
6,1,0,7,mixedType,0
7,3,0,10,mixedType,1
2,4,0,6,mixedType,0
5,3,0,8,mixedType,1
7,2,0,9,mixedType,1
15,1,0,16,mixedType,2
5,3,0,8,mixedType,1
5,5,0,10,mixedType,1
3,9,0,12,mixedType,1
5,5,0,10,mixedType,1
7,1,0,8,mixedType,1
2,7,0,9,mixedType,1
4,6,0,10,mixedType,1
5,3,0,8,mixedType,1
8,2,0,10,mixedType,1
5,3,0,8,mixedType,1
5,4,0,9,mixedType,1
3,7,0,10,mixedType,1
7,2,0,9,mixedType,1
9,2,0,11,mixedType,1
5,2,0,7,mixedType,0
5,11,0,16,mixedType,2
9,4,0,13,mixedType,1
8,2,0,10,mixedType,1
9,1,0,10,mixedType,1
4,5,0,9,mixedType,1
8,3,0,11,mixedType,1
8,1,0,9,mixedType,1
14,2,0,16,mixedType,2
15,1,0,16,mixedType,2
14,2,0,16,mixedType,2
13,3,0,16,mixedType,2
25,3,1,29,mixedType,2
14,2,0,16,mixedType,2
11,1,0,12,mixedType,1
6,2,0,8,mixedType,1
5,3,0,8,mixedType,1
6,2,0,8,mixedType,1
1,8,0,9,mixedType,1
6,4,0,10,mixedType,1
8,1,0,9,mixedType,1
7,3,0,10,mixedType,1
5,4,0,9,mixedType,1
7,3,0,10,mixedType,1
5,3,0,8,mixedType,1
8,4,0,12,mixedType,1
7,3,0,10,mixedType,1
8,2,0,10,mixedType,1
9,3,0,12,mixedType,1
3,8,0,11,mixedType,1
8,2,0,10,mixedType,1
7,3,0,10,mixedType,1
6,3,0,9,mixedType,1
8,1,0,9,mixedType,1
8,3,0,11,mixedType,1
7,2,0,9,mixedType,1
5,2,0,7,mixedType,0
6,3,0,9,mixedType,1
4,2,0,6,mixedType,0
4,4,0,8,mixedType,1
1,8,0,9,mixedType,1
8,2,0,10,mixedType,1
5,3,0,8,mixedType,1
6,1,0,7,mixedType,0
6,1,0,7,mixedType,0
7,3,0,10,mixedType,1
7,2,0,9,mixedType,1
7,1,0,8,mixedType,1
7,2,0,9,mixedType,1
6,3,0,9,mixedType,1
10,1,0,11,mixedType,1
8,1,0,9,mixedType,1
4,6,0,10,mixedType,1
8,1,0,9,mixedType,1
11,2,0,13,mixedType,1
12,1,0,13,mixedType,1
2,8,0,10,mixedType,1
8,2,0,10,mixedType,1
9,2,0,11,mixedType,1
4,4,0,8,mixedType,1
10,4,0,14,mixedType,2
6,4,0,10,mixedType,1
5,3,0,8,mixedType,1
3,8,0,11,mixedType,1
7,4,0,11,mixedType,1
13,3,0,16,mixedType,2
7,2,0,9,mixedType,1
5,0,1,6,mixedType,0
1,7,0,8,mixedType,1
5,4,0,9,mixedType,1
6,3,0,9,mixedType,1
12,3,0,15,mixedType,2
9,1,0,10,mixedType,1
5,1,0,6,mixedType,0
15,1,0,16,mixedType,2
5,3,0,8,mixedType,1
4,4,0,8,mixedType,1
5,2,0,7,mixedType,0
2,6,0,8,mixedType,1
5,3,0,8,mixedType,1
6,4,0,10,mixedType,1
8,3,0,11,mixedType,1
15,1,0,16,mixedType,2
6,8,0,14,mixedType,2
6,4,0,10,mixedType,1
8,3,0,11,mixedType,1
4,6,0,10,mixedType,1
2,4,0,6,mixedType,0
6,3,0,9,mixedType,1
5,4,0,9,mixedType,1
6,2,0,8,mixedType,1
4,5,0,9,mixedType,1
7,4,0,11,mixedType,1
7,2,0,9,mixedType,1
8,4,0,12,mixedType,1
13,1,1,15,mixedType,2
6,1,0,7,mixedType,0
7,1,0,8,mixedType,1
6,3,0,9,mixedType,1
8,2,0,10,mixedType,1
8,4,0,12,mixedType,1
8,3,0,11,mixedType,1
6,2,0,8,mixedType,1
12,3,0,15,mixedType,2
3,6,0,9,mixedType,1
8,1,0,9,mixedType,1
4,6,0,10,mixedType,1
6,4,0,10,mixedType,1
7,3,0,10,mixedType,1
14,1,0,15,mixedType,2
14,2,0,16,mixedType,2
13,3,0,16,mixedType,2
7,3,0,10,mixedType,1
6,1,0,7,mixedType,0
8,2,0,10,mixedType,1
9,3,0,12,mixedType,1
5,3,0,8,mixedType,1
1,8,0,9,mixedType,1
7,3,0,10,mixedType,1
6,3,0,9,mixedType,1
6,3,0,9,mixedType,1
8,2,0,10,mixedType,1
1,8,0,9,mixedType,1
8,2,0,10,mixedType,1
2,6,0,8,mixedType,1
14,2,0,16,mixedType,2
9,2,0,11,mixedType,1
7,2,0,9,mixedType,1
7,3,0,10,mixedType,1
8,1,0,9,mixedType,1
9,3,0,12,mixedType,1
4,4,0,8,mixedType,1
6,4,0,10,mixedType,1
3,3,0,6,mixedType,0
6,3,0,9,mixedType,1
15,1,0,16,mixedType,2
3,11,0,14,mixedType,2
3,3,0,6,mixedType,0
7,2,0,9,mixedType,1
9,1,0,10,mixedType,1
12,3,0,15,mixedType,2
6,4,0,10,mixedType,1
5,2,0,7,mixedType,0
7,2,0,9,mixedType,1
8,2,0,10,mixedType,1
13,3,0,16,mixedType,2
6,2,0,8,mixedType,1
8,1,0,9,mixedType,1
2,8,0,10,mixedType,1
14,2,0,16,mixedType,2
14,2,0,16,mixedType,2
7,1,0,8,mixedType,1
6,3,0,9,mixedType,1
1,8,0,9,mixedType,1
8,2,0,10,mixedType,1
9,1,0,10,mixedType,1
7,2,0,9,mixedType,1
8,2,0,10,mixedType,1
6,4,0,10,mixedType,1
7,3,0,10,mixedType,1
15,1,0,16,mixedType,2
8,3,0,11,mixedType,1
14,2,0,16,mixedType,2
5,3,0,8,mixedType,1
3,6,0,9,mixedType,1
9,1,0,10,mixedType,1
8,2,0,10,mixedType,1
8,2,0,10,mixedType,1
5,3,0,8,mixedType,1
4,2,0,6,mixedType,0
6,4,0,10,mixedType,1
9,2,0,11,mixedType,1
4,6,0,10,mixedType,1
1,5,0,6,mixedType,0
6,4,0,10,mixedType,1
9,2,0,11,mixedType,1
5,2,0,7,mixedType,0
8,3,0,11,mixedType,1
5,6,0,11,mixedType,1
3,6,0,9,mixedType,1
14,2,0,16,mixedType,2
14,2,0,16,mixedType,2
7,2,0,9,mixedType,1
9,1,0,10,mixedType,1
8,4,0,12,mixedType,1
5,8,0,13,mixedType,1
6,4,0,10,mixedType,1
5,3,0,8,mixedType,1
8,1,0,9,mixedType,1
7,2,0,9,mixedType,1
6,2,0,8,mixedType,1
6,2,0,8,mixedType,1
7,1,0,8,mixedType,1
7,1,0,8,mixedType,1
5,4,0,9,mixedType,1
8,1,0,9,mixedType,1
14,4,0,18,mixedType,2
5,6,0,11,mixedType,1
6,3,0,9,mixedType,1
9,2,0,11,mixedType,1
6,3,0,9,mixedType,1
7,3,0,10,mixedType,1
6,6,2,14,mixedType,2
6,2,0,8,mixedType,1
11,1,0,12,mixedType,1
7,2,0,9,mixedType,1
5,4,0,9,mixedType,1
4,2,0,6,mixedType,0
7,1,0,8,mixedType,1
9,3,0,12,mixedType,1
5,3,0,8,mixedType,1
7,3,0,10,mixedType,1
9,2,0,11,mixedType,1
4,2,0,6,mixedType,0
7,3,0,10,mixedType,1
3,7,0,10,mixedType,1
8,1,0,9,mixedType,1
8,2,0,10,mixedType,1
3,6,0,9,mixedType,1
5,3,0,8,mixedType,1
5,4,0,9,mixedType,1
4,2,0,6,mixedType,0
4,6,0,10,mixedType,1
10,1,0,11,mixedType,1
7,3,0,10,mixedType,1
6,3,0,9,mixedType,1
2,4,0,6,mixedType,0
6,4,0,10,mixedType,1
13,3,0,16,mixedType,2
7,2,0,9,mixedType,1
7,3,0,10,mixedType,1
8,7,0,15,mixedType,2
5,2,0,7,mixedType,0
7,1,0,8,mixedType,1
9,4,0,13,mixedType,1
1,10,0,11,mixedType,1
5,2,0,7,mixedType,0
4,4,0,8,mixedType,1
8,1,0,9,mixedType,1
5,5,0,10,mixedType,1
7,3,0,10,mixedType,1
4,6,0,10,mixedType,1
7,3,0,10,mixedType,1
5,2,0,7,mixedType,0
4,4,0,8,mixedType,1
6,4,0,10,mixedType,1
9,4,0,13,mixedType,1
4,2,0,6,mixedType,0
7,1,0,8,mixedType,1
10,2,0,12,mixedType,1
4,6,0,10,mixedType,1
7,1,0,8,mixedType,1
7,0,1,8,mixedType,1
2,10,0,12,mixedType,1
8,2,0,10,mixedType,1
6,2,0,8,mixedType,1
7,1,0,8,mixedType,1
6,2,0,8,mixedType,1
8,1,0,9,mixedType,1
8,2,0,10,mixedType,1
6,4,0,10,mixedType,1
1,8,0,9,mixedType,1
8,2,0,10,mixedType,1
5,4,0,9,mixedType,1
6,4,0,10,mixedType,1
5,2,0,7,mixedType,0
6,1,0,7,mixedType,0
15,1,0,16,mixedType,2
6,4,0,10,mixedType,1
8,2,0,10,mixedType,1
5,5,0,10,mixedType,1
6,1,0,7,mixedType,0
3,3,0,6,mixedType,0
10,2,0,12,mixedType,1
7,3,0,10,mixedType,1
14,2,0,16,mixedType,2
8,2,0,10,mixedType,1
6,4,0,10,mixedType,1
6,2,0,8,mixedType,1
5,2,0,7,mixedType,0
14,2,0,16,mixedType,2
6,1,0,7,mixedType,0
5,1,0,6,mixedType,0
2,7,0,9,mixedType,1
7,3,0,10,mixedType,1
8,1,0,9,mixedType,1
5,3,0,8,mixedType,1
11,1,0,12,mixedType,1
6,3,0,9,mixedType,1
2,6,0,8,mixedType,1
8,1,0,9,mixedType,1
4,6,0,10,mixedType,1
9,1,0,10,mixedType,1
6,1,0,7,mixedType,0
7,2,0,9,mixedType,1
6,4,0,10,mixedType,1
6,2,0,8,mixedType,1
9,2,0,11,mixedType,1
4,5,0,9,mixedType,1
9,2,0,11,mixedType,1
3,3,0,6,mixedType,0
7,3,0,10,mixedType,1
8,2,0,10,mixedType,1
7,3,0,10,mixedType,1
7,3,0,10,mixedType,1
10,1,0,11,mixedType,1
7,4,0,11,mixedType,1
5,2,0,7,mixedType,0
5,3,0,8,mixedType,1
4,2,0,6,mixedType,0
13,3,0,16,mixedType,2
6,3,0,9,mixedType,1
2,4,0,6,mixedType,0
7,3,0,10,mixedType,1
5,2,0,7,mixedType,0
17,4,0,21,mixedType,2
4,2,0,6,mixedType,0
5,3,0,8,mixedType,1
5,1,0,6,mixedType,0
5,2,0,7,mixedType,0
3,5,0,8,mixedType,1
5,4,0,9,mixedType,1
5,4,0,9,mixedType,1
14,2,0,16,mixedType,2
5,4,0,9,mixedType,1
3,6,0,9,mixedType,1
5,1,0,6,mixedType,0
5,1,0,6,mixedType,0
8,1,0,9,mixedType,1
7,2,0,9,mixedType,1
15,1,0,16,mixedType,2
5,3,0,8,mixedType,1
5,4,0,9,mixedType,1
10,2,0,12,mixedType,1
4,2,0,6,mixedType,0
1,10,0,11,mixedType,1
4,4,0,8,mixedType,1
7,3,0,10,mixedType,1
3,6,0,9,mixedType,1
5,5,0,10,mixedType,1
4,4,0,8,mixedType,1
5,2,0,7,mixedType,0
4,6,0,10,mixedType,1
9,2,0,11,mixedType,1
5,1,0,6,mixedType,0
5,6,0,11,mixedType,1
11,4,0,15,mixedType,2
7,3,0,10,mixedType,1
5,4,0,9,mixedType,1
8,1,0,9,mixedType,1
11,3,0,14,mixedType,2
3,7,0,10,mixedType,1
5,3,0,8,mixedType,1
2,6,0,8,mixedType,1
6,6,0,12,mixedType,1
4,9,0,13,mixedType,1
7,2,0,9,mixedType,1
2,4,0,6,mixedType,0
6,3,0,9,mixedType,1
6,3,0,9,mixedType,1
7,4,0,11,mixedType,1
6,3,0,9,mixedType,1
8,2,0,10,mixedType,1
7,6,2,15,mixedType,2
6,2,0,8,mixedType,1
4,4,0,8,mixedType,1
6,3,0,9,mixedType,1
4,9,0,13,mixedType,1
6,4,0,10,mixedType,1
4,4,0,8,mixedType,1
7,1,0,8,mixedType,1
7,2,0,9,mixedType,1
5,2,0,7,mixedType,0
6,2,0,8,mixedType,1
8,2,0,10,mixedType,1
3,9,0,12,mixedType,1
11,5,0,16,mixedType,2
4,7,0,11,mixedType,1
4,2,0,6,mixedType,0
6,2,0,8,mixedType,1
13,3,0,16,mixedType,2
1,10,0,11,mixedType,1
6,2,0,8,mixedType,1
2,4,0,6,mixedType,0
6,6,0,12,mixedType,1
14,2,0,16,mixedType,2
10,1,0,11,mixedType,1
13,3,0,16,mixedType,2
4,8,0,12,mixedType,1
7,3,0,10,mixedType,1
9,2,0,11,mixedType,1
4,4,0,8,mixedType,1
9,1,0,10,mixedType,1
9,3,0,12,mixedType,1
6,3,0,9,mixedType,1
5,4,0,9,mixedType,1
8,1,0,9,mixedType,1
7,3,0,10,mixedType,1
9,2,0,11,mixedType,1
6,1,0,7,mixedType,0
10,3,0,13,mixedType,1
3,6,0,9,mixedType,1
6,2,0,8,mixedType,1
4,8,0,12,mixedType,1
5,3,0,8,mixedType,1
6,6,0,12,mixedType,1
7,2,0,9,mixedType,1
8,2,0,10,mixedType,1
4,4,0,8,mixedType,1
2,6,0,8,mixedType,1
14,2,0,16,mixedType,2
6,4,0,10,mixedType,1
15,2,2,19,mixedType,2
8,7,2,17,mixedType,2
6,2,0,8,mixedType,1
7,2,0,9,mixedType,1
9,3,0,12,mixedType,1
8,2,0,10,mixedType,1
6,4,0,10,mixedType,1
3,6,0,9,mixedType,1
7,3,0,10,mixedType,1
3,7,0,10,mixedType,1
9,1,0,10,mixedType,1
8,1,0,9,mixedType,1
6,3,0,9,mixedType,1
11,1,0,12,mixedType,1
9,1,0,10,mixedType,1
7,3,0,10,mixedType,1
5,3,0,8,mixedType,1
6,4,0,10,mixedType,1
8,1,0,9,mixedType,1
12,1,0,13,mixedType,1
5,6,0,11,mixedType,1
6,2,0,8,mixedType,1
2,6,0,8,mixedType,1
9,2,0,11,mixedType,1
7,1,0,8,mixedType,1
8,2,0,10,mixedType,1
3,6,0,9,mixedType,1
14,2,0,16,mixedType,2
6,1,0,7,mixedType,0
4,4,0,8,mixedType,1
9,1,0,10,mixedType,1
6,3,0,9,mixedType,1
5,2,0,7,mixedType,0
5,2,0,7,mixedType,0
6,2,0,8,mixedType,1
7,3,0,10,mixedType,1
9,1,0,10,mixedType,1
6,4,0,10,mixedType,1
7,1,0,8,mixedType,1
2,7,0,9,mixedType,1
6,3,0,9,mixedType,1
15,1,1,17,mixedType,2
4,6,0,10,mixedType,1
5,3,0,8,mixedType,1
5,2,0,7,mixedType,0
7,2,0,9,mixedType,1
8,1,0,9,mixedType,1
12,0,1,13,mixedType,1
12,4,0,16,mixedType,2
8,1,0,9,mixedType,1
3,6,0,9,mixedType,1
7,2,0,9,mixedType,1
6,4,0,10,mixedType,1
5,2,0,7,mixedType,0
7,3,0,10,mixedType,1
6,3,0,9,mixedType,1
6,2,0,8,mixedType,1
6,3,0,9,mixedType,1
1,8,0,9,mixedType,1
7,3,0,10,mixedType,1
14,2,0,16,mixedType,2
8,4,0,12,mixedType,1
4,4,0,8,mixedType,1
7,1,0,8,mixedType,1
7,2,0,9,mixedType,1
8,1,0,9,mixedType,1
6,4,0,10,mixedType,1
7,4,0,11,mixedType,1
6,3,0,9,mixedType,1
8,2,0,10,mixedType,1
3,6,0,9,mixedType,1
6,1,0,7,mixedType,0
1,9,0,10,mixedType,1
5,3,0,8,mixedType,1
6,2,0,8,mixedType,1
9,2,0,11,mixedType,1
14,2,0,16,mixedType,2
15,1,0,16,mixedType,2
9,3,0,12,mixedType,1
6,1,0,7,mixedType,0
5,2,0,7,mixedType,0
4,6,0,10,mixedType,1
1,8,0,9,mixedType,1
6,4,0,10,mixedType,1
3,5,0,8,mixedType,1
5,3,0,8,mixedType,1
6,6,0,12,mixedType,1
2,6,0,8,mixedType,1
11,1,0,12,mixedType,1
1,8,0,9,mixedType,1
13,3,0,16,mixedType,2
4,4,0,8,mixedType,1
8,3,0,11,mixedType,1
14,2,0,16,mixedType,2
6,5,0,11,mixedType,1
8,2,0,10,mixedType,1
8,1,0,9,mixedType,1
14,1,1,16,mixedType,2
7,3,0,10,mixedType,1
6,3,0,9,mixedType,1
7,3,0,10,mixedType,1
4,6,0,10,mixedType,1
4,5,0,9,mixedType,1
4,4,0,8,mixedType,1
5,2,0,7,mixedType,0
11,2,0,13,mixedType,1
1,7,0,8,mixedType,1
4,10,0,14,mixedType,2
7,3,0,10,mixedType,1
4,2,0,6,mixedType,0
6,3,0,9,mixedType,1
4,7,0,11,mixedType,1
6,3,0,9,mixedType,1
5,5,0,10,mixedType,1
2,6,0,8,mixedType,1
6,1,0,7,mixedType,0
6,1,0,7,mixedType,0
5,3,0,8,mixedType,1
12,4,0,16,mixedType,2
6,1,0,7,mixedType,0
7,2,0,9,mixedType,1
1,11,0,12,mixedType,1
9,1,0,10,mixedType,1
1,7,0,8,mixedType,1
6,4,0,10,mixedType,1
10,3,0,13,mixedType,1
14,2,0,16,mixedType,2
7,4,0,11,mixedType,1
9,4,0,13,mixedType,1
8,4,0,12,mixedType,1
7,4,0,11,mixedType,1
6,1,0,7,mixedType,0
5,3,0,8,mixedType,1
7,3,0,10,mixedType,1
5,2,0,7,mixedType,0
10,3,0,13,mixedType,1
4,2,0,6,mixedType,0
7,2,0,9,mixedType,1
4,4,0,8,mixedType,1
6,3,0,9,mixedType,1
4,2,0,6,mixedType,0
7,2,0,9,mixedType,1
8,4,0,12,mixedType,1
5,7,0,12,mixedType,1
2,6,0,8,mixedType,1
8,3,0,11,mixedType,1
5,4,0,9,mixedType,1
5,2,0,7,mixedType,0
6,2,0,8,mixedType,1
4,2,0,6,mixedType,0
1,7,0,8,mixedType,1
3,7,0,10,mixedType,1
11,2,0,13,mixedType,1
6,4,0,10,mixedType,1
5,4,0,9,mixedType,1
3,5,0,8,mixedType,1
6,4,0,10,mixedType,1
5,3,0,8,mixedType,1
8,1,0,9,mixedType,1
7,3,0,10,mixedType,1
8,4,0,12,mixedType,1
15,1,0,16,mixedType,2
9,1,0,10,mixedType,1
5,3,0,8,mixedType,1
5,3,0,8,mixedType,1
6,2,0,8,mixedType,1
5,5,0,10,mixedType,1
6,2,0,8,mixedType,1
15,1,0,16,mixedType,2
6,1,0,7,mixedType,0
7,4,0,11,mixedType,1
4,2,0,6,mixedType,0
7,1,0,8,mixedType,1
4,4,0,8,mixedType,1
5,4,0,9,mixedType,1
8,8,1,17,mixedType,2
13,2,1,16,mixedType,2
9,1,0,10,mixedType,1
4,4,0,8,mixedType,1
8,1,0,9,mixedType,1
5,4,0,9,mixedType,1
1,8,0,9,mixedType,1
7,1,0,8,mixedType,1
8,2,0,10,mixedType,1
6,4,0,10,mixedType,1
8,2,0,10,mixedType,1
8,1,0,9,mixedType,1
5,2,0,7,mixedType,0
12,4,0,16,mixedType,2
9,0,1,10,mixedType,1
1,7,0,8,mixedType,1
7,3,0,10,mixedType,1
14,1,1,16,mixedType,2
6,2,0,8,mixedType,1
4,4,0,8,mixedType,1
11,1,0,12,mixedType,1
8,3,0,11,mixedType,1
5,2,0,7,mixedType,0
8,1,0,9,mixedType,1
6,2,0,8,mixedType,1
6,2,0,8,mixedType,1
8,4,0,12,mixedType,1
8,2,0,10,mixedType,1
12,4,0,16,mixedType,2
3,6,0,9,mixedType,1
11,2,0,13,mixedType,1
9,2,0,11,mixedType,1
5,4,0,9,mixedType,1
3,7,0,10,mixedType,1
8,1,0,9,mixedType,1
4,4,0,8,mixedType,1
7,2,0,9,mixedType,1
4,4,0,8,mixedType,1
2,8,0,10,mixedType,1
4,6,0,10,mixedType,1
8,2,0,10,mixedType,1
15,1,0,16,mixedType,2
3,8,0,11,mixedType,1
9,4,0,13,mixedType,1
12,4,0,16,mixedType,2
1,9,0,10,mixedType,1
6,1,0,7,mixedType,0
8,4,0,12,mixedType,1
4,2,0,6,mixedType,0
5,5,0,10,mixedType,1
8,2,0,10,mixedType,1
4,2,0,6,mixedType,0
5,3,0,8,mixedType,1
8,1,0,9,mixedType,1
13,3,0,16,mixedType,2
5,2,0,7,mixedType,0
8,3,0,11,mixedType,1
1,8,0,9,mixedType,1
6,1,0,7,mixedType,0
8,3,0,11,mixedType,1
6,3,0,9,mixedType,1
6,3,0,9,mixedType,1
6,4,0,10,mixedType,1
5,3,0,8,mixedType,1
4,2,0,6,mixedType,0
6,3,0,9,mixedType,1
7,1,0,8,mixedType,1
8,4,0,12,mixedType,1
7,3,0,10,mixedType,1
9,1,0,10,mixedType,1
5,2,0,7,mixedType,0
4,6,0,10,mixedType,1
5,6,0,11,mixedType,1
12,4,0,16,mixedType,2
6,3,0,9,mixedType,1
7,3,0,10,mixedType,1
4,5,0,9,mixedType,1
11,0,1,12,mixedType,1
5,3,0,8,mixedType,1
5,2,0,7,mixedType,0
7,3,0,10,mixedType,1
3,7,0,10,mixedType,1
7,2,0,9,mixedType,1
6,2,0,8,mixedType,1
6,3,0,9,mixedType,1
8,5,0,13,mixedType,1
7,3,0,10,mixedType,1
4,4,0,8,mixedType,1
4,4,0,8,mixedType,1
6,3,0,9,mixedType,1
5,4,0,9,mixedType,1
13,3,0,16,mixedType,2
4,5,0,9,mixedType,1
8,2,0,10,mixedType,1
10,2,0,12,mixedType,1
3,8,0,11,mixedType,1
8,1,0,9,mixedType,1
11,5,0,16,mixedType,2
15,1,0,16,mixedType,2
9,1,0,10,mixedType,1
1,7,0,8,mixedType,1
6,1,0,7,mixedType,0
5,8,0,13,mixedType,1
7,2,0,9,mixedType,1
3,9,0,12,mixedType,1
3,6,0,9,mixedType,1
7,3,0,10,mixedType,1
12,4,0,16,mixedType,2
1,12,0,13,mixedType,1
3,5,0,8,mixedType,1
6,3,0,9,mixedType,1
8,1,0,9,mixedType,1
7,1,0,8,mixedType,1
6,2,0,8,mixedType,1
2,4,0,6,mixedType,0
6,1,0,7,mixedType,0
12,4,0,16,mixedType,2
7,1,0,8,mixedType,1
5,3,0,8,mixedType,1
8,3,0,11,mixedType,1
6,6,0,12,mixedType,1
6,4,0,10,mixedType,1
6,6,0,12,mixedType,1
7,1,0,8,mixedType,1
6,2,0,8,mixedType,1
14,2,0,16,mixedType,2
12,4,0,16,mixedType,2
14,2,0,16,mixedType,2
7,2,0,9,mixedType,1
6,2,0,8,mixedType,1
8,1,0,9,mixedType,1
6,3,0,9,mixedType,1
6,1,0,7,mixedType,0
12,4,0,16,mixedType,2
8,4,0,12,mixedType,1
5,4,0,9,mixedType,1
5,2,0,7,mixedType,0
7,5,0,12,mixedType,1
9,1,0,10,mixedType,1
5,3,0,8,mixedType,1
9,4,0,13,mixedType,1
4,6,0,10,mixedType,1
8,1,0,9,mixedType,1
2,4,0,6,mixedType,0
0,4,0,4,sameType,0
5,4,0,9,mixedType,1
8,0,1,9,mixedType,1
10,2,0,12,mixedType,1
6,2,0,8,mixedType,1
9,2,0,11,mixedType,1
4,4,0,8,mixedType,1
6,3,0,9,mixedType,1
3,3,0,6,mixedType,0
2,6,0,8,mixedType,1
6,1,0,7,mixedType,0
4,4,0,8,mixedType,1
5,4,0,9,mixedType,1
9,2,0,11,mixedType,1
8,2,0,10,mixedType,1
2,8,0,10,mixedType,1
3,6,0,9,mixedType,1
9,2,0,11,mixedType,1
12,4,0,16,mixedType,2
12,3,0,15,mixedType,2
7,3,0,10,mixedType,1
7,2,0,9,mixedType,1
7,2,0,9,mixedType,1
7,1,0,8,mixedType,1
9,1,0,10,mixedType,1
5,6,0,11,mixedType,1
5,1,0,6,mixedType,0
4,4,0,8,mixedType,1
5,6,0,11,mixedType,1
7,2,0,9,mixedType,1
7,4,0,11,mixedType,1
9,3,0,12,mixedType,1
12,1,0,13,mixedType,1
8,1,0,9,mixedType,1
6,1,0,7,mixedType,0
15,1,0,16,mixedType,2
2,6,0,8,mixedType,1
6,2,0,8,mixedType,1
8,2,0,10,mixedType,1
4,2,0,6,mixedType,0
8,4,0,12,mixedType,1
6,6,0,12,mixedType,1
6,4,0,10,mixedType,1
6,2,0,8,mixedType,1
7,3,0,10,mixedType,1
5,2,0,7,mixedType,0
7,3,0,10,mixedType,1
15,1,0,16,mixedType,2
8,3,0,11,mixedType,1
8,1,0,9,mixedType,1
8,4,0,12,mixedType,1
6,3,0,9,mixedType,1
3,10,0,13,mixedType,1
5,3,0,8,mixedType,1
6,2,0,8,mixedType,1
6,2,0,8,mixedType,1
1,9,0,10,mixedType,1
5,5,0,10,mixedType,1
9,1,0,10,mixedType,1
5,4,0,9,mixedType,1
6,2,0,8,mixedType,1
6,3,0,9,mixedType,1
6,3,0,9,mixedType,1
6,2,0,8,mixedType,1
14,2,0,16,mixedType,2
9,1,0,10,mixedType,1
7,2,0,9,mixedType,1
7,2,0,9,mixedType,1
2,9,0,11,mixedType,1
4,7,0,11,mixedType,1
11,2,1,14,mixedType,2
8,4,0,12,mixedType,1
7,2,0,9,mixedType,1
7,3,0,10,mixedType,1
2,7,0,9,mixedType,1
11,2,0,13,mixedType,1
5,5,0,10,mixedType,1
6,4,0,10,mixedType,1
6,2,0,8,mixedType,1
7,2,0,9,mixedType,1
3,8,0,11,mixedType,1
10,1,0,11,mixedType,1
7,6,0,13,mixedType,1
7,3,0,10,mixedType,1
6,3,0,9,mixedType,1
10,2,0,12,mixedType,1
6,2,0,8,mixedType,1
6,1,0,7,mixedType,0
6,2,0,8,mixedType,1
6,4,0,10,mixedType,1
8,6,0,14,mixedType,2
3,6,0,9,mixedType,1
4,2,0,6,mixedType,0
5,2,0,7,mixedType,0
6,3,0,9,mixedType,1
13,3,0,16,mixedType,2
12,3,0,15,mixedType,2
9,1,0,10,mixedType,1
7,4,0,11,mixedType,1
1,6,0,7,mixedType,0
5,3,0,8,mixedType,1
7,3,0,10,mixedType,1
8,1,0,9,mixedType,1
6,3,0,9,mixedType,1
8,4,0,12,mixedType,1
3,6,0,9,mixedType,1
7,1,0,8,mixedType,1
6,3,0,9,mixedType,1
4,4,0,8,mixedType,1
7,2,0,9,mixedType,1
1,8,0,9,mixedType,1
8,1,0,9,mixedType,1
13,2,1,16,mixedType,2
4,4,0,8,mixedType,1
8,2,0,10,mixedType,1
14,2,0,16,mixedType,2
5,3,0,8,mixedType,1
11,3,0,14,mixedType,2
6,3,0,9,mixedType,1
9,1,0,10,mixedType,1
12,3,0,15,mixedType,2
5,2,0,7,mixedType,0
5,3,0,8,mixedType,1
9,1,0,10,mixedType,1
5,2,0,7,mixedType,0
6,1,0,7,mixedType,0
15,1,0,16,mixedType,2
8,1,0,9,mixedType,1
6,1,0,7,mixedType,0
6,1,0,7,mixedType,0
6,1,0,7,mixedType,0
9,1,0,10,mixedType,1
7,9,0,16,mixedType,2
6,1,0,7,mixedType,0
5,3,0,8,mixedType,1
3,3,0,6,mixedType,0
10,3,1,14,mixedType,2
6,4,0,10,mixedType,1
7,1,0,8,mixedType,1
13,3,0,16,mixedType,2
6,2,0,8,mixedType,1
6,4,0,10,mixedType,1
8,2,0,10,mixedType,1
4,2,0,6,mixedType,0
6,3,0,9,mixedType,1
8,2,0,10,mixedType,1
5,2,0,7,mixedType,0
13,3,0,16,mixedType,2
8,1,0,9,mixedType,1
4,4,0,8,mixedType,1
15,1,0,16,mixedType,2
7,2,0,9,mixedType,1
6,7,0,13,mixedType,1
7,1,0,8,mixedType,1
6,3,0,9,mixedType,1
14,2,0,16,mixedType,2
2,8,0,10,mixedType,1
9,2,0,11,mixedType,1
7,3,0,10,mixedType,1
8,2,0,10,mixedType,1
12,4,0,16,mixedType,2
8,2,0,10,mixedType,1
5,2,0,7,mixedType,0
4,6,0,10,mixedType,1
3,7,0,10,mixedType,1
5,2,0,7,mixedType,0
6,3,0,9,mixedType,1
2,7,0,9,mixedType,1
5,2,0,7,mixedType,0
7,2,0,9,mixedType,1
9,3,0,12,mixedType,1
3,7,0,10,mixedType,1
7,3,0,10,mixedType,1
5,6,0,11,mixedType,1
5,3,0,8,mixedType,1
6,2,0,8,mixedType,1
1,11,0,12,mixedType,1
3,6,0,9,mixedType,1
6,3,0,9,mixedType,1
8,1,0,9,mixedType,1
8,2,0,10,mixedType,1
7,2,0,9,mixedType,1
6,2,0,8,mixedType,1
5,3,0,8,mixedType,1
6,4,0,10,mixedType,1
5,4,0,9,mixedType,1
12,4,0,16,mixedType,2
6,3,0,9,mixedType,1
12,3,0,15,mixedType,2
5,2,0,7,mixedType,0
11,2,0,13,mixedType,1
14,2,0,16,mixedType,2
6,2,0,8,mixedType,1
7,3,0,10,mixedType,1
5,4,0,9,mixedType,1
3,7,0,10,mixedType,1
8,1,0,9,mixedType,1
2,8,0,10,mixedType,1
5,2,0,7,mixedType,0
6,3,0,9,mixedType,1
7,3,0,10,mixedType,1
2,7,0,9,mixedType,1
7,3,0,10,mixedType,1
9,5,1,15,mixedType,2
7,1,0,8,mixedType,1
3,6,0,9,mixedType,1
8,4,0,12,mixedType,1
5,2,1,8,mixedType,1
5,2,0,7,mixedType,0
6,1,0,7,mixedType,0
4,4,0,8,mixedType,1
6,2,0,8,mixedType,1
7,3,0,10,mixedType,1
10,1,0,11,mixedType,1
10,2,0,12,mixedType,1
12,3,0,15,mixedType,2
4,4,0,8,mixedType,1
1,7,0,8,mixedType,1
8,2,0,10,mixedType,1
5,3,0,8,mixedType,1
0,5,4,9,mixedType,1
6,2,0,8,mixedType,1
7,3,0,10,mixedType,1
6,1,0,7,mixedType,0
7,2,0,9,mixedType,1
3,6,0,9,mixedType,1
13,3,0,16,mixedType,2
6,3,0,9,mixedType,1
7,3,0,10,mixedType,1
7,1,0,8,mixedType,1
3,7,0,10,mixedType,1
5,2,0,7,mixedType,0
5,2,0,7,mixedType,0
4,4,0,8,mixedType,1
10,2,0,12,mixedType,1
4,4,0,8,mixedType,1
5,2,0,7,mixedType,0
8,2,0,10,mixedType,1
14,2,0,16,mixedType,2
2,4,0,6,mixedType,0
11,2,0,13,mixedType,1
7,4,0,11,mixedType,1
0,9,0,9,sameType,1
3,5,0,8,mixedType,1
5,4,0,9,mixedType,1
11,3,0,14,mixedType,2
5,3,0,8,mixedType,1
6,4,0,10,mixedType,1
9,3,0,12,mixedType,1
4,6,0,10,mixedType,1
6,4,0,10,mixedType,1
6,1,0,7,mixedType,0
6,2,0,8,mixedType,1
6,4,0,10,mixedType,1
5,4,0,9,mixedType,1
9,8,0,17,mixedType,2
4,2,0,6,mixedType,0
8,1,0,9,mixedType,1
7,2,0,9,mixedType,1
1,8,0,9,mixedType,1
11,1,0,12,mixedType,1
12,3,0,15,mixedType,2
9,2,0,11,mixedType,1
6,2,0,8,mixedType,1
14,2,0,16,mixedType,2
6,1,0,7,mixedType,0
6,3,0,9,mixedType,1
9,4,0,13,mixedType,1
5,2,0,7,mixedType,0
2,6,0,8,mixedType,1
7,1,0,8,mixedType,1
12,3,0,15,mixedType,2
6,2,0,8,mixedType,1
12,4,0,16,mixedType,2
6,4,0,10,mixedType,1
4,2,0,6,mixedType,0
11,5,0,16,mixedType,2
1,7,0,8,mixedType,1
15,1,0,16,mixedType,2
5,8,0,13,mixedType,1
13,3,0,16,mixedType,2
12,3,0,15,mixedType,2
4,2,0,6,mixedType,0
6,3,0,9,mixedType,1
7,3,0,10,mixedType,1
7,2,0,9,mixedType,1
5,3,0,8,mixedType,1
7,2,0,9,mixedType,1
8,4,0,12,mixedType,1
7,3,0,10,mixedType,1
5,3,0,8,mixedType,1
2,8,0,10,mixedType,1
6,4,0,10,mixedType,1
7,4,0,11,mixedType,1
2,6,0,8,mixedType,1
6,2,0,8,mixedType,1
6,4,0,10,mixedType,1
9,3,0,12,mixedType,1
6,3,0,9,mixedType,1
9,1,0,10,mixedType,1
6,3,0,9,mixedType,1
4,5,0,9,mixedType,1
7,1,0,8,mixedType,1
8,2,0,10,mixedType,1
6,2,0,8,mixedType,1
5,3,0,8,mixedType,1
15,1,0,16,mixedType,2
3,6,0,9,mixedType,1
12,4,0,16,mixedType,2
9,3,0,12,mixedType,1
6,3,0,9,mixedType,1
6,6,0,12,mixedType,1
5,3,0,8,mixedType,1
6,1,0,7,mixedType,0
6,2,0,8,mixedType,1
7,2,0,9,mixedType,1
4,6,0,10,mixedType,1
8,1,0,9,mixedType,1
10,4,1,15,mixedType,2
4,5,0,9,mixedType,1
6,3,0,9,mixedType,1
4,4,0,8,mixedType,1
2,6,0,8,mixedType,1
7,4,0,11,mixedType,1
6,6,0,12,mixedType,1
4,4,0,8,mixedType,1
7,1,0,8,mixedType,1
14,1,0,15,mixedType,2
7,4,0,11,mixedType,1
7,3,0,10,mixedType,1
1,8,0,9,mixedType,1
13,3,0,16,mixedType,2
12,1,0,13,mixedType,1
10,2,0,12,mixedType,1
5,4,0,9,mixedType,1
8,1,0,9,mixedType,1
7,4,0,11,mixedType,1
7,5,0,12,mixedType,1
6,3,0,9,mixedType,1
5,4,0,9,mixedType,1
7,3,0,10,mixedType,1
8,2,0,10,mixedType,1
7,5,0,12,mixedType,1
6,2,0,8,mixedType,1
8,2,0,10,mixedType,1
8,2,0,10,mixedType,1
6,0,1,7,mixedType,0
8,3,0,11,mixedType,1
6,1,0,7,mixedType,0
3,5,0,8,mixedType,1
7,2,0,9,mixedType,1
8,2,0,10,mixedType,1
4,2,0,6,mixedType,0
10,2,0,12,mixedType,1
5,2,0,7,mixedType,0
7,1,0,8,mixedType,1
10,1,0,11,mixedType,1
14,2,0,16,mixedType,2
7,3,0,10,mixedType,1
4,4,0,8,mixedType,1
4,2,0,6,mixedType,0
7,3,0,10,mixedType,1
1,9,0,10,mixedType,1
0,4,3,7,mixedType,0
5,4,0,9,mixedType,1
5,4,0,9,mixedType,1
3,3,0,6,mixedType,0
5,3,0,8,mixedType,1
1,7,0,8,mixedType,1
6,2,0,8,mixedType,1
6,3,0,9,mixedType,1
3,8,0,11,mixedType,1
9,1,0,10,mixedType,1
6,3,0,9,mixedType,1
1,8,0,9,mixedType,1
2,6,0,8,mixedType,1
5,2,0,7,mixedType,0
9,2,0,11,mixedType,1
6,3,0,9,mixedType,1
5,8,0,13,mixedType,1
6,1,0,7,mixedType,0
9,1,0,10,mixedType,1
5,1,0,6,mixedType,0
7,2,0,9,mixedType,1
11,5,0,16,mixedType,2
6,2,0,8,mixedType,1
7,6,0,13,mixedType,1
2,6,0,8,mixedType,1
11,5,0,16,mixedType,2
7,2,0,9,mixedType,1
9,3,0,12,mixedType,1
7,1,0,8,mixedType,1
5,5,0,10,mixedType,1
7,1,0,8,mixedType,1
6,4,0,10,mixedType,1
7,3,0,10,mixedType,1
10,2,0,12,mixedType,1
7,3,0,10,mixedType,1
15,1,0,16,mixedType,2
7,1,0,8,mixedType,1
8,2,0,10,mixedType,1
6,3,0,9,mixedType,1
3,3,0,6,mixedType,0
9,2,0,11,mixedType,1
10,2,0,12,mixedType,1
4,2,0,6,mixedType,0
1,9,0,10,mixedType,1
7,3,0,10,mixedType,1
2,6,0,8,mixedType,1
6,7,0,13,mixedType,1
12,1,0,13,mixedType,1
4,5,0,9,mixedType,1
5,5,0,10,mixedType,1
5,4,0,9,mixedType,1
6,2,0,8,mixedType,1
9,8,0,17,mixedType,2
3,6,0,9,mixedType,1
7,2,0,9,mixedType,1
6,3,0,9,mixedType,1
12,3,0,15,mixedType,2
8,3,0,11,mixedType,1
2,8,0,10,mixedType,1
8,2,0,10,mixedType,1
8,1,0,9,mixedType,1
9,2,0,11,mixedType,1
14,2,0,16,mixedType,2
6,4,0,10,mixedType,1
7,4,0,11,mixedType,1
3,6,0,9,mixedType,1
6,3,0,9,mixedType,1
7,1,0,8,mixedType,1
7,3,0,10,mixedType,1
4,4,0,8,mixedType,1
7,1,0,8,mixedType,1
4,4,0,8,mixedType,1
6,3,0,9,mixedType,1
7,6,0,13,mixedType,1
8,1,0,9,mixedType,1
5,4,0,9,mixedType,1
7,2,0,9,mixedType,1
11,5,0,16,mixedType,2
6,1,0,7,mixedType,0
6,6,0,12,mixedType,1
4,9,0,13,mixedType,1
6,3,0,9,mixedType,1
7,3,0,10,mixedType,1
4,2,0,6,mixedType,0
14,2,0,16,mixedType,2
6,4,0,10,mixedType,1
7,2,0,9,mixedType,1
5,2,0,7,mixedType,0
9,3,0,12,mixedType,1
4,6,0,10,mixedType,1
8,1,0,9,mixedType,1
4,4,0,8,mixedType,1
15,1,0,16,mixedType,2
7,2,0,9,mixedType,1
14,2,0,16,mixedType,2
5,3,0,8,mixedType,1
6,2,0,8,mixedType,1
2,4,0,6,mixedType,0
5,3,0,8,mixedType,1
6,3,0,9,mixedType,1
15,1,0,16,mixedType,2
6,1,0,7,mixedType,0
1,8,0,9,mixedType,1
11,1,0,12,mixedType,1
5,3,0,8,mixedType,1
15,1,0,16,mixedType,2
14,2,0,16,mixedType,2
7,1,0,8,mixedType,1
13,3,0,16,mixedType,2
5,3,0,8,mixedType,1
6,1,0,7,mixedType,0
5,3,0,8,mixedType,1
5,2,0,7,mixedType,0
3,7,0,10,mixedType,1
5,3,0,8,mixedType,1
10,2,0,12,mixedType,1
6,2,0,8,mixedType,1
3,6,0,9,mixedType,1
1,11,0,12,mixedType,1
6,6,0,12,mixedType,1
2,6,0,8,mixedType,1
5,2,0,7,mixedType,0
12,3,0,15,mixedType,2
9,1,0,10,mixedType,1
8,2,0,10,mixedType,1
4,2,0,6,mixedType,0
7,1,0,8,mixedType,1
3,7,0,10,mixedType,1
5,3,0,8,mixedType,1
7,2,0,9,mixedType,1
5,3,0,8,mixedType,1
6,2,0,8,mixedType,1
4,4,0,8,mixedType,1
8,2,0,10,mixedType,1
8,3,0,11,mixedType,1
6,3,0,9,mixedType,1
8,2,0,10,mixedType,1
5,2,0,7,mixedType,0
5,4,0,9,mixedType,1
6,3,0,9,mixedType,1
5,2,0,7,mixedType,0
11,3,0,14,mixedType,2
3,7,0,10,mixedType,1
14,2,0,16,mixedType,2
11,1,0,12,mixedType,1
5,2,0,7,mixedType,0
11,2,0,13,mixedType,1
6,4,0,10,mixedType,1
6,3,0,9,mixedType,1
6,3,0,9,mixedType,1
5,0,0,5,sameType,0
5,2,0,7,mixedType,0
5,1,0,6,mixedType,0
1,9,0,10,mixedType,1
7,2,0,9,mixedType,1
8,1,0,9,mixedType,1
1,8,0,9,mixedType,1
1,10,0,11,mixedType,1
5,4,0,9,mixedType,1
1,9,0,10,mixedType,1
6,3,0,9,mixedType,1
13,3,0,16,mixedType,2
2,6,0,8,mixedType,1
5,4,0,9,mixedType,1
4,2,0,6,mixedType,0
5,1,0,6,mixedType,0
6,3,0,9,mixedType,1
8,4,0,12,mixedType,1
6,4,0,10,mixedType,1
7,2,0,9,mixedType,1
11,2,0,13,mixedType,1
7,10,0,17,mixedType,2
8,1,0,9,mixedType,1
2,7,0,9,mixedType,1
7,2,0,9,mixedType,1
8,1,0,9,mixedType,1
7,6,0,13,mixedType,1
5,4,0,9,mixedType,1
6,2,0,8,mixedType,1
4,2,0,6,mixedType,0
14,2,0,16,mixedType,2
6,1,0,7,mixedType,0
10,4,0,14,mixedType,2
5,4,0,9,mixedType,1
5,7,0,12,mixedType,1
6,5,0,11,mixedType,1
4,2,0,6,mixedType,0
4,4,0,8,mixedType,1
7,2,0,9,mixedType,1
5,3,0,8,mixedType,1
6,3,0,9,mixedType,1
6,1,0,7,mixedType,0
5,2,0,7,mixedType,0
6,2,0,8,mixedType,1
7,4,0,11,mixedType,1
6,2,0,8,mixedType,1
10,2,0,12,mixedType,1
5,4,0,9,mixedType,1
8,2,0,10,mixedType,1
6,2,0,8,mixedType,1
6,2,0,8,mixedType,1
9,4,0,13,mixedType,1
6,1,0,7,mixedType,0
3,7,0,10,mixedType,1
13,3,0,16,mixedType,2
5,6,0,11,mixedType,1
6,4,0,10,mixedType,1
6,2,0,8,mixedType,1
3,7,0,10,mixedType,1
8,3,0,11,mixedType,1
6,4,0,10,mixedType,1
6,2,0,8,mixedType,1
6,3,0,9,mixedType,1
1,8,0,9,mixedType,1
6,3,0,9,mixedType,1
9,3,0,12,mixedType,1
14,2,0,16,mixedType,2
8,2,0,10,mixedType,1
6,2,0,8,mixedType,1
7,3,0,10,mixedType,1
3,4,0,7,mixedType,0
9,2,0,11,mixedType,1
6,2,0,8,mixedType,1
9,4,0,13,mixedType,1
5,3,0,8,mixedType,1
7,1,0,8,mixedType,1
9,2,0,11,mixedType,1
7,3,0,10,mixedType,1
8,1,0,9,mixedType,1
2,6,0,8,mixedType,1
7,3,0,10,mixedType,1
4,4,0,8,mixedType,1
11,5,0,16,mixedType,2
5,1,0,6,mixedType,0
6,3,0,9,mixedType,1
7,1,0,8,mixedType,1
8,1,0,9,mixedType,1
9,1,0,10,mixedType,1
5,1,0,6,mixedType,0
7,2,0,9,mixedType,1
1,12,0,13,mixedType,1
11,2,0,13,mixedType,1
9,1,0,10,mixedType,1
14,2,0,16,mixedType,2
6,4,0,10,mixedType,1
15,1,0,16,mixedType,2
5,3,0,8,mixedType,1
5,3,0,8,mixedType,1
12,4,0,16,mixedType,2
4,4,0,8,mixedType,1
7,2,0,9,mixedType,1
11,2,1,14,mixedType,2
8,1,0,9,mixedType,1
5,3,0,8,mixedType,1
7,2,0,9,mixedType,1
5,3,0,8,mixedType,1
14,2,0,16,mixedType,2
5,3,0,8,mixedType,1
6,1,0,7,mixedType,0
5,3,0,8,mixedType,1
9,3,0,12,mixedType,1
6,2,0,8,mixedType,1
5,4,0,9,mixedType,1
5,4,0,9,mixedType,1
5,4,0,9,mixedType,1
6,3,0,9,mixedType,1
8,1,0,9,mixedType,1
5,1,0,6,mixedType,0
6,4,0,10,mixedType,1
6,3,0,9,mixedType,1
7,3,0,10,mixedType,1
8,3,0,11,mixedType,1
8,2,0,10,mixedType,1
2,8,0,10,mixedType,1
11,5,0,16,mixedType,2
5,4,0,9,mixedType,1
5,2,0,7,mixedType,0
7,2,0,9,mixedType,1
5,5,0,10,mixedType,1
5,2,0,7,mixedType,0
7,1,0,8,mixedType,1
5,2,0,7,mixedType,0
3,6,0,9,mixedType,1
14,2,0,16,mixedType,2
5,4,0,9,mixedType,1
5,4,0,9,mixedType,1
1,8,0,9,mixedType,1
9,2,0,11,mixedType,1
4,2,0,6,mixedType,0
5,4,0,9,mixedType,1
4,2,0,6,mixedType,0
4,5,0,9,mixedType,1
7,2,0,9,mixedType,1
5,2,0,7,mixedType,0
15,1,0,16,mixedType,2
7,1,0,8,mixedType,1
6,3,0,9,mixedType,1
4,4,0,8,mixedType,1
8,1,0,9,mixedType,1
7,3,0,10,mixedType,1
6,3,0,9,mixedType,1
8,1,0,9,mixedType,1
9,4,0,13,mixedType,1
6,4,0,10,mixedType,1
6,3,0,9,mixedType,1
12,3,0,15,mixedType,2
6,4,0,10,mixedType,1
6,3,0,9,mixedType,1
7,3,0,10,mixedType,1
7,1,0,8,mixedType,1
7,2,0,9,mixedType,1
6,4,0,10,mixedType,1
15,1,0,16,mixedType,2
3,7,0,10,mixedType,1
10,1,0,11,mixedType,1
5,3,0,8,mixedType,1
5,1,0,6,mixedType,0
5,4,0,9,mixedType,1
11,1,0,12,mixedType,1
15,1,0,16,mixedType,2
8,1,0,9,mixedType,1
2,8,0,10,mixedType,1
7,3,0,10,mixedType,1
1,8,0,9,mixedType,1
8,4,0,12,mixedType,1
11,5,0,16,mixedType,2
7,2,0,9,mixedType,1
3,5,0,8,mixedType,1
6,2,0,8,mixedType,1
12,4,0,16,mixedType,2
7,1,0,8,mixedType,1
3,8,0,11,mixedType,1
6,3,0,9,mixedType,1
7,2,0,9,mixedType,1
3,7,0,10,mixedType,1
7,3,0,10,mixedType,1
5,5,0,10,mixedType,1
5,3,0,8,mixedType,1
4,6,0,10,mixedType,1
3,6,0,9,mixedType,1
4,8,0,12,mixedType,1
7,1,0,8,mixedType,1
7,3,0,10,mixedType,1
5,3,0,8,mixedType,1
6,3,0,9,mixedType,1
13,3,0,16,mixedType,2
8,3,0,11,mixedType,1
6,2,0,8,mixedType,1
9,1,0,10,mixedType,1
5,3,0,8,mixedType,1
2,6,0,8,mixedType,1
5,3,0,8,mixedType,1
7,3,0,10,mixedType,1
9,4,0,13,mixedType,1
2,4,0,6,mixedType,0
4,4,0,8,mixedType,1
6,3,0,9,mixedType,1
5,3,0,8,mixedType,1
5,1,0,6,mixedType,0
5,3,0,8,mixedType,1
8,2,0,10,mixedType,1
7,4,0,11,mixedType,1
7,3,0,10,mixedType,1
6,1,0,7,mixedType,0
3,6,0,9,mixedType,1
7,2,0,9,mixedType,1
17,2,2,21,mixedType,2
7,2,0,9,mixedType,1
3,3,0,6,mixedType,0
4,2,0,6,mixedType,0
7,1,0,8,mixedType,1
8,4,0,12,mixedType,1
5,2,0,7,mixedType,0
6,3,0,9,mixedType,1
7,3,0,10,mixedType,1
8,2,0,10,mixedType,1
4,5,0,9,mixedType,1
7,4,0,11,mixedType,1
2,6,0,8,mixedType,1
8,4,0,12,mixedType,1
6,3,0,9,mixedType,1
4,4,0,8,mixedType,1
12,3,0,15,mixedType,2
9,2,0,11,mixedType,1
5,4,0,9,mixedType,1
10,2,0,12,mixedType,1
7,1,0,8,mixedType,1
7,2,0,9,mixedType,1
6,4,0,10,mixedType,1
3,6,0,9,mixedType,1
2,6,0,8,mixedType,1
6,3,0,9,mixedType,1
5,2,0,7,mixedType,0
6,3,0,9,mixedType,1
5,3,0,8,mixedType,1
9,4,0,13,mixedType,1
12,4,0,16,mixedType,2
7,3,0,10,mixedType,1
5,5,0,10,mixedType,1
5,3,0,8,mixedType,1
3,3,0,6,mixedType,0
8,1,0,9,mixedType,1
7,3,0,10,mixedType,1
5,4,0,9,mixedType,1
7,4,0,11,mixedType,1
8,3,0,11,mixedType,1
11,3,0,14,mixedType,2
8,2,0,10,mixedType,1
6,3,0,9,mixedType,1
7,2,0,9,mixedType,1
7,1,0,8,mixedType,1
7,3,0,10,mixedType,1
5,1,0,6,mixedType,0
6,4,0,10,mixedType,1
6,3,0,9,mixedType,1
5,3,0,8,mixedType,1
6,4,0,10,mixedType,1
11,2,2,15,mixedType,2
7,3,0,10,mixedType,1
6,3,0,9,mixedType,1
6,2,0,8,mixedType,1
8,1,0,9,mixedType,1
5,3,0,8,mixedType,1
5,2,0,7,mixedType,0
7,3,0,10,mixedType,1
7,2,0,9,mixedType,1
9,3,0,12,mixedType,1
8,0,1,9,mixedType,1
5,0,1,6,mixedType,0
11,3,0,14,mixedType,2
8,3,0,11,mixedType,1
8,2,0,10,mixedType,1
5,2,0,7,mixedType,0
6,3,0,9,mixedType,1
2,6,0,8,mixedType,1
6,3,0,9,mixedType,1
6,2,0,8,mixedType,1
4,2,0,6,mixedType,0
5,3,0,8,mixedType,1
5,2,0,7,mixedType,0
5,3,0,8,mixedType,1
6,4,0,10,mixedType,1
4,4,0,8,mixedType,1
6,3,0,9,mixedType,1
9,2,0,11,mixedType,1
7,2,0,9,mixedType,1
6,2,0,8,mixedType,1
9,2,0,11,mixedType,1
8,1,0,9,mixedType,1
2,7,0,9,mixedType,1
6,1,0,7,mixedType,0
5,6,0,11,mixedType,1
9,1,0,10,mixedType,1
7,6,0,13,mixedType,1
5,8,0,13,mixedType,1
8,2,0,10,mixedType,1
6,2,0,8,mixedType,1
2,8,0,10,mixedType,1
8,2,0,10,mixedType,1
9,4,0,13,mixedType,1
6,5,0,11,mixedType,1
1,7,0,8,mixedType,1
5,3,0,8,mixedType,1
7,2,0,9,mixedType,1
6,2,0,8,mixedType,1
11,5,0,16,mixedType,2
3,5,0,8,mixedType,1
9,4,0,13,mixedType,1
3,3,0,6,mixedType,0
2,10,0,12,mixedType,1
4,2,0,6,mixedType,0
8,1,0,9,mixedType,1
7,3,0,10,mixedType,1
12,4,0,16,mixedType,2
8,2,0,10,mixedType,1
6,6,0,12,mixedType,1
9,1,0,10,mixedType,1
7,2,0,9,mixedType,1
12,1,0,13,mixedType,1
7,3,0,10,mixedType,1
3,5,0,8,mixedType,1
5,4,0,9,mixedType,1
5,1,0,6,mixedType,0
8,1,0,9,mixedType,1
1,8,0,9,mixedType,1
1,7,0,8,mixedType,1
6,7,0,13,mixedType,1
7,1,0,8,mixedType,1
6,3,0,9,mixedType,1
6,4,0,10,mixedType,1
6,4,0,10,mixedType,1
4,2,0,6,mixedType,0
8,1,0,9,mixedType,1
10,3,0,13,mixedType,1
7,3,0,10,mixedType,1
5,6,0,11,mixedType,1
5,4,0,9,mixedType,1
7,3,0,10,mixedType,1
13,3,0,16,mixedType,2
6,2,0,8,mixedType,1
8,2,0,10,mixedType,1
13,3,0,16,mixedType,2
5,2,0,7,mixedType,0
5,4,0,9,mixedType,1
6,2,0,8,mixedType,1
11,3,0,14,mixedType,2
2,7,0,9,mixedType,1
7,1,0,8,mixedType,1
5,3,0,8,mixedType,1
6,3,0,9,mixedType,1
5,3,0,8,mixedType,1
4,2,0,6,mixedType,0
5,3,0,8,mixedType,1
1,10,0,11,mixedType,1
6,3,0,9,mixedType,1
6,3,0,9,mixedType,1
2,8,0,10,mixedType,1
13,3,0,16,mixedType,2
5,2,0,7,mixedType,0
2,7,0,9,mixedType,1
9,1,0,10,mixedType,1
6,3,0,9,mixedType,1
8,2,0,10,mixedType,1
5,1,0,6,mixedType,0
14,2,0,16,mixedType,2
6,2,0,8,mixedType,1
5,1,0,6,mixedType,0
9,1,0,10,mixedType,1
7,2,0,9,mixedType,1
6,3,0,9,mixedType,1
5,2,0,7,mixedType,0
10,6,0,16,mixedType,2
6,3,0,9,mixedType,1
6,3,0,9,mixedType,1
5,1,0,6,mixedType,0
6,1,0,7,mixedType,0
6,5,0,11,mixedType,1
10,3,1,14,mixedType,2
1,8,0,9,mixedType,1
10,2,0,12,mixedType,1
4,4,0,8,mixedType,1
9,3,0,12,mixedType,1
12,3,0,15,mixedType,2
8,2,0,10,mixedType,1
12,4,0,16,mixedType,2
6,1,0,7,mixedType,0
6,3,0,9,mixedType,1
3,10,0,13,mixedType,1
7,3,0,10,mixedType,1
4,5,0,9,mixedType,1
6,5,0,11,mixedType,1
8,4,0,12,mixedType,1
8,1,0,9,mixedType,1
7,2,0,9,mixedType,1
7,2,0,9,mixedType,1
7,2,0,9,mixedType,1
3,5,0,8,mixedType,1
5,3,0,8,mixedType,1
15,1,0,16,mixedType,2
6,5,0,11,mixedType,1
14,2,0,16,mixedType,2
4,6,0,10,mixedType,1
8,4,0,12,mixedType,1
12,3,0,15,mixedType,2
15,1,0,16,mixedType,2
7,3,0,10,mixedType,1
11,1,0,12,mixedType,1
6,4,0,10,mixedType,1
5,2,0,7,mixedType,0
7,2,0,9,mixedType,1
7,2,0,9,mixedType,1
5,3,0,8,mixedType,1
7,3,0,10,mixedType,1
12,4,0,16,mixedType,2
8,2,0,10,mixedType,1
4,4,0,8,mixedType,1
4,4,0,8,mixedType,1
5,4,0,9,mixedType,1
4,4,0,8,mixedType,1
6,4,0,10,mixedType,1
4,6,0,10,mixedType,1
1,9,0,10,mixedType,1
15,1,0,16,mixedType,2
5,2,0,7,mixedType,0
6,3,0,9,mixedType,1
13,3,0,16,mixedType,2
4,6,0,10,mixedType,1
5,1,0,6,mixedType,0
7,6,0,13,mixedType,1
6,4,0,10,mixedType,1
1,8,0,9,mixedType,1
9,2,0,11,mixedType,1
15,1,0,16,mixedType,2
14,2,0,16,mixedType,2
14,2,0,16,mixedType,2
4,5,0,9,mixedType,1
3,6,0,9,mixedType,1
7,3,0,10,mixedType,1
5,1,0,6,mixedType,0
2,4,0,6,mixedType,0
9,1,0,10,mixedType,1
6,3,0,9,mixedType,1
6,2,0,8,mixedType,1
4,5,0,9,mixedType,1
3,6,0,9,mixedType,1
12,4,0,16,mixedType,2
9,1,0,10,mixedType,1
6,4,0,10,mixedType,1
7,3,0,10,mixedType,1
2,4,0,6,mixedType,0
5,1,0,6,mixedType,0
1,8,0,9,mixedType,1
6,1,0,7,mixedType,0
10,2,0,12,mixedType,1
8,2,0,10,mixedType,1
4,4,0,8,mixedType,1
7,3,0,10,mixedType,1
7,2,0,9,mixedType,1
7,1,0,8,mixedType,1
4,6,0,10,mixedType,1
7,3,0,10,mixedType,1
2,8,0,10,mixedType,1
7,1,0,8,mixedType,1
7,6,0,13,mixedType,1
7,2,0,9,mixedType,1
8,2,0,10,mixedType,1
5,0,1,6,mixedType,0
9,1,0,10,mixedType,1
7,2,0,9,mixedType,1
6,2,0,8,mixedType,1
7,1,0,8,mixedType,1
8,2,0,10,mixedType,1
12,4,0,16,mixedType,2
7,3,0,10,mixedType,1
2,6,0,8,mixedType,1
7,2,0,9,mixedType,1
8,3,0,11,mixedType,1
7,2,0,9,mixedType,1
10,4,0,14,mixedType,2
6,4,0,10,mixedType,1
8,1,0,9,mixedType,1
5,4,0,9,mixedType,1
1,8,0,9,mixedType,1
8,1,0,9,mixedType,1
5,4,0,9,mixedType,1
9,1,0,10,mixedType,1
7,1,0,8,mixedType,1
6,7,0,13,mixedType,1
12,4,0,16,mixedType,2
4,2,0,6,mixedType,0
8,2,0,10,mixedType,1
9,2,0,11,mixedType,1
3,7,0,10,mixedType,1
4,8,0,12,mixedType,1
14,2,0,16,mixedType,2
15,1,0,16,mixedType,2
4,7,0,11,mixedType,1
4,6,0,10,mixedType,1
7,3,0,10,mixedType,1
2,6,0,8,mixedType,1
5,4,0,9,mixedType,1
6,5,0,11,mixedType,1
5,6,0,11,mixedType,1
7,4,0,11,mixedType,1
10,2,0,12,mixedType,1
10,2,0,12,mixedType,1
7,3,0,10,mixedType,1
6,3,0,9,mixedType,1
11,5,0,16,mixedType,2
5,3,0,8,mixedType,1
7,3,0,10,mixedType,1
8,1,0,9,mixedType,1
7,2,0,9,mixedType,1
7,1,0,8,mixedType,1
7,4,0,11,mixedType,1
6,4,0,10,mixedType,1
4,4,0,8,mixedType,1
9,1,0,10,mixedType,1
13,1,1,15,mixedType,2
14,2,0,16,mixedType,2
10,0,1,11,mixedType,1
11,3,0,14,mixedType,2
5,4,0,9,mixedType,1
1,8,0,9,mixedType,1
5,6,0,11,mixedType,1
3,3,0,6,mixedType,0
4,6,0,10,mixedType,1
17,1,1,19,mixedType,2
7,3,0,10,mixedType,1
4,4,0,8,mixedType,1
6,7,0,13,mixedType,1
3,5,0,8,mixedType,1
15,1,0,16,mixedType,2
5,3,0,8,mixedType,1
8,2,0,10,mixedType,1
6,3,0,9,mixedType,1
15,1,0,16,mixedType,2
7,4,0,11,mixedType,1
7,3,0,10,mixedType,1
5,6,0,11,mixedType,1
6,3,0,9,mixedType,1
6,4,0,10,mixedType,1
14,1,0,15,mixedType,2
3,6,0,9,mixedType,1
8,5,0,13,mixedType,1
8,4,0,12,mixedType,1
5,3,0,8,mixedType,1
6,4,0,10,mixedType,1
7,2,0,9,mixedType,1
6,3,0,9,mixedType,1
14,2,0,16,mixedType,2
14,2,0,16,mixedType,2
14,2,0,16,mixedType,2
7,3,0,10,mixedType,1
5,4,0,9,mixedType,1
8,2,0,10,mixedType,1
3,6,0,9,mixedType,1
2,8,0,10,mixedType,1
4,5,0,9,mixedType,1
7,2,0,9,mixedType,1
1,8,0,9,mixedType,1
7,1,0,8,mixedType,1
6,3,0,9,mixedType,1
6,1,0,7,mixedType,0
8,3,0,11,mixedType,1
6,2,0,8,mixedType,1
9,1,0,10,mixedType,1
8,2,0,10,mixedType,1
7,4,0,11,mixedType,1
12,3,0,15,mixedType,2
7,1,0,8,mixedType,1
6,1,0,7,mixedType,0
9,1,0,10,mixedType,1
6,4,0,10,mixedType,1
4,2,0,6,mixedType,0
5,6,0,11,mixedType,1
9,1,0,10,mixedType,1
9,2,0,11,mixedType,1
12,4,0,16,mixedType,2
8,4,0,12,mixedType,1
2,8,0,10,mixedType,1
14,2,0,16,mixedType,2
9,1,0,10,mixedType,1
7,2,0,9,mixedType,1
7,2,0,9,mixedType,1
1,9,0,10,mixedType,1
6,3,0,9,mixedType,1
6,3,0,9,mixedType,1
5,1,0,6,mixedType,0
7,3,0,10,mixedType,1
4,2,0,6,mixedType,0
8,1,0,9,mixedType,1
5,3,0,8,mixedType,1
6,1,0,7,mixedType,0
5,8,0,13,mixedType,1
9,1,0,10,mixedType,1
7,6,0,13,mixedType,1
7,1,0,8,mixedType,1
7,2,0,9,mixedType,1
3,6,0,9,mixedType,1
8,2,0,10,mixedType,1
1,8,0,9,mixedType,1
8,3,0,11,mixedType,1
14,2,0,16,mixedType,2
6,3,0,9,mixedType,1
8,2,0,10,mixedType,1
8,2,0,10,mixedType,1
5,4,0,9,mixedType,1
9,1,0,10,mixedType,1
7,3,0,10,mixedType,1
5,5,0,10,mixedType,1
5,3,0,8,mixedType,1
9,1,0,10,mixedType,1
6,3,0,9,mixedType,1
6,6,0,12,mixedType,1
11,1,0,12,mixedType,1
6,3,0,9,mixedType,1
4,6,0,10,mixedType,1
6,4,0,10,mixedType,1
6,4,0,10,mixedType,1
5,4,0,9,mixedType,1
3,6,0,9,mixedType,1
8,1,0,9,mixedType,1
6,1,0,7,mixedType,0
6,1,0,7,mixedType,0
9,2,0,11,mixedType,1
6,2,0,8,mixedType,1
6,3,0,9,mixedType,1
7,2,0,9,mixedType,1
7,2,0,9,mixedType,1
12,0,1,13,mixedType,1
12,4,0,16,mixedType,2
7,2,0,9,mixedType,1
14,2,0,16,mixedType,2
7,2,0,9,mixedType,1
3,7,0,10,mixedType,1
1,10,0,11,mixedType,1
6,1,0,7,mixedType,0
3,8,0,11,mixedType,1
6,3,0,9,mixedType,1
6,4,0,10,mixedType,1
6,3,0,9,mixedType,1
5,6,0,11,mixedType,1
3,5,0,8,mixedType,1
8,3,0,11,mixedType,1
8,1,0,9,mixedType,1
8,1,0,9,mixedType,1
5,4,0,9,mixedType,1
6,1,0,7,mixedType,0
5,6,0,11,mixedType,1
6,1,0,7,mixedType,0
5,1,0,6,mixedType,0
6,4,0,10,mixedType,1
5,3,0,8,mixedType,1
2,8,0,10,mixedType,1
8,5,1,14,mixedType,2
10,3,0,13,mixedType,1
11,3,0,14,mixedType,2
8,1,0,9,mixedType,1
6,2,0,8,mixedType,1
4,2,0,6,mixedType,0
8,1,0,9,mixedType,1
12,3,0,15,mixedType,2
2,6,0,8,mixedType,1
8,2,0,10,mixedType,1
13,3,0,16,mixedType,2
5,3,0,8,mixedType,1
6,1,0,7,mixedType,0
9,4,2,15,mixedType,2
6,1,0,7,mixedType,0
4,4,0,8,mixedType,1
6,2,0,8,mixedType,1
7,3,0,10,mixedType,1
7,2,0,9,mixedType,1
5,2,0,7,mixedType,0
6,1,0,7,mixedType,0
5,4,0,9,mixedType,1
13,3,0,16,mixedType,2
13,3,0,16,mixedType,2
3,9,0,12,mixedType,1
8,2,0,10,mixedType,1
7,1,0,8,mixedType,1
7,3,0,10,mixedType,1
5,2,0,7,mixedType,0
6,3,0,9,mixedType,1
9,2,0,11,mixedType,1
8,1,0,9,mixedType,1
4,7,0,11,mixedType,1
3,5,0,8,mixedType,1
8,3,0,11,mixedType,1
9,2,0,11,mixedType,1
5,1,0,6,mixedType,0
6,2,0,8,mixedType,1
8,2,0,10,mixedType,1
8,4,0,12,mixedType,1
10,1,0,11,mixedType,1
6,3,0,9,mixedType,1
3,6,0,9,mixedType,1
7,1,0,8,mixedType,1
4,4,0,8,mixedType,1
8,4,0,12,mixedType,1
14,2,0,16,mixedType,2
9,1,0,10,mixedType,1
11,3,0,14,mixedType,2
7,3,0,10,mixedType,1
6,1,0,7,mixedType,0
6,1,0,7,mixedType,0
9,1,0,10,mixedType,1
4,4,0,8,mixedType,1
7,2,0,9,mixedType,1
6,4,0,10,mixedType,1
8,1,0,9,mixedType,1
6,1,0,7,mixedType,0
6,1,0,7,mixedType,0
3,8,0,11,mixedType,1
7,1,0,8,mixedType,1
7,3,0,10,mixedType,1
8,1,0,9,mixedType,1
6,2,0,8,mixedType,1
6,4,0,10,mixedType,1
7,3,0,10,mixedType,1
10,1,0,11,mixedType,1
4,4,0,8,mixedType,1
9,1,0,10,mixedType,1
14,2,0,16,mixedType,2
7,3,0,10,mixedType,1
3,6,0,9,mixedType,1
6,1,0,7,mixedType,0
6,1,0,7,mixedType,0
5,3,0,8,mixedType,1
7,1,0,8,mixedType,1
5,1,0,6,mixedType,0
4,4,0,8,mixedType,1
6,3,0,9,mixedType,1
1,8,0,9,mixedType,1
6,3,0,9,mixedType,1
6,4,0,10,mixedType,1
15,1,0,16,mixedType,2
4,4,0,8,mixedType,1
6,4,0,10,mixedType,1
5,2,0,7,mixedType,0
8,3,0,11,mixedType,1
9,2,0,11,mixedType,1
5,1,0,6,mixedType,0
7,2,0,9,mixedType,1
4,4,0,8,mixedType,1
3,3,0,6,mixedType,0
2,10,0,12,mixedType,1
5,2,0,7,mixedType,0
7,3,0,10,mixedType,1
4,2,0,6,mixedType,0
7,2,0,9,mixedType,1
13,3,0,16,mixedType,2
14,2,0,16,mixedType,2
7,3,0,10,mixedType,1
6,1,0,7,mixedType,0
14,2,0,16,mixedType,2
8,1,0,9,mixedType,1
7,3,0,10,mixedType,1
6,4,0,10,mixedType,1
5,2,0,7,mixedType,0
15,4,0,19,mixedType,2
8,1,0,9,mixedType,1
4,6,0,10,mixedType,1
5,2,0,7,mixedType,0
8,2,0,10,mixedType,1
3,5,0,8,mixedType,1
4,6,0,10,mixedType,1
4,4,0,8,mixedType,1
8,1,0,9,mixedType,1
8,2,0,10,mixedType,1
7,3,0,10,mixedType,1
8,1,0,9,mixedType,1
4,4,0,8,mixedType,1
6,3,0,9,mixedType,1
6,2,0,8,mixedType,1
7,3,0,10,mixedType,1
9,1,0,10,mixedType,1
6,2,0,8,mixedType,1
8,6,0,14,mixedType,2
2,4,0,6,mixedType,0
2,4,0,6,mixedType,0
5,5,0,10,mixedType,1
2,4,0,6,mixedType,0
7,2,0,9,mixedType,1
5,0,0,5,sameType,0
9,1,0,10,mixedType,1
4,2,0,6,mixedType,0
3,7,0,10,mixedType,1
6,1,0,7,mixedType,0
7,1,0,8,mixedType,1
7,2,0,9,mixedType,1
7,2,0,9,mixedType,1
6,4,0,10,mixedType,1
8,2,0,10,mixedType,1
8,2,0,10,mixedType,1
11,1,0,12,mixedType,1
6,3,0,9,mixedType,1
8,1,0,9,mixedType,1
1,5,0,6,mixedType,0
3,6,0,9,mixedType,1
5,4,0,9,mixedType,1
4,4,0,8,mixedType,1
6,1,0,7,mixedType,0
8,2,0,10,mixedType,1
6,2,0,8,mixedType,1
14,2,0,16,mixedType,2
5,8,0,13,mixedType,1
9,3,0,12,mixedType,1
10,0,1,11,mixedType,1
8,2,0,10,mixedType,1
5,3,0,8,mixedType,1
8,2,0,10,mixedType,1
15,4,0,19,mixedType,2
5,2,0,7,mixedType,0
6,1,0,7,mixedType,0
6,2,0,8,mixedType,1
5,2,0,7,mixedType,0
1,9,0,10,mixedType,1
0,6,1,7,mixedType,0
5,2,0,7,mixedType,0
1,8,0,9,mixedType,1
7,3,0,10,mixedType,1
5,10,0,15,mixedType,2
11,1,0,12,mixedType,1
9,4,0,13,mixedType,1
6,1,0,7,mixedType,0
7,4,0,11,mixedType,1
6,4,0,10,mixedType,1
13,3,0,16,mixedType,2
5,1,0,6,mixedType,0
9,1,0,10,mixedType,1
3,8,0,11,mixedType,1
6,2,0,8,mixedType,1
4,2,0,6,mixedType,0
7,2,0,9,mixedType,1
14,2,0,16,mixedType,2
9,3,0,12,mixedType,1
5,4,0,9,mixedType,1
5,2,0,7,mixedType,0
7,3,0,10,mixedType,1
1,7,0,8,mixedType,1
6,3,0,9,mixedType,1
14,2,2,18,mixedType,2
6,0,2,8,mixedType,1
8,3,0,11,mixedType,1
2,9,0,11,mixedType,1
5,2,0,7,mixedType,0
5,6,0,11,mixedType,1
6,4,0,10,mixedType,1
5,3,0,8,mixedType,1
3,3,0,6,mixedType,0
6,4,0,10,mixedType,1
6,4,0,10,mixedType,1
6,1,0,7,mixedType,0
6,3,0,9,mixedType,1
5,5,0,10,mixedType,1
6,2,0,8,mixedType,1
8,1,0,9,mixedType,1
6,2,0,8,mixedType,1
7,2,0,9,mixedType,1
9,2,0,11,mixedType,1
5,3,0,8,mixedType,1
1,11,0,12,mixedType,1
8,2,0,10,mixedType,1
11,3,0,14,mixedType,2
7,1,0,8,mixedType,1
9,1,0,10,mixedType,1
6,1,0,7,mixedType,0
4,6,0,10,mixedType,1
6,4,0,10,mixedType,1
9,4,0,13,mixedType,1
15,1,0,16,mixedType,2
15,1,0,16,mixedType,2
9,1,0,10,mixedType,1
7,2,0,9,mixedType,1
14,2,0,16,mixedType,2
8,1,0,9,mixedType,1
6,4,0,10,mixedType,1
5,4,0,9,mixedType,1
2,6,0,8,mixedType,1
14,2,0,16,mixedType,2
14,2,0,16,mixedType,2
7,3,0,10,mixedType,1
5,1,0,6,mixedType,0
8,2,0,10,mixedType,1
6,1,0,7,mixedType,0
2,7,0,9,mixedType,1
4,4,0,8,mixedType,1
8,2,0,10,mixedType,1
6,3,0,9,mixedType,1
4,2,0,6,mixedType,0
7,2,0,9,mixedType,1
2,8,0,10,mixedType,1
9,4,0,13,mixedType,1
6,2,0,8,mixedType,1
14,2,0,16,mixedType,2
7,0,1,8,mixedType,1
7,2,0,9,mixedType,1
9,2,0,11,mixedType,1
7,2,0,9,mixedType,1
2,6,0,8,mixedType,1
9,2,0,11,mixedType,1
12,3,0,15,mixedType,2
15,1,0,16,mixedType,2
4,6,0,10,mixedType,1
4,6,0,10,mixedType,1
9,1,0,10,mixedType,1
7,5,0,12,mixedType,1
6,2,0,8,mixedType,1
4,4,0,8,mixedType,1
4,2,0,6,mixedType,0
6,3,0,9,mixedType,1
9,1,0,10,mixedType,1
6,3,0,9,mixedType,1
6,1,0,7,mixedType,0
3,7,0,10,mixedType,1
7,6,0,13,mixedType,1
7,1,0,8,mixedType,1
9,1,0,10,mixedType,1
2,6,0,8,mixedType,1
15,1,0,16,mixedType,2
7,1,0,8,mixedType,1
7,3,0,10,mixedType,1
5,5,0,10,mixedType,1
8,0,1,9,mixedType,1
6,3,0,9,mixedType,1
9,4,1,14,mixedType,2
9,1,0,10,mixedType,1
7,2,0,9,mixedType,1
2,7,0,9,mixedType,1
5,8,0,13,mixedType,1
8,2,0,10,mixedType,1
5,3,0,8,mixedType,1
6,2,0,8,mixedType,1
8,4,0,12,mixedType,1
6,3,0,9,mixedType,1
5,3,0,8,mixedType,1
7,3,0,10,mixedType,1
10,5,0,15,mixedType,2
5,3,0,8,mixedType,1
8,4,0,12,mixedType,1
1,8,0,9,mixedType,1
3,6,0,9,mixedType,1
5,3,0,8,mixedType,1
5,0,1,6,mixedType,0
1,9,0,10,mixedType,1
5,7,0,12,mixedType,1
8,1,0,9,mixedType,1
9,4,0,13,mixedType,1
5,3,0,8,mixedType,1
5,3,0,8,mixedType,1
12,3,0,15,mixedType,2
5,4,0,9,mixedType,1
3,10,1,14,mixedType,2
9,1,0,10,mixedType,1
8,1,0,9,mixedType,1
8,2,0,10,mixedType,1
9,4,0,13,mixedType,1
6,3,0,9,mixedType,1
7,2,0,9,mixedType,1
5,6,0,11,mixedType,1
6,2,0,8,mixedType,1
7,1,0,8,mixedType,1
6,3,0,9,mixedType,1
3,7,0,10,mixedType,1
5,2,0,7,mixedType,0
9,2,0,11,mixedType,1
5,2,0,7,mixedType,0
8,2,0,10,mixedType,1
8,2,0,10,mixedType,1
7,3,0,10,mixedType,1
4,5,0,9,mixedType,1
6,2,0,8,mixedType,1
8,2,0,10,mixedType,1
7,3,0,10,mixedType,1
10,2,0,12,mixedType,1
9,1,0,10,mixedType,1
7,3,0,10,mixedType,1
4,4,0,8,mixedType,1
8,2,0,10,mixedType,1
12,3,1,16,mixedType,2
8,1,0,9,mixedType,1
12,1,0,13,mixedType,1
8,2,0,10,mixedType,1
3,6,0,9,mixedType,1
10,3,0,13,mixedType,1
7,3,0,10,mixedType,1
2,4,0,6,mixedType,0
7,3,0,10,mixedType,1
6,4,0,10,mixedType,1
7,3,0,10,mixedType,1
5,3,0,8,mixedType,1
8,2,0,10,mixedType,1
7,3,0,10,mixedType,1
1,8,0,9,mixedType,1
7,2,0,9,mixedType,1
6,2,0,8,mixedType,1
7,3,0,10,mixedType,1
3,6,0,9,mixedType,1
11,11,2,24,mixedType,2
2,6,0,8,mixedType,1
8,4,0,12,mixedType,1
3,5,0,8,mixedType,1
6,1,0,7,mixedType,0
3,8,0,11,mixedType,1
9,4,0,13,mixedType,1
14,1,1,16,mixedType,2
5,8,1,14,mixedType,2
4,7,0,11,mixedType,1
1,8,0,9,mixedType,1
14,2,0,16,mixedType,2
11,3,0,14,mixedType,2
3,6,0,9,mixedType,1
6,3,0,9,mixedType,1
8,3,0,11,mixedType,1
7,2,0,9,mixedType,1
7,2,0,9,mixedType,1
7,4,3,14,mixedType,2
1,8,0,9,mixedType,1
3,8,0,11,mixedType,1
2,6,0,8,mixedType,1
7,1,0,8,mixedType,1
4,6,0,10,mixedType,1
5,6,0,11,mixedType,1
14,2,0,16,mixedType,2
3,3,0,6,mixedType,0
6,2,0,8,mixedType,1
11,1,0,12,mixedType,1
6,1,0,7,mixedType,0
5,2,0,7,mixedType,0
8,2,0,10,mixedType,1
6,2,0,8,mixedType,1
1,8,0,9,mixedType,1
3,5,0,8,mixedType,1
7,3,0,10,mixedType,1
5,2,0,7,mixedType,0
5,5,0,10,mixedType,1
4,4,0,8,mixedType,1
8,1,0,9,mixedType,1
5,5,0,10,mixedType,1
10,6,0,16,mixedType,2
2,8,0,10,mixedType,1
4,7,0,11,mixedType,1
5,3,0,8,mixedType,1
5,3,0,8,mixedType,1
6,3,0,9,mixedType,1
6,3,0,9,mixedType,1
4,4,0,8,mixedType,1
11,3,0,14,mixedType,2
4,6,0,10,mixedType,1
5,3,0,8,mixedType,1
9,2,0,11,mixedType,1
7,3,0,10,mixedType,1
3,8,0,11,mixedType,1
6,4,0,10,mixedType,1
9,2,0,11,mixedType,1
1,8,0,9,mixedType,1
4,4,0,8,mixedType,1
9,2,0,11,mixedType,1
6,1,0,7,mixedType,0
5,2,0,7,mixedType,0
7,3,0,10,mixedType,1
7,1,0,8,mixedType,1
6,2,0,8,mixedType,1
11,1,0,12,mixedType,1
6,3,0,9,mixedType,1
4,2,0,6,mixedType,0
6,3,0,9,mixedType,1
12,3,0,15,mixedType,2
5,3,0,8,mixedType,1
5,2,0,7,mixedType,0
5,1,0,6,mixedType,0
10,4,0,14,mixedType,2
5,3,0,8,mixedType,1
6,1,0,7,mixedType,0
6,2,0,8,mixedType,1
5,3,0,8,mixedType,1
5,3,0,8,mixedType,1
2,4,0,6,mixedType,0
4,6,0,10,mixedType,1
8,4,0,12,mixedType,1
7,1,0,8,mixedType,1
6,3,0,9,mixedType,1
6,4,0,10,mixedType,1
13,3,0,16,mixedType,2
11,3,0,14,mixedType,2
7,4,0,11,mixedType,1
9,1,0,10,mixedType,1
7,5,0,12,mixedType,1
5,3,0,8,mixedType,1
6,3,0,9,mixedType,1
6,1,0,7,mixedType,0
7,3,0,10,mixedType,1
7,2,0,9,mixedType,1
4,2,0,6,mixedType,0
6,4,0,10,mixedType,1
6,1,0,7,mixedType,0
8,2,0,10,mixedType,1
6,2,0,8,mixedType,1
6,2,0,8,mixedType,1
5,3,0,8,mixedType,1
6,4,0,10,mixedType,1
16,4,2,22,mixedType,2
9,2,0,11,mixedType,1
6,3,0,9,mixedType,1
4,2,0,6,mixedType,0
1,8,0,9,mixedType,1
11,1,0,12,mixedType,1
4,4,0,8,mixedType,1
4,6,0,10,mixedType,1
6,3,0,9,mixedType,1
5,2,0,7,mixedType,0
7,3,0,10,mixedType,1
8,2,0,10,mixedType,1
6,4,0,10,mixedType,1
2,4,0,6,mixedType,0
5,2,0,7,mixedType,0
9,2,0,11,mixedType,1
8,2,0,10,mixedType,1
7,3,0,10,mixedType,1
7,3,0,10,mixedType,1
7,2,0,9,mixedType,1
4,2,0,6,mixedType,0
6,3,0,9,mixedType,1
7,1,0,8,mixedType,1
13,3,0,16,mixedType,2
6,3,0,9,mixedType,1
3,3,0,6,mixedType,0
4,4,0,8,mixedType,1
12,4,0,16,mixedType,2
7,2,0,9,mixedType,1
6,4,0,10,mixedType,1
4,6,0,10,mixedType,1
14,2,0,16,mixedType,2
5,2,0,7,mixedType,0
6,3,0,9,mixedType,1
7,2,0,9,mixedType,1
2,7,0,9,mixedType,1
3,6,0,9,mixedType,1
7,4,0,11,mixedType,1
7,1,0,8,mixedType,1
2,7,0,9,mixedType,1
6,1,0,7,mixedType,0
8,2,0,10,mixedType,1
6,6,0,12,mixedType,1
8,1,0,9,mixedType,1
12,4,0,16,mixedType,2
4,4,0,8,mixedType,1
4,2,0,6,mixedType,0
6,4,0,10,mixedType,1
2,7,0,9,mixedType,1
8,2,0,10,mixedType,1
8,4,0,12,mixedType,1
8,4,0,12,mixedType,1
4,4,0,8,mixedType,1
7,2,0,9,mixedType,1
8,1,0,9,mixedType,1
15,1,0,16,mixedType,2
5,3,0,8,mixedType,1
6,2,0,8,mixedType,1
9,1,0,10,mixedType,1
12,4,0,16,mixedType,2
12,4,0,16,mixedType,2
4,4,0,8,mixedType,1
4,4,0,8,mixedType,1
7,3,0,10,mixedType,1
7,5,0,12,mixedType,1
13,3,0,16,mixedType,2
3,8,0,11,mixedType,1
7,1,0,8,mixedType,1
2,7,0,9,mixedType,1
4,4,0,8,mixedType,1
5,2,0,7,mixedType,0
9,4,0,13,mixedType,1
5,3,0,8,mixedType,1
6,2,0,8,mixedType,1
9,4,0,13,mixedType,1
5,3,0,8,mixedType,1
7,3,0,10,mixedType,1
3,5,0,8,mixedType,1
11,2,0,13,mixedType,1
6,2,0,8,mixedType,1
6,2,0,8,mixedType,1
8,3,0,11,mixedType,1
5,5,0,10,mixedType,1
5,4,0,9,mixedType,1
6,1,0,7,mixedType,0
6,2,0,8,mixedType,1
15,1,0,16,mixedType,2
5,1,0,6,mixedType,0
6,2,0,8,mixedType,1
8,4,0,12,mixedType,1
8,1,0,9,mixedType,1
5,3,0,8,mixedType,1
6,4,0,10,mixedType,1
8,2,0,10,mixedType,1
6,3,0,9,mixedType,1
7,3,0,10,mixedType,1
12,4,0,16,mixedType,2
8,4,0,12,mixedType,1
5,6,0,11,mixedType,1
7,2,0,9,mixedType,1
9,3,0,12,mixedType,1
11,3,0,14,mixedType,2
4,2,0,6,mixedType,0
4,6,0,10,mixedType,1
5,4,0,9,mixedType,1
3,5,0,8,mixedType,1
8,1,0,9,mixedType,1
7,1,0,8,mixedType,1
5,8,0,13,mixedType,1
5,3,0,8,mixedType,1
7,2,0,9,mixedType,1
4,4,0,8,mixedType,1
6,4,0,10,mixedType,1
6,2,0,8,mixedType,1
5,5,0,10,mixedType,1
5,2,0,7,mixedType,0
5,4,0,9,mixedType,1
6,2,0,8,mixedType,1
6,3,0,9,mixedType,1
9,1,0,10,mixedType,1
4,4,0,8,mixedType,1
7,4,0,11,mixedType,1
9,1,0,10,mixedType,1
4,4,0,8,mixedType,1
8,1,0,9,mixedType,1
4,5,0,9,mixedType,1
6,3,0,9,mixedType,1
6,2,0,8,mixedType,1
4,2,0,6,mixedType,0
7,2,0,9,mixedType,1
6,1,0,7,mixedType,0
6,3,0,9,mixedType,1
7,1,0,8,mixedType,1
6,1,0,7,mixedType,0
11,4,1,16,mixedType,2
15,1,0,16,mixedType,2
4,2,0,6,mixedType,0
9,2,0,11,mixedType,1
5,3,0,8,mixedType,1
7,2,0,9,mixedType,1
10,2,0,12,mixedType,1
10,2,0,12,mixedType,1
6,3,0,9,mixedType,1
5,4,0,9,mixedType,1
5,3,0,8,mixedType,1
7,2,0,9,mixedType,1
15,1,0,16,mixedType,2
2,7,0,9,mixedType,1
6,4,0,10,mixedType,1
5,6,0,11,mixedType,1
6,4,0,10,mixedType,1
4,5,0,9,mixedType,1
4,2,0,6,mixedType,0
8,1,0,9,mixedType,1
5,1,0,6,mixedType,0
5,3,0,8,mixedType,1
4,9,1,14,mixedType,2
4,9,0,13,mixedType,1
7,8,0,15,mixedType,2
9,2,0,11,mixedType,1
9,3,0,12,mixedType,1
7,3,0,10,mixedType,1
7,1,0,8,mixedType,1
1,8,0,9,mixedType,1
4,6,0,10,mixedType,1
5,2,0,7,mixedType,0
8,1,0,9,mixedType,1
1,7,0,8,mixedType,1
5,4,0,9,mixedType,1
5,3,0,8,mixedType,1
6,3,0,9,mixedType,1
9,1,0,10,mixedType,1
7,6,0,13,mixedType,1
8,2,0,10,mixedType,1
10,4,2,16,mixedType,2
2,6,0,8,mixedType,1
7,3,0,10,mixedType,1
1,8,0,9,mixedType,1
5,1,0,6,mixedType,0
5,2,0,7,mixedType,0
6,4,0,10,mixedType,1
8,1,0,9,mixedType,1
5,2,0,7,mixedType,0
7,3,0,10,mixedType,1
6,2,0,8,mixedType,1
5,3,0,8,mixedType,1
5,4,0,9,mixedType,1
9,4,0,13,mixedType,1
5,3,0,8,mixedType,1
4,4,0,8,mixedType,1
7,2,0,9,mixedType,1
8,1,0,9,mixedType,1
7,3,0,10,mixedType,1
2,7,0,9,mixedType,1
2,6,0,8,mixedType,1
7,3,0,10,mixedType,1
6,4,0,10,mixedType,1
15,1,0,16,mixedType,2
9,2,0,11,mixedType,1
9,1,0,10,mixedType,1
14,2,0,16,mixedType,2
7,2,0,9,mixedType,1
6,2,0,8,mixedType,1
14,1,0,15,mixedType,2
8,2,0,10,mixedType,1
6,2,0,8,mixedType,1
6,3,0,9,mixedType,1
8,3,0,11,mixedType,1
7,3,0,10,mixedType,1
9,3,0,12,mixedType,1
13,3,0,16,mixedType,2
6,3,0,9,mixedType,1
6,1,0,7,mixedType,0
4,2,0,6,mixedType,0
6,1,0,7,mixedType,0
5,3,0,8,mixedType,1
7,3,0,10,mixedType,1
7,3,0,10,mixedType,1
10,2,0,12,mixedType,1
7,2,0,9,mixedType,1
14,2,0,16,mixedType,2
4,2,0,6,mixedType,0
14,2,0,16,mixedType,2
12,3,0,15,mixedType,2
5,6,0,11,mixedType,1
9,1,0,10,mixedType,1
7,3,0,10,mixedType,1
3,6,0,9,mixedType,1
6,2,0,8,mixedType,1
15,1,0,16,mixedType,2
11,5,0,16,mixedType,2
6,3,0,9,mixedType,1
8,4,0,12,mixedType,1
6,2,0,8,mixedType,1
10,2,0,12,mixedType,1
4,6,0,10,mixedType,1
1,10,0,11,mixedType,1
4,2,0,6,mixedType,0
14,2,0,16,mixedType,2
5,5,0,10,mixedType,1
8,1,0,9,mixedType,1
13,2,0,15,mixedType,2
8,2,0,10,mixedType,1
8,1,0,9,mixedType,1
8,2,0,10,mixedType,1
9,4,1,14,mixedType,2
12,4,0,16,mixedType,2
6,2,0,8,mixedType,1
5,3,0,8,mixedType,1
5,2,0,7,mixedType,0
3,8,0,11,mixedType,1
2,7,0,9,mixedType,1
6,3,0,9,mixedType,1
11,2,0,13,mixedType,1
7,3,0,10,mixedType,1
9,3,0,12,mixedType,1
6,1,0,7,mixedType,0
15,1,0,16,mixedType,2
6,3,0,9,mixedType,1
10,1,0,11,mixedType,1
6,6,0,12,mixedType,1
5,4,0,9,mixedType,1
2,8,0,10,mixedType,1
5,3,0,8,mixedType,1
10,3,0,13,mixedType,1
15,1,0,16,mixedType,2
6,3,0,9,mixedType,1
12,1,0,13,mixedType,1
3,6,0,9,mixedType,1
7,2,0,9,mixedType,1
7,3,0,10,mixedType,1
14,2,0,16,mixedType,2
5,4,0,9,mixedType,1
9,1,0,10,mixedType,1
5,3,0,8,mixedType,1
7,2,0,9,mixedType,1
4,2,0,6,mixedType,0
8,3,0,11,mixedType,1
4,4,0,8,mixedType,1
7,3,0,10,mixedType,1
8,2,0,10,mixedType,1
14,2,0,16,mixedType,2
14,2,0,16,mixedType,2
4,4,0,8,mixedType,1
6,2,0,8,mixedType,1
2,8,0,10,mixedType,1
12,4,0,16,mixedType,2
6,4,0,10,mixedType,1
7,2,0,9,mixedType,1
6,3,0,9,mixedType,1
7,3,0,10,mixedType,1
6,8,0,14,mixedType,2
6,3,0,9,mixedType,1
3,6,0,9,mixedType,1
5,4,0,9,mixedType,1
4,2,0,6,mixedType,0
6,4,0,10,mixedType,1
14,2,0,16,mixedType,2
6,4,0,10,mixedType,1
14,2,0,16,mixedType,2
5,4,0,9,mixedType,1
14,2,0,16,mixedType,2
5,1,0,6,mixedType,0
7,3,0,10,mixedType,1
4,4,0,8,mixedType,1
5,2,0,7,mixedType,0
4,6,0,10,mixedType,1
8,1,0,9,mixedType,1
5,3,0,8,mixedType,1
2,6,0,8,mixedType,1
1,8,0,9,mixedType,1
2,6,0,8,mixedType,1
5,3,0,8,mixedType,1
3,3,0,6,mixedType,0
2,10,0,12,mixedType,1
6,9,0,15,mixedType,2
4,6,0,10,mixedType,1
7,1,0,8,mixedType,1
6,3,0,9,mixedType,1
13,3,0,16,mixedType,2
5,4,0,9,mixedType,1
5,2,0,7,mixedType,0
5,2,0,7,mixedType,0
6,2,0,8,mixedType,1
6,3,0,9,mixedType,1
4,4,0,8,mixedType,1
5,3,0,8,mixedType,1
6,3,0,9,mixedType,1
4,8,0,12,mixedType,1
5,4,0,9,mixedType,1
10,3,0,13,mixedType,1
7,1,0,8,mixedType,1
6,3,0,9,mixedType,1
1,10,0,11,mixedType,1
3,6,0,9,mixedType,1
8,1,0,9,mixedType,1
4,6,0,10,mixedType,1
8,1,0,9,mixedType,1
7,2,0,9,mixedType,1
3,7,0,10,mixedType,1
5,7,0,12,mixedType,1
1,8,0,9,mixedType,1
6,4,0,10,mixedType,1
13,3,0,16,mixedType,2
5,2,0,7,mixedType,0
1,7,0,8,mixedType,1
5,1,0,6,mixedType,0
7,3,0,10,mixedType,1
4,8,0,12,mixedType,1
12,4,0,16,mixedType,2
8,1,0,9,mixedType,1
6,3,0,9,mixedType,1
7,2,0,9,mixedType,1
7,3,0,10,mixedType,1
7,3,0,10,mixedType,1
10,0,1,11,mixedType,1
5,6,0,11,mixedType,1
9,4,0,13,mixedType,1
7,2,0,9,mixedType,1
6,2,0,8,mixedType,1
5,4,0,9,mixedType,1
6,8,1,15,mixedType,2
9,3,0,12,mixedType,1
14,2,0,16,mixedType,2
8,2,0,10,mixedType,1
4,2,0,6,mixedType,0
12,4,0,16,mixedType,2
6,3,0,9,mixedType,1
4,6,0,10,mixedType,1
12,4,0,16,mixedType,2
13,3,0,16,mixedType,2
12,4,0,16,mixedType,2
3,6,0,9,mixedType,1
4,6,0,10,mixedType,1
5,4,0,9,mixedType,1
8,1,0,9,mixedType,1
6,3,0,9,mixedType,1
7,3,0,10,mixedType,1
6,3,0,9,mixedType,1
12,3,0,15,mixedType,2
5,2,0,7,mixedType,0
5,4,0,9,mixedType,1
14,2,0,16,mixedType,2
6,2,0,8,mixedType,1
6,2,0,8,mixedType,1
4,6,0,10,mixedType,1
6,3,0,9,mixedType,1
2,8,0,10,mixedType,1
7,3,0,10,mixedType,1
3,3,0,6,mixedType,0
6,3,0,9,mixedType,1
9,1,0,10,mixedType,1
6,3,0,9,mixedType,1
8,3,0,11,mixedType,1
9,2,0,11,mixedType,1
14,2,0,16,mixedType,2
4,4,0,8,mixedType,1
6,2,0,8,mixedType,1
6,3,0,9,mixedType,1
7,2,0,9,mixedType,1
7,2,0,9,mixedType,1
5,4,0,9,mixedType,1
5,4,0,9,mixedType,1
5,4,0,9,mixedType,1
4,4,0,8,mixedType,1
7,2,0,9,mixedType,1
4,2,0,6,mixedType,0
4,2,0,6,mixedType,0
5,2,0,7,mixedType,0
11,1,0,12,mixedType,1
5,2,0,7,mixedType,0
5,4,0,9,mixedType,1
7,1,0,8,mixedType,1
4,4,0,8,mixedType,1
13,3,0,16,mixedType,2
6,1,0,7,mixedType,0
5,4,0,9,mixedType,1
3,3,0,6,mixedType,0
7,2,0,9,mixedType,1
4,4,0,8,mixedType,1
9,3,0,12,mixedType,1
7,2,0,9,mixedType,1
3,3,0,6,mixedType,0
8,4,0,12,mixedType,1
6,3,0,9,mixedType,1
6,3,0,9,mixedType,1
5,3,0,8,mixedType,1
8,1,0,9,mixedType,1
3,8,0,11,mixedType,1
1,9,0,10,mixedType,1
12,4,0,16,mixedType,2
1,6,0,7,mixedType,0
7,2,0,9,mixedType,1
5,4,0,9,mixedType,1
6,2,0,8,mixedType,1
8,1,0,9,mixedType,1
4,2,0,6,mixedType,0
4,6,0,10,mixedType,1
8,2,0,10,mixedType,1
7,3,0,10,mixedType,1
4,2,0,6,mixedType,0
6,1,0,7,mixedType,0
6,4,0,10,mixedType,1
7,2,0,9,mixedType,1
4,4,0,8,mixedType,1
7,7,1,15,mixedType,2
8,2,0,10,mixedType,1
7,3,0,10,mixedType,1
14,2,0,16,mixedType,2
3,3,0,6,mixedType,0
5,3,0,8,mixedType,1
8,3,0,11,mixedType,1
4,5,0,9,mixedType,1
5,3,0,8,mixedType,1
7,3,0,10,mixedType,1
6,1,0,7,mixedType,0
7,1,0,8,mixedType,1
8,1,0,9,mixedType,1
5,3,0,8,mixedType,1
7,4,0,11,mixedType,1
7,3,0,10,mixedType,1
7,2,0,9,mixedType,1
8,3,0,11,mixedType,1
8,3,0,11,mixedType,1
5,3,0,8,mixedType,1
6,4,0,10,mixedType,1
5,3,0,8,mixedType,1
3,6,0,9,mixedType,1
6,3,0,9,mixedType,1
8,4,0,12,mixedType,1
4,4,0,8,mixedType,1
12,4,0,16,mixedType,2
6,3,0,9,mixedType,1
7,2,0,9,mixedType,1
8,3,0,11,mixedType,1
3,3,0,6,mixedType,0
13,3,0,16,mixedType,2
3,8,0,11,mixedType,1
15,1,0,16,mixedType,2
4,2,0,6,mixedType,0
14,2,0,16,mixedType,2
9,4,0,13,mixedType,1
7,3,0,10,mixedType,1
6,4,0,10,mixedType,1
9,1,0,10,mixedType,1
7,3,0,10,mixedType,1
19,1,1,21,mixedType,2
11,3,0,14,mixedType,2
4,2,0,6,mixedType,0
2,4,0,6,mixedType,0
6,3,0,9,mixedType,1
7,1,0,8,mixedType,1
9,1,0,10,mixedType,1
5,2,0,7,mixedType,0
8,2,0,10,mixedType,1
6,3,0,9,mixedType,1
6,2,0,8,mixedType,1
6,2,0,8,mixedType,1
3,6,0,9,mixedType,1
6,3,0,9,mixedType,1
7,2,0,9,mixedType,1
8,2,0,10,mixedType,1
9,2,0,11,mixedType,1
3,5,0,8,mixedType,1
4,4,0,8,mixedType,1
9,3,0,12,mixedType,1
10,4,0,14,mixedType,2
7,3,0,10,mixedType,1
4,8,0,12,mixedType,1
2,7,0,9,mixedType,1
6,3,0,9,mixedType,1
8,2,0,10,mixedType,1
5,2,0,7,mixedType,0
3,5,0,8,mixedType,1
4,2,0,6,mixedType,0
4,4,0,8,mixedType,1
3,7,0,10,mixedType,1
8,4,0,12,mixedType,1
8,1,0,9,mixedType,1
2,8,0,10,mixedType,1
15,1,0,16,mixedType,2
9,2,0,11,mixedType,1
13,3,0,16,mixedType,2
5,6,0,11,mixedType,1
6,1,0,7,mixedType,0
7,2,0,9,mixedType,1
6,2,0,8,mixedType,1
2,7,0,9,mixedType,1
5,2,0,7,mixedType,0
4,2,0,6,mixedType,0
2,6,0,8,mixedType,1
12,4,0,16,mixedType,2
6,4,0,10,mixedType,1
12,3,0,15,mixedType,2
8,2,0,10,mixedType,1
8,4,0,12,mixedType,1
4,5,0,9,mixedType,1
12,3,0,15,mixedType,2
15,1,0,16,mixedType,2
6,3,0,9,mixedType,1
4,2,0,6,mixedType,0
5,3,0,8,mixedType,1
5,1,0,6,mixedType,0
4,2,0,6,mixedType,0
6,3,0,9,mixedType,1
3,3,0,6,mixedType,0
3,7,0,10,mixedType,1
5,4,0,9,mixedType,1
1,9,0,10,mixedType,1
10,1,0,11,mixedType,1
13,3,0,16,mixedType,2
6,3,0,9,mixedType,1
2,6,0,8,mixedType,1
7,3,0,10,mixedType,1
11,0,1,12,mixedType,1
3,3,0,6,mixedType,0
10,3,0,13,mixedType,1
4,5,0,9,mixedType,1
7,3,0,10,mixedType,1
10,1,0,11,mixedType,1
5,4,0,9,mixedType,1
4,5,0,9,mixedType,1
4,2,0,6,mixedType,0
2,8,0,10,mixedType,1
10,4,0,14,mixedType,2
8,1,0,9,mixedType,1
7,4,0,11,mixedType,1
8,2,0,10,mixedType,1
8,1,0,9,mixedType,1
6,2,0,8,mixedType,1
8,2,0,10,mixedType,1
9,6,0,15,mixedType,2
7,2,0,9,mixedType,1
4,2,0,6,mixedType,0
9,2,0,11,mixedType,1
12,4,0,16,mixedType,2
7,2,0,9,mixedType,1
6,3,0,9,mixedType,1
9,3,0,12,mixedType,1
15,1,0,16,mixedType,2
6,3,0,9,mixedType,1
6,4,0,10,mixedType,1
8,2,0,10,mixedType,1
5,6,0,11,mixedType,1
8,2,0,10,mixedType,1
5,4,0,9,mixedType,1
5,2,0,7,mixedType,0
11,3,0,14,mixedType,2
6,2,0,8,mixedType,1
13,3,0,16,mixedType,2
6,3,0,9,mixedType,1
1,9,0,10,mixedType,1
7,1,0,8,mixedType,1
9,2,0,11,mixedType,1
6,4,0,10,mixedType,1
7,1,0,8,mixedType,1
3,6,0,9,mixedType,1
6,4,0,10,mixedType,1
6,4,0,10,mixedType,1
9,1,0,10,mixedType,1
6,1,0,7,mixedType,0
6,4,0,10,mixedType,1
9,5,0,14,mixedType,2
12,4,0,16,mixedType,2
4,4,0,8,mixedType,1
7,1,0,8,mixedType,1
7,3,0,10,mixedType,1
8,2,0,10,mixedType,1
5,3,0,8,mixedType,1
7,1,0,8,mixedType,1
6,1,0,7,mixedType,0
6,3,0,9,mixedType,1
7,3,0,10,mixedType,1
8,4,0,12,mixedType,1
7,3,0,10,mixedType,1
5,3,0,8,mixedType,1
7,2,0,9,mixedType,1
8,4,0,12,mixedType,1
1,9,0,10,mixedType,1
5,4,0,9,mixedType,1
5,2,0,7,mixedType,0
13,3,0,16,mixedType,2
5,3,0,8,mixedType,1
7,3,0,10,mixedType,1
11,3,0,14,mixedType,2
8,1,0,9,mixedType,1
8,2,0,10,mixedType,1
8,2,0,10,mixedType,1
4,8,0,12,mixedType,1
6,2,0,8,mixedType,1
4,2,0,6,mixedType,0
8,1,0,9,mixedType,1
8,1,0,9,mixedType,1
7,2,0,9,mixedType,1
7,4,0,11,mixedType,1
15,1,0,16,mixedType,2
1,8,0,9,mixedType,1
7,2,0,9,mixedType,1
14,2,0,16,mixedType,2
4,6,0,10,mixedType,1
9,1,0,10,mixedType,1
7,3,0,10,mixedType,1
6,2,0,8,mixedType,1
7,2,0,9,mixedType,1
2,8,0,10,mixedType,1
6,3,0,9,mixedType,1
8,2,0,10,mixedType,1
11,3,0,14,mixedType,2
5,3,0,8,mixedType,1
2,7,0,9,mixedType,1
7,2,0,9,mixedType,1
10,2,0,12,mixedType,1
12,4,0,16,mixedType,2
4,4,0,8,mixedType,1
5,2,0,7,mixedType,0
1,10,0,11,mixedType,1
6,2,0,8,mixedType,1
8,4,0,12,mixedType,1
8,4,0,12,mixedType,1
8,2,0,10,mixedType,1
6,3,0,9,mixedType,1
6,2,0,8,mixedType,1
8,2,0,10,mixedType,1
5,4,0,9,mixedType,1
5,6,0,11,mixedType,1
12,3,0,15,mixedType,2
6,3,0,9,mixedType,1
8,1,0,9,mixedType,1
6,6,0,12,mixedType,1
4,2,0,6,mixedType,0
3,6,0,9,mixedType,1
5,3,0,8,mixedType,1
4,2,0,6,mixedType,0
6,3,0,9,mixedType,1
6,3,0,9,mixedType,1
12,4,0,16,mixedType,2
5,2,0,7,mixedType,0
6,7,0,13,mixedType,1
0,4,3,7,mixedType,0
6,3,0,9,mixedType,1
8,2,0,10,mixedType,1
6,2,0,8,mixedType,1
12,4,0,16,mixedType,2
11,1,0,12,mixedType,1
9,1,0,10,mixedType,1
6,3,0,9,mixedType,1
6,1,0,7,mixedType,0
9,2,0,11,mixedType,1
9,4,0,13,mixedType,1
4,4,0,8,mixedType,1
4,4,0,8,mixedType,1
8,2,0,10,mixedType,1
3,6,0,9,mixedType,1
3,6,0,9,mixedType,1
8,1,0,9,mixedType,1
8,2,0,10,mixedType,1
14,2,0,16,mixedType,2
10,3,0,13,mixedType,1
5,5,0,10,mixedType,1
7,3,0,10,mixedType,1
9,1,0,10,mixedType,1
6,2,0,8,mixedType,1
8,3,0,11,mixedType,1
1,9,0,10,mixedType,1
5,2,0,7,mixedType,0
8,2,0,10,mixedType,1
6,3,0,9,mixedType,1
5,3,0,8,mixedType,1
13,3,0,16,mixedType,2
9,2,0,11,mixedType,1
5,4,0,9,mixedType,1
8,2,0,10,mixedType,1
7,3,0,10,mixedType,1
5,3,0,8,mixedType,1
5,3,0,8,mixedType,1
7,3,0,10,mixedType,1
14,2,0,16,mixedType,2
5,1,0,6,mixedType,0
15,1,0,16,mixedType,2
6,3,0,9,mixedType,1
7,0,0,7,sameType,0
6,4,0,10,mixedType,1
3,7,0,10,mixedType,1
2,7,0,9,mixedType,1
7,3,0,10,mixedType,1
8,2,0,10,mixedType,1
7,3,0,10,mixedType,1
4,5,0,9,mixedType,1
15,1,0,16,mixedType,2
8,2,0,10,mixedType,1
6,3,0,9,mixedType,1
6,3,0,9,mixedType,1
7,3,0,10,mixedType,1
3,3,0,6,mixedType,0
12,4,0,16,mixedType,2
5,3,0,8,mixedType,1
5,4,0,9,mixedType,1
5,3,0,8,mixedType,1
12,4,0,16,mixedType,2
6,1,0,7,mixedType,0
8,1,0,9,mixedType,1
11,3,0,14,mixedType,2
8,2,0,10,mixedType,1
5,6,0,11,mixedType,1
6,2,0,8,mixedType,1
13,3,0,16,mixedType,2
3,8,0,11,mixedType,1
7,1,0,8,mixedType,1
13,3,0,16,mixedType,2
6,2,0,8,mixedType,1
9,1,0,10,mixedType,1
12,1,1,14,mixedType,2
12,3,0,15,mixedType,2
8,4,0,12,mixedType,1
7,3,0,10,mixedType,1
5,6,0,11,mixedType,1
1,8,0,9,mixedType,1
6,2,0,8,mixedType,1
13,3,0,16,mixedType,2
5,3,0,8,mixedType,1
7,3,0,10,mixedType,1
8,1,0,9,mixedType,1
6,3,0,9,mixedType,1
6,4,0,10,mixedType,1
11,3,0,14,mixedType,2
12,1,0,13,mixedType,1
6,3,0,9,mixedType,1
3,3,0,6,mixedType,0
7,3,0,10,mixedType,1
6,3,0,9,mixedType,1
5,3,0,8,mixedType,1
11,5,0,16,mixedType,2
7,3,0,10,mixedType,1
5,2,0,7,mixedType,0
7,3,0,10,mixedType,1
4,2,0,6,mixedType,0
3,3,0,6,mixedType,0
9,2,0,11,mixedType,1
9,1,0,10,mixedType,1
1,7,0,8,mixedType,1
2,4,0,6,mixedType,0
7,2,0,9,mixedType,1
6,3,0,9,mixedType,1
6,3,0,9,mixedType,1
8,3,0,11,mixedType,1
7,3,0,10,mixedType,1
15,1,0,16,mixedType,2
6,3,0,9,mixedType,1
7,3,0,10,mixedType,1
8,3,0,11,mixedType,1
9,1,0,10,mixedType,1
7,1,0,8,mixedType,1
6,4,0,10,mixedType,1
4,8,0,12,mixedType,1
7,3,0,10,mixedType,1
7,2,0,9,mixedType,1
11,1,0,12,mixedType,1
5,4,0,9,mixedType,1
5,3,0,8,mixedType,1
3,6,0,9,mixedType,1
5,2,0,7,mixedType,0
7,4,0,11,mixedType,1
4,6,0,10,mixedType,1
3,5,0,8,mixedType,1
8,2,0,10,mixedType,1
6,1,0,7,mixedType,0
6,1,0,7,mixedType,0
5,3,0,8,mixedType,1
8,2,0,10,mixedType,1
4,4,0,8,mixedType,1
5,3,0,8,mixedType,1
3,3,0,6,mixedType,0
11,2,0,13,mixedType,1
2,7,0,9,mixedType,1
6,2,0,8,mixedType,1
5,2,0,7,mixedType,0
5,3,0,8,mixedType,1
5,6,0,11,mixedType,1
5,2,0,7,mixedType,0
8,2,0,10,mixedType,1
6,1,0,7,mixedType,0
7,2,0,9,mixedType,1
3,3,0,6,mixedType,0
4,4,0,8,mixedType,1
7,2,0,9,mixedType,1
5,1,0,6,mixedType,0
7,3,0,10,mixedType,1
8,2,0,10,mixedType,1
7,2,0,9,mixedType,1
4,2,0,6,mixedType,0
5,3,0,8,mixedType,1
6,4,0,10,mixedType,1
5,2,0,7,mixedType,0
1,7,0,8,mixedType,1
7,3,0,10,mixedType,1
12,4,0,16,mixedType,2
10,2,0,12,mixedType,1
6,8,1,15,mixedType,2
4,8,0,12,mixedType,1
6,2,0,8,mixedType,1
5,7,0,12,mixedType,1
6,2,0,8,mixedType,1
5,3,0,8,mixedType,1
5,2,0,7,mixedType,0
3,6,0,9,mixedType,1
5,5,0,10,mixedType,1
5,3,0,8,mixedType,1
3,5,0,8,mixedType,1
5,2,0,7,mixedType,0
6,4,0,10,mixedType,1
13,3,0,16,mixedType,2
4,6,0,10,mixedType,1
6,3,0,9,mixedType,1
7,1,0,8,mixedType,1
11,3,0,14,mixedType,2
2,7,0,9,mixedType,1
8,2,0,10,mixedType,1
5,3,0,8,mixedType,1
6,3,0,9,mixedType,1
7,1,0,8,mixedType,1
6,4,0,10,mixedType,1
7,1,0,8,mixedType,1
2,8,0,10,mixedType,1
6,3,0,9,mixedType,1
4,4,0,8,mixedType,1
5,1,0,6,mixedType,0
6,1,0,7,mixedType,0
4,2,0,6,mixedType,0
6,2,0,8,mixedType,1
6,3,0,9,mixedType,1
8,4,0,12,mixedType,1
5,1,0,6,mixedType,0
7,3,0,10,mixedType,1
15,1,0,16,mixedType,2
7,3,0,10,mixedType,1
4,4,0,8,mixedType,1
6,1,0,7,mixedType,0
6,1,0,7,mixedType,0
10,3,0,13,mixedType,1
7,2,0,9,mixedType,1
6,2,0,8,mixedType,1
9,1,0,10,mixedType,1
5,3,0,8,mixedType,1
1,8,0,9,mixedType,1
13,3,0,16,mixedType,2
6,1,0,7,mixedType,0
9,3,0,12,mixedType,1
6,4,0,10,mixedType,1
14,2,0,16,mixedType,2
9,4,0,13,mixedType,1
6,3,0,9,mixedType,1
6,2,0,8,mixedType,1
5,3,0,8,mixedType,1
8,8,0,16,mixedType,2
10,3,0,13,mixedType,1
7,1,0,8,mixedType,1
5,2,0,7,mixedType,0
7,2,0,9,mixedType,1
7,6,3,16,mixedType,2
11,2,1,14,mixedType,2
8,1,0,9,mixedType,1
8,1,0,9,mixedType,1
7,2,0,9,mixedType,1
5,3,0,8,mixedType,1
5,2,0,7,mixedType,0
12,3,0,15,mixedType,2
4,2,0,6,mixedType,0
6,2,0,8,mixedType,1
6,3,0,9,mixedType,1
5,3,0,8,mixedType,1
6,3,0,9,mixedType,1
6,2,0,8,mixedType,1
6,3,0,9,mixedType,1
8,2,0,10,mixedType,1
8,1,0,9,mixedType,1
7,2,0,9,mixedType,1
5,2,0,7,mixedType,0
5,0,1,6,mixedType,0
10,2,0,12,mixedType,1
8,1,0,9,mixedType,1
3,7,0,10,mixedType,1
9,1,0,10,mixedType,1
3,3,0,6,mixedType,0
5,6,0,11,mixedType,1
5,2,0,7,mixedType,0
9,2,0,11,mixedType,1
14,2,0,16,mixedType,2
12,3,0,15,mixedType,2
13,3,0,16,mixedType,2
7,2,0,9,mixedType,1
6,4,0,10,mixedType,1
6,8,0,14,mixedType,2
5,2,0,7,mixedType,0
5,4,0,9,mixedType,1
2,6,0,8,mixedType,1
7,3,0,10,mixedType,1
5,4,0,9,mixedType,1
15,1,0,16,mixedType,2
8,1,0,9,mixedType,1
6,1,0,7,mixedType,0
9,2,0,11,mixedType,1
7,2,0,9,mixedType,1
7,3,0,10,mixedType,1
2,7,0,9,mixedType,1
5,4,0,9,mixedType,1
8,3,0,11,mixedType,1
5,4,0,9,mixedType,1
7,1,0,8,mixedType,1
14,2,0,16,mixedType,2
3,5,0,8,mixedType,1
9,1,0,10,mixedType,1
7,3,0,10,mixedType,1
6,2,0,8,mixedType,1
1,8,0,9,mixedType,1
5,3,0,8,mixedType,1
5,4,0,9,mixedType,1
2,6,0,8,mixedType,1
12,4,0,16,mixedType,2
12,1,3,16,mixedType,2
8,1,0,9,mixedType,1
6,3,0,9,mixedType,1
5,2,0,7,mixedType,0
3,3,0,6,mixedType,0
7,3,0,10,mixedType,1
6,3,0,9,mixedType,1
1,8,0,9,mixedType,1
3,6,0,9,mixedType,1
3,8,0,11,mixedType,1
6,1,0,7,mixedType,0
2,8,0,10,mixedType,1
8,2,0,10,mixedType,1
7,2,0,9,mixedType,1
15,1,0,16,mixedType,2
6,4,0,10,mixedType,1
8,2,0,10,mixedType,1
8,1,0,9,mixedType,1
9,2,0,11,mixedType,1
6,1,0,7,mixedType,0
7,2,0,9,mixedType,1
3,6,0,9,mixedType,1
6,2,0,8,mixedType,1
12,4,0,16,mixedType,2
2,8,0,10,mixedType,1
6,2,0,8,mixedType,1
5,3,0,8,mixedType,1
9,3,0,12,mixedType,1
6,4,0,10,mixedType,1
5,1,0,6,mixedType,0
7,1,0,8,mixedType,1
5,2,0,7,mixedType,0
7,3,0,10,mixedType,1
7,2,0,9,mixedType,1
14,2,0,16,mixedType,2
9,3,0,12,mixedType,1
5,4,0,9,mixedType,1
4,2,0,6,mixedType,0
7,2,0,9,mixedType,1
15,1,0,16,mixedType,2
8,2,0,10,mixedType,1
6,4,0,10,mixedType,1
14,6,0,20,mixedType,2
9,3,0,12,mixedType,1
6,4,0,10,mixedType,1
5,2,0,7,mixedType,0
8,1,0,9,mixedType,1
8,2,0,10,mixedType,1
13,4,0,17,mixedType,2
12,4,0,16,mixedType,2
1,7,0,8,mixedType,1
14,2,0,16,mixedType,2
12,4,0,16,mixedType,2
6,3,0,9,mixedType,1
5,5,0,10,mixedType,1
5,4,0,9,mixedType,1
6,3,0,9,mixedType,1
6,4,0,10,mixedType,1
6,1,0,7,mixedType,0
4,4,0,8,mixedType,1
5,4,0,9,mixedType,1
7,3,0,10,mixedType,1
7,2,0,9,mixedType,1
8,2,0,10,mixedType,1
8,3,0,11,mixedType,1
6,3,0,9,mixedType,1
12,3,0,15,mixedType,2
15,1,0,16,mixedType,2
7,2,0,9,mixedType,1
5,3,0,8,mixedType,1
6,1,0,7,mixedType,0
7,1,0,8,mixedType,1
15,1,0,16,mixedType,2
6,2,0,8,mixedType,1
2,8,0,10,mixedType,1
5,2,0,7,mixedType,0
7,2,0,9,mixedType,1
6,4,0,10,mixedType,1
5,4,0,9,mixedType,1
5,3,0,8,mixedType,1
6,6,0,12,mixedType,1
8,1,0,9,mixedType,1
13,3,0,16,mixedType,2
1,10,0,11,mixedType,1
6,1,0,7,mixedType,0
8,2,0,10,mixedType,1
8,1,0,9,mixedType,1
7,3,0,10,mixedType,1
8,1,0,9,mixedType,1
1,8,0,9,mixedType,1
1,8,0,9,mixedType,1
6,2,0,8,mixedType,1
6,2,0,8,mixedType,1
7,3,0,10,mixedType,1
5,1,0,6,mixedType,0
2,9,0,11,mixedType,1
6,2,0,8,mixedType,1
8,4,0,12,mixedType,1
5,2,0,7,mixedType,0
1,9,0,10,mixedType,1
8,2,0,10,mixedType,1
5,3,0,8,mixedType,1
4,2,0,6,mixedType,0
10,2,0,12,mixedType,1
14,2,0,16,mixedType,2
7,3,0,10,mixedType,1
2,8,0,10,mixedType,1
7,3,0,10,mixedType,1
10,2,0,12,mixedType,1
9,1,0,10,mixedType,1
6,4,0,10,mixedType,1
6,4,0,10,mixedType,1
1,7,0,8,mixedType,1
8,3,0,11,mixedType,1
6,2,0,8,mixedType,1
4,5,0,9,mixedType,1
6,1,0,7,mixedType,0
7,2,0,9,mixedType,1
1,7,0,8,mixedType,1
4,2,0,6,mixedType,0
4,4,0,8,mixedType,1
6,1,0,7,mixedType,0
5,4,0,9,mixedType,1
8,4,0,12,mixedType,1
6,2,0,8,mixedType,1
6,2,0,8,mixedType,1
6,7,0,13,mixedType,1
2,4,0,6,mixedType,0
7,3,0,10,mixedType,1
9,2,0,11,mixedType,1
7,3,0,10,mixedType,1
4,6,0,10,mixedType,1
8,1,0,9,mixedType,1
6,3,0,9,mixedType,1
27,3,0,30,mixedType,2
6,5,0,11,mixedType,1
6,3,0,9,mixedType,1
5,6,0,11,mixedType,1
6,2,0,8,mixedType,1
11,5,0,16,mixedType,2
7,3,0,10,mixedType,1
5,4,0,9,mixedType,1
8,4,0,12,mixedType,1
7,3,0,10,mixedType,1
5,9,0,14,mixedType,2
6,3,0,9,mixedType,1
5,2,0,7,mixedType,0
2,6,0,8,mixedType,1
9,1,0,10,mixedType,1
9,1,0,10,mixedType,1
4,2,0,6,mixedType,0
6,2,0,8,mixedType,1
1,6,0,7,mixedType,0
5,8,0,13,mixedType,1
5,4,0,9,mixedType,1
5,4,0,9,mixedType,1
8,1,0,9,mixedType,1
11,1,0,12,mixedType,1
2,6,0,8,mixedType,1
5,2,0,7,mixedType,0
7,3,0,10,mixedType,1
6,3,0,9,mixedType,1
7,1,0,8,mixedType,1
6,4,0,10,mixedType,1
6,3,0,9,mixedType,1
6,2,0,8,mixedType,1
10,2,0,12,mixedType,1
5,1,0,6,mixedType,0
11,1,0,12,mixedType,1
12,4,0,16,mixedType,2
6,4,0,10,mixedType,1
8,2,0,10,mixedType,1
6,3,0,9,mixedType,1
10,4,1,15,mixedType,2
5,2,0,7,mixedType,0
7,1,0,8,mixedType,1
13,3,0,16,mixedType,2
6,3,0,9,mixedType,1
8,2,0,10,mixedType,1
7,3,0,10,mixedType,1
2,4,0,6,mixedType,0
7,4,0,11,mixedType,1
9,3,0,12,mixedType,1
12,4,3,19,mixedType,2
3,6,0,9,mixedType,1
14,2,0,16,mixedType,2
3,6,0,9,mixedType,1
4,4,0,8,mixedType,1
7,3,0,10,mixedType,1
8,2,0,10,mixedType,1
4,2,0,6,mixedType,0
6,3,0,9,mixedType,1
3,3,0,6,mixedType,0
4,2,0,6,mixedType,0
6,3,0,9,mixedType,1
7,2,0,9,mixedType,1
1,7,0,8,mixedType,1
4,5,0,9,mixedType,1
1,9,0,10,mixedType,1
6,1,0,7,mixedType,0
4,2,0,6,mixedType,0
12,3,0,15,mixedType,2
2,4,0,6,mixedType,0
5,4,0,9,mixedType,1
5,1,0,6,mixedType,0
4,4,0,8,mixedType,1
5,1,0,6,mixedType,0
5,3,0,8,mixedType,1
6,2,0,8,mixedType,1
6,1,0,7,mixedType,0
3,8,0,11,mixedType,1
7,3,0,10,mixedType,1
7,2,0,9,mixedType,1
6,4,0,10,mixedType,1
12,3,0,15,mixedType,2
5,4,0,9,mixedType,1
12,4,0,16,mixedType,2
9,4,0,13,mixedType,1
6,1,0,7,mixedType,0
3,6,0,9,mixedType,1
5,3,0,8,mixedType,1
6,1,0,7,mixedType,0
7,3,0,10,mixedType,1
2,8,0,10,mixedType,1
7,3,0,10,mixedType,1
1,8,0,9,mixedType,1
5,3,0,8,mixedType,1
14,2,0,16,mixedType,2
2,4,0,6,mixedType,0
8,1,0,9,mixedType,1
6,4,0,10,mixedType,1
7,3,0,10,mixedType,1
6,3,0,9,mixedType,1
7,3,0,10,mixedType,1
5,3,0,8,mixedType,1
15,1,0,16,mixedType,2
9,2,0,11,mixedType,1
6,1,0,7,mixedType,0
4,2,0,6,mixedType,0
8,1,0,9,mixedType,1
2,9,0,11,mixedType,1
8,2,0,10,mixedType,1
6,4,0,10,mixedType,1
8,3,0,11,mixedType,1
4,2,0,6,mixedType,0
7,1,0,8,mixedType,1
7,3,0,10,mixedType,1
8,2,0,10,mixedType,1
9,2,0,11,mixedType,1
1,8,0,9,mixedType,1
7,4,0,11,mixedType,1
7,3,0,10,mixedType,1
15,1,0,16,mixedType,2
4,6,0,10,mixedType,1
3,6,0,9,mixedType,1
8,2,0,10,mixedType,1
6,3,0,9,mixedType,1
7,4,0,11,mixedType,1
4,8,0,12,mixedType,1
6,4,0,10,mixedType,1
5,4,0,9,mixedType,1
5,3,0,8,mixedType,1
9,1,0,10,mixedType,1
5,3,0,8,mixedType,1
6,3,0,9,mixedType,1
7,2,0,9,mixedType,1
2,6,0,8,mixedType,1
3,8,0,11,mixedType,1
6,4,0,10,mixedType,1
4,2,0,6,mixedType,0
4,4,0,8,mixedType,1
6,1,0,7,mixedType,0
7,3,0,10,mixedType,1
3,3,0,6,mixedType,0
7,3,0,10,mixedType,1
5,3,0,8,mixedType,1
7,2,0,9,mixedType,1
1,8,0,9,mixedType,1
6,3,0,9,mixedType,1
6,1,0,7,mixedType,0
9,1,0,10,mixedType,1
5,1,0,6,mixedType,0
6,4,0,10,mixedType,1
8,2,0,10,mixedType,1
1,9,0,10,mixedType,1
6,4,0,10,mixedType,1
8,1,0,9,mixedType,1
9,1,0,10,mixedType,1
11,2,0,13,mixedType,1
7,2,0,9,mixedType,1
5,6,0,11,mixedType,1
4,6,0,10,mixedType,1
5,2,0,7,mixedType,0
6,4,0,10,mixedType,1
8,4,0,12,mixedType,1
5,6,0,11,mixedType,1
15,1,1,17,mixedType,2
14,2,0,16,mixedType,2
3,6,0,9,mixedType,1
6,3,0,9,mixedType,1
7,2,0,9,mixedType,1
12,4,0,16,mixedType,2
6,3,0,9,mixedType,1
1,8,0,9,mixedType,1
4,2,0,6,mixedType,0
8,3,0,11,mixedType,1
1,5,0,6,mixedType,0
13,3,0,16,mixedType,2
6,1,0,7,mixedType,0
8,1,0,9,mixedType,1
8,1,0,9,mixedType,1
4,2,0,6,mixedType,0
7,1,0,8,mixedType,1
7,2,0,9,mixedType,1
5,3,0,8,mixedType,1
5,3,0,8,mixedType,1
7,2,0,9,mixedType,1
7,3,0,10,mixedType,1
7,2,0,9,mixedType,1
7,2,0,9,mixedType,1
7,3,0,10,mixedType,1
4,4,0,8,mixedType,1
6,3,0,9,mixedType,1
6,2,0,8,mixedType,1
5,3,0,8,mixedType,1
6,3,0,9,mixedType,1
4,4,0,8,mixedType,1
6,3,0,9,mixedType,1
5,4,0,9,mixedType,1
4,4,0,8,mixedType,1
7,3,0,10,mixedType,1
5,4,0,9,mixedType,1
9,1,0,10,mixedType,1
4,2,0,6,mixedType,0
2,6,0,8,mixedType,1
5,1,0,6,mixedType,0
14,2,0,16,mixedType,2
7,0,0,7,sameType,0
1,6,0,7,mixedType,0
6,3,0,9,mixedType,1
6,4,0,10,mixedType,1
9,2,0,11,mixedType,1
7,3,0,10,mixedType,1
3,6,0,9,mixedType,1
5,2,0,7,mixedType,0
11,2,0,13,mixedType,1
5,3,0,8,mixedType,1
6,5,0,11,mixedType,1
5,3,0,8,mixedType,1
12,4,0,16,mixedType,2
15,1,0,16,mixedType,2
6,2,0,8,mixedType,1
6,2,0,8,mixedType,1
5,4,0,9,mixedType,1
1,8,0,9,mixedType,1
6,2,0,8,mixedType,1
7,3,0,10,mixedType,1
5,2,0,7,mixedType,0
1,11,0,12,mixedType,1
10,4,0,14,mixedType,2
5,2,0,7,mixedType,0
9,4,0,13,mixedType,1
23,1,1,25,mixedType,2
8,2,0,10,mixedType,1
6,3,0,9,mixedType,1
8,4,0,12,mixedType,1
11,3,1,15,mixedType,2
3,5,0,8,mixedType,1
7,2,0,9,mixedType,1
6,3,0,9,mixedType,1
7,2,0,9,mixedType,1
4,4,0,8,mixedType,1
7,3,0,10,mixedType,1
6,4,0,10,mixedType,1
3,5,0,8,mixedType,1
7,2,0,9,mixedType,1
9,2,0,11,mixedType,1
6,2,0,8,mixedType,1
8,2,0,10,mixedType,1
5,1,0,6,mixedType,0
5,2,0,7,mixedType,0
6,1,0,7,mixedType,0
14,2,0,16,mixedType,2
8,2,0,10,mixedType,1
5,2,0,7,mixedType,0
8,6,0,14,mixedType,2
8,2,0,10,mixedType,1
10,2,0,12,mixedType,1
5,3,0,8,mixedType,1
5,4,0,9,mixedType,1
8,3,0,11,mixedType,1
9,3,2,14,mixedType,2
8,1,0,9,mixedType,1
8,3,0,11,mixedType,1
4,2,0,6,mixedType,0
4,4,0,8,mixedType,1
10,2,0,12,mixedType,1
0,5,2,7,mixedType,0
8,2,0,10,mixedType,1
6,4,0,10,mixedType,1
6,3,0,9,mixedType,1
6,3,0,9,mixedType,1
4,4,0,8,mixedType,1
8,2,0,10,mixedType,1
2,8,0,10,mixedType,1
3,6,0,9,mixedType,1
6,2,0,8,mixedType,1
6,3,0,9,mixedType,1
7,2,0,9,mixedType,1
8,1,0,9,mixedType,1
12,4,0,16,mixedType,2
6,3,0,9,mixedType,1
6,3,0,9,mixedType,1
4,5,0,9,mixedType,1
15,1,0,16,mixedType,2
5,4,0,9,mixedType,1
6,4,0,10,mixedType,1
7,1,0,8,mixedType,1
8,2,0,10,mixedType,1
1,12,0,13,mixedType,1
5,3,0,8,mixedType,1
7,2,0,9,mixedType,1
6,2,0,8,mixedType,1
9,1,0,10,mixedType,1
4,2,0,6,mixedType,0
6,3,0,9,mixedType,1
5,0,1,6,mixedType,0
8,5,0,13,mixedType,1
4,2,0,6,mixedType,0
3,10,0,13,mixedType,1
14,2,0,16,mixedType,2
4,4,0,8,mixedType,1
8,1,0,9,mixedType,1
7,4,0,11,mixedType,1
5,1,0,6,mixedType,0
6,3,0,9,mixedType,1
9,1,0,10,mixedType,1
6,4,0,10,mixedType,1
5,2,0,7,mixedType,0
5,3,0,8,mixedType,1
5,2,0,7,mixedType,0
7,1,0,8,mixedType,1
6,1,0,7,mixedType,0
4,2,0,6,mixedType,0
12,4,0,16,mixedType,2
6,1,0,7,mixedType,0
5,3,0,8,mixedType,1
6,2,0,8,mixedType,1
5,4,0,9,mixedType,1
6,3,0,9,mixedType,1
10,1,0,11,mixedType,1
6,3,0,9,mixedType,1
15,1,0,16,mixedType,2
10,1,0,11,mixedType,1
14,2,0,16,mixedType,2
8,2,0,10,mixedType,1
15,1,0,16,mixedType,2
4,2,0,6,mixedType,0
8,1,0,9,mixedType,1
10,1,0,11,mixedType,1
8,3,0,11,mixedType,1
8,3,0,11,mixedType,1
7,3,0,10,mixedType,1
4,4,0,8,mixedType,1
5,2,0,7,mixedType,0
5,3,0,8,mixedType,1
7,3,0,10,mixedType,1
5,1,0,6,mixedType,0
14,2,0,16,mixedType,2
7,1,0,8,mixedType,1
8,2,0,10,mixedType,1
5,1,0,6,mixedType,0
6,2,0,8,mixedType,1
3,7,0,10,mixedType,1
13,3,0,16,mixedType,2
10,4,1,15,mixedType,2
1,8,0,9,mixedType,1
8,2,0,10,mixedType,1
5,4,0,9,mixedType,1
3,3,0,6,mixedType,0
7,3,0,10,mixedType,1
5,3,0,8,mixedType,1
10,3,0,13,mixedType,1
4,5,0,9,mixedType,1
7,2,0,9,mixedType,1
14,2,0,16,mixedType,2
7,2,0,9,mixedType,1
14,2,0,16,mixedType,2
12,4,0,16,mixedType,2
6,3,0,9,mixedType,1
6,4,0,10,mixedType,1
6,3,0,9,mixedType,1
6,4,0,10,mixedType,1
8,1,0,9,mixedType,1
8,2,0,10,mixedType,1
10,2,0,12,mixedType,1
1,8,0,9,mixedType,1
2,4,0,6,mixedType,0
13,3,0,16,mixedType,2
7,1,0,8,mixedType,1
14,2,0,16,mixedType,2
1,9,0,10,mixedType,1
5,3,0,8,mixedType,1
10,6,0,16,mixedType,2
6,6,0,12,mixedType,1
4,5,0,9,mixedType,1
7,1,0,8,mixedType,1
8,1,0,9,mixedType,1
8,1,0,9,mixedType,1
5,8,1,14,mixedType,2
15,1,0,16,mixedType,2
8,3,0,11,mixedType,1
13,2,1,16,mixedType,2
6,4,0,10,mixedType,1
8,3,0,11,mixedType,1
3,6,0,9,mixedType,1
5,1,0,6,mixedType,0
6,0,1,7,mixedType,0
5,5,0,10,mixedType,1
8,3,0,11,mixedType,1
4,6,0,10,mixedType,1
3,3,0,6,mixedType,0
6,1,0,7,mixedType,0
9,3,0,12,mixedType,1
4,2,0,6,mixedType,0
5,4,0,9,mixedType,1
8,1,0,9,mixedType,1
6,2,0,8,mixedType,1
4,9,0,13,mixedType,1
10,1,0,11,mixedType,1
11,3,0,14,mixedType,2
8,2,0,10,mixedType,1
6,4,0,10,mixedType,1
2,8,0,10,mixedType,1
10,2,0,12,mixedType,1
6,4,0,10,mixedType,1
12,4,0,16,mixedType,2
1,9,0,10,mixedType,1
9,5,0,14,mixedType,2
10,2,0,12,mixedType,1
1,8,0,9,mixedType,1
11,2,0,13,mixedType,1
7,3,0,10,mixedType,1
6,4,0,10,mixedType,1
11,1,0,12,mixedType,1
6,2,0,8,mixedType,1
9,4,0,13,mixedType,1
5,4,0,9,mixedType,1
7,4,0,11,mixedType,1
7,3,0,10,mixedType,1
9,1,0,10,mixedType,1
13,3,0,16,mixedType,2
8,1,0,9,mixedType,1
4,2,0,6,mixedType,0
7,3,0,10,mixedType,1
8,1,0,9,mixedType,1
8,2,0,10,mixedType,1
6,4,0,10,mixedType,1
8,2,0,10,mixedType,1
6,3,0,9,mixedType,1
6,1,0,7,mixedType,0
7,3,0,10,mixedType,1
1,10,0,11,mixedType,1
7,3,0,10,mixedType,1
4,6,0,10,mixedType,1
5,2,0,7,mixedType,0
6,1,0,7,mixedType,0
5,2,0,7,mixedType,0
6,2,0,8,mixedType,1
7,3,0,10,mixedType,1
4,2,0,6,mixedType,0
8,2,0,10,mixedType,1
10,4,0,14,mixedType,2
6,3,0,9,mixedType,1
5,4,0,9,mixedType,1
4,4,0,8,mixedType,1
5,3,0,8,mixedType,1
6,2,0,8,mixedType,1
3,3,0,6,mixedType,0
6,3,0,9,mixedType,1
9,2,0,11,mixedType,1
3,8,0,11,mixedType,1
4,4,0,8,mixedType,1
8,3,0,11,mixedType,1
5,3,0,8,mixedType,1
11,2,0,13,mixedType,1
1,7,0,8,mixedType,1
6,3,0,9,mixedType,1
10,4,0,14,mixedType,2
3,8,0,11,mixedType,1
8,1,0,9,mixedType,1
7,3,0,10,mixedType,1
9,2,0,11,mixedType,1
14,2,0,16,mixedType,2
15,1,0,16,mixedType,2
13,3,0,16,mixedType,2
14,2,0,16,mixedType,2
12,4,0,16,mixedType,2
6,3,0,9,mixedType,1
6,2,0,8,mixedType,1
8,2,0,10,mixedType,1
8,2,0,10,mixedType,1
10,2,2,14,mixedType,2
4,5,0,9,mixedType,1
5,2,0,7,mixedType,0
8,1,0,9,mixedType,1
9,1,0,10,mixedType,1
6,2,0,8,mixedType,1
14,2,0,16,mixedType,2
4,2,0,6,mixedType,0
15,6,0,21,mixedType,2
5,3,0,8,mixedType,1
8,4,0,12,mixedType,1
5,2,0,7,mixedType,0
5,3,0,8,mixedType,1
5,1,0,6,mixedType,0
1,11,0,12,mixedType,1
0,7,1,8,mixedType,1
8,2,0,10,mixedType,1
6,2,0,8,mixedType,1
3,9,0,12,mixedType,1
6,2,0,8,mixedType,1
5,3,0,8,mixedType,1
1,12,0,13,mixedType,1
5,4,0,9,mixedType,1
3,8,0,11,mixedType,1
9,1,0,10,mixedType,1
5,3,0,8,mixedType,1
8,1,0,9,mixedType,1
7,4,0,11,mixedType,1
2,4,0,6,mixedType,0
7,2,0,9,mixedType,1
5,4,0,9,mixedType,1
13,3,0,16,mixedType,2
7,2,0,9,mixedType,1
7,2,0,9,mixedType,1
5,8,0,13,mixedType,1
6,1,0,7,mixedType,0
5,3,0,8,mixedType,1
8,1,0,9,mixedType,1
5,1,0,6,mixedType,0
8,1,0,9,mixedType,1
5,5,0,10,mixedType,1
13,3,0,16,mixedType,2
3,6,0,9,mixedType,1
4,5,0,9,mixedType,1
6,7,0,13,mixedType,1
9,1,0,10,mixedType,1
3,5,0,8,mixedType,1
15,1,0,16,mixedType,2
7,2,0,9,mixedType,1
5,3,0,8,mixedType,1
7,4,0,11,mixedType,1
2,9,0,11,mixedType,1
6,3,0,9,mixedType,1
6,1,0,7,mixedType,0
4,6,0,10,mixedType,1
4,6,0,10,mixedType,1
10,1,0,11,mixedType,1
3,10,2,15,mixedType,2
6,4,0,10,mixedType,1
6,2,0,8,mixedType,1
6,2,0,8,mixedType,1
4,2,0,6,mixedType,0
8,4,0,12,mixedType,1
2,9,0,11,mixedType,1
14,2,0,16,mixedType,2
8,1,0,9,mixedType,1
7,2,0,9,mixedType,1
6,4,0,10,mixedType,1
5,2,0,7,mixedType,0
5,4,0,9,mixedType,1
5,3,0,8,mixedType,1
12,1,1,14,mixedType,2
6,3,0,9,mixedType,1
8,2,0,10,mixedType,1
4,4,0,8,mixedType,1
14,1,0,15,mixedType,2
6,3,0,9,mixedType,1
5,2,0,7,mixedType,0
5,4,0,9,mixedType,1
7,1,0,8,mixedType,1
8,2,0,10,mixedType,1
5,4,0,9,mixedType,1
7,3,0,10,mixedType,1
7,1,0,8,mixedType,1
4,4,0,8,mixedType,1
12,3,0,15,mixedType,2
6,3,0,9,mixedType,1
4,6,0,10,mixedType,1
7,6,1,14,mixedType,2
4,2,0,6,mixedType,0
5,3,0,8,mixedType,1
5,2,0,7,mixedType,0
7,2,0,9,mixedType,1
14,4,2,20,mixedType,2
8,3,0,11,mixedType,1
6,1,0,7,mixedType,0
7,3,0,10,mixedType,1
7,3,0,10,mixedType,1
8,4,0,12,mixedType,1
5,4,0,9,mixedType,1
3,7,0,10,mixedType,1
8,1,0,9,mixedType,1
6,2,0,8,mixedType,1
1,8,0,9,mixedType,1
7,3,0,10,mixedType,1
2,6,0,8,mixedType,1
5,3,0,8,mixedType,1
8,2,0,10,mixedType,1
5,3,0,8,mixedType,1
4,8,0,12,mixedType,1
5,3,0,8,mixedType,1
13,3,0,16,mixedType,2
14,2,0,16,mixedType,2
7,1,0,8,mixedType,1
3,7,0,10,mixedType,1
6,3,0,9,mixedType,1
5,2,0,7,mixedType,0
9,2,0,11,mixedType,1
5,3,0,8,mixedType,1
2,8,0,10,mixedType,1
6,3,0,9,mixedType,1
7,3,0,10,mixedType,1
9,2,0,11,mixedType,1
15,1,0,16,mixedType,2
5,4,0,9,mixedType,1
12,4,0,16,mixedType,2
5,4,0,9,mixedType,1
7,2,0,9,mixedType,1
9,4,0,13,mixedType,1
7,2,0,9,mixedType,1
8,1,0,9,mixedType,1
3,3,0,6,mixedType,0
9,1,0,10,mixedType,1
6,3,0,9,mixedType,1
6,2,0,8,mixedType,1
8,3,0,11,mixedType,1
8,1,0,9,mixedType,1
5,4,0,9,mixedType,1
3,7,0,10,mixedType,1
5,4,0,9,mixedType,1
7,2,0,9,mixedType,1
12,4,0,16,mixedType,2
4,6,0,10,mixedType,1
7,1,0,8,mixedType,1
7,3,0,10,mixedType,1
9,2,0,11,mixedType,1
6,3,0,9,mixedType,1
12,4,0,16,mixedType,2
7,3,0,10,mixedType,1
3,6,0,9,mixedType,1
4,6,0,10,mixedType,1
10,2,0,12,mixedType,1
15,1,0,16,mixedType,2
4,6,0,10,mixedType,1
6,3,0,9,mixedType,1
4,6,0,10,mixedType,1
1,8,0,9,mixedType,1
6,2,0,8,mixedType,1
8,2,0,10,mixedType,1
7,4,0,11,mixedType,1
5,2,0,7,mixedType,0
15,1,0,16,mixedType,2
5,2,0,7,mixedType,0
7,3,0,10,mixedType,1
10,6,0,16,mixedType,2
8,1,0,9,mixedType,1
7,2,0,9,mixedType,1
7,4,0,11,mixedType,1
9,2,0,11,mixedType,1
5,2,0,7,mixedType,0
8,3,0,11,mixedType,1
13,2,0,15,mixedType,2
4,2,0,6,mixedType,0
8,1,0,9,mixedType,1
3,7,0,10,mixedType,1
6,2,0,8,mixedType,1
5,2,0,7,mixedType,0
8,2,0,10,mixedType,1
8,4,0,12,mixedType,1
6,2,0,8,mixedType,1
11,3,0,14,mixedType,2
5,7,0,12,mixedType,1
5,3,0,8,mixedType,1
6,2,0,8,mixedType,1
6,1,0,7,mixedType,0
8,2,0,10,mixedType,1
13,3,0,16,mixedType,2
12,3,0,15,mixedType,2
5,3,0,8,mixedType,1
5,4,0,9,mixedType,1
3,6,0,9,mixedType,1
5,2,0,7,mixedType,0
6,4,0,10,mixedType,1
8,4,0,12,mixedType,1
5,2,0,7,mixedType,0
12,3,0,15,mixedType,2
9,1,0,10,mixedType,1
9,0,1,10,mixedType,1
15,1,0,16,mixedType,2
4,4,0,8,mixedType,1
6,3,0,9,mixedType,1
14,2,0,16,mixedType,2
12,4,0,16,mixedType,2
7,6,0,13,mixedType,1
5,1,0,6,mixedType,0
5,2,0,7,mixedType,0
7,3,0,10,mixedType,1
7,3,0,10,mixedType,1
7,3,0,10,mixedType,1
5,1,0,6,mixedType,0
5,3,0,8,mixedType,1
6,3,0,9,mixedType,1
3,7,0,10,mixedType,1
6,5,0,11,mixedType,1
5,4,0,9,mixedType,1
13,3,0,16,mixedType,2
4,2,0,6,mixedType,0
2,4,0,6,mixedType,0
6,2,0,8,mixedType,1
1,8,0,9,mixedType,1
6,5,0,11,mixedType,1
8,3,0,11,mixedType,1
12,4,0,16,mixedType,2
6,6,0,12,mixedType,1
8,1,0,9,mixedType,1
4,4,0,8,mixedType,1
8,3,0,11,mixedType,1
7,2,0,9,mixedType,1
1,8,0,9,mixedType,1
7,6,0,13,mixedType,1
6,2,0,8,mixedType,1
5,3,0,8,mixedType,1
9,3,0,12,mixedType,1
8,2,0,10,mixedType,1
9,2,0,11,mixedType,1
8,2,0,10,mixedType,1
6,3,0,9,mixedType,1
5,4,0,9,mixedType,1
13,3,0,16,mixedType,2
11,3,0,14,mixedType,2
9,1,0,10,mixedType,1
4,4,0,8,mixedType,1
1,8,0,9,mixedType,1
11,5,0,16,mixedType,2
7,3,0,10,mixedType,1
6,3,0,9,mixedType,1
3,8,0,11,mixedType,1
4,10,0,14,mixedType,2
5,3,0,8,mixedType,1
7,3,0,10,mixedType,1
1,11,0,12,mixedType,1
7,3,0,10,mixedType,1
6,4,0,10,mixedType,1
4,9,0,13,mixedType,1
7,4,0,11,mixedType,1
3,6,0,9,mixedType,1
8,1,0,9,mixedType,1
4,2,0,6,mixedType,0
6,1,0,7,mixedType,0
9,1,0,10,mixedType,1
8,1,0,9,mixedType,1
6,3,0,9,mixedType,1
4,5,0,9,mixedType,1
6,3,0,9,mixedType,1
3,5,0,8,mixedType,1
13,3,0,16,mixedType,2
2,6,0,8,mixedType,1
4,6,0,10,mixedType,1
4,4,0,8,mixedType,1
3,10,0,13,mixedType,1
6,4,0,10,mixedType,1
10,6,0,16,mixedType,2
8,2,0,10,mixedType,1
6,4,0,10,mixedType,1
6,3,0,9,mixedType,1
6,3,0,9,mixedType,1
10,2,0,12,mixedType,1
8,4,0,12,mixedType,1
6,2,0,8,mixedType,1
4,4,0,8,mixedType,1
3,3,0,6,mixedType,0
7,1,0,8,mixedType,1
9,2,0,11,mixedType,1
13,3,0,16,mixedType,2
8,2,0,10,mixedType,1
9,1,0,10,mixedType,1
7,3,0,10,mixedType,1
7,3,0,10,mixedType,1
7,3,0,10,mixedType,1
6,4,0,10,mixedType,1
8,1,0,9,mixedType,1
5,3,0,8,mixedType,1
5,6,0,11,mixedType,1
6,2,0,8,mixedType,1
5,1,0,6,mixedType,0
5,1,0,6,mixedType,0
22,5,3,30,mixedType,2
7,2,0,9,mixedType,1
1,11,0,12,mixedType,1
7,3,0,10,mixedType,1
6,4,0,10,mixedType,1
14,2,0,16,mixedType,2
8,1,0,9,mixedType,1
7,1,0,8,mixedType,1
8,1,0,9,mixedType,1
11,1,0,12,mixedType,1
5,0,0,5,sameType,0
12,3,0,15,mixedType,2
8,2,0,10,mixedType,1
1,7,0,8,mixedType,1
1,10,0,11,mixedType,1
8,2,0,10,mixedType,1
6,3,0,9,mixedType,1
4,2,0,6,mixedType,0
7,4,0,11,mixedType,1
3,7,0,10,mixedType,1
6,2,0,8,mixedType,1
6,3,0,9,mixedType,1
6,2,0,8,mixedType,1
6,2,0,8,mixedType,1
6,3,0,9,mixedType,1
12,4,0,16,mixedType,2
3,8,0,11,mixedType,1
6,2,0,8,mixedType,1
6,2,0,8,mixedType,1
8,3,0,11,mixedType,1
7,3,0,10,mixedType,1
3,6,0,9,mixedType,1
4,2,0,6,mixedType,0
6,1,0,7,mixedType,0
6,3,0,9,mixedType,1
13,3,0,16,mixedType,2
5,1,0,6,mixedType,0
5,4,0,9,mixedType,1
7,3,0,10,mixedType,1
6,2,0,8,mixedType,1
4,2,0,6,mixedType,0
7,3,0,10,mixedType,1
5,3,0,8,mixedType,1
3,5,0,8,mixedType,1
6,1,0,7,mixedType,0
4,4,0,8,mixedType,1
5,4,0,9,mixedType,1
9,4,0,13,mixedType,1
13,3,0,16,mixedType,2
8,2,0,10,mixedType,1
9,1,0,10,mixedType,1
6,3,0,9,mixedType,1
8,2,0,10,mixedType,1
13,3,0,16,mixedType,2
9,2,0,11,mixedType,1
1,7,0,8,mixedType,1
6,4,0,10,mixedType,1
6,3,0,9,mixedType,1
6,1,0,7,mixedType,0
9,2,0,11,mixedType,1
5,11,0,16,mixedType,2
14,2,1,17,mixedType,2
4,4,0,8,mixedType,1
7,4,0,11,mixedType,1
7,3,0,10,mixedType,1
7,3,0,10,mixedType,1
4,6,0,10,mixedType,1
8,1,0,9,mixedType,1
1,8,0,9,mixedType,1
4,2,0,6,mixedType,0
8,1,0,9,mixedType,1
5,1,0,6,mixedType,0
11,2,0,13,mixedType,1
3,6,0,9,mixedType,1
14,2,0,16,mixedType,2
8,2,0,10,mixedType,1
5,3,0,8,mixedType,1
5,2,0,7,mixedType,0
4,2,0,6,mixedType,0
4,2,0,6,mixedType,0
8,2,0,10,mixedType,1
9,1,0,10,mixedType,1
7,2,0,9,mixedType,1
6,3,0,9,mixedType,1
1,9,0,10,mixedType,1
4,8,0,12,mixedType,1
5,3,0,8,mixedType,1
13,3,0,16,mixedType,2
6,4,0,10,mixedType,1
7,3,0,10,mixedType,1
10,1,0,11,mixedType,1
6,3,0,9,mixedType,1
7,4,0,11,mixedType,1
5,4,0,9,mixedType,1
15,1,0,16,mixedType,2
6,3,0,9,mixedType,1
11,3,0,14,mixedType,2
5,3,0,8,mixedType,1
7,2,0,9,mixedType,1
14,2,0,16,mixedType,2
8,4,0,12,mixedType,1
8,2,0,10,mixedType,1
6,1,0,7,mixedType,0
5,2,0,7,mixedType,0
5,2,0,7,mixedType,0
9,2,0,11,mixedType,1
15,1,0,16,mixedType,2
7,4,0,11,mixedType,1
8,1,0,9,mixedType,1
4,2,0,6,mixedType,0
3,8,0,11,mixedType,1
10,2,0,12,mixedType,1
6,3,0,9,mixedType,1
8,3,0,11,mixedType,1
6,3,0,9,mixedType,1
7,2,0,9,mixedType,1
6,4,0,10,mixedType,1
6,2,0,8,mixedType,1
7,1,0,8,mixedType,1
5,1,0,6,mixedType,0
8,3,0,11,mixedType,1
7,3,0,10,mixedType,1
9,2,0,11,mixedType,1
5,4,0,9,mixedType,1
5,5,0,10,mixedType,1
2,6,0,8,mixedType,1
8,1,0,9,mixedType,1
8,1,0,9,mixedType,1
7,1,0,8,mixedType,1
3,7,0,10,mixedType,1
8,2,0,10,mixedType,1
7,2,0,9,mixedType,1
5,7,0,12,mixedType,1
8,1,0,9,mixedType,1
7,2,0,9,mixedType,1
5,2,0,7,mixedType,0
10,3,1,14,mixedType,2
2,4,0,6,mixedType,0
7,3,0,10,mixedType,1
9,2,0,11,mixedType,1
11,2,0,13,mixedType,1
5,3,0,8,mixedType,1
4,4,0,8,mixedType,1
6,4,0,10,mixedType,1
7,4,0,11,mixedType,1
5,6,0,11,mixedType,1
2,8,0,10,mixedType,1
5,1,0,6,mixedType,0
6,7,0,13,mixedType,1
11,5,0,16,mixedType,2
4,4,0,8,mixedType,1
5,3,0,8,mixedType,1
6,3,0,9,mixedType,1
9,2,0,11,mixedType,1
5,4,0,9,mixedType,1
12,4,0,16,mixedType,2
9,2,0,11,mixedType,1
10,1,0,11,mixedType,1
5,3,0,8,mixedType,1
3,5,0,8,mixedType,1
8,2,0,10,mixedType,1
6,2,0,8,mixedType,1
6,3,0,9,mixedType,1
10,2,0,12,mixedType,1
1,9,0,10,mixedType,1
7,4,0,11,mixedType,1
5,3,0,8,mixedType,1
6,2,0,8,mixedType,1
6,2,0,8,mixedType,1
8,2,0,10,mixedType,1
8,3,0,11,mixedType,1
7,2,0,9,mixedType,1
6,4,0,10,mixedType,1
5,2,0,7,mixedType,0
9,1,0,10,mixedType,1
5,3,0,8,mixedType,1
4,2,0,6,mixedType,0
11,5,0,16,mixedType,2
13,1,1,15,mixedType,2
1,8,0,9,mixedType,1
5,1,0,6,mixedType,0
5,2,0,7,mixedType,0
12,4,0,16,mixedType,2
6,3,0,9,mixedType,1
6,1,0,7,mixedType,0
5,4,0,9,mixedType,1
2,4,0,6,mixedType,0
11,5,0,16,mixedType,2
10,2,0,12,mixedType,1
4,2,0,6,mixedType,0
8,2,0,10,mixedType,1
12,4,1,17,mixedType,2
5,3,0,8,mixedType,1
7,4,0,11,mixedType,1
8,2,0,10,mixedType,1
5,2,0,7,mixedType,0
5,4,0,9,mixedType,1
2,7,0,9,mixedType,1
4,2,0,6,mixedType,0
1,10,0,11,mixedType,1
8,2,0,10,mixedType,1
6,2,0,8,mixedType,1
6,4,0,10,mixedType,1
6,3,0,9,mixedType,1
9,4,0,13,mixedType,1
5,4,0,9,mixedType,1
3,3,0,6,mixedType,0
5,1,0,6,mixedType,0
7,4,0,11,mixedType,1
12,4,0,16,mixedType,2
5,6,0,11,mixedType,1
8,1,0,9,mixedType,1
4,2,0,6,mixedType,0
4,4,0,8,mixedType,1
5,3,0,8,mixedType,1
8,4,0,12,mixedType,1
7,2,0,9,mixedType,1
6,2,0,8,mixedType,1
6,4,0,10,mixedType,1
10,2,0,12,mixedType,1
8,2,0,10,mixedType,1
3,3,0,6,mixedType,0
7,1,0,8,mixedType,1
8,1,0,9,mixedType,1
8,1,0,9,mixedType,1
13,3,0,16,mixedType,2
9,2,0,11,mixedType,1
13,3,0,16,mixedType,2
6,2,0,8,mixedType,1
14,2,0,16,mixedType,2
2,6,0,8,mixedType,1
6,2,0,8,mixedType,1
4,4,0,8,mixedType,1
7,3,0,10,mixedType,1
6,1,0,7,mixedType,0
9,1,0,10,mixedType,1
5,1,0,6,mixedType,0
7,3,0,10,mixedType,1
6,3,0,9,mixedType,1
6,3,0,9,mixedType,1
6,3,0,9,mixedType,1
5,1,0,6,mixedType,0
5,2,0,7,mixedType,0
1,7,0,8,mixedType,1
8,2,0,10,mixedType,1
8,2,0,10,mixedType,1
0,5,2,7,mixedType,0
7,3,0,10,mixedType,1
5,3,0,8,mixedType,1
3,6,0,9,mixedType,1
3,8,0,11,mixedType,1
12,4,0,16,mixedType,2
2,9,0,11,mixedType,1
14,2,0,16,mixedType,2
5,4,0,9,mixedType,1
5,3,0,8,mixedType,1
5,4,0,9,mixedType,1
15,1,0,16,mixedType,2
7,2,0,9,mixedType,1
7,1,0,8,mixedType,1
6,1,0,7,mixedType,0
11,3,0,14,mixedType,2
7,2,0,9,mixedType,1
14,2,0,16,mixedType,2
6,4,0,10,mixedType,1
7,1,0,8,mixedType,1
9,1,0,10,mixedType,1
7,1,0,8,mixedType,1
5,4,0,9,mixedType,1
10,1,0,11,mixedType,1
7,3,0,10,mixedType,1
6,2,0,8,mixedType,1
4,2,0,6,mixedType,0
11,5,0,16,mixedType,2
5,1,0,6,mixedType,0
8,1,0,9,mixedType,1
1,8,0,9,mixedType,1
4,4,0,8,mixedType,1
5,3,0,8,mixedType,1
2,8,0,10,mixedType,1
6,1,0,7,mixedType,0
2,6,0,8,mixedType,1
6,2,0,8,mixedType,1
8,1,0,9,mixedType,1
6,1,0,7,mixedType,0
9,4,0,13,mixedType,1
2,8,0,10,mixedType,1
7,1,0,8,mixedType,1
5,2,0,7,mixedType,0
6,4,0,10,mixedType,1
10,1,0,11,mixedType,1
6,4,0,10,mixedType,1
9,1,0,10,mixedType,1
6,2,0,8,mixedType,1
5,4,0,9,mixedType,1
8,2,0,10,mixedType,1
4,6,0,10,mixedType,1
6,4,0,10,mixedType,1
4,2,0,6,mixedType,0
3,7,0,10,mixedType,1
7,1,0,8,mixedType,1
5,1,0,6,mixedType,0
5,4,0,9,mixedType,1
3,9,0,12,mixedType,1
9,1,0,10,mixedType,1
13,3,0,16,mixedType,2
10,5,0,15,mixedType,2
6,2,0,8,mixedType,1
6,3,0,9,mixedType,1
8,1,0,9,mixedType,1
7,1,0,8,mixedType,1
9,3,0,12,mixedType,1
2,8,0,10,mixedType,1
13,3,0,16,mixedType,2
1,7,0,8,mixedType,1
4,2,0,6,mixedType,0
5,5,0,10,mixedType,1
14,2,0,16,mixedType,2
12,4,0,16,mixedType,2
8,4,0,12,mixedType,1
5,1,0,6,mixedType,0
9,1,0,10,mixedType,1
4,2,0,6,mixedType,0
1,9,0,10,mixedType,1
7,3,0,10,mixedType,1
7,2,0,9,mixedType,1
8,1,0,9,mixedType,1
9,4,0,13,mixedType,1
5,2,0,7,mixedType,0
10,3,0,13,mixedType,1
14,2,0,16,mixedType,2
9,1,0,10,mixedType,1
2,6,0,8,mixedType,1
3,5,0,8,mixedType,1
8,3,0,11,mixedType,1
7,3,0,10,mixedType,1
6,3,0,9,mixedType,1
6,2,0,8,mixedType,1
4,4,0,8,mixedType,1
12,1,0,13,mixedType,1
5,4,0,9,mixedType,1
5,3,0,8,mixedType,1
5,3,0,8,mixedType,1
14,2,0,16,mixedType,2
4,4,0,8,mixedType,1
11,5,0,16,mixedType,2
6,1,0,7,mixedType,0
7,6,0,13,mixedType,1
6,2,0,8,mixedType,1
6,8,0,14,mixedType,2
4,2,0,6,mixedType,0
12,3,0,15,mixedType,2
5,2,0,7,mixedType,0
7,4,0,11,mixedType,1
6,3,0,9,mixedType,1
7,3,0,10,mixedType,1
7,5,0,12,mixedType,1
3,5,0,8,mixedType,1
2,6,0,8,mixedType,1
8,1,0,9,mixedType,1
7,2,0,9,mixedType,1
5,2,0,7,mixedType,0
10,4,1,15,mixedType,2
13,3,0,16,mixedType,2
3,5,0,8,mixedType,1
8,1,0,9,mixedType,1
6,2,0,8,mixedType,1
8,3,0,11,mixedType,1
8,4,0,12,mixedType,1
6,4,0,10,mixedType,1
7,2,0,9,mixedType,1
5,2,0,7,mixedType,0
15,1,0,16,mixedType,2
10,2,0,12,mixedType,1
9,1,0,10,mixedType,1
5,1,0,6,mixedType,0
8,2,0,10,mixedType,1
8,3,0,11,mixedType,1
3,10,0,13,mixedType,1
8,3,0,11,mixedType,1
9,2,0,11,mixedType,1
8,2,0,10,mixedType,1
6,1,0,7,mixedType,0
5,4,0,9,mixedType,1
7,1,0,8,mixedType,1
3,7,0,10,mixedType,1
9,3,0,12,mixedType,1
7,4,0,11,mixedType,1
8,2,0,10,mixedType,1
5,3,0,8,mixedType,1
4,3,0,7,mixedType,0
3,7,0,10,mixedType,1
10,1,0,11,mixedType,1
4,8,0,12,mixedType,1
7,1,0,8,mixedType,1
6,3,0,9,mixedType,1
6,6,0,12,mixedType,1
12,4,0,16,mixedType,2
6,1,0,7,mixedType,0
11,3,0,14,mixedType,2
6,2,0,8,mixedType,1
6,1,0,7,mixedType,0
12,4,0,16,mixedType,2
3,5,0,8,mixedType,1
6,4,0,10,mixedType,1
4,6,0,10,mixedType,1
6,2,0,8,mixedType,1
5,3,0,8,mixedType,1
6,2,0,8,mixedType,1
6,4,0,10,mixedType,1
7,3,0,10,mixedType,1
1,7,0,8,mixedType,1
5,4,0,9,mixedType,1
9,3,0,12,mixedType,1
6,3,0,9,mixedType,1
8,3,0,11,mixedType,1
5,2,0,7,mixedType,0
4,8,0,12,mixedType,1
13,3,0,16,mixedType,2
6,4,0,10,mixedType,1
7,2,0,9,mixedType,1
5,4,0,9,mixedType,1
5,3,0,8,mixedType,1
8,1,0,9,mixedType,1
6,1,0,7,mixedType,0
9,3,0,12,mixedType,1
1,8,0,9,mixedType,1
8,2,0,10,mixedType,1
4,6,0,10,mixedType,1
6,2,0,8,mixedType,1
13,3,0,16,mixedType,2
9,3,0,12,mixedType,1
8,2,0,10,mixedType,1
3,7,0,10,mixedType,1
9,3,0,12,mixedType,1
8,3,0,11,mixedType,1
9,2,0,11,mixedType,1
6,4,0,10,mixedType,1
8,1,0,9,mixedType,1
6,3,0,9,mixedType,1
4,6,0,10,mixedType,1
7,2,0,9,mixedType,1
13,3,0,16,mixedType,2
6,3,0,9,mixedType,1
6,1,0,7,mixedType,0
5,2,0,7,mixedType,0
2,8,0,10,mixedType,1
7,2,0,9,mixedType,1
8,1,0,9,mixedType,1
5,4,0,9,mixedType,1
5,3,0,8,mixedType,1
6,4,0,10,mixedType,1
8,4,0,12,mixedType,1
8,4,0,12,mixedType,1
14,2,0,16,mixedType,2
8,1,0,9,mixedType,1
5,2,0,7,mixedType,0
12,4,0,16,mixedType,2
5,3,0,8,mixedType,1
23,4,0,27,mixedType,2
12,3,0,15,mixedType,2
8,2,0,10,mixedType,1
5,1,0,6,mixedType,0
13,3,0,16,mixedType,2
12,4,0,16,mixedType,2
6,1,0,7,mixedType,0
1,8,0,9,mixedType,1
5,1,0,6,mixedType,0
4,4,0,8,mixedType,1
5,3,0,8,mixedType,1
4,6,0,10,mixedType,1
8,1,0,9,mixedType,1
7,3,0,10,mixedType,1
7,1,0,8,mixedType,1
15,1,0,16,mixedType,2
1,8,0,9,mixedType,1
7,2,0,9,mixedType,1
6,3,0,9,mixedType,1
3,6,0,9,mixedType,1
7,1,0,8,mixedType,1
14,2,0,16,mixedType,2
7,2,0,9,mixedType,1
9,3,0,12,mixedType,1
7,3,0,10,mixedType,1
1,8,0,9,mixedType,1
13,3,0,16,mixedType,2
14,2,0,16,mixedType,2
13,3,0,16,mixedType,2
6,4,0,10,mixedType,1
4,2,0,6,mixedType,0
8,2,0,10,mixedType,1
1,8,0,9,mixedType,1
5,4,0,9,mixedType,1
6,4,0,10,mixedType,1
8,5,0,13,mixedType,1
5,3,0,8,mixedType,1
6,4,0,10,mixedType,1
6,4,0,10,mixedType,1
2,6,0,8,mixedType,1
6,3,0,9,mixedType,1
7,2,0,9,mixedType,1
7,2,0,9,mixedType,1
1,8,0,9,mixedType,1
7,1,0,8,mixedType,1
9,1,0,10,mixedType,1
9,3,0,12,mixedType,1
3,5,0,8,mixedType,1
8,2,0,10,mixedType,1
0,6,1,7,mixedType,0
7,3,0,10,mixedType,1
12,3,0,15,mixedType,2
2,7,0,9,mixedType,1
5,2,0,7,mixedType,0
7,3,0,10,mixedType,1
6,7,0,13,mixedType,1
7,2,0,9,mixedType,1
4,10,0,14,mixedType,2
6,4,0,10,mixedType,1
7,2,0,9,mixedType,1
7,2,0,9,mixedType,1
6,3,0,9,mixedType,1
13,3,0,16,mixedType,2
6,1,0,7,mixedType,0
4,4,0,8,mixedType,1
2,11,1,14,mixedType,2
10,6,0,16,mixedType,2
5,7,0,12,mixedType,1
1,7,0,8,mixedType,1
6,2,0,8,mixedType,1
5,3,0,8,mixedType,1
5,2,0,7,mixedType,0
9,1,0,10,mixedType,1
12,3,0,15,mixedType,2
5,3,0,8,mixedType,1
5,6,0,11,mixedType,1
3,3,0,6,mixedType,0
4,6,0,10,mixedType,1
6,1,0,7,mixedType,0
8,1,0,9,mixedType,1
1,8,0,9,mixedType,1
8,1,0,9,mixedType,1
8,1,0,9,mixedType,1
7,3,0,10,mixedType,1
5,2,0,7,mixedType,0
5,4,0,9,mixedType,1
4,4,0,8,mixedType,1
9,3,0,12,mixedType,1
6,2,0,8,mixedType,1
2,8,0,10,mixedType,1
6,1,0,7,mixedType,0
5,3,0,8,mixedType,1
7,3,0,10,mixedType,1
4,8,0,12,mixedType,1
5,1,0,6,mixedType,0
7,2,0,9,mixedType,1
7,4,0,11,mixedType,1
5,4,0,9,mixedType,1
7,2,0,9,mixedType,1
5,4,0,9,mixedType,1
8,1,0,9,mixedType,1
6,4,0,10,mixedType,1
14,2,0,16,mixedType,2
6,2,0,8,mixedType,1
1,7,0,8,mixedType,1
6,1,0,7,mixedType,0
1,8,0,9,mixedType,1
8,2,0,10,mixedType,1
12,4,0,16,mixedType,2
7,2,0,9,mixedType,1
8,1,0,9,mixedType,1
7,1,0,8,mixedType,1
13,3,0,16,mixedType,2
11,3,0,14,mixedType,2
3,5,0,8,mixedType,1
14,2,0,16,mixedType,2
7,4,0,11,mixedType,1
8,2,0,10,mixedType,1
4,2,0,6,mixedType,0
5,2,0,7,mixedType,0
6,2,0,8,mixedType,1
10,1,0,11,mixedType,1
5,3,0,8,mixedType,1
1,8,0,9,mixedType,1
7,2,0,9,mixedType,1
3,9,0,12,mixedType,1
4,6,0,10,mixedType,1
5,3,0,8,mixedType,1
5,1,0,6,mixedType,0
5,10,0,15,mixedType,2
9,1,0,10,mixedType,1
6,1,0,7,mixedType,0
2,8,0,10,mixedType,1
4,14,0,18,mixedType,2
4,4,0,8,mixedType,1
7,3,0,10,mixedType,1
5,3,0,8,mixedType,1
11,2,0,13,mixedType,1
5,6,0,11,mixedType,1
6,1,0,7,mixedType,0
2,8,0,10,mixedType,1
8,4,0,12,mixedType,1
2,6,0,8,mixedType,1
7,3,0,10,mixedType,1
9,1,0,10,mixedType,1
6,3,0,9,mixedType,1
9,0,1,10,mixedType,1
6,1,0,7,mixedType,0
4,4,0,8,mixedType,1
5,1,0,6,mixedType,0
5,4,0,9,mixedType,1
7,3,0,10,mixedType,1
6,2,0,8,mixedType,1
9,1,0,10,mixedType,1
6,3,0,9,mixedType,1
5,2,0,7,mixedType,0
13,3,0,16,mixedType,2
15,1,0,16,mixedType,2
2,4,0,6,mixedType,0
4,6,0,10,mixedType,1
6,1,0,7,mixedType,0
3,8,0,11,mixedType,1
4,6,0,10,mixedType,1
5,3,0,8,mixedType,1
8,1,0,9,mixedType,1
10,1,0,11,mixedType,1
5,3,0,8,mixedType,1
7,3,0,10,mixedType,1
6,1,0,7,mixedType,0
5,3,0,8,mixedType,1
5,3,0,8,mixedType,1
14,2,0,16,mixedType,2
7,1,0,8,mixedType,1
7,2,0,9,mixedType,1
7,2,0,9,mixedType,1
6,4,0,10,mixedType,1
9,3,0,12,mixedType,1
5,3,0,8,mixedType,1
8,3,0,11,mixedType,1
7,2,0,9,mixedType,1
4,6,0,10,mixedType,1
12,4,0,16,mixedType,2
6,1,0,7,mixedType,0
9,3,0,12,mixedType,1
11,5,0,16,mixedType,2
5,3,0,8,mixedType,1
5,3,0,8,mixedType,1
5,3,0,8,mixedType,1
7,2,0,9,mixedType,1
4,4,0,8,mixedType,1
2,8,0,10,mixedType,1
6,7,0,13,mixedType,1
9,3,0,12,mixedType,1
6,4,0,10,mixedType,1
6,3,0,9,mixedType,1
12,3,0,15,mixedType,2
15,1,0,16,mixedType,2
9,3,0,12,mixedType,1
15,1,0,16,mixedType,2
5,3,0,8,mixedType,1
10,2,0,12,mixedType,1
6,4,0,10,mixedType,1
7,2,0,9,mixedType,1
5,6,0,11,mixedType,1
6,2,0,8,mixedType,1
7,2,0,9,mixedType,1
7,1,0,8,mixedType,1
5,4,0,9,mixedType,1
6,3,0,9,mixedType,1
8,2,0,10,mixedType,1
8,1,0,9,mixedType,1
6,2,0,8,mixedType,1
4,2,0,6,mixedType,0
14,2,0,16,mixedType,2
6,3,0,9,mixedType,1
8,6,0,14,mixedType,2
10,3,0,13,mixedType,1
2,4,0,6,mixedType,0
7,3,0,10,mixedType,1
7,3,0,10,mixedType,1
6,3,0,9,mixedType,1
2,4,0,6,mixedType,0
5,2,0,7,mixedType,0
7,3,0,10,mixedType,1
7,2,0,9,mixedType,1
2,6,0,8,mixedType,1
5,3,0,8,mixedType,1
7,3,0,10,mixedType,1
5,3,0,8,mixedType,1
8,1,0,9,mixedType,1
6,2,0,8,mixedType,1
4,5,0,9,mixedType,1
3,11,0,14,mixedType,2
8,1,0,9,mixedType,1
9,1,0,10,mixedType,1
7,3,0,10,mixedType,1
6,3,0,9,mixedType,1
2,4,0,6,mixedType,0
8,6,0,14,mixedType,2
5,1,0,6,mixedType,0
7,3,0,10,mixedType,1
8,4,0,12,mixedType,1
6,2,0,8,mixedType,1
2,5,0,7,mixedType,0
4,4,0,8,mixedType,1
1,8,0,9,mixedType,1
7,2,0,9,mixedType,1
7,3,0,10,mixedType,1
15,1,0,16,mixedType,2
12,4,0,16,mixedType,2
7,3,0,10,mixedType,1
14,2,0,16,mixedType,2
8,2,0,10,mixedType,1
7,2,0,9,mixedType,1
5,4,0,9,mixedType,1
2,8,0,10,mixedType,1
6,3,0,9,mixedType,1
7,4,0,11,mixedType,1
6,1,0,7,mixedType,0
7,1,0,8,mixedType,1
7,4,0,11,mixedType,1
11,3,0,14,mixedType,2
6,3,0,9,mixedType,1
7,3,0,10,mixedType,1
6,3,0,9,mixedType,1
4,8,0,12,mixedType,1
8,2,0,10,mixedType,1
7,2,0,9,mixedType,1
8,2,0,10,mixedType,1
5,5,0,10,mixedType,1
7,4,0,11,mixedType,1
6,1,0,7,mixedType,0
6,4,0,10,mixedType,1
7,4,0,11,mixedType,1
12,3,0,15,mixedType,2
6,3,0,9,mixedType,1
4,4,0,8,mixedType,1
15,1,0,16,mixedType,2
7,3,0,10,mixedType,1
5,2,0,7,mixedType,0
7,3,0,10,mixedType,1
6,2,0,8,mixedType,1
5,4,0,9,mixedType,1
7,3,0,10,mixedType,1
8,2,0,10,mixedType,1
3,3,0,6,mixedType,0
15,1,0,16,mixedType,2
10,2,0,12,mixedType,1
6,2,0,8,mixedType,1
4,4,0,8,mixedType,1
6,1,0,7,mixedType,0
1,7,0,8,mixedType,1
5,1,0,6,mixedType,0
2,8,0,10,mixedType,1
14,2,0,16,mixedType,2
7,2,0,9,mixedType,1
6,3,0,9,mixedType,1
8,1,0,9,mixedType,1
8,1,0,9,mixedType,1
14,2,0,16,mixedType,2
4,4,0,8,mixedType,1
5,3,0,8,mixedType,1
4,4,0,8,mixedType,1
6,3,0,9,mixedType,1
7,3,0,10,mixedType,1
9,1,0,10,mixedType,1
7,1,0,8,mixedType,1
8,1,0,9,mixedType,1
3,7,0,10,mixedType,1
8,1,0,9,mixedType,1
2,9,0,11,mixedType,1
7,2,0,9,mixedType,1
6,1,0,7,mixedType,0
5,4,0,9,mixedType,1
5,1,0,6,mixedType,0
6,3,0,9,mixedType,1
6,3,0,9,mixedType,1
8,1,0,9,mixedType,1
6,2,0,8,mixedType,1
5,3,0,8,mixedType,1
15,1,0,16,mixedType,2
5,1,0,6,mixedType,0
6,3,0,9,mixedType,1
8,3,0,11,mixedType,1
7,1,0,8,mixedType,1
6,4,0,10,mixedType,1
5,3,0,8,mixedType,1
5,1,0,6,mixedType,0
7,3,0,10,mixedType,1
15,1,0,16,mixedType,2
8,1,0,9,mixedType,1
15,1,0,16,mixedType,2
11,1,0,12,mixedType,1
5,4,0,9,mixedType,1
4,0,4,8,mixedType,1
8,3,0,11,mixedType,1
6,5,0,11,mixedType,1
5,2,0,7,mixedType,0
9,1,0,10,mixedType,1
7,2,0,9,mixedType,1
5,4,0,9,mixedType,1
15,1,0,16,mixedType,2
8,4,0,12,mixedType,1
6,2,0,8,mixedType,1
6,6,0,12,mixedType,1
6,3,0,9,mixedType,1
9,2,0,11,mixedType,1
8,2,0,10,mixedType,1
6,2,0,8,mixedType,1
5,4,0,9,mixedType,1
15,1,0,16,mixedType,2
6,4,0,10,mixedType,1
8,2,0,10,mixedType,1
6,2,0,8,mixedType,1
5,4,0,9,mixedType,1
3,8,0,11,mixedType,1
5,4,0,9,mixedType,1
6,1,0,7,mixedType,0
3,7,0,10,mixedType,1
3,6,0,9,mixedType,1
7,3,0,10,mixedType,1
7,3,0,10,mixedType,1
13,3,0,16,mixedType,2
3,6,0,9,mixedType,1
6,2,0,8,mixedType,1
12,4,1,17,mixedType,2
7,1,0,8,mixedType,1
8,1,0,9,mixedType,1
9,5,0,14,mixedType,2
2,8,0,10,mixedType,1
14,2,0,16,mixedType,2
5,7,0,12,mixedType,1
7,3,0,10,mixedType,1
6,3,0,9,mixedType,1
7,2,0,9,mixedType,1
4,4,0,8,mixedType,1
5,4,0,9,mixedType,1
8,1,0,9,mixedType,1
7,3,0,10,mixedType,1
2,6,0,8,mixedType,1
6,1,0,7,mixedType,0
14,2,0,16,mixedType,2
1,8,0,9,mixedType,1
7,4,0,11,mixedType,1
7,3,0,10,mixedType,1
6,2,0,8,mixedType,1
10,1,0,11,mixedType,1
5,4,0,9,mixedType,1
13,3,0,16,mixedType,2
6,1,0,7,mixedType,0
4,2,0,6,mixedType,0
5,9,0,14,mixedType,2
6,3,0,9,mixedType,1
7,1,0,8,mixedType,1
4,4,0,8,mixedType,1
7,3,0,10,mixedType,1
1,9,0,10,mixedType,1
7,2,0,9,mixedType,1
6,4,0,10,mixedType,1
9,4,0,13,mixedType,1
4,4,0,8,mixedType,1
7,4,0,11,mixedType,1
15,1,0,16,mixedType,2
14,2,0,16,mixedType,2
6,2,0,8,mixedType,1
9,3,0,12,mixedType,1
9,3,0,12,mixedType,1
6,3,0,9,mixedType,1
12,1,0,13,mixedType,1
15,1,0,16,mixedType,2
8,3,0,11,mixedType,1
2,8,0,10,mixedType,1
4,6,0,10,mixedType,1
6,3,0,9,mixedType,1
7,3,0,10,mixedType,1
8,1,0,9,mixedType,1
8,2,0,10,mixedType,1
15,1,0,16,mixedType,2
6,3,0,9,mixedType,1
5,3,0,8,mixedType,1
5,3,0,8,mixedType,1
5,2,0,7,mixedType,0
4,7,0,11,mixedType,1
10,3,0,13,mixedType,1
8,1,0,9,mixedType,1
15,1,0,16,mixedType,2
6,3,0,9,mixedType,1
7,2,0,9,mixedType,1
1,8,0,9,mixedType,1
5,4,0,9,mixedType,1
6,3,0,9,mixedType,1
6,3,0,9,mixedType,1
4,2,0,6,mixedType,0
6,2,0,8,mixedType,1
7,3,0,10,mixedType,1
6,2,0,8,mixedType,1
3,10,0,13,mixedType,1
6,2,0,8,mixedType,1
8,2,0,10,mixedType,1
2,6,0,8,mixedType,1
4,2,0,6,mixedType,0
3,6,0,9,mixedType,1
6,3,0,9,mixedType,1
8,1,0,9,mixedType,1
11,3,0,14,mixedType,2
14,2,0,16,mixedType,2
7,2,0,9,mixedType,1
2,6,0,8,mixedType,1
8,2,0,10,mixedType,1
4,2,0,6,mixedType,0
4,4,0,8,mixedType,1
7,4,0,11,mixedType,1
11,1,0,12,mixedType,1
8,2,0,10,mixedType,1
8,1,0,9,mixedType,1
4,6,0,10,mixedType,1
8,1,0,9,mixedType,1
11,5,0,16,mixedType,2
7,3,0,10,mixedType,1
8,4,0,12,mixedType,1
10,3,0,13,mixedType,1
6,4,0,10,mixedType,1
6,1,0,7,mixedType,0
4,5,0,9,mixedType,1
7,4,0,11,mixedType,1
6,4,0,10,mixedType,1
6,5,0,11,mixedType,1
3,6,0,9,mixedType,1
5,2,0,7,mixedType,0
13,4,1,18,mixedType,2
6,1,0,7,mixedType,0
5,3,0,8,mixedType,1
6,5,0,11,mixedType,1
3,6,0,9,mixedType,1
3,6,0,9,mixedType,1
2,7,0,9,mixedType,1
6,2,0,8,mixedType,1
11,3,0,14,mixedType,2
9,1,0,10,mixedType,1
6,1,0,7,mixedType,0
6,1,0,7,mixedType,0
6,2,0,8,mixedType,1
13,3,0,16,mixedType,2
6,1,0,7,mixedType,0
6,2,0,8,mixedType,1
5,3,0,8,mixedType,1
4,8,0,12,mixedType,1
5,2,0,7,mixedType,0
3,3,0,6,mixedType,0
8,1,0,9,mixedType,1
5,3,0,8,mixedType,1
15,1,0,16,mixedType,2
6,1,0,7,mixedType,0
4,4,0,8,mixedType,1
2,6,0,8,mixedType,1
6,3,0,9,mixedType,1
4,2,0,6,mixedType,0
2,6,0,8,mixedType,1
14,2,0,16,mixedType,2
4,2,0,6,mixedType,0
7,1,0,8,mixedType,1
12,1,0,13,mixedType,1
9,1,0,10,mixedType,1
11,2,1,14,mixedType,2
6,3,0,9,mixedType,1
2,9,0,11,mixedType,1
6,4,0,10,mixedType,1
5,5,0,10,mixedType,1
5,2,0,7,mixedType,0
7,3,0,10,mixedType,1
7,3,0,10,mixedType,1
8,3,0,11,mixedType,1
6,3,0,9,mixedType,1
2,6,0,8,mixedType,1
6,4,0,10,mixedType,1
7,3,0,10,mixedType,1
4,4,0,8,mixedType,1
13,3,0,16,mixedType,2
9,1,0,10,mixedType,1
7,3,0,10,mixedType,1
6,4,0,10,mixedType,1
6,1,0,7,mixedType,0
3,5,0,8,mixedType,1
8,2,0,10,mixedType,1
4,2,0,6,mixedType,0
4,5,0,9,mixedType,1
6,2,0,8,mixedType,1
4,2,0,6,mixedType,0
6,2,0,8,mixedType,1
6,1,0,7,mixedType,0
5,3,0,8,mixedType,1
6,3,0,9,mixedType,1
8,2,0,10,mixedType,1
4,4,0,8,mixedType,1
7,1,0,8,mixedType,1
7,3,0,10,mixedType,1
7,3,0,10,mixedType,1
6,1,0,7,mixedType,0
14,2,0,16,mixedType,2
7,1,0,8,mixedType,1
4,2,0,6,mixedType,0
7,3,0,10,mixedType,1
6,3,0,9,mixedType,1
4,2,0,6,mixedType,0
6,4,0,10,mixedType,1
7,2,0,9,mixedType,1
2,10,0,12,mixedType,1
1,7,0,8,mixedType,1
6,3,0,9,mixedType,1
5,1,0,6,mixedType,0
8,4,0,12,mixedType,1
7,5,0,12,mixedType,1
1,8,0,9,mixedType,1
9,2,0,11,mixedType,1
7,2,0,9,mixedType,1
11,3,0,14,mixedType,2
10,3,0,13,mixedType,1
7,3,0,10,mixedType,1
2,6,0,8,mixedType,1
7,2,0,9,mixedType,1
1,7,0,8,mixedType,1
8,2,0,10,mixedType,1
2,4,0,6,mixedType,0
6,1,0,7,mixedType,0
4,4,0,8,mixedType,1
3,5,0,8,mixedType,1
8,2,0,10,mixedType,1
4,2,0,6,mixedType,0
11,3,0,14,mixedType,2
5,3,0,8,mixedType,1
7,3,0,10,mixedType,1
6,4,0,10,mixedType,1
2,11,0,13,mixedType,1
15,1,0,16,mixedType,2
4,4,0,8,mixedType,1
6,5,0,11,mixedType,1
8,2,0,10,mixedType,1
5,3,0,8,mixedType,1
7,2,0,9,mixedType,1
11,3,0,14,mixedType,2
4,6,0,10,mixedType,1
5,9,0,14,mixedType,2
6,6,0,12,mixedType,1
4,2,0,6,mixedType,0
5,3,0,8,mixedType,1
1,7,0,8,mixedType,1
5,2,0,7,mixedType,0
1,8,0,9,mixedType,1
4,2,0,6,mixedType,0
13,3,0,16,mixedType,2
2,7,0,9,mixedType,1
9,2,0,11,mixedType,1
11,2,0,13,mixedType,1
12,3,0,15,mixedType,2
5,1,0,6,mixedType,0
4,4,0,8,mixedType,1
6,3,0,9,mixedType,1
6,4,0,10,mixedType,1
3,4,0,7,mixedType,0
7,3,0,10,mixedType,1
7,3,0,10,mixedType,1
9,3,0,12,mixedType,1
4,4,0,8,mixedType,1
2,4,0,6,mixedType,0
5,5,0,10,mixedType,1
10,1,0,11,mixedType,1
14,2,0,16,mixedType,2
7,1,0,8,mixedType,1
7,3,0,10,mixedType,1
1,9,0,10,mixedType,1
9,4,0,13,mixedType,1
8,2,0,10,mixedType,1
7,1,0,8,mixedType,1
4,5,0,9,mixedType,1
14,2,0,16,mixedType,2
6,1,0,7,mixedType,0
12,4,0,16,mixedType,2
5,2,0,7,mixedType,0
5,1,0,6,mixedType,0
9,2,0,11,mixedType,1
5,1,0,6,mixedType,0
7,3,0,10,mixedType,1
3,3,0,6,mixedType,0
2,6,0,8,mixedType,1
15,3,1,19,mixedType,2
5,3,0,8,mixedType,1
6,1,0,7,mixedType,0
7,5,0,12,mixedType,1
5,8,0,13,mixedType,1
3,6,0,9,mixedType,1
6,3,0,9,mixedType,1
6,4,0,10,mixedType,1
7,2,0,9,mixedType,1
5,4,0,9,mixedType,1
3,3,0,6,mixedType,0
5,3,0,8,mixedType,1
9,2,0,11,mixedType,1
8,1,0,9,mixedType,1
8,3,0,11,mixedType,1
5,2,0,7,mixedType,0
9,4,0,13,mixedType,1
6,2,0,8,mixedType,1
1,10,0,11,mixedType,1
7,2,0,9,mixedType,1
7,2,0,9,mixedType,1
8,1,0,9,mixedType,1
7,2,0,9,mixedType,1
6,6,0,12,mixedType,1
12,4,0,16,mixedType,2
15,1,0,16,mixedType,2
6,3,0,9,mixedType,1
5,3,0,8,mixedType,1
9,2,0,11,mixedType,1
7,2,0,9,mixedType,1
6,1,0,7,mixedType,0
4,6,0,10,mixedType,1
8,2,0,10,mixedType,1
6,4,0,10,mixedType,1
7,2,0,9,mixedType,1
15,1,0,16,mixedType,2
9,1,0,10,mixedType,1
4,4,0,8,mixedType,1
7,1,0,8,mixedType,1
14,2,0,16,mixedType,2
4,2,0,6,mixedType,0
1,9,0,10,mixedType,1
4,8,0,12,mixedType,1
12,3,0,15,mixedType,2
6,3,0,9,mixedType,1
8,2,0,10,mixedType,1
12,3,0,15,mixedType,2
5,3,0,8,mixedType,1
1,8,0,9,mixedType,1
15,1,0,16,mixedType,2
5,2,0,7,mixedType,0
5,4,0,9,mixedType,1
11,2,0,13,mixedType,1
1,8,0,9,mixedType,1
8,4,0,12,mixedType,1
2,6,0,8,mixedType,1
8,2,0,10,mixedType,1
6,3,0,9,mixedType,1
7,2,0,9,mixedType,1
6,4,0,10,mixedType,1
4,2,0,6,mixedType,0
4,4,0,8,mixedType,1
8,2,0,10,mixedType,1
6,3,0,9,mixedType,1
1,7,0,8,mixedType,1
5,3,0,8,mixedType,1
6,3,0,9,mixedType,1
7,5,0,12,mixedType,1
4,2,0,6,mixedType,0
5,3,0,8,mixedType,1
5,1,0,6,mixedType,0
7,1,0,8,mixedType,1
5,7,0,12,mixedType,1
5,1,0,6,mixedType,0
6,3,0,9,mixedType,1
5,2,0,7,mixedType,0
5,2,0,7,mixedType,0
3,5,0,8,mixedType,1
9,1,0,10,mixedType,1
6,4,0,10,mixedType,1
6,3,0,9,mixedType,1
6,1,0,7,mixedType,0
8,1,0,9,mixedType,1
15,1,0,16,mixedType,2
7,3,0,10,mixedType,1
7,4,0,11,mixedType,1
7,2,0,9,mixedType,1
5,2,0,7,mixedType,0
6,4,0,10,mixedType,1
4,4,0,8,mixedType,1
2,6,0,8,mixedType,1
9,3,0,12,mixedType,1
6,3,0,9,mixedType,1
6,4,0,10,mixedType,1
7,4,0,11,mixedType,1
6,4,0,10,mixedType,1
7,3,0,10,mixedType,1
6,5,0,11,mixedType,1
7,3,0,10,mixedType,1
5,1,0,6,mixedType,0
9,3,0,12,mixedType,1
5,3,0,8,mixedType,1
11,1,0,12,mixedType,1
10,2,0,12,mixedType,1
3,3,0,6,mixedType,0
8,3,0,11,mixedType,1
10,4,0,14,mixedType,2
13,3,0,16,mixedType,2
6,3,0,9,mixedType,1
6,4,0,10,mixedType,1
5,3,0,8,mixedType,1
4,8,0,12,mixedType,1
8,1,0,9,mixedType,1
3,6,0,9,mixedType,1
6,3,0,9,mixedType,1
5,2,0,7,mixedType,0
6,1,0,7,mixedType,0
13,3,0,16,mixedType,2
6,6,0,12,mixedType,1
6,4,0,10,mixedType,1
9,1,0,10,mixedType,1
13,3,0,16,mixedType,2
6,3,0,9,mixedType,1
8,3,0,11,mixedType,1
8,2,0,10,mixedType,1
6,7,0,13,mixedType,1
6,4,0,10,mixedType,1
5,4,0,9,mixedType,1
5,2,0,7,mixedType,0
2,7,0,9,mixedType,1
7,2,0,9,mixedType,1
15,1,0,16,mixedType,2
13,3,0,16,mixedType,2
5,3,0,8,mixedType,1
5,3,0,8,mixedType,1
9,2,0,11,mixedType,1
7,3,0,10,mixedType,1
6,3,0,9,mixedType,1
8,1,0,9,mixedType,1
15,1,0,16,mixedType,2
5,2,0,7,mixedType,0
8,2,0,10,mixedType,1
13,3,1,17,mixedType,2
6,1,0,7,mixedType,0
8,1,0,9,mixedType,1
5,2,0,7,mixedType,0
7,2,0,9,mixedType,1
5,1,0,6,mixedType,0
9,1,0,10,mixedType,1
8,1,0,9,mixedType,1
6,1,0,7,mixedType,0
8,3,0,11,mixedType,1
2,6,0,8,mixedType,1
7,3,0,10,mixedType,1
10,1,0,11,mixedType,1
13,3,0,16,mixedType,2
3,6,0,9,mixedType,1
12,6,3,21,mixedType,2
7,1,0,8,mixedType,1
6,2,0,8,mixedType,1
12,3,0,15,mixedType,2
3,6,0,9,mixedType,1
8,1,0,9,mixedType,1
6,3,0,9,mixedType,1
6,5,0,11,mixedType,1
6,1,0,7,mixedType,0
10,2,0,12,mixedType,1
14,2,0,16,mixedType,2
4,4,0,8,mixedType,1
4,4,0,8,mixedType,1
5,4,0,9,mixedType,1
4,2,0,6,mixedType,0
4,8,0,12,mixedType,1
6,4,0,10,mixedType,1
5,2,0,7,mixedType,0
6,4,0,10,mixedType,1
4,2,0,6,mixedType,0
4,5,0,9,mixedType,1
7,3,0,10,mixedType,1
7,3,0,10,mixedType,1
5,4,0,9,mixedType,1
7,2,0,9,mixedType,1
6,1,0,7,mixedType,0
8,4,0,12,mixedType,1
1,9,0,10,mixedType,1
12,4,0,16,mixedType,2
5,2,0,7,mixedType,0
6,1,0,7,mixedType,0
4,5,0,9,mixedType,1
1,7,0,8,mixedType,1
7,2,0,9,mixedType,1
2,8,0,10,mixedType,1
9,3,0,12,mixedType,1
8,2,0,10,mixedType,1
6,3,0,9,mixedType,1
7,3,0,10,mixedType,1
12,3,0,15,mixedType,2
6,4,0,10,mixedType,1
7,3,0,10,mixedType,1
7,3,0,10,mixedType,1
4,4,0,8,mixedType,1
4,2,0,6,mixedType,0
6,2,0,8,mixedType,1
4,6,0,10,mixedType,1
6,4,0,10,mixedType,1
8,3,0,11,mixedType,1
7,1,0,8,mixedType,1
5,1,0,6,mixedType,0
5,2,0,7,mixedType,0
10,4,0,14,mixedType,2
3,6,0,9,mixedType,1
6,4,0,10,mixedType,1
6,1,0,7,mixedType,0
4,2,0,6,mixedType,0
7,4,0,11,mixedType,1
6,4,0,10,mixedType,1
4,5,0,9,mixedType,1
10,2,0,12,mixedType,1
8,1,0,9,mixedType,1
7,1,0,8,mixedType,1
8,1,0,9,mixedType,1
6,3,0,9,mixedType,1
4,6,0,10,mixedType,1
5,3,0,8,mixedType,1
7,2,0,9,mixedType,1
6,3,0,9,mixedType,1
8,2,0,10,mixedType,1
8,2,0,10,mixedType,1
6,4,0,10,mixedType,1
5,3,0,8,mixedType,1
6,1,0,7,mixedType,0
4,4,0,8,mixedType,1
3,3,0,6,mixedType,0
7,3,0,10,mixedType,1
8,2,0,10,mixedType,1
1,8,0,9,mixedType,1
6,3,0,9,mixedType,1
11,2,0,13,mixedType,1
14,2,0,16,mixedType,2
3,6,0,9,mixedType,1
7,1,0,8,mixedType,1
9,1,0,10,mixedType,1
6,1,0,7,mixedType,0
5,1,0,6,mixedType,0
8,3,0,11,mixedType,1
8,2,0,10,mixedType,1
7,2,0,9,mixedType,1
6,3,0,9,mixedType,1
7,3,0,10,mixedType,1
5,6,0,11,mixedType,1
9,2,0,11,mixedType,1
14,2,0,16,mixedType,2
6,2,0,8,mixedType,1
6,1,0,7,mixedType,0
3,8,0,11,mixedType,1
6,4,0,10,mixedType,1
7,3,0,10,mixedType,1
7,3,0,10,mixedType,1
7,4,0,11,mixedType,1
5,2,0,7,mixedType,0
5,2,0,7,mixedType,0
5,2,0,7,mixedType,0
9,1,0,10,mixedType,1
4,4,0,8,mixedType,1
5,2,0,7,mixedType,0
5,2,0,7,mixedType,0
4,4,0,8,mixedType,1
6,4,0,10,mixedType,1
5,3,0,8,mixedType,1
11,2,0,13,mixedType,1
4,9,0,13,mixedType,1
5,3,0,8,mixedType,1
4,8,0,12,mixedType,1
7,2,0,9,mixedType,1
6,3,0,9,mixedType,1
2,7,0,9,mixedType,1
14,2,0,16,mixedType,2
5,6,0,11,mixedType,1
5,3,0,8,mixedType,1
7,2,0,9,mixedType,1
6,2,0,8,mixedType,1
7,1,0,8,mixedType,1
9,1,0,10,mixedType,1
8,1,0,9,mixedType,1
8,2,0,10,mixedType,1
10,1,0,11,mixedType,1
11,3,0,14,mixedType,2
7,3,0,10,mixedType,1
4,4,0,8,mixedType,1
15,1,0,16,mixedType,2
6,6,0,12,mixedType,1
5,5,0,10,mixedType,1
2,6,0,8,mixedType,1
2,8,0,10,mixedType,1
7,2,0,9,mixedType,1
6,1,0,7,mixedType,0
6,1,0,7,mixedType,0
11,0,1,12,mixedType,1
7,2,0,9,mixedType,1
8,1,0,9,mixedType,1
9,4,0,13,mixedType,1
10,3,0,13,mixedType,1
4,2,0,6,mixedType,0
7,3,0,10,mixedType,1
7,1,0,8,mixedType,1
5,3,0,8,mixedType,1
8,2,0,10,mixedType,1
9,2,0,11,mixedType,1
1,11,0,12,mixedType,1
5,8,0,13,mixedType,1
4,2,0,6,mixedType,0
6,3,0,9,mixedType,1
9,3,0,12,mixedType,1
5,1,0,6,mixedType,0
9,4,0,13,mixedType,1
4,4,0,8,mixedType,1
7,3,0,10,mixedType,1
5,4,0,9,mixedType,1
6,6,0,12,mixedType,1
13,3,0,16,mixedType,2
9,1,0,10,mixedType,1
11,2,0,13,mixedType,1
6,3,0,9,mixedType,1
7,2,0,9,mixedType,1
10,3,0,13,mixedType,1
5,3,0,8,mixedType,1
9,3,0,12,mixedType,1
11,3,0,14,mixedType,2
9,3,0,12,mixedType,1
3,10,0,13,mixedType,1
5,3,0,8,mixedType,1
5,5,0,10,mixedType,1
9,1,0,10,mixedType,1
4,2,0,6,mixedType,0
8,1,0,9,mixedType,1
6,3,0,9,mixedType,1
6,4,0,10,mixedType,1
5,3,0,8,mixedType,1
5,1,0,6,mixedType,0
5,2,0,7,mixedType,0
8,1,0,9,mixedType,1
12,4,0,16,mixedType,2
1,8,0,9,mixedType,1
5,3,0,8,mixedType,1
6,3,0,9,mixedType,1
5,3,0,8,mixedType,1
2,8,0,10,mixedType,1
7,2,0,9,mixedType,1
14,2,0,16,mixedType,2
10,4,0,14,mixedType,2
8,1,0,9,mixedType,1
2,6,0,8,mixedType,1
4,2,0,6,mixedType,0
8,2,0,10,mixedType,1
6,4,0,10,mixedType,1
6,4,0,10,mixedType,1
14,2,0,16,mixedType,2
13,2,0,15,mixedType,2
1,8,0,9,mixedType,1
5,3,0,8,mixedType,1
7,4,0,11,mixedType,1
13,3,0,16,mixedType,2
5,3,0,8,mixedType,1
6,1,0,7,mixedType,0
6,4,0,10,mixedType,1
4,4,0,8,mixedType,1
7,2,0,9,mixedType,1
5,4,0,9,mixedType,1
8,4,0,12,mixedType,1
1,7,0,8,mixedType,1
4,4,0,8,mixedType,1
12,4,0,16,mixedType,2
12,3,0,15,mixedType,2
7,2,0,9,mixedType,1
5,3,0,8,mixedType,1
4,2,0,6,mixedType,0
6,3,0,9,mixedType,1
10,2,0,12,mixedType,1
6,4,0,10,mixedType,1
8,2,0,10,mixedType,1
9,1,0,10,mixedType,1
13,3,0,16,mixedType,2
8,2,0,10,mixedType,1
6,3,0,9,mixedType,1
5,2,0,7,mixedType,0
8,1,0,9,mixedType,1
5,2,0,7,mixedType,0
6,1,0,7,mixedType,0
8,2,0,10,mixedType,1
1,10,0,11,mixedType,1
5,3,0,8,mixedType,1
10,1,0,11,mixedType,1
6,1,0,7,mixedType,0
6,2,0,8,mixedType,1
1,7,0,8,mixedType,1
8,2,0,10,mixedType,1
8,3,0,11,mixedType,1
4,6,0,10,mixedType,1
6,4,0,10,mixedType,1
6,1,0,7,mixedType,0
11,5,0,16,mixedType,2
4,2,0,6,mixedType,0
14,2,0,16,mixedType,2
5,3,0,8,mixedType,1
10,3,0,13,mixedType,1
6,3,0,9,mixedType,1
8,1,0,9,mixedType,1
10,3,0,13,mixedType,1
4,4,0,8,mixedType,1
6,3,0,9,mixedType,1
5,4,0,9,mixedType,1
5,4,0,9,mixedType,1
3,3,0,6,mixedType,0
10,1,0,11,mixedType,1
7,1,0,8,mixedType,1
6,5,0,11,mixedType,1
6,3,0,9,mixedType,1
5,2,0,7,mixedType,0
8,1,0,9,mixedType,1
5,1,0,6,mixedType,0
6,3,0,9,mixedType,1
5,4,0,9,mixedType,1
15,1,0,16,mixedType,2
14,2,0,16,mixedType,2
7,3,0,10,mixedType,1
8,1,0,9,mixedType,1
5,3,0,8,mixedType,1
5,3,0,8,mixedType,1
10,4,0,14,mixedType,2
5,1,0,6,mixedType,0
8,3,0,11,mixedType,1
8,2,0,10,mixedType,1
7,1,0,8,mixedType,1
13,3,0,16,mixedType,2
6,2,0,8,mixedType,1
11,3,0,14,mixedType,2
1,7,0,8,mixedType,1
6,3,0,9,mixedType,1
6,1,0,7,mixedType,0
6,4,0,10,mixedType,1
9,3,0,12,mixedType,1
9,2,0,11,mixedType,1
5,2,0,7,mixedType,0
3,6,0,9,mixedType,1
7,3,0,10,mixedType,1
9,1,0,10,mixedType,1
6,4,0,10,mixedType,1
6,1,0,7,mixedType,0
5,3,0,8,mixedType,1
2,6,0,8,mixedType,1
14,1,0,15,mixedType,2
6,2,0,8,mixedType,1
8,1,0,9,mixedType,1
9,3,0,12,mixedType,1
6,3,0,9,mixedType,1
11,5,0,16,mixedType,2
4,4,0,8,mixedType,1
8,4,0,12,mixedType,1
11,1,0,12,mixedType,1
4,4,0,8,mixedType,1
1,8,0,9,mixedType,1
9,1,0,10,mixedType,1
5,3,0,8,mixedType,1
1,7,0,8,mixedType,1
3,6,0,9,mixedType,1
7,3,0,10,mixedType,1
14,2,0,16,mixedType,2
3,6,0,9,mixedType,1
3,7,0,10,mixedType,1
6,4,0,10,mixedType,1
6,3,0,9,mixedType,1
6,6,0,12,mixedType,1
8,2,0,10,mixedType,1
6,1,0,7,mixedType,0
6,3,0,9,mixedType,1
8,4,0,12,mixedType,1
5,4,0,9,mixedType,1
5,3,0,8,mixedType,1
9,3,0,12,mixedType,1
7,2,0,9,mixedType,1
25,1,0,26,mixedType,2
6,2,0,8,mixedType,1
5,2,0,7,mixedType,0
8,2,0,10,mixedType,1
1,8,0,9,mixedType,1
2,4,0,6,mixedType,0
7,3,0,10,mixedType,1
8,1,0,9,mixedType,1
5,3,0,8,mixedType,1
6,2,0,8,mixedType,1
8,1,0,9,mixedType,1
1,10,0,11,mixedType,1
7,3,0,10,mixedType,1
5,3,0,8,mixedType,1
6,3,0,9,mixedType,1
7,3,0,10,mixedType,1
9,3,0,12,mixedType,1
9,2,0,11,mixedType,1
5,3,0,8,mixedType,1
6,3,0,9,mixedType,1
5,2,0,7,mixedType,0
6,1,0,7,mixedType,0
7,3,0,10,mixedType,1
7,3,0,10,mixedType,1
3,8,0,11,mixedType,1
5,2,0,7,mixedType,0
8,4,0,12,mixedType,1
14,2,0,16,mixedType,2
15,1,0,16,mixedType,2
4,5,0,9,mixedType,1
14,2,0,16,mixedType,2
8,2,0,10,mixedType,1
6,3,0,9,mixedType,1
7,4,0,11,mixedType,1
6,2,0,8,mixedType,1
9,1,0,10,mixedType,1
6,2,0,8,mixedType,1
4,2,0,6,mixedType,0
14,2,0,16,mixedType,2
2,4,0,6,mixedType,0
7,3,0,10,mixedType,1
14,2,0,16,mixedType,2
6,4,0,10,mixedType,1
4,4,0,8,mixedType,1
4,2,0,6,mixedType,0
6,3,0,9,mixedType,1
14,2,0,16,mixedType,2
11,3,0,14,mixedType,2
9,3,0,12,mixedType,1
7,1,0,8,mixedType,1
15,1,0,16,mixedType,2
8,1,0,9,mixedType,1
4,2,0,6,mixedType,0
6,3,0,9,mixedType,1
3,7,0,10,mixedType,1
6,2,0,8,mixedType,1
7,4,0,11,mixedType,1
8,3,0,11,mixedType,1
6,3,0,9,mixedType,1
5,3,0,8,mixedType,1
5,3,0,8,mixedType,1
8,4,0,12,mixedType,1
6,2,0,8,mixedType,1
14,2,0,16,mixedType,2
6,3,0,9,mixedType,1
8,1,0,9,mixedType,1
7,3,0,10,mixedType,1
7,2,0,9,mixedType,1
6,4,0,10,mixedType,1
6,3,0,9,mixedType,1
7,2,0,9,mixedType,1
4,4,0,8,mixedType,1
6,4,0,10,mixedType,1
8,2,0,10,mixedType,1
7,3,0,10,mixedType,1
6,2,0,8,mixedType,1
9,1,0,10,mixedType,1
7,4,0,11,mixedType,1
6,3,0,9,mixedType,1
5,3,0,8,mixedType,1
3,3,0,6,mixedType,0
8,4,0,12,mixedType,1
14,2,0,16,mixedType,2
7,3,0,10,mixedType,1
2,6,0,8,mixedType,1
5,2,0,7,mixedType,0
6,1,0,7,mixedType,0
5,3,0,8,mixedType,1
15,1,0,16,mixedType,2
12,4,0,16,mixedType,2
7,3,0,10,mixedType,1
5,4,0,9,mixedType,1
5,4,0,9,mixedType,1
4,4,0,8,mixedType,1
9,1,0,10,mixedType,1
4,2,0,6,mixedType,0
10,3,0,13,mixedType,1
5,3,0,8,mixedType,1
8,4,0,12,mixedType,1
5,3,0,8,mixedType,1
4,2,0,6,mixedType,0
6,3,0,9,mixedType,1
4,2,0,6,mixedType,0
5,4,0,9,mixedType,1
6,2,0,8,mixedType,1
7,3,0,10,mixedType,1
5,4,0,9,mixedType,1
14,2,0,16,mixedType,2
5,7,0,12,mixedType,1
5,1,0,6,mixedType,0
8,2,0,10,mixedType,1
11,5,0,16,mixedType,2
13,2,1,16,mixedType,2
6,6,0,12,mixedType,1
2,6,0,8,mixedType,1
4,7,0,11,mixedType,1
2,8,0,10,mixedType,1
5,1,0,6,mixedType,0
9,2,0,11,mixedType,1
8,2,0,10,mixedType,1
19,1,1,21,mixedType,2
7,3,0,10,mixedType,1
4,6,0,10,mixedType,1
5,4,0,9,mixedType,1
7,3,0,10,mixedType,1
7,3,0,10,mixedType,1
5,4,0,9,mixedType,1
8,1,0,9,mixedType,1
15,1,0,16,mixedType,2
6,1,0,7,mixedType,0
5,4,0,9,mixedType,1
7,1,0,8,mixedType,1
7,3,0,10,mixedType,1
8,4,0,12,mixedType,1
6,2,0,8,mixedType,1
6,2,0,8,mixedType,1
7,2,0,9,mixedType,1
1,7,0,8,mixedType,1
10,2,0,12,mixedType,1
4,4,0,8,mixedType,1
6,4,0,10,mixedType,1
6,4,0,10,mixedType,1
5,1,0,6,mixedType,0
13,6,0,19,mixedType,2
2,6,0,8,mixedType,1
9,2,0,11,mixedType,1
4,4,0,8,mixedType,1
0,6,0,6,sameType,0
4,4,0,8,mixedType,1
14,2,0,16,mixedType,2
9,4,0,13,mixedType,1
7,2,0,9,mixedType,1
5,7,0,12,mixedType,1
15,1,0,16,mixedType,2
7,3,0,10,mixedType,1
7,3,0,10,mixedType,1
7,2,0,9,mixedType,1
5,9,0,14,mixedType,2
5,3,0,8,mixedType,1
2,4,0,6,mixedType,0
2,4,0,6,mixedType,0
3,6,0,9,mixedType,1
1,8,0,9,mixedType,1
13,3,0,16,mixedType,2
7,3,0,10,mixedType,1
3,6,0,9,mixedType,1
7,2,0,9,mixedType,1
7,4,0,11,mixedType,1
7,5,0,12,mixedType,1
6,3,0,9,mixedType,1
8,2,0,10,mixedType,1
6,2,0,8,mixedType,1
1,9,0,10,mixedType,1
7,1,0,8,mixedType,1
5,3,0,8,mixedType,1
8,2,0,10,mixedType,1
6,2,0,8,mixedType,1
12,1,0,13,mixedType,1
7,3,0,10,mixedType,1
6,3,0,9,mixedType,1
2,7,0,9,mixedType,1
13,3,0,16,mixedType,2
6,1,0,7,mixedType,0
8,3,0,11,mixedType,1
3,7,0,10,mixedType,1
8,3,0,11,mixedType,1
3,6,0,9,mixedType,1
8,4,0,12,mixedType,1
14,2,0,16,mixedType,2
4,2,0,6,mixedType,0
7,3,0,10,mixedType,1
5,3,0,8,mixedType,1
6,6,0,12,mixedType,1
6,3,0,9,mixedType,1
7,3,0,10,mixedType,1
2,8,0,10,mixedType,1
14,2,0,16,mixedType,2
5,6,0,11,mixedType,1
2,6,0,8,mixedType,1
9,1,0,10,mixedType,1
7,1,0,8,mixedType,1
4,8,0,12,mixedType,1
9,1,0,10,mixedType,1
4,2,0,6,mixedType,0
7,1,0,8,mixedType,1
6,1,0,7,mixedType,0
5,8,0,13,mixedType,1
1,9,0,10,mixedType,1
12,4,0,16,mixedType,2
7,3,0,10,mixedType,1
6,3,0,9,mixedType,1
4,6,0,10,mixedType,1
1,7,0,8,mixedType,1
4,6,0,10,mixedType,1
6,2,0,8,mixedType,1
5,4,0,9,mixedType,1
4,2,0,6,mixedType,0
4,6,0,10,mixedType,1
7,3,0,10,mixedType,1
4,2,0,6,mixedType,0
7,3,0,10,mixedType,1
6,3,0,9,mixedType,1
5,1,0,6,mixedType,0
5,1,0,6,mixedType,0
6,1,0,7,mixedType,0
7,2,0,9,mixedType,1
6,2,0,8,mixedType,1
5,4,0,9,mixedType,1
7,4,0,11,mixedType,1
7,2,0,9,mixedType,1
6,3,0,9,mixedType,1
4,4,0,8,mixedType,1
3,6,0,9,mixedType,1
4,2,0,6,mixedType,0
11,6,1,18,mixedType,2
6,1,0,7,mixedType,0
6,3,0,9,mixedType,1
5,2,0,7,mixedType,0
5,1,0,6,mixedType,0
7,2,0,9,mixedType,1
1,7,0,8,mixedType,1
3,9,0,12,mixedType,1
6,1,0,7,mixedType,0
5,3,0,8,mixedType,1
7,3,0,10,mixedType,1
8,3,0,11,mixedType,1
7,3,0,10,mixedType,1
7,3,0,10,mixedType,1
3,6,0,9,mixedType,1
11,3,0,14,mixedType,2
1,8,0,9,mixedType,1
6,2,0,8,mixedType,1
2,6,0,8,mixedType,1
6,3,0,9,mixedType,1
7,4,0,11,mixedType,1
9,2,0,11,mixedType,1
6,1,0,7,mixedType,0
7,2,0,9,mixedType,1
7,1,0,8,mixedType,1
7,5,0,12,mixedType,1
15,1,0,16,mixedType,2
2,6,0,8,mixedType,1
7,3,0,10,mixedType,1
8,2,0,10,mixedType,1
8,2,0,10,mixedType,1
9,2,0,11,mixedType,1
5,4,0,9,mixedType,1
7,3,0,10,mixedType,1
0,7,2,9,mixedType,1
5,8,0,13,mixedType,1
5,3,0,8,mixedType,1
5,3,0,8,mixedType,1
7,4,0,11,mixedType,1
5,3,0,8,mixedType,1
6,4,0,10,mixedType,1
6,3,0,9,mixedType,1
8,4,0,12,mixedType,1
6,3,0,9,mixedType,1
7,2,0,9,mixedType,1
6,4,0,10,mixedType,1
8,1,0,9,mixedType,1
9,1,0,10,mixedType,1
1,10,0,11,mixedType,1
4,6,0,10,mixedType,1
3,5,0,8,mixedType,1
13,3,0,16,mixedType,2
6,2,0,8,mixedType,1
11,3,0,14,mixedType,2
7,2,0,9,mixedType,1
5,2,0,7,mixedType,0
7,3,0,10,mixedType,1
13,3,0,16,mixedType,2
7,2,0,9,mixedType,1
7,2,0,9,mixedType,1
2,8,0,10,mixedType,1
4,4,0,8,mixedType,1
6,3,0,9,mixedType,1
1,5,0,6,mixedType,0
10,3,0,13,mixedType,1
7,1,0,8,mixedType,1
15,1,0,16,mixedType,2
5,5,1,11,mixedType,1
3,6,0,9,mixedType,1
7,2,0,9,mixedType,1
7,3,0,10,mixedType,1
13,3,0,16,mixedType,2
5,4,0,9,mixedType,1
6,3,0,9,mixedType,1
8,2,0,10,mixedType,1
8,1,0,9,mixedType,1
7,4,0,11,mixedType,1
6,1,0,7,mixedType,0
8,2,0,10,mixedType,1
9,1,0,10,mixedType,1
3,3,0,6,mixedType,0
4,4,0,8,mixedType,1
3,5,0,8,mixedType,1
6,3,0,9,mixedType,1
10,3,0,13,mixedType,1
9,1,0,10,mixedType,1
14,1,0,15,mixedType,2
4,5,0,9,mixedType,1
7,3,0,10,mixedType,1
6,3,0,9,mixedType,1
2,8,0,10,mixedType,1
11,3,0,14,mixedType,2
10,2,0,12,mixedType,1
4,2,0,6,mixedType,0
4,4,0,8,mixedType,1
3,8,0,11,mixedType,1
5,2,0,7,mixedType,0
6,3,0,9,mixedType,1
4,4,0,8,mixedType,1
7,3,0,10,mixedType,1
5,4,0,9,mixedType,1
7,2,0,9,mixedType,1
8,2,0,10,mixedType,1
6,3,0,9,mixedType,1
7,2,0,9,mixedType,1
5,2,0,7,mixedType,0
5,4,0,9,mixedType,1
9,1,0,10,mixedType,1
6,3,0,9,mixedType,1
3,3,0,6,mixedType,0
10,2,0,12,mixedType,1
9,2,0,11,mixedType,1
5,3,0,8,mixedType,1
6,2,0,8,mixedType,1
7,4,0,11,mixedType,1
6,4,0,10,mixedType,1
15,1,0,16,mixedType,2
15,1,0,16,mixedType,2
5,4,0,9,mixedType,1
7,3,0,10,mixedType,1
4,4,0,8,mixedType,1
5,4,0,9,mixedType,1
7,1,0,8,mixedType,1
5,2,0,7,mixedType,0
3,3,0,6,mixedType,0
5,4,0,9,mixedType,1
12,3,0,15,mixedType,2
7,3,0,10,mixedType,1
12,3,0,15,mixedType,2
5,7,0,12,mixedType,1
7,3,0,10,mixedType,1
10,10,0,20,mixedType,2
8,3,0,11,mixedType,1
5,4,0,9,mixedType,1
8,2,0,10,mixedType,1
7,2,0,9,mixedType,1
6,3,0,9,mixedType,1
7,3,0,10,mixedType,1
2,8,0,10,mixedType,1
3,6,0,9,mixedType,1
7,2,0,9,mixedType,1
3,6,0,9,mixedType,1
6,2,0,8,mixedType,1
6,1,0,7,mixedType,0
6,1,0,7,mixedType,0
4,2,0,6,mixedType,0
3,6,0,9,mixedType,1
9,4,0,13,mixedType,1
7,3,0,10,mixedType,1
6,3,0,9,mixedType,1
5,3,0,8,mixedType,1
2,6,0,8,mixedType,1
3,6,0,9,mixedType,1
7,3,0,10,mixedType,1
7,3,0,10,mixedType,1
8,1,0,9,mixedType,1
4,5,0,9,mixedType,1
7,2,0,9,mixedType,1
8,2,0,10,mixedType,1
5,3,0,8,mixedType,1
10,1,0,11,mixedType,1
9,7,0,16,mixedType,2
1,8,0,9,mixedType,1
10,2,0,12,mixedType,1
8,1,0,9,mixedType,1
5,7,0,12,mixedType,1
9,3,0,12,mixedType,1
5,2,0,7,mixedType,0
8,4,0,12,mixedType,1
5,2,0,7,mixedType,0
13,3,0,16,mixedType,2
4,6,0,10,mixedType,1
9,7,0,16,mixedType,2
3,10,0,13,mixedType,1
12,3,0,15,mixedType,2
7,1,0,8,mixedType,1
12,3,0,15,mixedType,2
8,3,0,11,mixedType,1
5,2,0,7,mixedType,0
2,6,0,8,mixedType,1
6,4,0,10,mixedType,1
6,5,0,11,mixedType,1
4,2,0,6,mixedType,0
5,7,0,12,mixedType,1
9,1,0,10,mixedType,1
2,6,0,8,mixedType,1
7,3,0,10,mixedType,1
6,1,0,7,mixedType,0
1,8,0,9,mixedType,1
5,1,0,6,mixedType,0
4,2,0,6,mixedType,0
7,4,0,11,mixedType,1
1,8,0,9,mixedType,1
9,2,0,11,mixedType,1
7,4,0,11,mixedType,1
7,3,0,10,mixedType,1
9,2,0,11,mixedType,1
11,4,0,15,mixedType,2
4,2,0,6,mixedType,0
5,3,0,8,mixedType,1
6,4,0,10,mixedType,1
5,3,0,8,mixedType,1
6,1,0,7,mixedType,0
8,1,0,9,mixedType,1
6,4,0,10,mixedType,1
6,1,0,7,mixedType,0
11,1,0,12,mixedType,1
6,3,0,9,mixedType,1
5,3,0,8,mixedType,1
8,2,0,10,mixedType,1
6,3,0,9,mixedType,1
6,4,0,10,mixedType,1
6,2,0,8,mixedType,1
6,4,0,10,mixedType,1
9,2,0,11,mixedType,1
4,2,0,6,mixedType,0
14,2,0,16,mixedType,2
7,1,0,8,mixedType,1
12,3,0,15,mixedType,2
7,3,0,10,mixedType,1
2,4,0,6,mixedType,0
6,4,0,10,mixedType,1
11,3,0,14,mixedType,2
8,2,0,10,mixedType,1
8,1,0,9,mixedType,1
6,2,0,8,mixedType,1
7,3,0,10,mixedType,1
7,3,0,10,mixedType,1
6,3,0,9,mixedType,1
6,3,0,9,mixedType,1
8,2,0,10,mixedType,1
7,2,0,9,mixedType,1
7,3,0,10,mixedType,1
5,4,0,9,mixedType,1
12,4,0,16,mixedType,2
9,5,0,14,mixedType,2
5,4,0,9,mixedType,1
4,2,0,6,mixedType,0
6,4,0,10,mixedType,1
6,2,0,8,mixedType,1
7,1,0,8,mixedType,1
6,2,0,8,mixedType,1
5,4,0,9,mixedType,1
7,2,0,9,mixedType,1
6,1,0,7,mixedType,0
8,2,0,10,mixedType,1
6,3,0,9,mixedType,1
3,6,0,9,mixedType,1
9,1,0,10,mixedType,1
4,2,0,6,mixedType,0
7,1,0,8,mixedType,1
5,4,0,9,mixedType,1
6,4,0,10,mixedType,1
7,3,0,10,mixedType,1
4,4,0,8,mixedType,1
8,3,0,11,mixedType,1
15,1,0,16,mixedType,2
5,3,0,8,mixedType,1
6,2,0,8,mixedType,1
9,1,0,10,mixedType,1
5,2,0,7,mixedType,0
3,7,0,10,mixedType,1
5,1,0,6,mixedType,0
2,6,0,8,mixedType,1
10,2,0,12,mixedType,1
14,2,0,16,mixedType,2
5,4,0,9,mixedType,1
6,4,0,10,mixedType,1
6,4,0,10,mixedType,1
9,1,0,10,mixedType,1
5,2,0,7,mixedType,0
5,4,0,9,mixedType,1
4,2,0,6,mixedType,0
6,4,0,10,mixedType,1
5,2,0,7,mixedType,0
6,3,0,9,mixedType,1
2,6,0,8,mixedType,1
5,3,0,8,mixedType,1
8,3,0,11,mixedType,1
9,3,0,12,mixedType,1
11,3,0,14,mixedType,2
4,4,0,8,mixedType,1
7,3,0,10,mixedType,1
6,6,0,12,mixedType,1
13,3,0,16,mixedType,2
8,2,0,10,mixedType,1
6,3,0,9,mixedType,1
5,4,0,9,mixedType,1
13,3,1,17,mixedType,2
7,1,0,8,mixedType,1
7,1,0,8,mixedType,1
6,2,0,8,mixedType,1
4,2,0,6,mixedType,0
4,4,0,8,mixedType,1
4,2,0,6,mixedType,0
8,1,0,9,mixedType,1
12,3,0,15,mixedType,2
7,2,0,9,mixedType,1
10,2,0,12,mixedType,1
8,2,0,10,mixedType,1
14,4,0,18,mixedType,2
2,8,0,10,mixedType,1
9,1,0,10,mixedType,1
6,1,0,7,mixedType,0
10,1,0,11,mixedType,1
5,3,0,8,mixedType,1
7,3,0,10,mixedType,1
5,2,0,7,mixedType,0
7,5,0,12,mixedType,1
8,3,0,11,mixedType,1
3,6,0,9,mixedType,1
5,1,0,6,mixedType,0
1,10,0,11,mixedType,1
9,4,0,13,mixedType,1
6,4,0,10,mixedType,1
5,2,0,7,mixedType,0
15,2,1,18,mixedType,2
7,1,0,8,mixedType,1
6,2,0,8,mixedType,1
3,7,0,10,mixedType,1
9,0,1,10,mixedType,1
6,3,0,9,mixedType,1
9,4,0,13,mixedType,1
7,3,0,10,mixedType,1
7,6,0,13,mixedType,1
4,4,0,8,mixedType,1
6,4,0,10,mixedType,1
8,2,0,10,mixedType,1
5,2,0,7,mixedType,0
11,2,3,16,mixedType,2
8,1,0,9,mixedType,1
8,1,0,9,mixedType,1
6,3,0,9,mixedType,1
6,2,0,8,mixedType,1
5,4,0,9,mixedType,1
7,2,0,9,mixedType,1
5,7,0,12,mixedType,1
7,3,0,10,mixedType,1
9,3,0,12,mixedType,1
13,3,0,16,mixedType,2
2,7,0,9,mixedType,1
6,3,0,9,mixedType,1
9,3,0,12,mixedType,1
7,1,0,8,mixedType,1
8,2,0,10,mixedType,1
5,3,0,8,mixedType,1
5,4,0,9,mixedType,1
5,6,0,11,mixedType,1
8,4,0,12,mixedType,1
9,3,0,12,mixedType,1
9,3,0,12,mixedType,1
8,2,0,10,mixedType,1
5,3,0,8,mixedType,1
6,4,0,10,mixedType,1
13,3,0,16,mixedType,2
6,4,0,10,mixedType,1
14,2,0,16,mixedType,2
14,2,0,16,mixedType,2
5,3,0,8,mixedType,1
6,3,0,9,mixedType,1
5,3,0,8,mixedType,1
7,3,0,10,mixedType,1
7,1,0,8,mixedType,1
13,3,0,16,mixedType,2
6,3,0,9,mixedType,1
3,5,0,8,mixedType,1
2,7,0,9,mixedType,1
6,4,0,10,mixedType,1
9,3,0,12,mixedType,1
9,1,0,10,mixedType,1
7,1,0,8,mixedType,1
6,3,0,9,mixedType,1
7,4,0,11,mixedType,1
5,4,0,9,mixedType,1
9,3,0,12,mixedType,1
6,8,0,14,mixedType,2
5,4,0,9,mixedType,1
3,8,0,11,mixedType,1
7,3,0,10,mixedType,1
6,1,0,7,mixedType,0
12,3,0,15,mixedType,2
14,2,0,16,mixedType,2
15,1,0,16,mixedType,2
7,1,0,8,mixedType,1
6,3,0,9,mixedType,1
6,1,0,7,mixedType,0
11,3,0,14,mixedType,2
11,2,0,13,mixedType,1
5,3,0,8,mixedType,1
1,10,0,11,mixedType,1
3,3,0,6,mixedType,0
5,1,0,6,mixedType,0
1,8,0,9,mixedType,1
7,2,0,9,mixedType,1
5,2,0,7,mixedType,0
6,3,0,9,mixedType,1
8,1,0,9,mixedType,1
8,1,0,9,mixedType,1
13,3,0,16,mixedType,2
7,3,0,10,mixedType,1
6,4,0,10,mixedType,1
13,3,0,16,mixedType,2
3,3,0,6,mixedType,0
7,1,0,8,mixedType,1
8,2,0,10,mixedType,1
6,7,0,13,mixedType,1
3,8,0,11,mixedType,1
4,6,0,10,mixedType,1
5,2,0,7,mixedType,0
7,4,0,11,mixedType,1
13,3,0,16,mixedType,2
8,1,0,9,mixedType,1
7,3,0,10,mixedType,1
7,3,0,10,mixedType,1
5,6,0,11,mixedType,1
1,8,0,9,mixedType,1
7,3,0,10,mixedType,1
12,3,0,15,mixedType,2
6,4,0,10,mixedType,1
8,3,0,11,mixedType,1
11,3,0,14,mixedType,2
7,3,0,10,mixedType,1
9,1,0,10,mixedType,1
6,3,0,9,mixedType,1
9,4,0,13,mixedType,1
5,3,0,8,mixedType,1
3,5,0,8,mixedType,1
12,4,0,16,mixedType,2
5,5,0,10,mixedType,1
12,1,0,13,mixedType,1
9,5,0,14,mixedType,2
15,1,0,16,mixedType,2
4,4,0,8,mixedType,1
4,7,0,11,mixedType,1
5,3,0,8,mixedType,1
5,3,0,8,mixedType,1
8,3,0,11,mixedType,1
5,2,0,7,mixedType,0
5,7,0,12,mixedType,1
5,4,0,9,mixedType,1
6,3,0,9,mixedType,1
7,2,0,9,mixedType,1
8,1,0,9,mixedType,1
8,1,0,9,mixedType,1
8,1,0,9,mixedType,1
8,2,0,10,mixedType,1
6,2,0,8,mixedType,1
8,2,0,10,mixedType,1
11,2,0,13,mixedType,1
13,3,0,16,mixedType,2
7,2,0,9,mixedType,1
12,3,0,15,mixedType,2
2,7,0,9,mixedType,1
1,9,0,10,mixedType,1
4,4,0,8,mixedType,1
7,2,0,9,mixedType,1
7,3,0,10,mixedType,1
4,2,0,6,mixedType,0
5,3,0,8,mixedType,1
5,3,0,8,mixedType,1
11,3,0,14,mixedType,2
8,2,0,10,mixedType,1
6,4,0,10,mixedType,1
3,6,0,9,mixedType,1
6,3,0,9,mixedType,1
8,2,0,10,mixedType,1
10,3,0,13,mixedType,1
8,3,0,11,mixedType,1
7,3,0,10,mixedType,1
6,8,1,15,mixedType,2
3,3,0,6,mixedType,0
8,2,0,10,mixedType,1
6,7,0,13,mixedType,1
6,2,0,8,mixedType,1
6,1,0,7,mixedType,0
9,1,0,10,mixedType,1
8,1,0,9,mixedType,1
12,4,0,16,mixedType,2
5,3,0,8,mixedType,1
6,6,0,12,mixedType,1
1,6,0,7,mixedType,0
7,2,0,9,mixedType,1
6,1,0,7,mixedType,0
6,1,0,7,mixedType,0
7,3,0,10,mixedType,1
13,3,0,16,mixedType,2
12,3,0,15,mixedType,2
8,4,0,12,mixedType,1
12,4,0,16,mixedType,2
7,2,0,9,mixedType,1
14,2,0,16,mixedType,2
13,3,0,16,mixedType,2
4,7,0,11,mixedType,1
7,3,0,10,mixedType,1
6,4,0,10,mixedType,1
14,2,0,16,mixedType,2
6,4,0,10,mixedType,1
4,10,1,15,mixedType,2
5,3,0,8,mixedType,1
7,3,0,10,mixedType,1
9,4,0,13,mixedType,1
7,3,0,10,mixedType,1
4,4,0,8,mixedType,1
11,3,0,14,mixedType,2
5,4,0,9,mixedType,1
4,4,0,8,mixedType,1
5,3,0,8,mixedType,1
6,6,0,12,mixedType,1
8,1,0,9,mixedType,1
5,5,0,10,mixedType,1
8,2,0,10,mixedType,1
8,2,0,10,mixedType,1
4,2,0,6,mixedType,0
5,8,1,14,mixedType,2
5,3,0,8,mixedType,1
7,2,0,9,mixedType,1
5,2,0,7,mixedType,0
6,4,0,10,mixedType,1
7,3,0,10,mixedType,1
10,1,0,11,mixedType,1
6,4,0,10,mixedType,1
9,2,0,11,mixedType,1
5,2,0,7,mixedType,0
7,3,0,10,mixedType,1
7,1,0,8,mixedType,1
8,7,0,15,mixedType,2
8,4,0,12,mixedType,1
6,3,0,9,mixedType,1
6,1,0,7,mixedType,0
3,6,0,9,mixedType,1
5,3,0,8,mixedType,1
10,1,0,11,mixedType,1
7,2,0,9,mixedType,1
3,6,0,9,mixedType,1
5,3,0,8,mixedType,1
2,4,0,6,mixedType,0
5,1,0,6,mixedType,0
6,2,0,8,mixedType,1
7,1,0,8,mixedType,1
5,2,0,7,mixedType,0
10,2,0,12,mixedType,1
5,4,0,9,mixedType,1
6,4,0,10,mixedType,1
4,6,0,10,mixedType,1
5,1,0,6,mixedType,0
4,2,0,6,mixedType,0
7,3,0,10,mixedType,1
6,3,0,9,mixedType,1
8,1,0,9,mixedType,1
9,4,0,13,mixedType,1
9,3,0,12,mixedType,1
12,3,0,15,mixedType,2
8,1,0,9,mixedType,1
6,3,0,9,mixedType,1
4,8,0,12,mixedType,1
6,1,0,7,mixedType,0
6,3,0,9,mixedType,1
5,5,0,10,mixedType,1
14,2,0,16,mixedType,2
14,2,0,16,mixedType,2
7,1,0,8,mixedType,1
6,3,0,9,mixedType,1
6,2,0,8,mixedType,1
6,8,0,14,mixedType,2
4,2,0,6,mixedType,0
9,4,0,13,mixedType,1
11,3,0,14,mixedType,2
14,2,0,16,mixedType,2
8,2,0,10,mixedType,1
8,2,0,10,mixedType,1
8,1,0,9,mixedType,1
8,2,0,10,mixedType,1
14,3,2,19,mixedType,2
6,6,0,12,mixedType,1
7,2,0,9,mixedType,1
5,4,0,9,mixedType,1
6,1,0,7,mixedType,0
12,3,0,15,mixedType,2
11,5,0,16,mixedType,2
7,2,0,9,mixedType,1
5,5,0,10,mixedType,1
1,8,0,9,mixedType,1
4,2,0,6,mixedType,0
8,1,0,9,mixedType,1
5,5,0,10,mixedType,1
5,2,0,7,mixedType,0
8,4,0,12,mixedType,1
14,2,0,16,mixedType,2
9,2,0,11,mixedType,1
5,2,0,7,mixedType,0
6,1,0,7,mixedType,0
6,3,0,9,mixedType,1
4,4,0,8,mixedType,1
7,3,0,10,mixedType,1
7,2,0,9,mixedType,1
3,6,0,9,mixedType,1
5,3,0,8,mixedType,1
8,2,0,10,mixedType,1
5,4,0,9,mixedType,1
11,3,0,14,mixedType,2
3,7,0,10,mixedType,1
8,4,0,12,mixedType,1
7,2,0,9,mixedType,1
5,6,0,11,mixedType,1
8,1,0,9,mixedType,1
8,3,0,11,mixedType,1
3,6,0,9,mixedType,1
6,3,0,9,mixedType,1
5,4,0,9,mixedType,1
5,3,0,8,mixedType,1
4,6,0,10,mixedType,1
5,4,0,9,mixedType,1
5,4,0,9,mixedType,1
7,2,0,9,mixedType,1
5,2,0,7,mixedType,0
8,1,0,9,mixedType,1
8,1,0,9,mixedType,1
4,4,0,8,mixedType,1
12,3,0,15,mixedType,2
8,2,0,10,mixedType,1
6,2,0,8,mixedType,1
3,8,0,11,mixedType,1
7,1,0,8,mixedType,1
5,2,0,7,mixedType,0
5,3,0,8,mixedType,1
1,7,0,8,mixedType,1
6,3,0,9,mixedType,1
6,4,0,10,mixedType,1
5,3,0,8,mixedType,1
8,2,0,10,mixedType,1
1,8,0,9,mixedType,1
6,3,0,9,mixedType,1
5,3,0,8,mixedType,1
12,4,0,16,mixedType,2
13,3,0,16,mixedType,2
8,4,0,12,mixedType,1
6,2,0,8,mixedType,1
10,2,0,12,mixedType,1
8,3,0,11,mixedType,1
6,3,0,9,mixedType,1
5,3,0,8,mixedType,1
8,1,0,9,mixedType,1
5,3,0,8,mixedType,1
4,2,0,6,mixedType,0
5,3,0,8,mixedType,1
11,3,0,14,mixedType,2
10,1,0,11,mixedType,1
6,2,0,8,mixedType,1
9,2,0,11,mixedType,1
4,6,0,10,mixedType,1
6,2,0,8,mixedType,1
2,9,0,11,mixedType,1
2,6,0,8,mixedType,1
6,4,0,10,mixedType,1
6,3,0,9,mixedType,1
8,2,0,10,mixedType,1
6,1,0,7,mixedType,0
5,2,0,7,mixedType,0
6,3,0,9,mixedType,1
3,6,0,9,mixedType,1
8,2,0,10,mixedType,1
8,1,0,9,mixedType,1
9,3,0,12,mixedType,1
4,4,0,8,mixedType,1
15,1,0,16,mixedType,2
7,1,0,8,mixedType,1
7,1,0,8,mixedType,1
6,1,0,7,mixedType,0
6,3,0,9,mixedType,1
7,2,0,9,mixedType,1
15,1,0,16,mixedType,2
14,2,0,16,mixedType,2
5,2,0,7,mixedType,0
9,4,0,13,mixedType,1
6,8,2,16,mixedType,2
5,1,0,6,mixedType,0
5,3,0,8,mixedType,1
6,3,0,9,mixedType,1
3,9,0,12,mixedType,1
8,1,0,9,mixedType,1
5,3,0,8,mixedType,1
7,3,0,10,mixedType,1
5,5,0,10,mixedType,1
7,3,0,10,mixedType,1
10,2,0,12,mixedType,1
9,3,0,12,mixedType,1
5,2,0,7,mixedType,0
5,4,0,9,mixedType,1
7,3,0,10,mixedType,1
8,2,0,10,mixedType,1
7,1,0,8,mixedType,1
1,8,0,9,mixedType,1
4,4,0,8,mixedType,1
4,2,0,6,mixedType,0
11,5,0,16,mixedType,2
4,8,0,12,mixedType,1
9,1,0,10,mixedType,1
7,2,0,9,mixedType,1
15,1,0,16,mixedType,2
6,3,0,9,mixedType,1
1,8,0,9,mixedType,1
5,4,0,9,mixedType,1
9,1,0,10,mixedType,1
9,1,0,10,mixedType,1
5,1,0,6,mixedType,0
12,3,0,15,mixedType,2
6,3,0,9,mixedType,1
0,11,1,12,mixedType,1
7,3,0,10,mixedType,1
4,4,0,8,mixedType,1
7,3,0,10,mixedType,1
9,1,0,10,mixedType,1
5,8,0,13,mixedType,1
9,2,0,11,mixedType,1
7,4,0,11,mixedType,1
8,3,0,11,mixedType,1
5,4,0,9,mixedType,1
13,3,0,16,mixedType,2
5,4,0,9,mixedType,1
2,8,0,10,mixedType,1
6,2,0,8,mixedType,1
5,2,0,7,mixedType,0
7,3,0,10,mixedType,1
4,2,0,6,mixedType,0
6,6,0,12,mixedType,1
3,6,0,9,mixedType,1
2,5,0,7,mixedType,0
9,3,0,12,mixedType,1
5,4,0,9,mixedType,1
7,3,0,10,mixedType,1
10,6,0,16,mixedType,2
6,2,0,8,mixedType,1
8,3,0,11,mixedType,1
7,2,0,9,mixedType,1
4,2,0,6,mixedType,0
8,4,0,12,mixedType,1
11,2,0,13,mixedType,1
7,3,0,10,mixedType,1
4,4,0,8,mixedType,1
6,2,0,8,mixedType,1
6,1,0,7,mixedType,0
1,10,0,11,mixedType,1
7,1,0,8,mixedType,1
7,4,0,11,mixedType,1
10,2,0,12,mixedType,1
6,1,0,7,mixedType,0
9,3,0,12,mixedType,1
7,3,0,10,mixedType,1
4,4,0,8,mixedType,1
12,3,0,15,mixedType,2
6,3,0,9,mixedType,1
5,3,0,8,mixedType,1
7,3,0,10,mixedType,1
5,2,0,7,mixedType,0
5,2,0,7,mixedType,0
8,4,0,12,mixedType,1
6,0,1,7,mixedType,0
3,5,0,8,mixedType,1
6,4,0,10,mixedType,1
8,1,0,9,mixedType,1
8,1,0,9,mixedType,1
13,3,0,16,mixedType,2
6,4,0,10,mixedType,1
6,3,0,9,mixedType,1
2,9,0,11,mixedType,1
9,1,0,10,mixedType,1
9,1,0,10,mixedType,1
6,3,0,9,mixedType,1
8,4,0,12,mixedType,1
14,2,0,16,mixedType,2
15,1,0,16,mixedType,2
6,2,0,8,mixedType,1
6,4,0,10,mixedType,1
4,2,0,6,mixedType,0
9,1,0,10,mixedType,1
8,3,0,11,mixedType,1
9,1,0,10,mixedType,1
8,1,0,9,mixedType,1
6,3,0,9,mixedType,1
5,3,0,8,mixedType,1
5,1,0,6,mixedType,0
8,3,0,11,mixedType,1
1,7,0,8,mixedType,1
5,2,0,7,mixedType,0
7,2,0,9,mixedType,1
17,3,2,22,mixedType,2
3,3,0,6,mixedType,0
12,3,0,15,mixedType,2
5,2,0,7,mixedType,0
12,0,1,13,mixedType,1
7,1,0,8,mixedType,1
14,2,0,16,mixedType,2
4,6,0,10,mixedType,1
5,8,0,13,mixedType,1
5,6,0,11,mixedType,1
5,1,0,6,mixedType,0
6,6,0,12,mixedType,1
4,6,0,10,mixedType,1
7,2,0,9,mixedType,1
8,4,0,12,mixedType,1
10,3,0,13,mixedType,1
14,2,0,16,mixedType,2
9,1,0,10,mixedType,1
2,6,0,8,mixedType,1
3,5,0,8,mixedType,1
4,4,0,8,mixedType,1
6,2,0,8,mixedType,1
5,3,0,8,mixedType,1
5,5,0,10,mixedType,1
4,4,0,8,mixedType,1
6,2,0,8,mixedType,1
10,1,0,11,mixedType,1
4,4,0,8,mixedType,1
9,2,0,11,mixedType,1
11,3,0,14,mixedType,2
6,3,0,9,mixedType,1
8,2,0,10,mixedType,1
7,2,0,9,mixedType,1
3,3,0,6,mixedType,0
9,1,0,10,mixedType,1
9,1,0,10,mixedType,1
5,4,0,9,mixedType,1
5,2,0,7,mixedType,0
1,8,0,9,mixedType,1
5,1,0,6,mixedType,0
7,3,0,10,mixedType,1
7,6,1,14,mixedType,2
3,5,0,8,mixedType,1
5,7,0,12,mixedType,1
6,4,0,10,mixedType,1
7,3,0,10,mixedType,1
8,1,0,9,mixedType,1
4,2,0,6,mixedType,0
2,10,0,12,mixedType,1
6,4,0,10,mixedType,1
6,3,0,9,mixedType,1
5,2,0,7,mixedType,0
6,2,0,8,mixedType,1
14,2,0,16,mixedType,2
6,3,0,9,mixedType,1
12,4,0,16,mixedType,2
14,2,0,16,mixedType,2
11,5,0,16,mixedType,2
7,3,0,10,mixedType,1
8,2,0,10,mixedType,1
4,2,0,6,mixedType,0
6,1,0,7,mixedType,0
14,2,0,16,mixedType,2
5,3,0,8,mixedType,1
6,1,0,7,mixedType,0
12,3,0,15,mixedType,2
6,4,0,10,mixedType,1
12,2,1,15,mixedType,2
6,2,0,8,mixedType,1
5,2,0,7,mixedType,0
7,1,0,8,mixedType,1
14,2,0,16,mixedType,2
7,2,0,9,mixedType,1
6,2,0,8,mixedType,1
14,2,0,16,mixedType,2
6,1,0,7,mixedType,0
5,1,0,6,mixedType,0
4,2,0,6,mixedType,0
7,2,0,9,mixedType,1
9,1,0,10,mixedType,1
5,1,0,6,mixedType,0
5,3,0,8,mixedType,1
4,4,0,8,mixedType,1
6,4,0,10,mixedType,1
9,1,0,10,mixedType,1
4,4,0,8,mixedType,1
0,6,2,8,mixedType,1
11,1,0,12,mixedType,1
1,8,0,9,mixedType,1
6,3,0,9,mixedType,1
15,1,0,16,mixedType,2
6,2,0,8,mixedType,1
7,3,0,10,mixedType,1
7,2,0,9,mixedType,1
1,5,0,6,mixedType,0
4,2,0,6,mixedType,0
8,3,0,11,mixedType,1
6,1,0,7,mixedType,0
5,4,0,9,mixedType,1
7,2,0,9,mixedType,1
6,3,0,9,mixedType,1
5,3,0,8,mixedType,1
7,4,0,11,mixedType,1
8,3,0,11,mixedType,1
8,1,0,9,mixedType,1
7,2,0,9,mixedType,1
4,2,0,6,mixedType,0
15,1,0,16,mixedType,2
8,2,0,10,mixedType,1
4,4,0,8,mixedType,1
7,3,0,10,mixedType,1
12,3,0,15,mixedType,2
6,2,0,8,mixedType,1
11,3,0,14,mixedType,2
3,8,0,11,mixedType,1
2,9,0,11,mixedType,1
5,4,0,9,mixedType,1
2,4,0,6,mixedType,0
6,6,0,12,mixedType,1
6,4,0,10,mixedType,1
5,3,0,8,mixedType,1
13,3,0,16,mixedType,2
6,2,0,8,mixedType,1
3,10,0,13,mixedType,1
14,2,0,16,mixedType,2
14,2,0,16,mixedType,2
5,2,0,7,mixedType,0
3,3,0,6,mixedType,0
6,3,0,9,mixedType,1
6,2,0,8,mixedType,1
5,2,0,7,mixedType,0
4,4,0,8,mixedType,1
3,3,0,6,mixedType,0
8,3,0,11,mixedType,1
5,3,0,8,mixedType,1
3,6,0,9,mixedType,1
4,8,0,12,mixedType,1
9,1,0,10,mixedType,1
4,4,0,8,mixedType,1
9,1,0,10,mixedType,1
5,2,0,7,mixedType,0
6,1,0,7,mixedType,0
13,3,0,16,mixedType,2
11,1,0,12,mixedType,1
6,2,0,8,mixedType,1
8,2,0,10,mixedType,1
14,2,0,16,mixedType,2
3,10,0,13,mixedType,1
6,6,0,12,mixedType,1
9,1,0,10,mixedType,1
3,6,0,9,mixedType,1
8,1,0,9,mixedType,1
5,3,0,8,mixedType,1
6,2,0,8,mixedType,1
4,8,0,12,mixedType,1
9,1,0,10,mixedType,1
2,8,0,10,mixedType,1
4,2,0,6,mixedType,0
9,0,1,10,mixedType,1
6,1,0,7,mixedType,0
8,2,0,10,mixedType,1
8,2,0,10,mixedType,1
6,2,0,8,mixedType,1
9,1,0,10,mixedType,1
5,4,0,9,mixedType,1
7,1,0,8,mixedType,1
4,5,0,9,mixedType,1
6,4,0,10,mixedType,1
6,3,0,9,mixedType,1
6,1,0,7,mixedType,0
8,1,0,9,mixedType,1
7,3,0,10,mixedType,1
6,1,0,7,mixedType,0
8,1,0,9,mixedType,1
5,3,0,8,mixedType,1
5,4,0,9,mixedType,1
7,2,0,9,mixedType,1
9,3,0,12,mixedType,1
4,2,0,6,mixedType,0
8,2,0,10,mixedType,1
11,3,0,14,mixedType,2
6,3,0,9,mixedType,1
5,4,0,9,mixedType,1
2,4,0,6,mixedType,0
8,1,0,9,mixedType,1
4,4,0,8,mixedType,1
1,10,0,11,mixedType,1
6,3,0,9,mixedType,1
10,2,0,12,mixedType,1
3,6,0,9,mixedType,1
5,5,0,10,mixedType,1
12,4,0,16,mixedType,2
7,1,0,8,mixedType,1
8,1,0,9,mixedType,1
5,3,0,8,mixedType,1
2,7,0,9,mixedType,1
8,2,0,10,mixedType,1
7,3,0,10,mixedType,1
6,8,0,14,mixedType,2
11,1,0,12,mixedType,1
1,8,0,9,mixedType,1
6,4,0,10,mixedType,1
6,3,0,9,mixedType,1
8,2,0,10,mixedType,1
7,1,0,8,mixedType,1
4,4,0,8,mixedType,1
4,2,0,6,mixedType,0
6,4,0,10,mixedType,1
2,9,0,11,mixedType,1
7,1,0,8,mixedType,1
15,1,0,16,mixedType,2
6,3,0,9,mixedType,1
8,2,0,10,mixedType,1
9,4,0,13,mixedType,1
6,2,0,8,mixedType,1
13,3,0,16,mixedType,2
9,1,0,10,mixedType,1
7,4,0,11,mixedType,1
9,2,0,11,mixedType,1
6,3,0,9,mixedType,1
7,1,0,8,mixedType,1
1,8,0,9,mixedType,1
8,2,0,10,mixedType,1
14,2,0,16,mixedType,2
7,3,0,10,mixedType,1
5,2,0,7,mixedType,0
10,2,0,12,mixedType,1
7,1,0,8,mixedType,1
8,8,0,16,mixedType,2
4,6,0,10,mixedType,1
7,3,0,10,mixedType,1
5,2,0,7,mixedType,0
8,2,0,10,mixedType,1
7,1,0,8,mixedType,1
5,4,0,9,mixedType,1
7,2,0,9,mixedType,1
4,4,0,8,mixedType,1
6,1,0,7,mixedType,0
7,3,0,10,mixedType,1
6,3,0,9,mixedType,1
11,5,0,16,mixedType,2
5,3,0,8,mixedType,1
2,4,0,6,mixedType,0
9,1,0,10,mixedType,1
6,3,0,9,mixedType,1
8,3,0,11,mixedType,1
5,3,0,8,mixedType,1
6,2,0,8,mixedType,1
4,4,0,8,mixedType,1
9,4,0,13,mixedType,1
8,3,0,11,mixedType,1
4,4,0,8,mixedType,1
6,3,0,9,mixedType,1
3,6,0,9,mixedType,1
15,1,0,16,mixedType,2
6,4,0,10,mixedType,1
13,3,0,16,mixedType,2
5,5,0,10,mixedType,1
5,1,0,6,mixedType,0
5,2,0,7,mixedType,0
5,2,0,7,mixedType,0
5,2,0,7,mixedType,0
7,2,0,9,mixedType,1
4,6,0,10,mixedType,1
5,4,0,9,mixedType,1
6,4,0,10,mixedType,1
5,3,0,8,mixedType,1
6,1,0,7,mixedType,0
6,4,0,10,mixedType,1
6,3,0,9,mixedType,1
3,7,0,10,mixedType,1
7,0,0,7,sameType,0
7,3,0,10,mixedType,1
1,8,0,9,mixedType,1
13,3,0,16,mixedType,2
6,3,0,9,mixedType,1
5,2,0,7,mixedType,0
4,4,0,8,mixedType,1
6,4,0,10,mixedType,1
5,4,0,9,mixedType,1
4,6,0,10,mixedType,1
7,3,0,10,mixedType,1
7,3,0,10,mixedType,1
5,2,0,7,mixedType,0
6,3,0,9,mixedType,1
8,1,0,9,mixedType,1
6,3,0,9,mixedType,1
14,2,0,16,mixedType,2
10,3,0,13,mixedType,1
9,3,0,12,mixedType,1
5,2,0,7,mixedType,0
12,4,0,16,mixedType,2
7,2,0,9,mixedType,1
8,6,2,16,mixedType,2
2,6,0,8,mixedType,1
6,2,0,8,mixedType,1
7,3,0,10,mixedType,1
8,4,0,12,mixedType,1
5,3,0,8,mixedType,1
7,3,0,10,mixedType,1
1,7,0,8,mixedType,1
7,2,0,9,mixedType,1
8,3,0,11,mixedType,1
5,2,0,7,mixedType,0
5,4,0,9,mixedType,1
3,5,0,8,mixedType,1
8,1,0,9,mixedType,1
6,2,0,8,mixedType,1
6,1,0,7,mixedType,0
13,3,0,16,mixedType,2
6,7,0,13,mixedType,1
5,5,0,10,mixedType,1
5,2,0,7,mixedType,0
5,5,0,10,mixedType,1
7,2,0,9,mixedType,1
5,3,0,8,mixedType,1
8,2,0,10,mixedType,1
7,3,0,10,mixedType,1
6,3,0,9,mixedType,1
2,6,0,8,mixedType,1
2,6,0,8,mixedType,1
11,2,0,13,mixedType,1
4,4,0,8,mixedType,1
5,4,0,9,mixedType,1
8,1,0,9,mixedType,1
8,2,0,10,mixedType,1
6,2,0,8,mixedType,1
7,2,0,9,mixedType,1
5,4,0,9,mixedType,1
4,2,0,6,mixedType,0
7,2,0,9,mixedType,1
9,4,0,13,mixedType,1
7,2,0,9,mixedType,1
6,4,0,10,mixedType,1
5,2,0,7,mixedType,0
13,3,0,16,mixedType,2
5,2,0,7,mixedType,0
4,4,0,8,mixedType,1
6,5,0,11,mixedType,1
13,3,0,16,mixedType,2
3,7,0,10,mixedType,1
2,6,0,8,mixedType,1
5,3,0,8,mixedType,1
5,3,0,8,mixedType,1
8,1,0,9,mixedType,1
4,2,0,6,mixedType,0
9,1,0,10,mixedType,1
5,2,0,7,mixedType,0
6,3,0,9,mixedType,1
12,1,0,13,mixedType,1
4,2,0,6,mixedType,0
6,1,0,7,mixedType,0
6,4,0,10,mixedType,1
2,8,0,10,mixedType,1
6,6,0,12,mixedType,1
7,3,0,10,mixedType,1
6,1,0,7,mixedType,0
8,2,0,10,mixedType,1
4,2,0,6,mixedType,0
12,3,0,15,mixedType,2
14,2,0,16,mixedType,2
6,5,0,11,mixedType,1
13,3,0,16,mixedType,2
2,8,0,10,mixedType,1
5,4,0,9,mixedType,1
7,1,0,8,mixedType,1
7,3,0,10,mixedType,1
4,2,0,6,mixedType,0
5,4,0,9,mixedType,1
8,1,0,9,mixedType,1
7,3,0,10,mixedType,1
7,2,0,9,mixedType,1
6,5,0,11,mixedType,1
13,3,0,16,mixedType,2
14,2,0,16,mixedType,2
12,4,0,16,mixedType,2
5,3,0,8,mixedType,1
7,1,0,8,mixedType,1
16,1,0,17,mixedType,2
8,1,0,9,mixedType,1
5,2,0,7,mixedType,0
9,1,0,10,mixedType,1
8,1,0,9,mixedType,1
8,3,0,11,mixedType,1
7,3,0,10,mixedType,1
15,1,0,16,mixedType,2
6,3,0,9,mixedType,1
4,2,0,6,mixedType,0
6,5,0,11,mixedType,1
7,2,0,9,mixedType,1
7,2,0,9,mixedType,1
7,3,0,10,mixedType,1
6,2,0,8,mixedType,1
8,1,0,9,mixedType,1
5,1,0,6,mixedType,0
6,2,0,8,mixedType,1
12,3,0,15,mixedType,2
2,7,0,9,mixedType,1
5,1,0,6,mixedType,0
12,1,0,13,mixedType,1
5,3,0,8,mixedType,1
6,3,0,9,mixedType,1
6,3,0,9,mixedType,1
6,3,0,9,mixedType,1
6,3,0,9,mixedType,1
9,2,0,11,mixedType,1
7,1,0,8,mixedType,1
2,6,0,8,mixedType,1
5,3,0,8,mixedType,1
7,1,0,8,mixedType,1
9,3,0,12,mixedType,1
8,8,1,17,mixedType,2
5,3,0,8,mixedType,1
4,4,0,8,mixedType,1
4,4,0,8,mixedType,1
9,3,0,12,mixedType,1
7,3,0,10,mixedType,1
8,2,0,10,mixedType,1
7,2,0,9,mixedType,1
14,2,0,16,mixedType,2
9,1,0,10,mixedType,1
11,3,0,14,mixedType,2
5,2,0,7,mixedType,0
11,5,0,16,mixedType,2
1,8,0,9,mixedType,1
7,3,0,10,mixedType,1
12,4,0,16,mixedType,2
4,8,0,12,mixedType,1
15,1,0,16,mixedType,2
2,7,0,9,mixedType,1
7,3,0,10,mixedType,1
7,2,0,9,mixedType,1
10,3,0,13,mixedType,1
8,3,0,11,mixedType,1
5,4,0,9,mixedType,1
10,3,0,13,mixedType,1
4,2,0,6,mixedType,0
5,4,0,9,mixedType,1
8,2,0,10,mixedType,1
13,3,0,16,mixedType,2
9,1,0,10,mixedType,1
7,3,0,10,mixedType,1
3,7,0,10,mixedType,1
2,10,0,12,mixedType,1
1,9,0,10,mixedType,1
6,1,0,7,mixedType,0
9,1,0,10,mixedType,1
7,5,0,12,mixedType,1
8,1,0,9,mixedType,1
6,4,0,10,mixedType,1
9,3,0,12,mixedType,1
6,3,0,9,mixedType,1
4,4,0,8,mixedType,1
5,1,0,6,mixedType,0
15,1,0,16,mixedType,2
4,9,0,13,mixedType,1
6,3,0,9,mixedType,1
6,3,0,9,mixedType,1
4,2,0,6,mixedType,0
8,4,0,12,mixedType,1
7,2,0,9,mixedType,1
11,1,0,12,mixedType,1
8,2,0,10,mixedType,1
5,3,0,8,mixedType,1
4,6,0,10,mixedType,1
2,6,0,8,mixedType,1
6,3,0,9,mixedType,1
11,3,0,14,mixedType,2
7,3,0,10,mixedType,1
3,8,0,11,mixedType,1
5,3,0,8,mixedType,1
5,3,0,8,mixedType,1
5,2,0,7,mixedType,0
4,2,0,6,mixedType,0
14,2,0,16,mixedType,2
7,3,0,10,mixedType,1
7,3,0,10,mixedType,1
5,1,0,6,mixedType,0
12,3,0,15,mixedType,2
5,3,0,8,mixedType,1
14,2,0,16,mixedType,2
6,3,0,9,mixedType,1
7,2,0,9,mixedType,1
6,2,0,8,mixedType,1
7,3,0,10,mixedType,1
15,1,0,16,mixedType,2
7,1,0,8,mixedType,1
10,6,0,16,mixedType,2
6,2,0,8,mixedType,1
1,8,0,9,mixedType,1
4,6,0,10,mixedType,1
6,6,0,12,mixedType,1
6,4,0,10,mixedType,1
7,3,0,10,mixedType,1
5,2,0,7,mixedType,0
4,2,0,6,mixedType,0
8,3,0,11,mixedType,1
8,1,0,9,mixedType,1
6,2,0,8,mixedType,1
4,2,0,6,mixedType,0
4,4,0,8,mixedType,1
7,1,0,8,mixedType,1
8,2,0,10,mixedType,1
6,3,0,9,mixedType,1
6,2,0,8,mixedType,1
8,4,0,12,mixedType,1
5,3,0,8,mixedType,1
9,2,0,11,mixedType,1
8,4,0,12,mixedType,1
7,4,0,11,mixedType,1
8,1,0,9,mixedType,1
5,6,0,11,mixedType,1
9,1,0,10,mixedType,1
7,2,0,9,mixedType,1
5,2,0,7,mixedType,0
7,3,0,10,mixedType,1
4,4,0,8,mixedType,1
5,3,0,8,mixedType,1
8,6,1,15,mixedType,2
5,5,0,10,mixedType,1
5,4,0,9,mixedType,1
10,1,0,11,mixedType,1
4,4,0,8,mixedType,1
7,2,0,9,mixedType,1
8,3,0,11,mixedType,1
8,2,0,10,mixedType,1
4,10,0,14,mixedType,2
7,3,0,10,mixedType,1
3,7,0,10,mixedType,1
7,3,0,10,mixedType,1
6,2,0,8,mixedType,1
6,1,0,7,mixedType,0
14,2,0,16,mixedType,2
7,1,0,8,mixedType,1
6,2,0,8,mixedType,1
4,2,0,6,mixedType,0
11,1,0,12,mixedType,1
2,7,0,9,mixedType,1
8,6,1,15,mixedType,2
4,2,0,6,mixedType,0
8,2,0,10,mixedType,1
6,3,0,9,mixedType,1
4,4,0,8,mixedType,1
7,1,0,8,mixedType,1
9,0,1,10,mixedType,1
7,1,0,8,mixedType,1
7,3,0,10,mixedType,1
9,2,0,11,mixedType,1
8,2,0,10,mixedType,1
15,1,0,16,mixedType,2
5,2,0,7,mixedType,0
2,6,0,8,mixedType,1
7,6,0,13,mixedType,1
3,9,0,12,mixedType,1
7,3,0,10,mixedType,1
5,7,0,12,mixedType,1
7,1,0,8,mixedType,1
7,4,0,11,mixedType,1
6,2,0,8,mixedType,1
7,3,0,10,mixedType,1
4,2,0,6,mixedType,0
8,4,0,12,mixedType,1
6,3,0,9,mixedType,1
5,6,0,11,mixedType,1
8,4,0,12,mixedType,1
8,3,0,11,mixedType,1
5,5,0,10,mixedType,1
4,4,0,8,mixedType,1
5,2,0,7,mixedType,0
9,3,0,12,mixedType,1
9,1,0,10,mixedType,1
2,6,0,8,mixedType,1
4,6,0,10,mixedType,1
13,3,0,16,mixedType,2
11,2,0,13,mixedType,1
13,3,0,16,mixedType,2
7,2,0,9,mixedType,1
6,3,0,9,mixedType,1
3,3,0,6,mixedType,0
4,2,0,6,mixedType,0
6,2,0,8,mixedType,1
5,4,0,9,mixedType,1
4,4,0,8,mixedType,1
7,2,0,9,mixedType,1
5,3,0,8,mixedType,1
12,3,0,15,mixedType,2
5,4,0,9,mixedType,1
1,8,0,9,mixedType,1
10,0,1,11,mixedType,1
11,5,0,16,mixedType,2
5,1,0,6,mixedType,0
17,1,1,19,mixedType,2
12,3,0,15,mixedType,2
7,1,0,8,mixedType,1
7,3,0,10,mixedType,1
8,2,0,10,mixedType,1
4,4,0,8,mixedType,1
5,1,0,6,mixedType,0
7,1,0,8,mixedType,1
12,4,0,16,mixedType,2
4,4,0,8,mixedType,1
5,3,0,8,mixedType,1
6,1,0,7,mixedType,0
6,1,0,7,mixedType,0
7,3,0,10,mixedType,1
7,3,0,10,mixedType,1
7,2,0,9,mixedType,1
9,2,0,11,mixedType,1
11,1,0,12,mixedType,1
8,4,0,12,mixedType,1
6,1,0,7,mixedType,0
9,4,0,13,mixedType,1
5,1,0,6,mixedType,0
7,4,0,11,mixedType,1
3,3,0,6,mixedType,0
8,1,0,9,mixedType,1
3,7,0,10,mixedType,1
8,0,1,9,mixedType,1
5,8,0,13,mixedType,1
5,2,0,7,mixedType,0
14,1,0,15,mixedType,2
7,3,0,10,mixedType,1
5,5,0,10,mixedType,1
6,6,0,12,mixedType,1
7,2,0,9,mixedType,1
6,4,0,10,mixedType,1
2,9,0,11,mixedType,1
8,2,0,10,mixedType,1
13,4,0,17,mixedType,2
6,3,0,9,mixedType,1
8,3,0,11,mixedType,1
3,5,0,8,mixedType,1
6,4,0,10,mixedType,1
7,3,0,10,mixedType,1
5,2,0,7,mixedType,0
6,1,0,7,mixedType,0
3,10,1,14,mixedType,2
2,9,0,11,mixedType,1
12,3,0,15,mixedType,2
6,2,0,8,mixedType,1
12,3,0,15,mixedType,2
11,5,0,16,mixedType,2
9,3,0,12,mixedType,1
2,9,0,11,mixedType,1
1,7,0,8,mixedType,1
6,2,0,8,mixedType,1
6,3,0,9,mixedType,1
3,7,0,10,mixedType,1
4,6,0,10,mixedType,1
6,4,0,10,mixedType,1
12,3,0,15,mixedType,2
10,11,0,21,mixedType,2
5,4,0,9,mixedType,1
5,3,0,8,mixedType,1
8,2,0,10,mixedType,1
5,3,0,8,mixedType,1
3,7,0,10,mixedType,1
5,1,0,6,mixedType,0
3,3,0,6,mixedType,0
14,2,0,16,mixedType,2
7,3,0,10,mixedType,1
6,3,0,9,mixedType,1
8,1,0,9,mixedType,1
9,3,0,12,mixedType,1
6,1,0,7,mixedType,0
13,2,0,15,mixedType,2
5,3,0,8,mixedType,1
7,2,0,9,mixedType,1
6,3,0,9,mixedType,1
3,7,0,10,mixedType,1
5,4,0,9,mixedType,1
8,3,0,11,mixedType,1
5,4,0,9,mixedType,1
16,2,2,20,mixedType,2
9,1,0,10,mixedType,1
11,1,0,12,mixedType,1
8,3,0,11,mixedType,1
7,3,0,10,mixedType,1
4,2,0,6,mixedType,0
8,6,0,14,mixedType,2
10,1,0,11,mixedType,1
6,2,0,8,mixedType,1
4,6,0,10,mixedType,1
4,4,0,8,mixedType,1
5,3,0,8,mixedType,1
6,4,0,10,mixedType,1
8,1,0,9,mixedType,1
4,6,0,10,mixedType,1
9,3,0,12,mixedType,1
5,4,0,9,mixedType,1
5,6,0,11,mixedType,1
12,4,0,16,mixedType,2
4,8,0,12,mixedType,1
1,10,0,11,mixedType,1
12,0,1,13,mixedType,1
6,3,0,9,mixedType,1
8,2,0,10,mixedType,1
7,3,0,10,mixedType,1
6,3,0,9,mixedType,1
6,3,0,9,mixedType,1
5,3,0,8,mixedType,1
14,2,0,16,mixedType,2
6,2,0,8,mixedType,1
13,3,0,16,mixedType,2
4,2,0,6,mixedType,0
6,3,0,9,mixedType,1
5,4,0,9,mixedType,1
7,3,0,10,mixedType,1
5,5,0,10,mixedType,1
7,2,0,9,mixedType,1
1,9,0,10,mixedType,1
7,3,0,10,mixedType,1
14,2,0,16,mixedType,2
5,3,0,8,mixedType,1
7,2,0,9,mixedType,1
5,2,0,7,mixedType,0
6,2,0,8,mixedType,1
5,1,0,6,mixedType,0
4,6,0,10,mixedType,1
6,1,0,7,mixedType,0
7,1,0,8,mixedType,1
7,1,0,8,mixedType,1
5,1,0,6,mixedType,0
5,2,0,7,mixedType,0
6,3,0,9,mixedType,1
3,6,0,9,mixedType,1
6,1,0,7,mixedType,0
6,4,0,10,mixedType,1
4,5,0,9,mixedType,1
3,4,0,7,mixedType,0
5,2,0,7,mixedType,0
3,6,0,9,mixedType,1
8,2,0,10,mixedType,1
2,6,0,8,mixedType,1
4,2,0,6,mixedType,0
5,3,0,8,mixedType,1
8,2,0,10,mixedType,1
7,3,0,10,mixedType,1
7,3,0,10,mixedType,1
8,3,0,11,mixedType,1
7,2,0,9,mixedType,1
4,2,0,6,mixedType,0
6,3,0,9,mixedType,1
4,4,0,8,mixedType,1
5,6,0,11,mixedType,1
7,2,0,9,mixedType,1
14,2,0,16,mixedType,2
5,2,0,7,mixedType,0
5,5,0,10,mixedType,1
15,1,0,16,mixedType,2
3,5,0,8,mixedType,1
11,5,0,16,mixedType,2
7,2,0,9,mixedType,1
4,2,0,6,mixedType,0
10,3,0,13,mixedType,1
8,3,0,11,mixedType,1
5,2,0,7,mixedType,0
5,8,0,13,mixedType,1
3,10,0,13,mixedType,1
4,6,0,10,mixedType,1
5,2,0,7,mixedType,0
7,3,0,10,mixedType,1
5,3,0,8,mixedType,1
4,4,0,8,mixedType,1
6,1,0,7,mixedType,0
11,3,0,14,mixedType,2
2,8,0,10,mixedType,1
5,2,0,7,mixedType,0
12,4,0,16,mixedType,2
8,1,0,9,mixedType,1
4,10,0,14,mixedType,2
5,2,0,7,mixedType,0
6,4,0,10,mixedType,1
3,6,0,9,mixedType,1
8,1,0,9,mixedType,1
4,4,0,8,mixedType,1
6,4,0,10,mixedType,1
4,4,0,8,mixedType,1
5,2,0,7,mixedType,0
8,1,0,9,mixedType,1
11,1,0,12,mixedType,1
8,2,0,10,mixedType,1
11,5,0,16,mixedType,2
5,3,0,8,mixedType,1
5,3,0,8,mixedType,1
10,3,0,13,mixedType,1
5,1,0,6,mixedType,0
9,3,0,12,mixedType,1
5,4,0,9,mixedType,1
7,1,0,8,mixedType,1
7,3,0,10,mixedType,1
6,1,0,7,mixedType,0
13,3,0,16,mixedType,2
11,4,0,15,mixedType,2
6,4,0,10,mixedType,1
9,1,0,10,mixedType,1
9,4,0,13,mixedType,1
5,2,0,7,mixedType,0
8,2,0,10,mixedType,1
8,1,0,9,mixedType,1
6,4,0,10,mixedType,1
13,3,0,16,mixedType,2
8,1,0,9,mixedType,1
2,7,0,9,mixedType,1
12,4,0,16,mixedType,2
6,4,0,10,mixedType,1
6,1,0,7,mixedType,0
8,1,0,9,mixedType,1
1,8,0,9,mixedType,1
9,2,0,11,mixedType,1
6,4,0,10,mixedType,1
1,9,0,10,mixedType,1
4,4,0,8,mixedType,1
6,2,0,8,mixedType,1
7,2,0,9,mixedType,1
5,3,0,8,mixedType,1
8,2,0,10,mixedType,1
3,6,0,9,mixedType,1
4,2,0,6,mixedType,0
5,2,0,7,mixedType,0
8,3,0,11,mixedType,1
9,3,0,12,mixedType,1
6,1,0,7,mixedType,0
1,8,0,9,mixedType,1
4,4,0,8,mixedType,1
14,2,0,16,mixedType,2
4,9,0,13,mixedType,1
5,3,0,8,mixedType,1
3,7,0,10,mixedType,1
6,2,0,8,mixedType,1
8,2,0,10,mixedType,1
4,4,0,8,mixedType,1
3,6,0,9,mixedType,1
2,6,0,8,mixedType,1
5,2,0,7,mixedType,0
11,3,0,14,mixedType,2
7,2,0,9,mixedType,1
7,3,0,10,mixedType,1
7,3,0,10,mixedType,1
7,8,0,15,mixedType,2
7,2,0,9,mixedType,1
7,2,0,9,mixedType,1
6,4,0,10,mixedType,1
7,3,0,10,mixedType,1
6,1,0,7,mixedType,0
4,7,0,11,mixedType,1
9,1,0,10,mixedType,1
5,8,0,13,mixedType,1
6,1,0,7,mixedType,0
7,2,0,9,mixedType,1
3,6,0,9,mixedType,1
4,6,0,10,mixedType,1
9,3,0,12,mixedType,1
5,2,0,7,mixedType,0
10,2,0,12,mixedType,1
9,4,0,13,mixedType,1
5,4,0,9,mixedType,1
13,3,0,16,mixedType,2
6,2,0,8,mixedType,1
6,4,0,10,mixedType,1
9,2,0,11,mixedType,1
5,4,0,9,mixedType,1
7,1,0,8,mixedType,1
5,6,0,11,mixedType,1
6,5,0,11,mixedType,1
9,1,0,10,mixedType,1
8,2,0,10,mixedType,1
10,1,0,11,mixedType,1
6,3,0,9,mixedType,1
6,4,0,10,mixedType,1
9,3,0,12,mixedType,1
7,4,0,11,mixedType,1
1,10,0,11,mixedType,1
8,4,0,12,mixedType,1
3,5,0,8,mixedType,1
4,5,0,9,mixedType,1
5,2,0,7,mixedType,0
8,1,0,9,mixedType,1
7,2,0,9,mixedType,1
5,1,0,6,mixedType,0
5,3,0,8,mixedType,1
4,6,0,10,mixedType,1
7,3,0,10,mixedType,1
8,1,0,9,mixedType,1
7,1,0,8,mixedType,1
9,3,0,12,mixedType,1
7,2,0,9,mixedType,1
4,6,0,10,mixedType,1
8,1,0,9,mixedType,1
2,8,0,10,mixedType,1
7,2,0,9,mixedType,1
6,3,0,9,mixedType,1
5,3,0,8,mixedType,1
6,4,0,10,mixedType,1
12,2,1,15,mixedType,2
6,3,0,9,mixedType,1
3,6,0,9,mixedType,1
14,2,0,16,mixedType,2
12,4,0,16,mixedType,2
6,4,0,10,mixedType,1
6,4,0,10,mixedType,1
6,3,0,9,mixedType,1
7,1,0,8,mixedType,1
6,3,0,9,mixedType,1
8,2,0,10,mixedType,1
6,1,0,7,mixedType,0
7,4,0,11,mixedType,1
6,3,0,9,mixedType,1
8,2,0,10,mixedType,1
5,2,0,7,mixedType,0
3,6,0,9,mixedType,1
9,1,0,10,mixedType,1
7,3,0,10,mixedType,1
7,1,0,8,mixedType,1
5,3,0,8,mixedType,1
8,2,0,10,mixedType,1
1,9,0,10,mixedType,1
14,2,0,16,mixedType,2
7,1,0,8,mixedType,1
9,4,2,15,mixedType,2
7,2,0,9,mixedType,1
5,3,0,8,mixedType,1
5,1,0,6,mixedType,0
4,5,0,9,mixedType,1
5,10,1,16,mixedType,2
4,4,0,8,mixedType,1
6,3,0,9,mixedType,1
6,3,0,9,mixedType,1
7,2,0,9,mixedType,1
5,2,0,7,mixedType,0
9,1,0,10,mixedType,1
14,2,0,16,mixedType,2
9,4,0,13,mixedType,1
6,3,0,9,mixedType,1
5,4,0,9,mixedType,1
7,3,0,10,mixedType,1
8,2,0,10,mixedType,1
9,1,0,10,mixedType,1
8,1,0,9,mixedType,1
1,9,0,10,mixedType,1
14,1,0,15,mixedType,2
7,2,0,9,mixedType,1
14,2,0,16,mixedType,2
5,3,0,8,mixedType,1
5,3,0,8,mixedType,1
5,2,0,7,mixedType,0
15,1,0,16,mixedType,2
8,5,0,13,mixedType,1
6,1,0,7,mixedType,0
6,3,0,9,mixedType,1
3,8,0,11,mixedType,1
6,2,0,8,mixedType,1
4,4,0,8,mixedType,1
8,2,0,10,mixedType,1
6,4,0,10,mixedType,1
11,3,0,14,mixedType,2
7,3,0,10,mixedType,1
7,1,0,8,mixedType,1
4,6,0,10,mixedType,1
4,2,0,6,mixedType,0
13,3,0,16,mixedType,2
8,1,0,9,mixedType,1
4,2,0,6,mixedType,0
7,1,0,8,mixedType,1
6,2,0,8,mixedType,1
4,8,0,12,mixedType,1
13,3,0,16,mixedType,2
9,1,0,10,mixedType,1
6,1,0,7,mixedType,0
14,2,0,16,mixedType,2
10,3,0,13,mixedType,1
8,3,0,11,mixedType,1
7,4,0,11,mixedType,1
7,4,0,11,mixedType,1
6,2,0,8,mixedType,1
3,6,0,9,mixedType,1
7,2,0,9,mixedType,1
7,4,0,11,mixedType,1
1,8,0,9,mixedType,1
6,3,0,9,mixedType,1
11,3,0,14,mixedType,2
12,1,0,13,mixedType,1
8,2,0,10,mixedType,1
5,7,0,12,mixedType,1
6,3,0,9,mixedType,1
6,3,0,9,mixedType,1
5,2,0,7,mixedType,0
4,8,0,12,mixedType,1
7,5,0,12,mixedType,1
7,3,0,10,mixedType,1
7,3,0,10,mixedType,1
4,6,0,10,mixedType,1
6,1,0,7,mixedType,0
7,3,0,10,mixedType,1
8,2,0,10,mixedType,1
7,1,0,8,mixedType,1
8,1,0,9,mixedType,1
6,4,0,10,mixedType,1
6,3,0,9,mixedType,1
14,2,0,16,mixedType,2
8,2,0,10,mixedType,1
5,2,0,7,mixedType,0
6,1,0,7,mixedType,0
5,7,0,12,mixedType,1
12,4,0,16,mixedType,2
3,6,0,9,mixedType,1
7,3,0,10,mixedType,1
7,2,0,9,mixedType,1
6,6,0,12,mixedType,1
10,1,0,11,mixedType,1
6,3,0,9,mixedType,1
2,4,0,6,mixedType,0
8,1,0,9,mixedType,1
5,3,0,8,mixedType,1
5,3,0,8,mixedType,1
5,2,0,7,mixedType,0
6,2,0,8,mixedType,1
9,3,0,12,mixedType,1
4,5,0,9,mixedType,1
5,3,0,8,mixedType,1
7,5,0,12,mixedType,1
9,3,0,12,mixedType,1
4,2,0,6,mixedType,0
8,1,0,9,mixedType,1
12,4,0,16,mixedType,2
5,2,0,7,mixedType,0
6,2,0,8,mixedType,1
7,3,0,10,mixedType,1
1,9,0,10,mixedType,1
6,2,0,8,mixedType,1
8,1,0,9,mixedType,1
7,3,0,10,mixedType,1
5,3,0,8,mixedType,1
8,3,0,11,mixedType,1
6,1,0,7,mixedType,0
4,2,0,6,mixedType,0
6,3,0,9,mixedType,1
4,4,0,8,mixedType,1
10,2,0,12,mixedType,1
7,2,0,9,mixedType,1
5,3,0,8,mixedType,1
7,3,0,10,mixedType,1
13,3,0,16,mixedType,2
9,2,0,11,mixedType,1
5,2,0,7,mixedType,0
6,7,0,13,mixedType,1
6,3,0,9,mixedType,1
5,4,0,9,mixedType,1
5,1,0,6,mixedType,0
9,4,1,14,mixedType,2
7,3,0,10,mixedType,1
6,4,0,10,mixedType,1
7,1,0,8,mixedType,1
9,2,0,11,mixedType,1
8,2,0,10,mixedType,1
4,6,0,10,mixedType,1
6,2,0,8,mixedType,1
5,4,0,9,mixedType,1
5,3,0,8,mixedType,1
3,10,0,13,mixedType,1
7,5,0,12,mixedType,1
5,1,0,6,mixedType,0
6,2,0,8,mixedType,1
4,6,0,10,mixedType,1
7,3,0,10,mixedType,1
6,4,0,10,mixedType,1
6,2,0,8,mixedType,1
10,1,0,11,mixedType,1
3,10,0,13,mixedType,1
6,1,0,7,mixedType,0
6,2,0,8,mixedType,1
6,3,0,9,mixedType,1
5,1,0,6,mixedType,0
6,2,0,8,mixedType,1
7,3,0,10,mixedType,1
4,2,0,6,mixedType,0
5,4,0,9,mixedType,1
7,3,0,10,mixedType,1
2,6,0,8,mixedType,1
3,7,0,10,mixedType,1
15,1,0,16,mixedType,2
7,3,0,10,mixedType,1
8,8,0,16,mixedType,2
2,6,0,8,mixedType,1
8,1,0,9,mixedType,1
5,3,0,8,mixedType,1
12,4,0,16,mixedType,2
6,2,0,8,mixedType,1
14,2,0,16,mixedType,2
5,7,0,12,mixedType,1
5,4,0,9,mixedType,1
7,1,0,8,mixedType,1
12,3,0,15,mixedType,2
6,4,0,10,mixedType,1
6,4,0,10,mixedType,1
6,4,0,10,mixedType,1
8,1,0,9,mixedType,1
9,8,0,17,mixedType,2
4,4,0,8,mixedType,1
5,3,0,8,mixedType,1
3,5,0,8,mixedType,1
7,3,0,10,mixedType,1
12,4,0,16,mixedType,2
8,1,0,9,mixedType,1
6,4,0,10,mixedType,1
9,1,0,10,mixedType,1
13,3,0,16,mixedType,2
6,4,0,10,mixedType,1
6,3,0,9,mixedType,1
13,3,0,16,mixedType,2
3,6,0,9,mixedType,1
8,1,0,9,mixedType,1
6,3,0,9,mixedType,1
5,4,0,9,mixedType,1
12,1,0,13,mixedType,1
5,2,0,7,mixedType,0
6,3,0,9,mixedType,1
7,1,0,8,mixedType,1
8,3,0,11,mixedType,1
5,6,0,11,mixedType,1
5,3,0,8,mixedType,1
5,3,0,8,mixedType,1
3,5,0,8,mixedType,1
8,3,0,11,mixedType,1
6,1,0,7,mixedType,0
6,4,0,10,mixedType,1
6,2,0,8,mixedType,1
11,2,0,13,mixedType,1
13,3,0,16,mixedType,2
3,6,0,9,mixedType,1
7,3,0,10,mixedType,1
1,11,0,12,mixedType,1
9,1,0,10,mixedType,1
4,4,0,8,mixedType,1
6,1,0,7,mixedType,0
8,1,0,9,mixedType,1
4,2,0,6,mixedType,0
11,2,0,13,mixedType,1
6,3,0,9,mixedType,1
4,2,0,6,mixedType,0
6,3,0,9,mixedType,1
8,0,1,9,mixedType,1
7,2,0,9,mixedType,1
9,2,0,11,mixedType,1
4,6,0,10,mixedType,1
16,3,1,20,mixedType,2
4,4,0,8,mixedType,1
3,5,0,8,mixedType,1
7,3,0,10,mixedType,1
7,3,0,10,mixedType,1
1,8,0,9,mixedType,1
5,3,0,8,mixedType,1
9,1,0,10,mixedType,1
8,3,0,11,mixedType,1
1,7,0,8,mixedType,1
15,1,0,16,mixedType,2
5,2,0,7,mixedType,0
9,1,0,10,mixedType,1
13,3,0,16,mixedType,2
7,3,0,10,mixedType,1
12,3,0,15,mixedType,2
2,7,0,9,mixedType,1
5,3,0,8,mixedType,1
5,2,0,7,mixedType,0
5,2,0,7,mixedType,0
8,1,0,9,mixedType,1
4,2,0,6,mixedType,0
10,2,0,12,mixedType,1
6,1,0,7,mixedType,0
2,6,0,8,mixedType,1
7,1,0,8,mixedType,1
6,2,0,8,mixedType,1
5,4,0,9,mixedType,1
6,3,0,9,mixedType,1
9,2,0,11,mixedType,1
8,2,0,10,mixedType,1
6,1,0,7,mixedType,0
11,0,2,13,mixedType,1
9,1,0,10,mixedType,1
6,1,0,7,mixedType,0
6,1,0,7,mixedType,0
5,1,0,6,mixedType,0
2,6,0,8,mixedType,1
14,2,0,16,mixedType,2
3,3,0,6,mixedType,0
7,2,0,9,mixedType,1
8,4,0,12,mixedType,1
8,4,0,12,mixedType,1
8,1,0,9,mixedType,1
6,4,0,10,mixedType,1
7,1,0,8,mixedType,1
4,6,0,10,mixedType,1
7,2,0,9,mixedType,1
15,1,0,16,mixedType,2
9,3,0,12,mixedType,1
6,4,0,10,mixedType,1
5,3,0,8,mixedType,1
7,2,0,9,mixedType,1
7,3,0,10,mixedType,1
5,4,0,9,mixedType,1
6,3,0,9,mixedType,1
6,3,0,9,mixedType,1
2,10,0,12,mixedType,1
5,3,0,8,mixedType,1
9,1,0,10,mixedType,1
11,3,0,14,mixedType,2
5,5,0,10,mixedType,1
8,2,0,10,mixedType,1
7,3,0,10,mixedType,1
5,2,0,7,mixedType,0
5,4,0,9,mixedType,1
4,8,0,12,mixedType,1
2,6,0,8,mixedType,1
5,3,0,8,mixedType,1
10,1,0,11,mixedType,1
8,2,0,10,mixedType,1
6,3,0,9,mixedType,1
6,7,0,13,mixedType,1
4,2,0,6,mixedType,0
6,7,0,13,mixedType,1
11,2,0,13,mixedType,1
4,4,0,8,mixedType,1
5,4,0,9,mixedType,1
3,6,0,9,mixedType,1
4,4,0,8,mixedType,1
7,3,0,10,mixedType,1
6,3,0,9,mixedType,1
6,1,0,7,mixedType,0
6,3,0,9,mixedType,1
2,8,0,10,mixedType,1
3,6,0,9,mixedType,1
14,2,0,16,mixedType,2
9,3,0,12,mixedType,1
6,2,0,8,mixedType,1
6,2,0,8,mixedType,1
9,1,0,10,mixedType,1
6,2,0,8,mixedType,1
3,8,0,11,mixedType,1
5,2,0,7,mixedType,0
1,9,0,10,mixedType,1
14,2,0,16,mixedType,2
10,4,0,14,mixedType,2
5,1,0,6,mixedType,0
12,4,0,16,mixedType,2
11,3,0,14,mixedType,2
1,7,0,8,mixedType,1
17,1,2,20,mixedType,2
9,2,0,11,mixedType,1
6,3,0,9,mixedType,1
5,3,0,8,mixedType,1
6,2,0,8,mixedType,1
7,2,0,9,mixedType,1
5,1,0,6,mixedType,0
6,3,0,9,mixedType,1
5,4,0,9,mixedType,1
3,3,0,6,mixedType,0
9,7,0,16,mixedType,2
7,3,0,10,mixedType,1
6,3,0,9,mixedType,1
11,3,0,14,mixedType,2
13,3,0,16,mixedType,2
4,4,0,8,mixedType,1
9,3,0,12,mixedType,1
6,2,0,8,mixedType,1
1,8,0,9,mixedType,1
6,2,0,8,mixedType,1
6,2,0,8,mixedType,1
11,3,0,14,mixedType,2
5,3,0,8,mixedType,1
5,3,0,8,mixedType,1
6,4,0,10,mixedType,1
8,2,0,10,mixedType,1
10,2,0,12,mixedType,1
7,6,0,13,mixedType,1
1,7,0,8,mixedType,1
8,1,0,9,mixedType,1
8,3,0,11,mixedType,1
6,1,0,7,mixedType,0
7,3,0,10,mixedType,1
6,6,0,12,mixedType,1
7,1,0,8,mixedType,1
5,3,0,8,mixedType,1
4,4,0,8,mixedType,1
6,2,0,8,mixedType,1
1,9,0,10,mixedType,1
5,4,0,9,mixedType,1
9,4,1,14,mixedType,2
7,4,0,11,mixedType,1
5,2,0,7,mixedType,0
9,4,0,13,mixedType,1
3,6,0,9,mixedType,1
9,1,0,10,mixedType,1
1,8,0,9,mixedType,1
11,5,0,16,mixedType,2
5,2,0,7,mixedType,0
12,3,0,15,mixedType,2
8,4,0,12,mixedType,1
3,7,0,10,mixedType,1
7,2,0,9,mixedType,1
5,1,0,6,mixedType,0
13,3,0,16,mixedType,2
8,1,0,9,mixedType,1
7,2,0,9,mixedType,1
6,1,0,7,mixedType,0
8,2,0,10,mixedType,1
15,1,0,16,mixedType,2
8,1,0,9,mixedType,1
2,8,0,10,mixedType,1
8,4,0,12,mixedType,1
5,4,0,9,mixedType,1
6,3,0,9,mixedType,1
7,2,0,9,mixedType,1
2,6,0,8,mixedType,1
6,3,0,9,mixedType,1
13,3,0,16,mixedType,2
7,6,0,13,mixedType,1
14,2,0,16,mixedType,2
6,3,0,9,mixedType,1
8,2,0,10,mixedType,1
7,3,0,10,mixedType,1
2,6,0,8,mixedType,1
7,2,0,9,mixedType,1
6,1,0,7,mixedType,0
6,4,0,10,mixedType,1
6,2,0,8,mixedType,1
6,3,0,9,mixedType,1
12,4,2,18,mixedType,2
11,5,0,16,mixedType,2
2,7,0,9,mixedType,1
8,1,0,9,mixedType,1
2,6,0,8,mixedType,1
2,6,0,8,mixedType,1
4,6,0,10,mixedType,1
8,1,0,9,mixedType,1
10,1,0,11,mixedType,1
5,2,0,7,mixedType,0
5,3,0,8,mixedType,1
7,3,0,10,mixedType,1
7,1,0,8,mixedType,1
6,5,0,11,mixedType,1
5,8,0,13,mixedType,1
4,6,0,10,mixedType,1
1,5,0,6,mixedType,0
1,8,0,9,mixedType,1
7,4,0,11,mixedType,1
7,2,0,9,mixedType,1
1,8,0,9,mixedType,1
5,2,0,7,mixedType,0
7,1,0,8,mixedType,1
6,6,0,12,mixedType,1
11,3,0,14,mixedType,2
4,2,0,6,mixedType,0
6,3,0,9,mixedType,1
15,1,0,16,mixedType,2
6,2,0,8,mixedType,1
4,5,0,9,mixedType,1
3,6,0,9,mixedType,1
5,4,0,9,mixedType,1
2,4,0,6,mixedType,0
7,1,0,8,mixedType,1
6,3,0,9,mixedType,1
6,3,0,9,mixedType,1
4,2,0,6,mixedType,0
6,1,0,7,mixedType,0
6,1,0,7,mixedType,0
6,3,0,9,mixedType,1
6,3,0,9,mixedType,1
13,1,1,15,mixedType,2
6,1,0,7,mixedType,0
7,3,0,10,mixedType,1
9,3,0,12,mixedType,1
8,2,0,10,mixedType,1
4,4,0,8,mixedType,1
2,4,0,6,mixedType,0
2,6,0,8,mixedType,1
14,2,0,16,mixedType,2
9,3,0,12,mixedType,1
5,4,0,9,mixedType,1
4,2,0,6,mixedType,0
7,3,0,10,mixedType,1
6,8,0,14,mixedType,2
7,3,0,10,mixedType,1
7,3,0,10,mixedType,1
5,3,0,8,mixedType,1
8,3,0,11,mixedType,1
6,2,0,8,mixedType,1
5,4,0,9,mixedType,1
9,1,0,10,mixedType,1
7,3,0,10,mixedType,1
6,7,0,13,mixedType,1
7,3,0,10,mixedType,1
6,4,0,10,mixedType,1
5,2,0,7,mixedType,0
5,4,0,9,mixedType,1
6,4,0,10,mixedType,1
7,2,0,9,mixedType,1
6,3,0,9,mixedType,1
7,2,0,9,mixedType,1
4,4,0,8,mixedType,1
6,3,0,9,mixedType,1
6,4,0,10,mixedType,1
4,4,0,8,mixedType,1
5,4,0,9,mixedType,1
14,2,0,16,mixedType,2
4,2,0,6,mixedType,0
6,3,0,9,mixedType,1
6,3,0,9,mixedType,1
8,3,0,11,mixedType,1
6,1,0,7,mixedType,0
1,9,0,10,mixedType,1
6,3,0,9,mixedType,1
14,2,0,16,mixedType,2
8,2,0,10,mixedType,1
7,4,0,11,mixedType,1
4,7,0,11,mixedType,1
5,1,0,6,mixedType,0
4,6,0,10,mixedType,1
5,1,0,6,mixedType,0
9,3,0,12,mixedType,1
1,8,0,9,mixedType,1
8,1,0,9,mixedType,1
7,6,0,13,mixedType,1
9,3,0,12,mixedType,1
12,4,0,16,mixedType,2
10,3,0,13,mixedType,1
1,7,0,8,mixedType,1
3,3,0,6,mixedType,0
7,3,0,10,mixedType,1
7,3,0,10,mixedType,1
5,4,0,9,mixedType,1
6,1,0,7,mixedType,0
5,3,0,8,mixedType,1
8,2,0,10,mixedType,1
9,2,0,11,mixedType,1
8,4,0,12,mixedType,1
5,2,0,7,mixedType,0
9,3,0,12,mixedType,1
9,1,0,10,mixedType,1
7,2,0,9,mixedType,1
6,3,0,9,mixedType,1
6,3,0,9,mixedType,1
1,8,0,9,mixedType,1
7,3,0,10,mixedType,1
5,2,0,7,mixedType,0
12,1,0,13,mixedType,1
3,8,0,11,mixedType,1
5,3,0,8,mixedType,1
8,2,0,10,mixedType,1
15,1,0,16,mixedType,2
7,1,0,8,mixedType,1
6,1,0,7,mixedType,0
8,2,0,10,mixedType,1
7,3,0,10,mixedType,1
6,3,0,9,mixedType,1
8,2,0,10,mixedType,1
3,3,0,6,mixedType,0
8,1,0,9,mixedType,1
10,2,0,12,mixedType,1
9,2,0,11,mixedType,1
5,2,0,7,mixedType,0
6,3,0,9,mixedType,1
6,3,0,9,mixedType,1
9,4,1,14,mixedType,2
6,10,0,16,mixedType,2
8,4,0,12,mixedType,1
12,3,0,15,mixedType,2
10,2,0,12,mixedType,1
13,3,0,16,mixedType,2
3,6,0,9,mixedType,1
1,9,0,10,mixedType,1
2,9,0,11,mixedType,1
7,1,0,8,mixedType,1
8,4,0,12,mixedType,1
5,1,0,6,mixedType,0
1,8,0,9,mixedType,1
5,3,0,8,mixedType,1
1,10,0,11,mixedType,1
4,2,0,6,mixedType,0
5,3,0,8,mixedType,1
7,2,0,9,mixedType,1
13,3,0,16,mixedType,2
4,4,0,8,mixedType,1
14,2,0,16,mixedType,2
2,9,0,11,mixedType,1
6,1,0,7,mixedType,0
14,2,0,16,mixedType,2
6,3,0,9,mixedType,1
4,4,0,8,mixedType,1
6,6,0,12,mixedType,1
6,4,0,10,mixedType,1
6,1,0,7,mixedType,0
6,2,0,8,mixedType,1
11,1,0,12,mixedType,1
7,3,0,10,mixedType,1
7,2,0,9,mixedType,1
5,3,0,8,mixedType,1
9,1,0,10,mixedType,1
6,5,5,16,mixedType,2
6,1,0,7,mixedType,0
6,2,0,8,mixedType,1
4,4,0,8,mixedType,1
6,4,0,10,mixedType,1
11,3,0,14,mixedType,2
5,3,0,8,mixedType,1
7,3,0,10,mixedType,1
8,2,0,10,mixedType,1
1,8,0,9,mixedType,1
7,3,0,10,mixedType,1
7,3,0,10,mixedType,1
9,4,0,13,mixedType,1
10,2,0,12,mixedType,1
6,4,0,10,mixedType,1
4,6,0,10,mixedType,1
6,6,0,12,mixedType,1
8,2,0,10,mixedType,1
9,4,0,13,mixedType,1
8,4,0,12,mixedType,1
7,2,0,9,mixedType,1
2,6,0,8,mixedType,1
6,4,0,10,mixedType,1
5,5,0,10,mixedType,1
15,1,0,16,mixedType,2
7,5,0,12,mixedType,1
9,1,0,10,mixedType,1
7,3,0,10,mixedType,1
8,1,0,9,mixedType,1
9,3,0,12,mixedType,1
5,3,0,8,mixedType,1
3,6,0,9,mixedType,1
4,4,0,8,mixedType,1
5,4,0,9,mixedType,1
6,2,0,8,mixedType,1
9,4,0,13,mixedType,1
5,2,0,7,mixedType,0
6,2,0,8,mixedType,1
5,3,0,8,mixedType,1
8,2,0,10,mixedType,1
5,2,0,7,mixedType,0
7,2,0,9,mixedType,1
7,2,0,9,mixedType,1
5,2,0,7,mixedType,0
12,3,0,15,mixedType,2
6,1,0,7,mixedType,0
4,4,0,8,mixedType,1
12,4,1,17,mixedType,2
7,3,0,10,mixedType,1
11,4,0,15,mixedType,2
7,3,0,10,mixedType,1
4,4,0,8,mixedType,1
6,3,0,9,mixedType,1
8,2,0,10,mixedType,1
5,3,0,8,mixedType,1
1,8,0,9,mixedType,1
15,1,0,16,mixedType,2
5,4,0,9,mixedType,1
8,1,0,9,mixedType,1
7,2,0,9,mixedType,1
8,4,0,12,mixedType,1
10,1,0,11,mixedType,1
5,2,0,7,mixedType,0
5,0,2,7,mixedType,0
4,4,0,8,mixedType,1
7,3,0,10,mixedType,1
9,1,0,10,mixedType,1
12,3,0,15,mixedType,2
14,2,0,16,mixedType,2
4,4,0,8,mixedType,1
8,0,2,10,mixedType,1
3,6,0,9,mixedType,1
8,2,0,10,mixedType,1
5,2,0,7,mixedType,0
2,8,0,10,mixedType,1
9,3,0,12,mixedType,1
6,3,0,9,mixedType,1
7,4,0,11,mixedType,1
11,5,0,16,mixedType,2
6,4,0,10,mixedType,1
4,2,0,6,mixedType,0
4,5,0,9,mixedType,1
6,3,0,9,mixedType,1
7,3,0,10,mixedType,1
1,7,0,8,mixedType,1
7,2,0,9,mixedType,1
7,6,0,13,mixedType,1
7,4,0,11,mixedType,1
4,6,0,10,mixedType,1
6,1,0,7,mixedType,0
14,2,0,16,mixedType,2
8,2,0,10,mixedType,1
5,4,0,9,mixedType,1
6,6,0,12,mixedType,1
8,4,0,12,mixedType,1
6,1,0,7,mixedType,0
3,5,0,8,mixedType,1
5,2,0,7,mixedType,0
5,2,0,7,mixedType,0
7,3,0,10,mixedType,1
9,3,0,12,mixedType,1
6,3,0,9,mixedType,1
7,1,0,8,mixedType,1
6,1,0,7,mixedType,0
3,8,0,11,mixedType,1
2,8,0,10,mixedType,1
8,2,0,10,mixedType,1
2,7,0,9,mixedType,1
1,9,0,10,mixedType,1
4,2,0,6,mixedType,0
6,2,0,8,mixedType,1
9,1,0,10,mixedType,1
13,3,0,16,mixedType,2
11,5,0,16,mixedType,2
7,2,0,9,mixedType,1
14,2,0,16,mixedType,2
5,2,0,7,mixedType,0
7,3,0,10,mixedType,1
2,4,0,6,mixedType,0
2,6,0,8,mixedType,1
5,1,0,6,mixedType,0
8,2,0,10,mixedType,1
6,4,0,10,mixedType,1
8,1,0,9,mixedType,1
4,5,0,9,mixedType,1
6,3,0,9,mixedType,1
4,2,0,6,mixedType,0
7,3,0,10,mixedType,1
6,1,0,7,mixedType,0
14,1,0,15,mixedType,2
3,10,0,13,mixedType,1
7,3,0,10,mixedType,1
9,3,0,12,mixedType,1
1,7,0,8,mixedType,1
7,2,0,9,mixedType,1
10,1,0,11,mixedType,1
5,4,0,9,mixedType,1
4,2,0,6,mixedType,0
7,2,0,9,mixedType,1
6,1,0,7,mixedType,0
9,3,0,12,mixedType,1
10,3,0,13,mixedType,1
5,3,0,8,mixedType,1
3,3,0,6,mixedType,0
5,3,0,8,mixedType,1
8,1,0,9,mixedType,1
8,0,2,10,mixedType,1
7,1,0,8,mixedType,1
7,3,0,10,mixedType,1
4,4,0,8,mixedType,1
7,2,0,9,mixedType,1
10,4,0,14,mixedType,2
14,2,0,16,mixedType,2
6,1,0,7,mixedType,0
5,2,0,7,mixedType,0
4,2,0,6,mixedType,0
15,1,0,16,mixedType,2
5,6,0,11,mixedType,1
4,4,0,8,mixedType,1
8,3,0,11,mixedType,1
9,2,0,11,mixedType,1
8,5,0,13,mixedType,1
3,6,0,9,mixedType,1
10,1,0,11,mixedType,1
3,5,0,8,mixedType,1
9,1,0,10,mixedType,1
5,4,0,9,mixedType,1
6,2,0,8,mixedType,1
5,4,0,9,mixedType,1
8,2,0,10,mixedType,1
3,3,0,6,mixedType,0
9,3,0,12,mixedType,1
13,3,0,16,mixedType,2
5,2,0,7,mixedType,0
5,4,0,9,mixedType,1
6,3,0,9,mixedType,1
6,3,0,9,mixedType,1
9,6,0,15,mixedType,2
5,6,0,11,mixedType,1
5,3,0,8,mixedType,1
7,3,0,10,mixedType,1
8,4,0,12,mixedType,1
6,4,0,10,mixedType,1
2,6,0,8,mixedType,1
7,2,0,9,mixedType,1
1,7,0,8,mixedType,1
9,1,0,10,mixedType,1
11,5,0,16,mixedType,2
6,4,0,10,mixedType,1
6,3,0,9,mixedType,1
9,3,0,12,mixedType,1
2,6,0,8,mixedType,1
6,3,0,9,mixedType,1
5,1,0,6,mixedType,0
3,6,0,9,mixedType,1
11,5,0,16,mixedType,2
4,4,0,8,mixedType,1
4,2,0,6,mixedType,0
8,2,0,10,mixedType,1
6,4,0,10,mixedType,1
8,3,0,11,mixedType,1
3,3,0,6,mixedType,0
10,3,0,13,mixedType,1
14,2,0,16,mixedType,2
9,3,0,12,mixedType,1
4,6,0,10,mixedType,1
6,1,0,7,mixedType,0
5,3,0,8,mixedType,1
8,2,0,10,mixedType,1
1,8,0,9,mixedType,1
6,3,0,9,mixedType,1
6,2,0,8,mixedType,1
8,4,0,12,mixedType,1
8,2,0,10,mixedType,1
2,8,0,10,mixedType,1
8,2,0,10,mixedType,1
6,6,0,12,mixedType,1
8,4,0,12,mixedType,1
6,2,0,8,mixedType,1
9,3,0,12,mixedType,1
15,1,0,16,mixedType,2
5,3,0,8,mixedType,1
4,4,0,8,mixedType,1
1,7,0,8,mixedType,1
7,3,0,10,mixedType,1
9,1,0,10,mixedType,1
8,3,0,11,mixedType,1
8,1,0,9,mixedType,1
6,1,0,7,mixedType,0
3,6,0,9,mixedType,1
3,7,0,10,mixedType,1
9,1,0,10,mixedType,1
6,1,0,7,mixedType,0
7,1,0,8,mixedType,1
6,3,0,9,mixedType,1
7,3,0,10,mixedType,1
15,1,0,16,mixedType,2
14,2,0,16,mixedType,2
14,2,0,16,mixedType,2
6,3,0,9,mixedType,1
3,5,0,8,mixedType,1
9,1,0,10,mixedType,1
13,3,0,16,mixedType,2
1,9,0,10,mixedType,1
7,2,0,9,mixedType,1
5,3,0,8,mixedType,1
7,3,0,10,mixedType,1
6,4,0,10,mixedType,1
6,4,0,10,mixedType,1
8,1,0,9,mixedType,1
8,1,0,9,mixedType,1
8,2,0,10,mixedType,1
15,1,0,16,mixedType,2
3,6,0,9,mixedType,1
7,3,0,10,mixedType,1
5,4,0,9,mixedType,1
9,1,0,10,mixedType,1
3,5,0,8,mixedType,1
7,3,0,10,mixedType,1
6,3,0,9,mixedType,1
5,3,0,8,mixedType,1
6,3,0,9,mixedType,1
8,3,0,11,mixedType,1
3,9,0,12,mixedType,1
5,2,0,7,mixedType,0
9,4,0,13,mixedType,1
1,7,0,8,mixedType,1
5,3,0,8,mixedType,1
9,1,0,10,mixedType,1
7,1,0,8,mixedType,1
8,1,0,9,mixedType,1
7,3,0,10,mixedType,1
9,1,0,10,mixedType,1
7,1,0,8,mixedType,1
12,4,0,16,mixedType,2
3,3,0,6,mixedType,0
5,5,0,10,mixedType,1
7,3,0,10,mixedType,1
6,3,0,9,mixedType,1
4,4,0,8,mixedType,1
5,3,0,8,mixedType,1
0,9,2,11,mixedType,1
4,6,0,10,mixedType,1
8,2,0,10,mixedType,1
3,5,0,8,mixedType,1
5,5,0,10,mixedType,1
7,3,0,10,mixedType,1
7,2,0,9,mixedType,1
7,2,0,9,mixedType,1
5,7,0,12,mixedType,1
8,1,0,9,mixedType,1
8,1,0,9,mixedType,1
4,5,0,9,mixedType,1
8,2,0,10,mixedType,1
8,1,0,9,mixedType,1
6,3,0,9,mixedType,1
5,3,0,8,mixedType,1
15,1,0,16,mixedType,2
8,2,0,10,mixedType,1
5,3,0,8,mixedType,1
14,2,0,16,mixedType,2
11,3,0,14,mixedType,2
8,1,0,9,mixedType,1
11,5,0,16,mixedType,2
14,2,0,16,mixedType,2
6,2,0,8,mixedType,1
3,6,0,9,mixedType,1
1,11,0,12,mixedType,1
9,2,0,11,mixedType,1
10,6,0,16,mixedType,2
5,7,0,12,mixedType,1
3,8,0,11,mixedType,1
6,1,0,7,mixedType,0
14,2,0,16,mixedType,2
2,7,0,9,mixedType,1
4,6,0,10,mixedType,1
8,1,0,9,mixedType,1
8,0,1,9,mixedType,1
6,2,0,8,mixedType,1
8,4,0,12,mixedType,1
7,3,0,10,mixedType,1
5,4,0,9,mixedType,1
3,7,0,10,mixedType,1
6,6,0,12,mixedType,1
7,2,0,9,mixedType,1
7,1,0,8,mixedType,1
4,4,0,8,mixedType,1
3,6,0,9,mixedType,1
14,2,0,16,mixedType,2
8,3,0,11,mixedType,1
8,1,0,9,mixedType,1
7,3,0,10,mixedType,1
7,1,0,8,mixedType,1
7,4,0,11,mixedType,1
10,4,1,15,mixedType,2
2,7,0,9,mixedType,1
5,4,0,9,mixedType,1
5,6,0,11,mixedType,1
8,2,0,10,mixedType,1
8,2,0,10,mixedType,1
12,4,0,16,mixedType,2
8,1,0,9,mixedType,1
4,2,0,6,mixedType,0
3,8,0,11,mixedType,1
13,3,0,16,mixedType,2
6,2,0,8,mixedType,1
13,3,0,16,mixedType,2
6,3,0,9,mixedType,1
3,5,0,8,mixedType,1
8,3,0,11,mixedType,1
6,1,0,7,mixedType,0
5,3,0,8,mixedType,1
14,2,0,16,mixedType,2
6,4,0,10,mixedType,1
7,2,0,9,mixedType,1
3,6,0,9,mixedType,1
15,1,0,16,mixedType,2
8,4,0,12,mixedType,1
6,2,0,8,mixedType,1
7,2,0,9,mixedType,1
7,2,0,9,mixedType,1
1,8,0,9,mixedType,1
6,3,0,9,mixedType,1
5,8,0,13,mixedType,1
1,8,0,9,mixedType,1
14,2,0,16,mixedType,2
5,1,0,6,mixedType,0
11,3,0,14,mixedType,2
7,3,0,10,mixedType,1
6,3,0,9,mixedType,1
6,5,0,11,mixedType,1
7,3,0,10,mixedType,1
7,4,0,11,mixedType,1
14,2,0,16,mixedType,2
6,3,0,9,mixedType,1
5,4,0,9,mixedType,1
2,4,0,6,mixedType,0
7,1,0,8,mixedType,1
7,1,0,8,mixedType,1
2,8,0,10,mixedType,1
6,3,0,9,mixedType,1
9,1,0,10,mixedType,1
3,9,0,12,mixedType,1
6,3,0,9,mixedType,1
8,2,0,10,mixedType,1
11,2,1,14,mixedType,2
3,4,0,7,mixedType,0
8,2,0,10,mixedType,1
13,3,0,16,mixedType,2
7,2,0,9,mixedType,1
7,2,0,9,mixedType,1
13,5,1,19,mixedType,2
3,6,0,9,mixedType,1
9,1,0,10,mixedType,1
6,1,0,7,mixedType,0
4,2,0,6,mixedType,0
2,7,0,9,mixedType,1
14,2,0,16,mixedType,2
4,8,0,12,mixedType,1
15,1,0,16,mixedType,2
6,4,0,10,mixedType,1
8,2,0,10,mixedType,1
7,3,0,10,mixedType,1
1,8,0,9,mixedType,1
9,1,0,10,mixedType,1
6,1,0,7,mixedType,0
6,4,0,10,mixedType,1
8,2,0,10,mixedType,1
6,3,0,9,mixedType,1
2,9,0,11,mixedType,1
14,2,0,16,mixedType,2
8,2,0,10,mixedType,1
6,4,0,10,mixedType,1
11,2,0,13,mixedType,1
13,3,0,16,mixedType,2
9,3,0,12,mixedType,1
5,2,0,7,mixedType,0
3,6,0,9,mixedType,1
4,4,0,8,mixedType,1
7,3,0,10,mixedType,1
5,4,0,9,mixedType,1
8,1,0,9,mixedType,1
4,4,0,8,mixedType,1
5,4,0,9,mixedType,1
9,4,0,13,mixedType,1
9,3,0,12,mixedType,1
6,1,0,7,mixedType,0
5,4,0,9,mixedType,1
6,2,0,8,mixedType,1
7,3,0,10,mixedType,1
6,4,0,10,mixedType,1
8,1,0,9,mixedType,1
6,1,0,7,mixedType,0
6,8,0,14,mixedType,2
1,8,0,9,mixedType,1
3,3,0,6,mixedType,0
11,2,0,13,mixedType,1
6,4,0,10,mixedType,1
7,2,0,9,mixedType,1
4,6,0,10,mixedType,1
6,1,0,7,mixedType,0
5,2,0,7,mixedType,0
11,5,0,16,mixedType,2
5,3,0,8,mixedType,1
7,2,0,9,mixedType,1
2,9,0,11,mixedType,1
8,5,0,13,mixedType,1
15,1,0,16,mixedType,2
14,2,0,16,mixedType,2
7,3,0,10,mixedType,1
6,4,0,10,mixedType,1
5,2,0,7,mixedType,0
4,2,0,6,mixedType,0
7,4,0,11,mixedType,1
2,7,0,9,mixedType,1
9,3,0,12,mixedType,1
5,4,0,9,mixedType,1
1,8,0,9,mixedType,1
3,5,0,8,mixedType,1
11,3,0,14,mixedType,2
10,1,0,11,mixedType,1
15,1,0,16,mixedType,2
8,2,0,10,mixedType,1
7,2,0,9,mixedType,1
6,1,0,7,mixedType,0
5,2,0,7,mixedType,0
7,3,0,10,mixedType,1
6,3,0,9,mixedType,1
5,1,0,6,mixedType,0
4,2,0,6,mixedType,0
2,7,0,9,mixedType,1
7,3,0,10,mixedType,1
7,3,0,10,mixedType,1
4,4,0,8,mixedType,1
2,7,0,9,mixedType,1
2,8,0,10,mixedType,1
6,1,0,7,mixedType,0
3,6,0,9,mixedType,1
5,5,0,10,mixedType,1
7,4,0,11,mixedType,1
7,2,0,9,mixedType,1
4,4,0,8,mixedType,1
4,2,0,6,mixedType,0
11,3,0,14,mixedType,2
5,1,0,6,mixedType,0
4,4,0,8,mixedType,1
1,9,0,10,mixedType,1
8,1,0,9,mixedType,1
7,2,0,9,mixedType,1
6,1,0,7,mixedType,0
6,6,0,12,mixedType,1
11,5,0,16,mixedType,2
8,2,0,10,mixedType,1
3,3,0,6,mixedType,0
1,8,0,9,mixedType,1
7,1,0,8,mixedType,1
7,2,0,9,mixedType,1
9,2,0,11,mixedType,1
5,2,0,7,mixedType,0
4,2,0,6,mixedType,0
7,3,0,10,mixedType,1
2,10,0,12,mixedType,1
7,3,0,10,mixedType,1
2,8,0,10,mixedType,1
4,5,0,9,mixedType,1
8,2,0,10,mixedType,1
4,2,0,6,mixedType,0
6,3,0,9,mixedType,1
15,1,0,16,mixedType,2
7,1,0,8,mixedType,1
6,4,0,10,mixedType,1
6,3,0,9,mixedType,1
9,3,0,12,mixedType,1
6,2,0,8,mixedType,1
6,2,0,8,mixedType,1
7,3,0,10,mixedType,1
6,1,0,7,mixedType,0
8,3,0,11,mixedType,1
6,2,0,8,mixedType,1
7,3,0,10,mixedType,1
6,4,0,10,mixedType,1
7,3,0,10,mixedType,1
8,1,0,9,mixedType,1
8,1,0,9,mixedType,1
5,3,0,8,mixedType,1
7,2,0,9,mixedType,1
6,2,0,8,mixedType,1
6,3,0,9,mixedType,1
8,3,0,11,mixedType,1
5,3,0,8,mixedType,1
14,2,0,16,mixedType,2
5,4,0,9,mixedType,1
13,3,0,16,mixedType,2
7,3,0,10,mixedType,1
3,6,0,9,mixedType,1
7,4,0,11,mixedType,1
5,2,0,7,mixedType,0
5,2,0,7,mixedType,0
3,5,0,8,mixedType,1
10,1,0,11,mixedType,1
1,8,0,9,mixedType,1
7,2,0,9,mixedType,1
6,1,0,7,mixedType,0
8,2,0,10,mixedType,1
5,7,0,12,mixedType,1
3,10,0,13,mixedType,1
6,2,0,8,mixedType,1
6,3,0,9,mixedType,1
11,1,0,12,mixedType,1
21,3,1,25,mixedType,2
15,1,0,16,mixedType,2
1,8,0,9,mixedType,1
1,11,3,15,mixedType,2
6,2,0,8,mixedType,1
8,3,1,12,mixedType,1
4,4,0,8,mixedType,1
4,4,0,8,mixedType,1
6,2,0,8,mixedType,1
3,5,0,8,mixedType,1
7,2,0,9,mixedType,1
5,4,0,9,mixedType,1
14,2,0,16,mixedType,2
5,3,0,8,mixedType,1
4,4,0,8,mixedType,1
6,4,0,10,mixedType,1
4,4,0,8,mixedType,1
6,2,0,8,mixedType,1
6,4,0,10,mixedType,1
4,4,0,8,mixedType,1
4,2,0,6,mixedType,0
12,5,3,20,mixedType,2
10,2,0,12,mixedType,1
7,3,0,10,mixedType,1
8,1,0,9,mixedType,1
7,3,0,10,mixedType,1
6,4,0,10,mixedType,1
4,4,0,8,mixedType,1
6,3,0,9,mixedType,1
14,2,0,16,mixedType,2
3,7,0,10,mixedType,1
4,7,0,11,mixedType,1
2,6,0,8,mixedType,1
10,0,1,11,mixedType,1
5,3,0,8,mixedType,1
7,3,0,10,mixedType,1
9,2,0,11,mixedType,1
1,8,0,9,mixedType,1
6,3,0,9,mixedType,1
7,3,0,10,mixedType,1
5,4,0,9,mixedType,1
10,1,0,11,mixedType,1
6,4,0,10,mixedType,1
4,4,0,8,mixedType,1
8,3,0,11,mixedType,1
8,2,0,10,mixedType,1
6,4,0,10,mixedType,1
6,1,0,7,mixedType,0
10,2,0,12,mixedType,1
4,6,0,10,mixedType,1
6,3,0,9,mixedType,1
7,3,0,10,mixedType,1
6,4,0,10,mixedType,1
8,2,0,10,mixedType,1
8,1,0,9,mixedType,1
8,2,0,10,mixedType,1
5,1,0,6,mixedType,0
6,3,0,9,mixedType,1
6,2,0,8,mixedType,1
7,3,0,10,mixedType,1
8,2,0,10,mixedType,1
6,3,0,9,mixedType,1
5,2,0,7,mixedType,0
1,8,0,9,mixedType,1
2,6,0,8,mixedType,1
8,2,0,10,mixedType,1
7,2,0,9,mixedType,1
2,8,0,10,mixedType,1
8,2,0,10,mixedType,1
6,3,0,9,mixedType,1
6,2,0,8,mixedType,1
6,3,0,9,mixedType,1
4,2,0,6,mixedType,0
0,6,0,6,sameType,1
4,2,0,6,mixedType,0
5,3,0,8,mixedType,1
8,3,0,11,mixedType,1
7,3,0,10,mixedType,1
5,4,0,9,mixedType,1
7,2,0,9,mixedType,1
4,7,0,11,mixedType,1
5,4,0,9,mixedType,1
6,0,0,6,sameType,0
4,6,0,10,mixedType,1
12,3,0,15,mixedType,2
9,3,0,12,mixedType,1
4,4,0,8,mixedType,1
7,2,0,9,mixedType,1
6,3,0,9,mixedType,1
14,2,0,16,mixedType,2
7,1,0,8,mixedType,1
1,7,0,8,mixedType,1
6,2,0,8,mixedType,1
2,9,0,11,mixedType,1
4,2,0,6,mixedType,0
4,6,0,10,mixedType,1
9,7,0,16,mixedType,2
12,9,1,22,mixedType,2
6,2,0,8,mixedType,1
7,2,0,9,mixedType,1
6,1,0,7,mixedType,0
12,4,0,16,mixedType,2
8,1,0,9,mixedType,1
5,2,0,7,mixedType,0
7,3,0,10,mixedType,1
16,7,0,23,mixedType,2
5,3,0,8,mixedType,1
1,8,0,9,mixedType,1
14,3,2,19,mixedType,2
10,2,0,12,mixedType,1
7,2,1,10,mixedType,1
8,2,0,10,mixedType,1
15,1,0,16,mixedType,2
3,5,0,8,mixedType,1
2,5,0,7,mixedType,0
7,3,0,10,mixedType,1
2,9,0,11,mixedType,1
5,1,0,6,mixedType,0
2,7,0,9,mixedType,1
14,2,0,16,mixedType,2
10,2,0,12,mixedType,1
15,1,0,16,mixedType,2
6,4,0,10,mixedType,1
6,2,0,8,mixedType,1
7,2,0,9,mixedType,1
1,11,0,12,mixedType,1
9,1,0,10,mixedType,1
4,5,0,9,mixedType,1
7,3,0,10,mixedType,1
7,3,0,10,mixedType,1
4,2,0,6,mixedType,0
6,4,0,10,mixedType,1
7,4,0,11,mixedType,1
5,2,0,7,mixedType,0
1,8,0,9,mixedType,1
7,3,0,10,mixedType,1
13,7,1,21,mixedType,2
5,2,0,7,mixedType,0
9,1,0,10,mixedType,1
7,2,0,9,mixedType,1
12,4,0,16,mixedType,2
14,2,0,16,mixedType,2
5,5,0,10,mixedType,1
5,2,0,7,mixedType,0
6,1,0,7,mixedType,0
5,4,0,9,mixedType,1
1,7,0,8,mixedType,1
7,3,0,10,mixedType,1
8,2,0,10,mixedType,1
10,1,0,11,mixedType,1
5,2,0,7,mixedType,0
7,3,0,10,mixedType,1
6,3,0,9,mixedType,1
6,4,0,10,mixedType,1
2,7,0,9,mixedType,1
7,3,0,10,mixedType,1
8,3,0,11,mixedType,1
9,4,0,13,mixedType,1
11,2,0,13,mixedType,1
4,2,0,6,mixedType,0
1,8,0,9,mixedType,1
9,2,0,11,mixedType,1
5,3,0,8,mixedType,1
4,4,0,8,mixedType,1
4,6,0,10,mixedType,1
8,3,0,11,mixedType,1
9,1,0,10,mixedType,1
5,2,0,7,mixedType,0
6,2,0,8,mixedType,1
1,8,0,9,mixedType,1
8,1,0,9,mixedType,1
8,2,0,10,mixedType,1
4,6,0,10,mixedType,1
5,3,0,8,mixedType,1
7,3,0,10,mixedType,1
6,2,0,8,mixedType,1
7,4,0,11,mixedType,1
9,1,0,10,mixedType,1
8,1,0,9,mixedType,1
4,2,0,6,mixedType,0
6,1,0,7,mixedType,0
7,3,0,10,mixedType,1
7,3,0,10,mixedType,1
8,2,0,10,mixedType,1
1,8,0,9,mixedType,1
7,2,0,9,mixedType,1
4,4,0,8,mixedType,1
7,1,0,8,mixedType,1
4,6,0,10,mixedType,1
6,4,0,10,mixedType,1
5,2,0,7,mixedType,0
5,8,0,13,mixedType,1
7,3,0,10,mixedType,1
6,4,0,10,mixedType,1
9,2,0,11,mixedType,1
12,4,0,16,mixedType,2
6,1,0,7,mixedType,0
8,4,0,12,mixedType,1
4,2,0,6,mixedType,0
7,2,0,9,mixedType,1
8,1,0,9,mixedType,1
5,3,0,8,mixedType,1
1,9,0,10,mixedType,1
9,3,0,12,mixedType,1
11,2,0,13,mixedType,1
4,4,0,8,mixedType,1
9,2,0,11,mixedType,1
10,2,0,12,mixedType,1
6,1,0,7,mixedType,0
13,3,0,16,mixedType,2
5,3,0,8,mixedType,1
14,2,0,16,mixedType,2
4,7,0,11,mixedType,1
10,3,0,13,mixedType,1
8,2,0,10,mixedType,1
5,2,0,7,mixedType,0
7,4,0,11,mixedType,1
6,3,0,9,mixedType,1
11,5,0,16,mixedType,2
4,4,0,8,mixedType,1
5,3,0,8,mixedType,1
7,3,0,10,mixedType,1
6,0,1,7,mixedType,0
9,1,0,10,mixedType,1
5,2,0,7,mixedType,0
7,3,0,10,mixedType,1
10,6,0,16,mixedType,2
4,9,0,13,mixedType,1
6,3,0,9,mixedType,1
6,1,0,7,mixedType,0
4,2,0,6,mixedType,0
4,4,0,8,mixedType,1
5,1,0,6,mixedType,0
6,1,0,7,mixedType,0
0,8,2,10,mixedType,1
9,1,0,10,mixedType,1
5,2,0,7,mixedType,0
1,8,0,9,mixedType,1
2,4,0,6,mixedType,0
5,4,0,9,mixedType,1
9,1,0,10,mixedType,1
8,2,0,10,mixedType,1
7,3,0,10,mixedType,1
9,3,0,12,mixedType,1
4,4,0,8,mixedType,1
6,1,0,7,mixedType,0
3,7,0,10,mixedType,1
7,2,0,9,mixedType,1
5,1,0,6,mixedType,0
8,2,0,10,mixedType,1
5,7,0,12,mixedType,1
3,8,0,11,mixedType,1
4,6,0,10,mixedType,1
6,3,0,9,mixedType,1
14,2,0,16,mixedType,2
8,2,0,10,mixedType,1
2,7,0,9,mixedType,1
8,1,0,9,mixedType,1
6,1,0,7,mixedType,0
7,2,0,9,mixedType,1
8,2,0,10,mixedType,1
6,2,0,8,mixedType,1
16,1,0,17,mixedType,2
5,3,0,8,mixedType,1
6,3,0,9,mixedType,1
9,1,0,10,mixedType,1
4,4,0,8,mixedType,1
11,3,0,14,mixedType,2
5,4,0,9,mixedType,1
3,3,0,6,mixedType,0
7,2,0,9,mixedType,1
7,2,0,9,mixedType,1
5,4,0,9,mixedType,1
1,8,0,9,mixedType,1
4,4,0,8,mixedType,1
4,2,0,6,mixedType,0
6,1,0,7,mixedType,0
1,8,0,9,mixedType,1
6,3,0,9,mixedType,1
6,4,0,10,mixedType,1
3,8,0,11,mixedType,1
13,2,0,15,mixedType,2
8,2,0,10,mixedType,1
6,3,0,9,mixedType,1
6,4,0,10,mixedType,1
8,2,0,10,mixedType,1
10,3,0,13,mixedType,1
4,5,0,9,mixedType,1
6,3,0,9,mixedType,1
15,1,0,16,mixedType,2
6,1,0,7,mixedType,0
5,3,0,8,mixedType,1
6,4,0,10,mixedType,1
7,2,0,9,mixedType,1
14,2,0,16,mixedType,2
6,2,0,8,mixedType,1
4,4,0,8,mixedType,1
7,2,0,9,mixedType,1
6,3,0,9,mixedType,1
4,4,0,8,mixedType,1
5,3,0,8,mixedType,1
8,2,0,10,mixedType,1
5,1,0,6,mixedType,0
6,1,0,7,mixedType,0
6,2,0,8,mixedType,1
7,3,0,10,mixedType,1
5,4,0,9,mixedType,1
8,1,0,9,mixedType,1
7,2,0,9,mixedType,1
14,1,0,15,mixedType,2
4,6,0,10,mixedType,1
6,1,0,7,mixedType,0
4,5,0,9,mixedType,1
1,8,0,9,mixedType,1
8,2,0,10,mixedType,1
9,2,0,11,mixedType,1
6,3,0,9,mixedType,1
8,2,0,10,mixedType,1
8,1,0,9,mixedType,1
16,3,0,19,mixedType,2
3,9,0,12,mixedType,1
4,2,0,6,mixedType,0
6,2,0,8,mixedType,1
6,3,0,9,mixedType,1
2,8,0,10,mixedType,1
5,3,0,8,mixedType,1
12,1,0,13,mixedType,1
13,3,0,16,mixedType,2
2,6,0,8,mixedType,1
15,1,0,16,mixedType,2
2,6,0,8,mixedType,1
4,4,0,8,mixedType,1
9,2,0,11,mixedType,1
5,2,0,7,mixedType,0
9,1,0,10,mixedType,1
13,3,0,16,mixedType,2
3,6,0,9,mixedType,1
1,8,0,9,mixedType,1
12,1,0,13,mixedType,1
11,5,0,16,mixedType,2
9,1,0,10,mixedType,1
4,7,0,11,mixedType,1
7,3,0,10,mixedType,1
6,1,0,7,mixedType,0
14,2,0,16,mixedType,2
5,6,0,11,mixedType,1
6,1,0,7,mixedType,0
4,2,0,6,mixedType,0
3,6,0,9,mixedType,1
10,3,0,13,mixedType,1
3,6,0,9,mixedType,1
3,6,0,9,mixedType,1
8,2,0,10,mixedType,1
5,5,0,10,mixedType,1
6,3,0,9,mixedType,1
7,2,0,9,mixedType,1
7,3,0,10,mixedType,1
1,8,0,9,mixedType,1
7,3,0,10,mixedType,1
6,3,0,9,mixedType,1
5,4,0,9,mixedType,1
6,2,0,8,mixedType,1
8,2,0,10,mixedType,1
4,2,0,6,mixedType,0
8,2,0,10,mixedType,1
10,1,0,11,mixedType,1
6,2,0,8,mixedType,1
6,1,0,7,mixedType,0
6,1,0,7,mixedType,0
5,1,0,6,mixedType,0
4,4,0,8,mixedType,1
8,1,0,9,mixedType,1
6,3,0,9,mixedType,1
4,6,0,10,mixedType,1
10,2,0,12,mixedType,1
14,2,0,16,mixedType,2
13,3,0,16,mixedType,2
15,1,0,16,mixedType,2
9,2,0,11,mixedType,1
11,2,0,13,mixedType,1
5,2,0,7,mixedType,0
5,3,0,8,mixedType,1
3,8,0,11,mixedType,1
7,2,0,9,mixedType,1
5,3,0,8,mixedType,1
5,3,0,8,mixedType,1
8,2,0,10,mixedType,1
6,1,0,7,mixedType,0
12,3,0,15,mixedType,2
7,2,0,9,mixedType,1
6,2,0,8,mixedType,1
9,3,0,12,mixedType,1
4,6,0,10,mixedType,1
5,3,0,8,mixedType,1
10,4,0,14,mixedType,2
5,0,2,7,mixedType,0
15,1,0,16,mixedType,2
5,3,0,8,mixedType,1
7,6,0,13,mixedType,1
12,4,0,16,mixedType,2
6,4,0,10,mixedType,1
5,3,0,8,mixedType,1
6,1,0,7,mixedType,0
2,8,0,10,mixedType,1
3,6,0,9,mixedType,1
6,3,0,9,mixedType,1
14,2,0,16,mixedType,2
8,2,0,10,mixedType,1
1,11,0,12,mixedType,1
8,1,0,9,mixedType,1
5,3,0,8,mixedType,1
11,3,0,14,mixedType,2
3,6,0,9,mixedType,1
9,1,0,10,mixedType,1
14,2,0,16,mixedType,2
7,1,0,8,mixedType,1
9,1,0,10,mixedType,1
4,4,0,8,mixedType,1
5,3,0,8,mixedType,1
2,7,0,9,mixedType,1
16,4,0,20,mixedType,2
4,6,0,10,mixedType,1
9,2,0,11,mixedType,1
6,4,0,10,mixedType,1
15,1,0,16,mixedType,2
8,3,0,11,mixedType,1
5,3,0,8,mixedType,1
7,3,0,10,mixedType,1
8,2,0,10,mixedType,1
7,2,0,9,mixedType,1
6,6,0,12,mixedType,1
15,1,0,16,mixedType,2
7,4,0,11,mixedType,1
1,8,0,9,mixedType,1
8,1,0,9,mixedType,1
6,4,0,10,mixedType,1
5,3,0,8,mixedType,1
5,2,0,7,mixedType,0
14,2,0,16,mixedType,2
7,1,0,8,mixedType,1
8,2,0,10,mixedType,1
7,3,0,10,mixedType,1
8,2,0,10,mixedType,1
5,1,0,6,mixedType,0
5,3,0,8,mixedType,1
8,1,0,9,mixedType,1
1,8,0,9,mixedType,1
5,1,0,6,mixedType,0
14,2,0,16,mixedType,2
2,8,0,10,mixedType,1
8,1,0,9,mixedType,1
13,3,0,16,mixedType,2
7,3,0,10,mixedType,1
5,2,0,7,mixedType,0
7,3,0,10,mixedType,1
5,3,0,8,mixedType,1
6,6,0,12,mixedType,1
4,4,0,8,mixedType,1
4,5,0,9,mixedType,1
6,3,0,9,mixedType,1
13,2,0,15,mixedType,2
7,2,0,9,mixedType,1
6,2,0,8,mixedType,1
11,3,0,14,mixedType,2
8,2,0,10,mixedType,1
12,1,1,14,mixedType,2
3,7,0,10,mixedType,1
5,3,0,8,mixedType,1
9,4,0,13,mixedType,1
7,3,0,10,mixedType,1
9,3,0,12,mixedType,1
7,2,0,9,mixedType,1
8,1,0,9,mixedType,1
8,2,0,10,mixedType,1
5,4,0,9,mixedType,1
2,7,0,9,mixedType,1
8,1,0,9,mixedType,1
7,2,0,9,mixedType,1
5,3,0,8,mixedType,1
8,1,0,9,mixedType,1
3,5,0,8,mixedType,1
5,3,0,8,mixedType,1
12,4,0,16,mixedType,2
14,2,0,16,mixedType,2
7,3,0,10,mixedType,1
5,1,0,6,mixedType,0
7,3,0,10,mixedType,1
6,4,0,10,mixedType,1
8,2,0,10,mixedType,1
6,3,0,9,mixedType,1
7,1,0,8,mixedType,1
8,3,0,11,mixedType,1
7,3,0,10,mixedType,1
6,3,0,9,mixedType,1
5,4,0,9,mixedType,1
8,1,0,9,mixedType,1
4,2,0,6,mixedType,0
6,1,0,7,mixedType,0
3,8,0,11,mixedType,1
12,3,0,15,mixedType,2
6,2,0,8,mixedType,1
8,3,0,11,mixedType,1
4,4,0,8,mixedType,1
5,4,0,9,mixedType,1
8,1,0,9,mixedType,1
15,1,0,16,mixedType,2
5,2,0,7,mixedType,0
13,3,0,16,mixedType,2
9,1,0,10,mixedType,1
3,6,0,9,mixedType,1
5,4,0,9,mixedType,1
6,4,0,10,mixedType,1
6,6,0,12,mixedType,1
8,1,0,9,mixedType,1
13,2,0,15,mixedType,2
6,3,0,9,mixedType,1
7,3,0,10,mixedType,1
6,1,0,7,mixedType,0
4,4,0,8,mixedType,1
13,3,0,16,mixedType,2
9,3,0,12,mixedType,1
7,3,0,10,mixedType,1
6,1,0,7,mixedType,0
7,6,0,13,mixedType,1
7,2,0,9,mixedType,1
8,1,0,9,mixedType,1
12,3,0,15,mixedType,2
6,2,0,8,mixedType,1
5,2,0,7,mixedType,0
12,3,0,15,mixedType,2
13,3,0,16,mixedType,2
8,2,0,10,mixedType,1
6,2,0,8,mixedType,1
14,2,0,16,mixedType,2
14,2,0,16,mixedType,2
10,2,0,12,mixedType,1
14,2,0,16,mixedType,2
8,3,0,11,mixedType,1
5,0,1,6,mixedType,0
5,5,0,10,mixedType,1
8,4,0,12,mixedType,1
9,4,0,13,mixedType,1
6,3,0,9,mixedType,1
1,10,0,11,mixedType,1
5,2,0,7,mixedType,0
6,1,0,7,mixedType,0
8,3,0,11,mixedType,1
5,2,0,7,mixedType,0
5,3,0,8,mixedType,1
7,3,0,10,mixedType,1
3,5,0,8,mixedType,1
5,2,0,7,mixedType,0
8,3,0,11,mixedType,1
6,4,0,10,mixedType,1
9,6,0,15,mixedType,2
1,8,0,9,mixedType,1
14,2,0,16,mixedType,2
19,3,0,22,mixedType,2
5,3,0,8,mixedType,1
8,2,0,10,mixedType,1
9,3,0,12,mixedType,1
8,4,0,12,mixedType,1
1,9,0,10,mixedType,1
6,1,0,7,mixedType,0
13,3,0,16,mixedType,2
9,3,0,12,mixedType,1
3,6,0,9,mixedType,1
8,2,0,10,mixedType,1
8,2,0,10,mixedType,1
14,2,0,16,mixedType,2
5,3,0,8,mixedType,1
8,3,0,11,mixedType,1
6,3,0,9,mixedType,1
5,3,0,8,mixedType,1
6,3,0,9,mixedType,1
8,2,0,10,mixedType,1
5,3,0,8,mixedType,1
6,1,0,7,mixedType,0
9,2,0,11,mixedType,1
7,2,0,9,mixedType,1
5,7,0,12,mixedType,1
8,2,0,10,mixedType,1
12,5,0,17,mixedType,2
6,3,0,9,mixedType,1
7,1,0,8,mixedType,1
5,4,0,9,mixedType,1
6,4,0,10,mixedType,1
5,3,0,8,mixedType,1
13,3,0,16,mixedType,2
12,4,0,16,mixedType,2
10,1,0,11,mixedType,1
5,4,0,9,mixedType,1
8,1,0,9,mixedType,1
12,4,0,16,mixedType,2
6,1,0,7,mixedType,0
11,2,0,13,mixedType,1
11,1,0,12,mixedType,1
3,3,0,6,mixedType,0
5,2,0,7,mixedType,0
2,8,0,10,mixedType,1
11,3,0,14,mixedType,2
5,3,0,8,mixedType,1
13,3,0,16,mixedType,2
7,4,0,11,mixedType,1
8,4,0,12,mixedType,1
6,1,0,7,mixedType,0
5,3,0,8,mixedType,1
7,2,0,9,mixedType,1
6,1,0,7,mixedType,0
5,4,0,9,mixedType,1
7,1,0,8,mixedType,1
2,6,0,8,mixedType,1
8,2,0,10,mixedType,1
9,1,0,10,mixedType,1
6,4,0,10,mixedType,1
4,6,0,10,mixedType,1
6,4,0,10,mixedType,1
6,3,0,9,mixedType,1
6,3,0,9,mixedType,1
11,5,0,16,mixedType,2
4,4,0,8,mixedType,1
4,6,0,10,mixedType,1
7,2,0,9,mixedType,1
5,0,4,9,mixedType,0
7,1,0,8,mixedType,1
7,4,0,11,mixedType,1
7,1,0,8,mixedType,1
7,5,0,12,mixedType,1
8,1,0,9,mixedType,1
6,3,0,9,mixedType,1
4,5,0,9,mixedType,1
11,1,0,12,mixedType,1
8,2,0,10,mixedType,1
9,2,0,11,mixedType,1
5,4,0,9,mixedType,1
1,9,0,10,mixedType,1
6,3,0,9,mixedType,1
5,4,0,9,mixedType,1
8,2,0,10,mixedType,1
6,3,0,9,mixedType,1
8,2,0,10,mixedType,1
6,1,0,7,mixedType,0
7,7,1,15,mixedType,2
7,3,0,10,mixedType,1
13,3,0,16,mixedType,2
6,2,0,8,mixedType,1
8,1,0,9,mixedType,1
13,3,0,16,mixedType,2
4,6,0,10,mixedType,1
5,4,0,9,mixedType,1
3,7,0,10,mixedType,1
6,6,0,12,mixedType,1
7,2,0,9,mixedType,1
7,1,0,8,mixedType,1
6,3,0,9,mixedType,1
8,3,0,11,mixedType,1
9,2,0,11,mixedType,1
5,3,0,8,mixedType,1
8,2,0,10,mixedType,1
5,4,0,9,mixedType,1
10,2,0,12,mixedType,1
8,2,0,10,mixedType,1
5,2,0,7,mixedType,0
12,1,0,13,mixedType,1
4,4,0,8,mixedType,1
6,4,0,10,mixedType,1
9,1,0,10,mixedType,1
5,3,0,8,mixedType,1
15,1,0,16,mixedType,2
6,4,0,10,mixedType,1
6,2,0,8,mixedType,1
4,2,0,6,mixedType,0
4,4,0,8,mixedType,1
4,2,0,6,mixedType,0
4,2,0,6,mixedType,0
1,6,1,8,mixedType,1
4,4,0,8,mixedType,1
8,1,0,9,mixedType,1
7,4,0,11,mixedType,1
5,2,0,7,mixedType,0
5,1,0,6,mixedType,0
4,4,0,8,mixedType,1
5,3,0,8,mixedType,1
14,2,0,16,mixedType,2
8,1,0,9,mixedType,1
6,3,0,9,mixedType,1
5,2,0,7,mixedType,0
1,8,0,9,mixedType,1
9,2,0,11,mixedType,1
5,2,0,7,mixedType,0
9,2,0,11,mixedType,1
5,3,0,8,mixedType,1
7,1,0,8,mixedType,1
5,5,0,10,mixedType,1
8,1,0,9,mixedType,1
4,9,0,13,mixedType,1
6,1,0,7,mixedType,0
9,4,0,13,mixedType,1
6,3,0,9,mixedType,1
5,3,0,8,mixedType,1
8,4,0,12,mixedType,1
7,2,0,9,mixedType,1
2,6,0,8,mixedType,1
13,3,0,16,mixedType,2
8,4,0,12,mixedType,1
18,1,1,20,mixedType,2
1,9,0,10,mixedType,1
6,2,0,8,mixedType,1
4,2,0,6,mixedType,0
8,1,0,9,mixedType,1
2,8,0,10,mixedType,1
5,2,0,7,mixedType,0
6,2,0,8,mixedType,1
9,3,0,12,mixedType,1
4,6,0,10,mixedType,1
8,1,0,9,mixedType,1
6,1,0,7,mixedType,0
8,4,0,12,mixedType,1
4,5,0,9,mixedType,1
5,1,0,6,mixedType,0
8,3,0,11,mixedType,1
8,1,0,9,mixedType,1
6,3,0,9,mixedType,1
13,2,1,16,mixedType,2
14,2,0,16,mixedType,2
9,2,0,11,mixedType,1
6,2,0,8,mixedType,1
8,3,0,11,mixedType,1
7,3,0,10,mixedType,1
9,1,0,10,mixedType,1
15,1,0,16,mixedType,2
4,2,0,6,mixedType,0
6,1,0,7,mixedType,0
8,2,0,10,mixedType,1
8,1,0,9,mixedType,1
5,1,0,6,mixedType,0
6,3,0,9,mixedType,1
6,3,0,9,mixedType,1
5,4,0,9,mixedType,1
6,4,0,10,mixedType,1
4,2,0,6,mixedType,0
5,2,0,7,mixedType,0
6,2,0,8,mixedType,1
6,1,0,7,mixedType,0
8,2,0,10,mixedType,1
8,2,0,10,mixedType,1
6,1,0,7,mixedType,0
15,1,0,16,mixedType,2
7,2,0,9,mixedType,1
7,1,0,8,mixedType,1
10,3,0,13,mixedType,1
5,3,0,8,mixedType,1
2,6,0,8,mixedType,1
3,8,0,11,mixedType,1
7,1,0,8,mixedType,1
6,3,0,9,mixedType,1
9,1,0,10,mixedType,1
7,3,0,10,mixedType,1
7,6,0,13,mixedType,1
6,1,0,7,mixedType,0
4,4,0,8,mixedType,1
3,8,0,11,mixedType,1
11,3,0,14,mixedType,2
2,9,0,11,mixedType,1
8,1,0,9,mixedType,1
5,8,0,13,mixedType,1
6,2,0,8,mixedType,1
10,2,0,12,mixedType,1
8,2,0,10,mixedType,1
8,1,0,9,mixedType,1
10,2,0,12,mixedType,1
2,9,0,11,mixedType,1
3,6,0,9,mixedType,1
3,8,0,11,mixedType,1
7,3,0,10,mixedType,1
4,2,0,6,mixedType,0
5,4,0,9,mixedType,1
6,4,0,10,mixedType,1
8,2,0,10,mixedType,1
3,7,0,10,mixedType,1
6,3,0,9,mixedType,1
6,1,0,7,mixedType,0
10,2,0,12,mixedType,1
12,4,0,16,mixedType,2
8,1,0,9,mixedType,1
7,1,0,8,mixedType,1
9,2,0,11,mixedType,1
8,2,0,10,mixedType,1
1,8,0,9,mixedType,1
7,3,0,10,mixedType,1
6,4,0,10,mixedType,1
6,1,0,7,mixedType,0
5,4,0,9,mixedType,1
5,1,0,6,mixedType,0
5,2,0,7,mixedType,0
7,3,0,10,mixedType,1
9,1,0,10,mixedType,1
6,2,0,8,mixedType,1
1,5,0,6,mixedType,0
6,3,0,9,mixedType,1
5,2,0,7,mixedType,0
5,3,0,8,mixedType,1
5,1,0,6,mixedType,0
2,7,0,9,mixedType,1
9,1,0,10,mixedType,1
6,3,0,9,mixedType,1
4,7,0,11,mixedType,1
7,1,0,8,mixedType,1
5,6,0,11,mixedType,1
7,4,0,11,mixedType,1
14,2,0,16,mixedType,2
12,4,0,16,mixedType,2
9,1,0,10,mixedType,1
7,1,0,8,mixedType,1
6,4,0,10,mixedType,1
14,2,0,16,mixedType,2
13,3,0,16,mixedType,2
3,6,0,9,mixedType,1
5,3,0,8,mixedType,1
6,4,0,10,mixedType,1
7,3,0,10,mixedType,1
5,1,0,6,mixedType,0
11,2,0,13,mixedType,1
3,6,0,9,mixedType,1
6,4,0,10,mixedType,1
11,1,2,14,mixedType,2
5,3,0,8,mixedType,1
7,2,0,9,mixedType,1
6,3,0,9,mixedType,1
10,3,0,13,mixedType,1
8,1,0,9,mixedType,1
7,2,0,9,mixedType,1
1,8,0,9,mixedType,1
6,2,0,8,mixedType,1
5,3,0,8,mixedType,1
4,2,0,6,mixedType,0
5,5,0,10,mixedType,1
8,1,0,9,mixedType,1
5,3,0,8,mixedType,1
8,1,0,9,mixedType,1
3,6,0,9,mixedType,1
6,3,0,9,mixedType,1
11,2,0,13,mixedType,1
9,1,0,10,mixedType,1
7,3,0,10,mixedType,1
5,1,0,6,mixedType,0
4,4,0,8,mixedType,1
9,4,0,13,mixedType,1
1,8,0,9,mixedType,1
1,8,0,9,mixedType,1
7,3,0,10,mixedType,1
15,1,0,16,mixedType,2
6,2,0,8,mixedType,1
9,1,0,10,mixedType,1
8,2,0,10,mixedType,1
8,2,0,10,mixedType,1
6,4,0,10,mixedType,1
7,4,0,11,mixedType,1
7,2,0,9,mixedType,1
7,3,0,10,mixedType,1
4,7,0,11,mixedType,1
6,3,0,9,mixedType,1
2,6,0,8,mixedType,1
7,4,0,11,mixedType,1
10,1,0,11,mixedType,1
3,3,0,6,mixedType,0
7,3,0,10,mixedType,1
13,3,0,16,mixedType,2
5,1,0,6,mixedType,0
5,2,0,7,mixedType,0
3,6,0,9,mixedType,1
7,2,0,9,mixedType,1
7,2,0,9,mixedType,1
5,3,0,8,mixedType,1
10,3,0,13,mixedType,1
3,3,0,6,mixedType,0
9,4,0,13,mixedType,1
5,4,0,9,mixedType,1
6,3,0,9,mixedType,1
6,1,0,7,mixedType,0
15,1,0,16,mixedType,2
6,1,0,7,mixedType,0
7,3,0,10,mixedType,1
8,2,0,10,mixedType,1
6,1,0,7,mixedType,0
5,4,0,9,mixedType,1
6,4,0,10,mixedType,1
6,3,0,9,mixedType,1
7,2,0,9,mixedType,1
4,4,0,8,mixedType,1
4,5,0,9,mixedType,1
8,1,0,9,mixedType,1
8,3,0,11,mixedType,1
7,3,0,10,mixedType,1
7,6,0,13,mixedType,1
12,1,0,13,mixedType,1
8,1,0,9,mixedType,1
2,6,0,8,mixedType,1
7,3,0,10,mixedType,1
3,3,0,6,mixedType,0
3,5,0,8,mixedType,1
6,3,0,9,mixedType,1
6,6,0,12,mixedType,1
6,5,0,11,mixedType,1
6,3,0,9,mixedType,1
7,3,0,10,mixedType,1
13,3,0,16,mixedType,2
6,3,0,9,mixedType,1
10,4,0,14,mixedType,2
6,3,0,9,mixedType,1
14,2,0,16,mixedType,2
7,4,0,11,mixedType,1
6,3,0,9,mixedType,1
7,4,0,11,mixedType,1
7,2,0,9,mixedType,1
6,3,0,9,mixedType,1
6,3,0,9,mixedType,1
7,1,0,8,mixedType,1
6,2,0,8,mixedType,1
14,2,0,16,mixedType,2
7,3,0,10,mixedType,1
5,6,0,11,mixedType,1
7,3,0,10,mixedType,1
14,2,0,16,mixedType,2
9,1,0,10,mixedType,1
6,3,0,9,mixedType,1
6,4,0,10,mixedType,1
4,6,0,10,mixedType,1
6,1,0,7,mixedType,0
1,7,0,8,mixedType,1
13,3,0,16,mixedType,2
6,2,0,8,mixedType,1
4,2,0,6,mixedType,0
7,2,0,9,mixedType,1
5,2,0,7,mixedType,0
6,3,0,9,mixedType,1
11,5,0,16,mixedType,2
9,2,0,11,mixedType,1
5,1,0,6,mixedType,0
6,4,0,10,mixedType,1
7,2,0,9,mixedType,1
8,3,0,11,mixedType,1
8,2,0,10,mixedType,1
9,4,0,13,mixedType,1
6,2,0,8,mixedType,1
9,3,0,12,mixedType,1
5,9,0,14,mixedType,2
7,1,0,8,mixedType,1
6,3,0,9,mixedType,1
7,3,0,10,mixedType,1
6,2,0,8,mixedType,1
8,2,0,10,mixedType,1
10,6,0,16,mixedType,2
11,2,0,13,mixedType,1
26,0,3,29,mixedType,2
8,2,0,10,mixedType,1
5,1,0,6,mixedType,0
6,3,0,9,mixedType,1
7,3,0,10,mixedType,1
6,4,0,10,mixedType,1
11,3,0,14,mixedType,2
7,3,0,10,mixedType,1
4,2,0,6,mixedType,0
8,5,0,13,mixedType,1
5,2,0,7,mixedType,0
8,2,0,10,mixedType,1
12,4,0,16,mixedType,2
9,2,0,11,mixedType,1
11,3,0,14,mixedType,2
6,3,0,9,mixedType,1
5,3,0,8,mixedType,1
6,3,0,9,mixedType,1
1,7,0,8,mixedType,1
6,1,0,7,mixedType,0
6,3,0,9,mixedType,1
7,2,0,9,mixedType,1
4,2,0,6,mixedType,0
5,2,0,7,mixedType,0
5,5,0,10,mixedType,1
8,2,0,10,mixedType,1
15,1,0,16,mixedType,2
4,6,0,10,mixedType,1
2,6,0,8,mixedType,1
8,3,0,11,mixedType,1
5,3,0,8,mixedType,1
5,4,0,9,mixedType,1
4,2,0,6,mixedType,0
4,8,0,12,mixedType,1
1,9,0,10,mixedType,1
7,2,0,9,mixedType,1
3,10,0,13,mixedType,1
7,4,0,11,mixedType,1
5,4,0,9,mixedType,1
8,1,0,9,mixedType,1
2,7,0,9,mixedType,1
4,2,0,6,mixedType,0
12,3,0,15,mixedType,2
4,6,0,10,mixedType,1
6,7,1,14,mixedType,2
5,3,0,8,mixedType,1
6,3,0,9,mixedType,1
7,3,0,10,mixedType,1
14,2,0,16,mixedType,2
5,4,0,9,mixedType,1
9,2,0,11,mixedType,1
6,4,0,10,mixedType,1
7,2,0,9,mixedType,1
16,3,2,21,mixedType,2
1,8,0,9,mixedType,1
6,6,0,12,mixedType,1
4,4,0,8,mixedType,1
7,1,1,9,mixedType,1
9,2,0,11,mixedType,1
11,3,0,14,mixedType,2
8,2,0,10,mixedType,1
6,4,0,10,mixedType,1
2,6,0,8,mixedType,1
15,1,0,16,mixedType,2
4,2,0,6,mixedType,0
1,9,0,10,mixedType,1
9,4,0,13,mixedType,1
8,5,0,13,mixedType,1
4,7,0,11,mixedType,1
5,3,0,8,mixedType,1
7,2,0,9,mixedType,1
5,2,0,7,mixedType,0
15,1,0,16,mixedType,2
5,1,0,6,mixedType,0
8,2,0,10,mixedType,1
15,1,0,16,mixedType,2
6,4,0,10,mixedType,1
7,4,0,11,mixedType,1
2,6,0,8,mixedType,1
7,1,0,8,mixedType,1
9,1,0,10,mixedType,1
12,4,0,16,mixedType,2
8,3,0,11,mixedType,1
7,1,0,8,mixedType,1
5,1,0,6,mixedType,0
4,2,0,6,mixedType,0
7,3,0,10,mixedType,1
3,5,0,8,mixedType,1
7,3,0,10,mixedType,1
4,6,0,10,mixedType,1
6,3,0,9,mixedType,1
6,7,0,13,mixedType,1
4,4,0,8,mixedType,1
7,2,0,9,mixedType,1
5,2,0,7,mixedType,0
7,3,0,10,mixedType,1
3,8,0,11,mixedType,1
2,8,0,10,mixedType,1
9,3,0,12,mixedType,1
14,2,0,16,mixedType,2
8,2,0,10,mixedType,1
6,3,0,9,mixedType,1
10,6,0,16,mixedType,2
8,1,0,9,mixedType,1
2,6,0,8,mixedType,1
4,2,0,6,mixedType,0
7,3,0,10,mixedType,1
7,1,0,8,mixedType,1
8,1,0,9,mixedType,1
7,2,0,9,mixedType,1
14,4,0,18,mixedType,2
1,7,0,8,mixedType,1
5,1,0,6,mixedType,0
15,1,0,16,mixedType,2
7,2,0,9,mixedType,1
9,4,0,13,mixedType,1
12,4,0,16,mixedType,2
9,2,0,11,mixedType,1
5,2,0,7,mixedType,0
4,2,0,6,mixedType,0
12,4,0,16,mixedType,2
6,0,1,7,mixedType,0
1,9,0,10,mixedType,1
7,1,0,8,mixedType,1
13,2,1,16,mixedType,2
11,5,0,16,mixedType,2
13,3,0,16,mixedType,2
8,3,0,11,mixedType,1
2,6,0,8,mixedType,1
9,1,0,10,mixedType,1
7,3,0,10,mixedType,1
9,1,0,10,mixedType,1
5,2,0,7,mixedType,0
6,2,0,8,mixedType,1
4,2,0,6,mixedType,0
7,3,0,10,mixedType,1
14,2,0,16,mixedType,2
7,3,0,10,mixedType,1
7,2,0,9,mixedType,1
5,3,0,8,mixedType,1
8,2,0,10,mixedType,1
9,2,0,11,mixedType,1
8,3,0,11,mixedType,1
4,4,0,8,mixedType,1
7,2,0,9,mixedType,1
6,4,0,10,mixedType,1
12,1,0,13,mixedType,1
7,2,0,9,mixedType,1
6,2,0,8,mixedType,1
14,2,0,16,mixedType,2
6,3,0,9,mixedType,1
5,3,0,8,mixedType,1
10,3,0,13,mixedType,1
7,4,0,11,mixedType,1
7,1,0,8,mixedType,1
6,1,0,7,mixedType,0
3,6,0,9,mixedType,1
10,2,0,12,mixedType,1
15,1,0,16,mixedType,2
1,9,0,10,mixedType,1
10,6,0,16,mixedType,2
7,3,0,10,mixedType,1
8,1,0,9,mixedType,1
6,3,0,9,mixedType,1
9,1,0,10,mixedType,1
4,2,0,6,mixedType,0
6,3,0,9,mixedType,1
18,2,0,20,mixedType,2
8,0,1,9,mixedType,1
4,4,0,8,mixedType,1
15,1,0,16,mixedType,2
1,9,0,10,mixedType,1
12,4,0,16,mixedType,2
2,8,0,10,mixedType,1
6,2,0,8,mixedType,1
5,4,0,9,mixedType,1
9,3,0,12,mixedType,1
8,2,0,10,mixedType,1
8,3,0,11,mixedType,1
6,2,0,8,mixedType,1
5,1,0,6,mixedType,0
5,1,0,6,mixedType,0
7,3,0,10,mixedType,1
7,3,0,10,mixedType,1
6,1,0,7,mixedType,0
10,0,1,11,mixedType,1
13,3,0,16,mixedType,2
3,6,0,9,mixedType,1
6,3,0,9,mixedType,1
7,3,0,10,mixedType,1
6,4,0,10,mixedType,1
6,5,0,11,mixedType,1
7,3,0,10,mixedType,1
6,2,0,8,mixedType,1
5,3,0,8,mixedType,1
9,3,0,12,mixedType,1
8,2,0,10,mixedType,1
8,2,0,10,mixedType,1
7,1,0,8,mixedType,1
2,8,0,10,mixedType,1
8,2,0,10,mixedType,1
8,6,1,15,mixedType,2
16,2,2,20,mixedType,2
6,2,0,8,mixedType,1
6,4,0,10,mixedType,1
6,2,0,8,mixedType,1
5,1,0,6,mixedType,0
3,9,0,12,mixedType,1
8,2,0,10,mixedType,1
6,4,0,10,mixedType,1
7,8,1,16,mixedType,2
5,5,0,10,mixedType,1
8,1,0,9,mixedType,1
16,1,1,18,mixedType,2
6,3,0,9,mixedType,1
5,4,0,9,mixedType,1
4,8,0,12,mixedType,1
6,4,0,10,mixedType,1
8,1,0,9,mixedType,1
13,3,0,16,mixedType,2
2,6,0,8,mixedType,1
4,2,0,6,mixedType,0
8,2,0,10,mixedType,1
5,6,0,11,mixedType,1
7,2,0,9,mixedType,1
7,2,0,9,mixedType,1
5,3,0,8,mixedType,1
8,2,0,10,mixedType,1
3,6,0,9,mixedType,1
5,2,0,7,mixedType,0
8,1,0,9,mixedType,1
7,3,0,10,mixedType,1
9,4,0,13,mixedType,1
8,2,0,10,mixedType,1
6,2,0,8,mixedType,1
5,3,0,8,mixedType,1
5,3,0,8,mixedType,1
4,4,0,8,mixedType,1
6,2,0,8,mixedType,1
9,1,0,10,mixedType,1
6,1,0,7,mixedType,0
3,3,0,6,mixedType,0
8,1,0,9,mixedType,1
6,4,0,10,mixedType,1
13,3,0,16,mixedType,2
11,3,0,14,mixedType,2
9,4,0,13,mixedType,1
7,3,0,10,mixedType,1
8,2,0,10,mixedType,1
9,2,0,11,mixedType,1
5,1,0,6,mixedType,0
6,3,0,9,mixedType,1
10,2,0,12,mixedType,1
8,2,0,10,mixedType,1
11,3,0,14,mixedType,2
7,2,0,9,mixedType,1
5,2,0,7,mixedType,0
5,2,0,7,mixedType,0
5,2,0,7,mixedType,0
5,3,0,8,mixedType,1
2,8,0,10,mixedType,1
5,1,0,6,mixedType,0
8,1,0,9,mixedType,1
8,1,0,9,mixedType,1
3,5,0,8,mixedType,1
6,4,0,10,mixedType,1
16,1,1,18,mixedType,2
17,1,1,19,mixedType,2
9,3,0,12,mixedType,1
2,8,0,10,mixedType,1
5,3,0,8,mixedType,1
5,2,0,7,mixedType,0
11,3,0,14,mixedType,2
7,1,0,8,mixedType,1
8,1,0,9,mixedType,1
7,2,0,9,mixedType,1
7,2,0,9,mixedType,1
5,1,0,6,mixedType,0
9,1,0,10,mixedType,1
8,1,0,9,mixedType,1
6,3,0,9,mixedType,1
5,1,0,6,mixedType,0
6,3,0,9,mixedType,1
6,4,0,10,mixedType,1
9,1,0,10,mixedType,1
6,1,0,7,mixedType,0
6,3,0,9,mixedType,1
2,8,0,10,mixedType,1
6,3,0,9,mixedType,1
6,2,0,8,mixedType,1
6,1,0,7,mixedType,0
9,1,0,10,mixedType,1
6,2,0,8,mixedType,1
6,4,0,10,mixedType,1
6,1,0,7,mixedType,0
6,2,0,8,mixedType,1
10,2,0,12,mixedType,1
9,1,0,10,mixedType,1
7,3,0,10,mixedType,1
14,2,0,16,mixedType,2
5,2,0,7,mixedType,0
6,3,0,9,mixedType,1
9,1,0,10,mixedType,1
3,3,0,6,mixedType,0
5,1,0,6,mixedType,0
6,2,0,8,mixedType,1
10,3,0,13,mixedType,1
8,4,0,12,mixedType,1
7,3,0,10,mixedType,1
5,3,0,8,mixedType,1
8,2,0,10,mixedType,1
5,4,0,9,mixedType,1
7,3,0,10,mixedType,1
3,7,0,10,mixedType,1
3,10,0,13,mixedType,1
5,2,0,7,mixedType,0
9,1,0,10,mixedType,1
15,1,0,16,mixedType,2
5,2,0,7,mixedType,0
14,2,0,16,mixedType,2
3,6,0,9,mixedType,1
3,6,0,9,mixedType,1
9,1,0,10,mixedType,1
4,4,0,8,mixedType,1
9,1,0,10,mixedType,1
7,1,0,8,mixedType,1
7,2,0,9,mixedType,1
8,2,0,10,mixedType,1
8,1,0,9,mixedType,1
8,2,0,10,mixedType,1
6,3,0,9,mixedType,1
1,9,0,10,mixedType,1
9,1,0,10,mixedType,1
3,7,0,10,mixedType,1
4,10,0,14,mixedType,2
7,1,0,8,mixedType,1
7,3,0,10,mixedType,1
12,3,0,15,mixedType,2
5,3,0,8,mixedType,1
3,10,0,13,mixedType,1
6,4,0,10,mixedType,1
6,4,0,10,mixedType,1
10,2,0,12,mixedType,1
7,1,0,8,mixedType,1
6,2,0,8,mixedType,1
5,2,0,7,mixedType,0
5,8,0,13,mixedType,1
7,4,0,11,mixedType,1
8,2,0,10,mixedType,1
5,3,0,8,mixedType,1
6,1,0,7,mixedType,0
6,2,0,8,mixedType,1
13,3,0,16,mixedType,2
7,1,0,8,mixedType,1
6,3,0,9,mixedType,1
8,2,0,10,mixedType,1
7,1,0,8,mixedType,1
8,1,0,9,mixedType,1
6,3,0,9,mixedType,1
9,2,0,11,mixedType,1
11,2,0,13,mixedType,1
6,3,0,9,mixedType,1
4,2,0,6,mixedType,0
6,1,0,7,mixedType,0
7,1,0,8,mixedType,1
7,6,0,13,mixedType,1
13,3,0,16,mixedType,2
5,1,0,6,mixedType,0
6,3,0,9,mixedType,1
5,6,0,11,mixedType,1
7,3,0,10,mixedType,1
6,4,0,10,mixedType,1
4,2,0,6,mixedType,0
7,4,0,11,mixedType,1
5,3,0,8,mixedType,1
6,2,0,8,mixedType,1
7,1,0,8,mixedType,1
7,1,0,8,mixedType,1
5,4,0,9,mixedType,1
5,4,0,9,mixedType,1
2,7,0,9,mixedType,1
7,2,0,9,mixedType,1
5,2,0,7,mixedType,0
6,4,0,10,mixedType,1
8,1,0,9,mixedType,1
4,9,0,13,mixedType,1
2,6,0,8,mixedType,1
6,1,0,7,mixedType,0
7,3,0,10,mixedType,1
4,2,0,6,mixedType,0
6,3,0,9,mixedType,1
13,3,0,16,mixedType,2
9,2,0,11,mixedType,1
7,2,0,9,mixedType,1
6,2,0,8,mixedType,1
14,2,0,16,mixedType,2
5,4,0,9,mixedType,1
5,4,0,9,mixedType,1
13,2,0,15,mixedType,2
9,1,0,10,mixedType,1
5,2,0,7,mixedType,0
3,6,0,9,mixedType,1
7,6,0,13,mixedType,1
5,2,0,7,mixedType,0
5,7,0,12,mixedType,1
6,3,0,9,mixedType,1
5,2,0,7,mixedType,0
7,2,0,9,mixedType,1
7,2,0,9,mixedType,1
6,2,0,8,mixedType,1
5,6,0,11,mixedType,1
7,3,0,10,mixedType,1
7,2,0,9,mixedType,1
7,8,1,16,mixedType,2
5,1,0,6,mixedType,0
7,3,0,10,mixedType,1
8,2,0,10,mixedType,1
5,3,0,8,mixedType,1
7,3,0,10,mixedType,1
5,1,0,6,mixedType,0
7,1,0,8,mixedType,1
3,3,0,6,mixedType,0
5,3,0,8,mixedType,1
4,6,0,10,mixedType,1
7,2,0,9,mixedType,1
14,1,1,16,mixedType,2
6,3,0,9,mixedType,1
5,2,0,7,mixedType,0
5,6,0,11,mixedType,1
4,2,0,6,mixedType,0
5,6,0,11,mixedType,1
14,2,0,16,mixedType,2
14,2,0,16,mixedType,2
6,2,0,8,mixedType,1
5,3,0,8,mixedType,1
4,2,0,6,mixedType,0
7,4,0,11,mixedType,1
11,2,0,13,mixedType,1
4,4,0,8,mixedType,1
6,3,0,9,mixedType,1
14,2,0,16,mixedType,2
12,3,1,16,mixedType,2
8,2,0,10,mixedType,1
15,1,0,16,mixedType,2
6,3,0,9,mixedType,1
8,2,0,10,mixedType,1
5,4,0,9,mixedType,1
4,2,0,6,mixedType,0
14,2,0,16,mixedType,2
3,6,0,9,mixedType,1
6,2,0,8,mixedType,1
3,7,0,10,mixedType,1
7,6,0,13,mixedType,1
12,3,0,15,mixedType,2
7,3,0,10,mixedType,1
6,3,0,9,mixedType,1
4,2,0,6,mixedType,0
5,4,0,9,mixedType,1
6,1,0,7,mixedType,0
9,1,0,10,mixedType,1
7,2,0,9,mixedType,1
6,3,0,9,mixedType,1
9,1,0,10,mixedType,1
7,2,0,9,mixedType,1
7,3,0,10,mixedType,1
5,3,0,8,mixedType,1
2,6,0,8,mixedType,1
6,2,0,8,mixedType,1
6,4,0,10,mixedType,1
4,4,0,8,mixedType,1
7,2,0,9,mixedType,1
2,4,0,6,mixedType,0
7,2,0,9,mixedType,1
1,8,0,9,mixedType,1
6,3,0,9,mixedType,1
2,9,0,11,mixedType,1
6,4,0,10,mixedType,1
2,11,0,13,mixedType,1
9,1,0,10,mixedType,1
8,2,0,10,mixedType,1
13,3,0,16,mixedType,2
8,3,0,11,mixedType,1
14,2,0,16,mixedType,2
14,2,0,16,mixedType,2
1,9,0,10,mixedType,1
7,3,0,10,mixedType,1
7,4,0,11,mixedType,1
6,2,0,8,mixedType,1
4,2,0,6,mixedType,0
7,3,0,10,mixedType,1
7,2,0,9,mixedType,1
8,1,0,9,mixedType,1
4,4,0,8,mixedType,1
12,4,0,16,mixedType,2
5,2,0,7,mixedType,0
7,3,0,10,mixedType,1
5,1,0,6,mixedType,0
5,2,0,7,mixedType,0
6,1,0,7,mixedType,0
5,3,0,8,mixedType,1
1,10,0,11,mixedType,1
13,3,0,16,mixedType,2
3,6,0,9,mixedType,1
8,1,0,9,mixedType,1
6,4,0,10,mixedType,1
7,2,0,9,mixedType,1
8,3,0,11,mixedType,1
2,7,0,9,mixedType,1
6,3,0,9,mixedType,1
9,4,0,13,mixedType,1
7,3,0,10,mixedType,1
7,2,0,9,mixedType,1
8,2,0,10,mixedType,1
11,5,0,16,mixedType,2
6,1,0,7,mixedType,0
6,2,0,8,mixedType,1
5,5,0,10,mixedType,1
7,3,0,10,mixedType,1
4,8,0,12,mixedType,1
5,2,0,7,mixedType,0
6,4,0,10,mixedType,1
14,2,0,16,mixedType,2
1,9,0,10,mixedType,1
7,3,0,10,mixedType,1
8,2,0,10,mixedType,1
6,3,0,9,mixedType,1
11,2,0,13,mixedType,1
3,9,0,12,mixedType,1
6,3,0,9,mixedType,1
3,5,0,8,mixedType,1
5,3,0,8,mixedType,1
8,4,0,12,mixedType,1
8,4,0,12,mixedType,1
6,4,0,10,mixedType,1
12,1,0,13,mixedType,1
12,1,0,13,mixedType,1
7,1,0,8,mixedType,1
8,1,0,9,mixedType,1
5,4,0,9,mixedType,1
2,6,0,8,mixedType,1
5,8,0,13,mixedType,1
12,3,0,15,mixedType,2
13,3,0,16,mixedType,2
15,1,0,16,mixedType,2
1,7,0,8,mixedType,1
5,4,0,9,mixedType,1
6,1,0,7,mixedType,0
5,1,0,6,mixedType,0
1,10,0,11,mixedType,1
1,10,0,11,mixedType,1
8,4,0,12,mixedType,1
8,3,0,11,mixedType,1
3,3,0,6,mixedType,0
5,4,0,9,mixedType,1
6,4,0,10,mixedType,1
7,4,0,11,mixedType,1
10,1,0,11,mixedType,1
9,1,0,10,mixedType,1
5,3,0,8,mixedType,1
7,1,0,8,mixedType,1
8,4,0,12,mixedType,1
9,1,0,10,mixedType,1
9,3,0,12,mixedType,1
5,4,0,9,mixedType,1
10,3,0,13,mixedType,1
5,3,0,8,mixedType,1
6,3,0,9,mixedType,1
11,2,1,14,mixedType,2
7,3,0,10,mixedType,1
6,1,0,7,mixedType,0
9,3,0,12,mixedType,1
6,3,0,9,mixedType,1
13,3,0,16,mixedType,2
0,7,2,9,mixedType,1
4,4,0,8,mixedType,1
5,1,0,6,mixedType,0
5,4,0,9,mixedType,1
13,3,0,16,mixedType,2
3,6,0,9,mixedType,1
9,3,0,12,mixedType,1
3,5,0,8,mixedType,1
5,1,0,6,mixedType,0
3,5,0,8,mixedType,1
15,1,0,16,mixedType,2
4,2,0,6,mixedType,0
2,6,0,8,mixedType,1
8,2,0,10,mixedType,1
7,1,0,8,mixedType,1
5,4,0,9,mixedType,1
1,9,0,10,mixedType,1
5,8,0,13,mixedType,1
4,6,0,10,mixedType,1
7,2,0,9,mixedType,1
4,4,0,8,mixedType,1
4,2,0,6,mixedType,0
6,3,0,9,mixedType,1
5,4,0,9,mixedType,1
8,2,0,10,mixedType,1
6,5,0,11,mixedType,1
7,2,0,9,mixedType,1
7,3,0,10,mixedType,1
8,3,0,11,mixedType,1
5,6,0,11,mixedType,1
7,4,0,11,mixedType,1
5,3,0,8,mixedType,1
6,6,0,12,mixedType,1
6,1,0,7,mixedType,0
6,1,0,7,mixedType,0
2,6,0,8,mixedType,1
6,3,0,9,mixedType,1
3,8,0,11,mixedType,1
6,4,0,10,mixedType,1
1,8,0,9,mixedType,1
7,2,0,9,mixedType,1
14,2,0,16,mixedType,2
5,2,0,7,mixedType,0
6,3,0,9,mixedType,1
5,3,0,8,mixedType,1
9,4,0,13,mixedType,1
7,1,0,8,mixedType,1
3,8,0,11,mixedType,1
6,4,0,10,mixedType,1
10,6,0,16,mixedType,2
9,1,0,10,mixedType,1
1,8,0,9,mixedType,1
5,4,0,9,mixedType,1
5,3,0,8,mixedType,1
7,2,0,9,mixedType,1
7,3,0,10,mixedType,1
4,6,0,10,mixedType,1
5,5,0,10,mixedType,1
5,5,0,10,mixedType,1
14,2,0,16,mixedType,2
4,2,0,6,mixedType,0
7,2,0,9,mixedType,1
6,3,0,9,mixedType,1
5,2,0,7,mixedType,0
12,4,0,16,mixedType,2
8,2,0,10,mixedType,1
2,6,0,8,mixedType,1
6,1,0,7,mixedType,0
4,4,0,8,mixedType,1
6,3,0,9,mixedType,1
4,4,0,8,mixedType,1
5,3,0,8,mixedType,1
5,4,0,9,mixedType,1
11,3,0,14,mixedType,2
4,2,0,6,mixedType,0
10,1,0,11,mixedType,1
8,2,0,10,mixedType,1
8,2,0,10,mixedType,1
6,1,0,7,mixedType,0
15,1,0,16,mixedType,2
6,3,0,9,mixedType,1
6,1,0,7,mixedType,0
5,6,0,11,mixedType,1
5,2,0,7,mixedType,0
6,2,0,8,mixedType,1
3,5,0,8,mixedType,1
8,5,0,13,mixedType,1
5,4,0,9,mixedType,1
11,5,0,16,mixedType,2
7,3,0,10,mixedType,1
12,3,0,15,mixedType,2
6,3,0,9,mixedType,1
6,3,0,9,mixedType,1
4,4,0,8,mixedType,1
9,1,0,10,mixedType,1
2,7,0,9,mixedType,1
6,4,0,10,mixedType,1
5,2,0,7,mixedType,0
6,4,0,10,mixedType,1
7,3,0,10,mixedType,1
8,3,0,11,mixedType,1
7,4,0,11,mixedType,1
15,1,0,16,mixedType,2
8,3,0,11,mixedType,1
6,4,0,10,mixedType,1
1,9,0,10,mixedType,1
1,7,0,8,mixedType,1
8,3,0,11,mixedType,1
7,1,0,8,mixedType,1
14,2,0,16,mixedType,2
9,1,0,10,mixedType,1
9,3,0,12,mixedType,1
8,2,0,10,mixedType,1
5,2,0,7,mixedType,0
7,2,0,9,mixedType,1
1,10,0,11,mixedType,1
9,1,0,10,mixedType,1
5,5,0,10,mixedType,1
6,1,0,7,mixedType,0
6,3,0,9,mixedType,1
5,4,0,9,mixedType,1
3,6,0,9,mixedType,1
2,6,0,8,mixedType,1
5,8,0,13,mixedType,1
6,2,0,8,mixedType,1
5,1,0,6,mixedType,0
3,6,0,9,mixedType,1
8,2,0,10,mixedType,1
5,2,0,7,mixedType,0
2,9,0,11,mixedType,1
6,4,0,10,mixedType,1
11,5,0,16,mixedType,2
2,8,0,10,mixedType,1
7,3,0,10,mixedType,1
14,2,0,16,mixedType,2
5,1,0,6,mixedType,0
7,3,0,10,mixedType,1
3,3,0,6,mixedType,0
6,1,0,7,mixedType,0
14,2,0,16,mixedType,2
6,4,0,10,mixedType,1
4,4,0,8,mixedType,1
8,1,0,9,mixedType,1
9,1,0,10,mixedType,1
6,1,0,7,mixedType,0
7,3,0,10,mixedType,1
6,4,0,10,mixedType,1
7,2,0,9,mixedType,1
14,2,0,16,mixedType,2
4,9,0,13,mixedType,1
10,2,0,12,mixedType,1
3,7,0,10,mixedType,1
10,1,0,11,mixedType,1
6,1,0,7,mixedType,0
5,3,0,8,mixedType,1
5,2,0,7,mixedType,0
3,3,0,6,mixedType,0
8,3,0,11,mixedType,1
6,4,0,10,mixedType,1
7,2,0,9,mixedType,1
7,1,0,8,mixedType,1
9,2,0,11,mixedType,1
7,2,0,9,mixedType,1
6,3,0,9,mixedType,1
8,1,0,9,mixedType,1
5,4,0,9,mixedType,1
2,8,0,10,mixedType,1
6,3,0,9,mixedType,1
7,3,0,10,mixedType,1
6,3,0,9,mixedType,1
1,9,0,10,mixedType,1
7,2,0,9,mixedType,1
3,5,0,8,mixedType,1
8,3,0,11,mixedType,1
7,2,0,9,mixedType,1
4,4,0,8,mixedType,1
2,8,0,10,mixedType,1
6,4,0,10,mixedType,1
14,2,0,16,mixedType,2
4,2,0,6,mixedType,0
3,6,0,9,mixedType,1
7,3,0,10,mixedType,1
7,3,0,10,mixedType,1
10,2,0,12,mixedType,1
7,2,0,9,mixedType,1
13,3,0,16,mixedType,2
11,3,0,14,mixedType,2
9,1,0,10,mixedType,1
1,8,0,9,mixedType,1
6,4,0,10,mixedType,1
6,1,0,7,mixedType,0
6,4,0,10,mixedType,1
6,4,0,10,mixedType,1
6,4,0,10,mixedType,1
14,2,0,16,mixedType,2
8,4,4,16,mixedType,2
15,1,0,16,mixedType,2
6,3,0,9,mixedType,1
7,1,0,8,mixedType,1
9,1,0,10,mixedType,1
8,2,0,10,mixedType,1
10,1,0,11,mixedType,1
2,9,0,11,mixedType,1
0,6,3,9,mixedType,1
7,6,0,13,mixedType,1
9,1,0,10,mixedType,1
10,2,0,12,mixedType,1
13,3,0,16,mixedType,2
8,1,0,9,mixedType,1
6,3,0,9,mixedType,1
6,2,0,8,mixedType,1
7,2,0,9,mixedType,1
6,2,0,8,mixedType,1
6,1,0,7,mixedType,0
7,2,0,9,mixedType,1
6,4,0,10,mixedType,1
4,4,0,8,mixedType,1
4,4,0,8,mixedType,1
7,4,0,11,mixedType,1
7,1,0,8,mixedType,1
14,2,0,16,mixedType,2
7,1,0,8,mixedType,1
5,3,0,8,mixedType,1
6,2,0,8,mixedType,1
7,6,0,13,mixedType,1
9,2,0,11,mixedType,1
5,0,1,6,mixedType,0
5,4,0,9,mixedType,1
12,4,0,16,mixedType,2
10,2,0,12,mixedType,1
15,1,0,16,mixedType,2
3,6,0,9,mixedType,1
6,2,0,8,mixedType,1
8,3,0,11,mixedType,1
6,3,0,9,mixedType,1
9,2,0,11,mixedType,1
7,2,0,9,mixedType,1
0,8,2,10,mixedType,1
6,4,0,10,mixedType,1
10,1,0,11,mixedType,1
5,1,0,6,mixedType,0
8,1,0,9,mixedType,1
5,2,0,7,mixedType,0
4,2,0,6,mixedType,0
7,4,0,11,mixedType,1
11,3,0,14,mixedType,2
6,1,0,7,mixedType,0
5,1,0,6,mixedType,0
5,3,0,8,mixedType,1
14,2,0,16,mixedType,2
5,2,0,7,mixedType,0
11,1,0,12,mixedType,1
2,6,0,8,mixedType,1
7,3,0,10,mixedType,1
6,1,0,7,mixedType,0
1,8,0,9,mixedType,1
6,3,0,9,mixedType,1
11,5,0,16,mixedType,2
6,2,0,8,mixedType,1
8,2,0,10,mixedType,1
5,1,0,6,mixedType,0
4,2,0,6,mixedType,0
9,4,0,13,mixedType,1
5,1,0,6,mixedType,0
2,6,0,8,mixedType,1
6,1,0,7,mixedType,0
7,1,0,8,mixedType,1
7,1,0,8,mixedType,1
7,3,0,10,mixedType,1
7,1,0,8,mixedType,1
4,5,0,9,mixedType,1
10,2,0,12,mixedType,1
20,3,1,24,mixedType,2
13,3,0,16,mixedType,2
4,4,0,8,mixedType,1
5,4,0,9,mixedType,1
5,2,0,7,mixedType,0
7,4,0,11,mixedType,1
12,4,0,16,mixedType,2
9,3,0,12,mixedType,1
9,1,0,10,mixedType,1
6,1,0,7,mixedType,0
6,1,0,7,mixedType,0
6,3,0,9,mixedType,1
6,1,0,7,mixedType,0
8,1,0,9,mixedType,1
7,4,0,11,mixedType,1
5,4,0,9,mixedType,1
6,3,0,9,mixedType,1
10,3,0,13,mixedType,1
8,2,0,10,mixedType,1
6,3,0,9,mixedType,1
4,2,0,6,mixedType,0
5,3,0,8,mixedType,1
5,1,0,6,mixedType,0
6,1,0,7,mixedType,0
6,4,0,10,mixedType,1
4,2,0,6,mixedType,0
6,1,0,7,mixedType,0
6,4,0,10,mixedType,1
5,5,0,10,mixedType,1
6,3,0,9,mixedType,1
11,2,0,13,mixedType,1
4,2,0,6,mixedType,0
5,3,0,8,mixedType,1
9,1,0,10,mixedType,1
6,4,0,10,mixedType,1
5,4,0,9,mixedType,1
5,3,0,8,mixedType,1
12,1,0,13,mixedType,1
7,1,0,8,mixedType,1
5,4,0,9,mixedType,1
2,7,0,9,mixedType,1
7,5,0,12,mixedType,1
2,8,0,10,mixedType,1
5,1,0,6,mixedType,0
1,9,0,10,mixedType,1
7,1,0,8,mixedType,1
5,2,0,7,mixedType,0
6,3,0,9,mixedType,1
9,1,0,10,mixedType,1
7,3,0,10,mixedType,1
6,2,0,8,mixedType,1
5,3,0,8,mixedType,1
4,4,0,8,mixedType,1
5,3,0,8,mixedType,1
2,4,0,6,mixedType,0
7,2,0,9,mixedType,1
7,3,0,10,mixedType,1
7,1,0,8,mixedType,1
5,3,0,8,mixedType,1
1,8,0,9,mixedType,1
5,4,0,9,mixedType,1
14,2,0,16,mixedType,2
7,3,0,10,mixedType,1
6,3,0,9,mixedType,1
7,3,0,10,mixedType,1
6,3,0,9,mixedType,1
6,3,0,9,mixedType,1
7,3,0,10,mixedType,1
9,3,0,12,mixedType,1
10,2,0,12,mixedType,1
6,4,0,10,mixedType,1
8,3,0,11,mixedType,1
9,3,0,12,mixedType,1
11,3,0,14,mixedType,2
1,8,0,9,mixedType,1
6,1,0,7,mixedType,0
7,3,0,10,mixedType,1
4,4,0,8,mixedType,1
10,4,0,14,mixedType,2
10,2,2,14,mixedType,2
5,4,0,9,mixedType,1
10,2,0,12,mixedType,1
7,1,0,8,mixedType,1
14,2,0,16,mixedType,2
8,2,0,10,mixedType,1
7,2,0,9,mixedType,1
7,3,0,10,mixedType,1
6,3,0,9,mixedType,1
6,3,0,9,mixedType,1
5,3,0,8,mixedType,1
3,6,0,9,mixedType,1
6,2,0,8,mixedType,1
6,3,0,9,mixedType,1
8,2,0,10,mixedType,1
3,6,0,9,mixedType,1
7,2,0,9,mixedType,1
7,2,0,9,mixedType,1
11,5,0,16,mixedType,2
5,2,0,7,mixedType,0
8,4,0,12,mixedType,1
11,4,0,15,mixedType,2
6,4,0,10,mixedType,1
7,4,0,11,mixedType,1
7,5,0,12,mixedType,1
5,5,0,10,mixedType,1
6,2,0,8,mixedType,1
9,3,0,12,mixedType,1
5,5,0,10,mixedType,1
5,3,0,8,mixedType,1
14,2,0,16,mixedType,2
4,2,0,6,mixedType,0
5,2,0,7,mixedType,0
9,1,0,10,mixedType,1
7,2,0,9,mixedType,1
5,2,0,7,mixedType,0
14,2,0,16,mixedType,2
4,4,0,8,mixedType,1
7,3,0,10,mixedType,1
3,6,0,9,mixedType,1
3,6,0,9,mixedType,1
15,1,0,16,mixedType,2
8,1,0,9,mixedType,1
6,3,0,9,mixedType,1
6,2,0,8,mixedType,1
8,1,0,9,mixedType,1
8,1,0,9,mixedType,1
5,2,0,7,mixedType,0
3,6,0,9,mixedType,1
5,3,0,8,mixedType,1
7,3,0,10,mixedType,1
13,3,0,16,mixedType,2
10,3,0,13,mixedType,1
6,6,0,12,mixedType,1
7,3,0,10,mixedType,1
7,5,0,12,mixedType,1
8,3,0,11,mixedType,1
4,2,0,6,mixedType,0
8,4,0,12,mixedType,1
8,3,0,11,mixedType,1
8,4,0,12,mixedType,1
1,7,0,8,mixedType,1
6,3,0,9,mixedType,1
4,2,0,6,mixedType,0
7,3,0,10,mixedType,1
3,8,0,11,mixedType,1
11,2,0,13,mixedType,1
5,4,0,9,mixedType,1
6,3,0,9,mixedType,1
4,2,0,6,mixedType,0
12,3,0,15,mixedType,2
7,3,0,10,mixedType,1
7,3,0,10,mixedType,1
7,3,0,10,mixedType,1
3,3,0,6,mixedType,0
4,2,0,6,mixedType,0
6,3,0,9,mixedType,1
5,4,0,9,mixedType,1
6,1,0,7,mixedType,0
5,2,0,7,mixedType,0
8,1,0,9,mixedType,1
5,2,0,7,mixedType,0
5,3,0,8,mixedType,1
7,1,0,8,mixedType,1
4,4,0,8,mixedType,1
9,3,0,12,mixedType,1
8,1,0,9,mixedType,1
8,1,0,9,mixedType,1
2,6,0,8,mixedType,1
9,1,0,10,mixedType,1
4,2,0,6,mixedType,0
13,3,0,16,mixedType,2
4,4,0,8,mixedType,1
6,4,0,10,mixedType,1
8,2,0,10,mixedType,1
0,8,2,10,mixedType,1
15,1,0,16,mixedType,2
8,1,0,9,mixedType,1
4,2,0,6,mixedType,0
7,3,0,10,mixedType,1
7,2,0,9,mixedType,1
3,6,0,9,mixedType,1
8,1,0,9,mixedType,1
4,2,0,6,mixedType,0
5,3,0,8,mixedType,1
7,2,0,9,mixedType,1
5,4,0,9,mixedType,1
7,3,0,10,mixedType,1
5,3,0,8,mixedType,1
7,2,0,9,mixedType,1
11,2,0,13,mixedType,1
4,4,0,8,mixedType,1
2,8,0,10,mixedType,1
6,2,1,9,mixedType,1
6,1,0,7,mixedType,0
15,1,0,16,mixedType,2
3,5,0,8,mixedType,1
7,4,0,11,mixedType,1
5,4,0,9,mixedType,1
13,3,0,16,mixedType,2
2,4,0,6,mixedType,0
7,2,0,9,mixedType,1
10,3,0,13,mixedType,1
6,4,0,10,mixedType,1
9,4,0,13,mixedType,1
5,3,0,8,mixedType,1
6,3,0,9,mixedType,1
12,4,0,16,mixedType,2
4,6,0,10,mixedType,1
5,4,0,9,mixedType,1
9,4,0,13,mixedType,1
7,2,0,9,mixedType,1
4,2,0,6,mixedType,0
8,2,0,10,mixedType,1
8,2,0,10,mixedType,1
5,2,0,7,mixedType,0
6,3,0,9,mixedType,1
7,4,0,11,mixedType,1
6,2,0,8,mixedType,1
4,2,0,6,mixedType,0
7,3,0,10,mixedType,1
2,8,0,10,mixedType,1
8,2,0,10,mixedType,1
7,3,0,10,mixedType,1
5,2,0,7,mixedType,0
7,3,0,10,mixedType,1
5,4,0,9,mixedType,1
7,3,0,10,mixedType,1
5,1,0,6,mixedType,0
5,3,0,8,mixedType,1
4,7,0,11,mixedType,1
10,1,0,11,mixedType,1
3,8,0,11,mixedType,1
5,2,0,7,mixedType,0
5,4,0,9,mixedType,1
13,3,0,16,mixedType,2
9,4,0,13,mixedType,1
5,1,0,6,mixedType,0
7,1,0,8,mixedType,1
5,4,0,9,mixedType,1
6,3,0,9,mixedType,1
11,0,1,12,mixedType,1
13,3,0,16,mixedType,2
2,4,0,6,mixedType,0
3,7,0,10,mixedType,1
6,4,0,10,mixedType,1
5,6,0,11,mixedType,1
8,2,0,10,mixedType,1
5,3,0,8,mixedType,1
8,1,0,9,mixedType,1
10,2,0,12,mixedType,1
12,3,0,15,mixedType,2
6,3,0,9,mixedType,1
3,7,0,10,mixedType,1
13,3,0,16,mixedType,2
8,2,0,10,mixedType,1
8,3,0,11,mixedType,1
15,1,0,16,mixedType,2
6,6,0,12,mixedType,1
8,1,0,9,mixedType,1
3,8,0,11,mixedType,1
5,5,0,10,mixedType,1
9,2,0,11,mixedType,1
8,1,0,9,mixedType,1
6,4,0,10,mixedType,1
8,3,0,11,mixedType,1
8,1,0,9,mixedType,1
6,3,0,9,mixedType,1
7,3,0,10,mixedType,1
4,2,0,6,mixedType,0
8,4,0,12,mixedType,1
12,3,0,15,mixedType,2
13,3,0,16,mixedType,2
6,1,0,7,mixedType,0
8,1,0,9,mixedType,1
7,1,0,8,mixedType,1
4,4,0,8,mixedType,1
8,2,0,10,mixedType,1
4,6,0,10,mixedType,1
6,2,0,8,mixedType,1
5,3,0,8,mixedType,1
7,3,0,10,mixedType,1
9,1,0,10,mixedType,1
10,4,0,14,mixedType,2
5,3,0,8,mixedType,1
4,4,0,8,mixedType,1
12,4,0,16,mixedType,2
4,7,5,16,mixedType,2
4,2,0,6,mixedType,0
5,2,0,7,mixedType,0
2,6,0,8,mixedType,1
7,2,0,9,mixedType,1
9,1,0,10,mixedType,1
2,8,0,10,mixedType,1
12,1,0,13,mixedType,1
4,2,0,6,mixedType,0
6,2,0,8,mixedType,1
5,3,0,8,mixedType,1
6,2,0,8,mixedType,1
7,3,0,10,mixedType,1
7,3,0,10,mixedType,1
6,1,0,7,mixedType,0
5,2,0,7,mixedType,0
7,3,0,10,mixedType,1
8,3,0,11,mixedType,1
1,8,0,9,mixedType,1
6,1,0,7,mixedType,0
7,3,0,10,mixedType,1
5,4,0,9,mixedType,1
8,1,0,9,mixedType,1
4,2,0,6,mixedType,0
3,5,0,8,mixedType,1
5,2,0,7,mixedType,0
7,2,0,9,mixedType,1
6,2,0,8,mixedType,1
6,2,0,8,mixedType,1
15,1,0,16,mixedType,2
2,4,0,6,mixedType,0
5,3,0,8,mixedType,1
8,2,0,10,mixedType,1
1,9,0,10,mixedType,1
5,1,0,6,mixedType,0
7,1,0,8,mixedType,1
4,4,0,8,mixedType,1
4,2,0,6,mixedType,0
10,3,0,13,mixedType,1
13,3,0,16,mixedType,2
6,4,0,10,mixedType,1
6,4,0,10,mixedType,1
5,3,0,8,mixedType,1
7,3,0,10,mixedType,1
4,4,0,8,mixedType,1
5,6,0,11,mixedType,1
6,3,0,9,mixedType,1
10,2,0,12,mixedType,1
7,2,0,9,mixedType,1
11,2,0,13,mixedType,1
7,3,0,10,mixedType,1
5,2,0,7,mixedType,0
9,3,0,12,mixedType,1
9,2,0,11,mixedType,1
9,4,1,14,mixedType,2
12,4,0,16,mixedType,2
6,3,0,9,mixedType,1
9,2,0,11,mixedType,1
10,3,0,13,mixedType,1
3,6,0,9,mixedType,1
6,3,0,9,mixedType,1
7,3,0,10,mixedType,1
6,4,0,10,mixedType,1
5,3,0,8,mixedType,1
18,1,1,20,mixedType,2
14,2,0,16,mixedType,2
3,6,0,9,mixedType,1
6,1,0,7,mixedType,0
4,7,0,11,mixedType,1
5,2,0,7,mixedType,0
6,4,0,10,mixedType,1
7,2,0,9,mixedType,1
6,4,0,10,mixedType,1
4,4,0,8,mixedType,1
19,7,0,26,mixedType,2
12,3,0,15,mixedType,2
6,1,0,7,mixedType,0
7,2,0,9,mixedType,1
5,4,0,9,mixedType,1
4,2,0,6,mixedType,0
13,3,3,19,mixedType,2
7,3,0,10,mixedType,1
5,4,0,9,mixedType,1
4,4,0,8,mixedType,1
6,4,0,10,mixedType,1
4,4,0,8,mixedType,1
8,4,0,12,mixedType,1
6,2,0,8,mixedType,1
8,1,0,9,mixedType,1
5,4,0,9,mixedType,1
6,4,0,10,mixedType,1
3,3,0,6,mixedType,0
7,3,0,10,mixedType,1
2,6,0,8,mixedType,1
6,4,0,10,mixedType,1
3,3,0,6,mixedType,0
1,10,0,11,mixedType,1
5,2,0,7,mixedType,0
5,3,0,8,mixedType,1
4,6,0,10,mixedType,1
7,4,0,11,mixedType,1
6,1,0,7,mixedType,0
5,5,0,10,mixedType,1
6,3,0,9,mixedType,1
8,1,0,9,mixedType,1
5,3,0,8,mixedType,1
13,3,0,16,mixedType,2
6,3,0,9,mixedType,1
6,3,0,9,mixedType,1
5,4,0,9,mixedType,1
15,1,0,16,mixedType,2
1,8,0,9,mixedType,1
10,4,0,14,mixedType,2
9,1,0,10,mixedType,1
5,2,0,7,mixedType,0
8,2,0,10,mixedType,1
8,2,0,10,mixedType,1
5,3,0,8,mixedType,1
7,3,0,10,mixedType,1
10,3,0,13,mixedType,1
7,1,0,8,mixedType,1
4,4,0,8,mixedType,1
1,8,0,9,mixedType,1
6,2,0,8,mixedType,1
3,3,0,6,mixedType,0
8,1,0,9,mixedType,1
4,8,0,12,mixedType,1
4,4,0,8,mixedType,1
7,3,0,10,mixedType,1
8,2,0,10,mixedType,1
6,3,0,9,mixedType,1
0,9,1,10,mixedType,1
7,2,0,9,mixedType,1
3,6,0,9,mixedType,1
8,2,0,10,mixedType,1
6,2,0,8,mixedType,1
5,4,0,9,mixedType,1
8,1,0,9,mixedType,1
2,7,0,9,mixedType,1
6,1,0,7,mixedType,0
13,3,0,16,mixedType,2
8,3,0,11,mixedType,1
9,1,0,10,mixedType,1
9,1,0,10,mixedType,1
10,1,0,11,mixedType,1
8,1,0,9,mixedType,1
7,4,0,11,mixedType,1
8,1,0,9,mixedType,1
4,2,0,6,mixedType,0
8,3,0,11,mixedType,1
6,2,0,8,mixedType,1
4,4,0,8,mixedType,1
7,3,0,10,mixedType,1
6,4,0,10,mixedType,1
6,3,0,9,mixedType,1
7,3,0,10,mixedType,1
7,1,0,8,mixedType,1
8,2,0,10,mixedType,1
1,12,0,13,mixedType,1
7,4,0,11,mixedType,1
1,12,0,13,mixedType,1
6,2,0,8,mixedType,1
6,2,0,8,mixedType,1
5,2,0,7,mixedType,0
6,6,0,12,mixedType,1
5,3,0,8,mixedType,1
7,1,0,8,mixedType,1
6,4,0,10,mixedType,1
6,1,0,7,mixedType,0
10,3,0,13,mixedType,1
8,2,0,10,mixedType,1
15,1,0,16,mixedType,2
5,4,0,9,mixedType,1
7,2,0,9,mixedType,1
5,3,0,8,mixedType,1
3,7,0,10,mixedType,1
8,3,0,11,mixedType,1
4,2,0,6,mixedType,0
6,3,0,9,mixedType,1
2,10,0,12,mixedType,1
7,2,0,9,mixedType,1
8,3,0,11,mixedType,1
8,2,0,10,mixedType,1
15,1,0,16,mixedType,2
3,6,0,9,mixedType,1
8,1,0,9,mixedType,1
4,6,0,10,mixedType,1
7,3,0,10,mixedType,1
8,2,0,10,mixedType,1
10,1,0,11,mixedType,1
8,3,0,11,mixedType,1
13,3,0,16,mixedType,2
4,4,0,8,mixedType,1
11,2,0,13,mixedType,1
7,3,0,10,mixedType,1
6,1,0,7,mixedType,0
7,3,0,10,mixedType,1
7,3,0,10,mixedType,1
6,1,0,7,mixedType,0
7,4,0,11,mixedType,1
2,8,0,10,mixedType,1
4,6,0,10,mixedType,1
4,5,0,9,mixedType,1
6,4,0,10,mixedType,1
11,2,0,13,mixedType,1
11,3,0,14,mixedType,2
9,4,0,13,mixedType,1
5,1,0,6,mixedType,0
8,3,0,11,mixedType,1
4,2,0,6,mixedType,0
7,3,0,10,mixedType,1
7,3,0,10,mixedType,1
10,4,0,14,mixedType,2
6,1,0,7,mixedType,0
5,4,0,9,mixedType,1
7,2,0,9,mixedType,1
4,4,0,8,mixedType,1
9,2,0,11,mixedType,1
5,3,0,8,mixedType,1
5,4,0,9,mixedType,1
10,3,0,13,mixedType,1
6,3,0,9,mixedType,1
7,3,0,10,mixedType,1
5,2,0,7,mixedType,0
6,1,0,7,mixedType,0
6,3,0,9,mixedType,1
6,4,0,10,mixedType,1
5,3,0,8,mixedType,1
8,1,0,9,mixedType,1
6,3,0,9,mixedType,1
3,8,0,11,mixedType,1
1,8,0,9,mixedType,1
10,3,0,13,mixedType,1
8,2,0,10,mixedType,1
5,4,0,9,mixedType,1
14,2,0,16,mixedType,2
6,3,0,9,mixedType,1
4,4,0,8,mixedType,1
6,1,0,7,mixedType,0
9,1,0,10,mixedType,1
9,1,0,10,mixedType,1
8,3,0,11,mixedType,1
5,4,0,9,mixedType,1
5,5,0,10,mixedType,1
5,2,0,7,mixedType,0
4,6,0,10,mixedType,1
8,2,0,10,mixedType,1
6,1,0,7,mixedType,0
2,6,0,8,mixedType,1
14,2,0,16,mixedType,2
6,2,0,8,mixedType,1
1,7,0,8,mixedType,1
9,1,0,10,mixedType,1
6,3,0,9,mixedType,1
5,2,0,7,mixedType,0
6,3,0,9,mixedType,1
4,2,0,6,mixedType,0
8,1,0,9,mixedType,1
4,2,0,6,mixedType,0
6,4,0,10,mixedType,1
6,1,0,7,mixedType,0
7,2,0,9,mixedType,1
6,3,0,9,mixedType,1
9,2,0,11,mixedType,1
6,2,0,8,mixedType,1
5,1,0,6,mixedType,0
7,3,0,10,mixedType,1
7,3,0,10,mixedType,1
8,2,0,10,mixedType,1
5,3,0,8,mixedType,1
8,1,0,9,mixedType,1
5,4,0,9,mixedType,1
9,2,0,11,mixedType,1
9,3,0,12,mixedType,1
11,3,0,14,mixedType,2
3,9,0,12,mixedType,1
7,3,0,10,mixedType,1
8,4,2,14,mixedType,2
4,4,0,8,mixedType,1
5,4,0,9,mixedType,1
3,9,0,12,mixedType,1
5,9,0,14,mixedType,2
8,2,0,10,mixedType,1
8,1,0,9,mixedType,1
6,4,0,10,mixedType,1
7,1,0,8,mixedType,1
11,3,1,15,mixedType,2
3,8,0,11,mixedType,1
5,2,0,7,mixedType,0
4,6,0,10,mixedType,1
6,4,0,10,mixedType,1
6,8,0,14,mixedType,2
7,2,0,9,mixedType,1
13,3,0,16,mixedType,2
6,3,0,9,mixedType,1
10,3,0,13,mixedType,1
6,2,0,8,mixedType,1
6,4,0,10,mixedType,1
7,3,0,10,mixedType,1
8,4,0,12,mixedType,1
12,3,0,15,mixedType,2
8,1,0,9,mixedType,1
7,2,0,9,mixedType,1
6,3,0,9,mixedType,1
6,3,0,9,mixedType,1
5,1,0,6,mixedType,0
9,1,0,10,mixedType,1
4,2,0,6,mixedType,0
15,1,0,16,mixedType,2
6,3,0,9,mixedType,1
1,8,0,9,mixedType,1
11,2,0,13,mixedType,1
1,8,0,9,mixedType,1
8,1,0,9,mixedType,1
5,4,0,9,mixedType,1
9,3,0,12,mixedType,1
5,4,0,9,mixedType,1
7,2,0,9,mixedType,1
7,1,0,8,mixedType,1
11,1,0,12,mixedType,1
4,4,0,8,mixedType,1
14,2,0,16,mixedType,2
11,3,0,14,mixedType,2
5,2,0,7,mixedType,0
0,12,1,13,mixedType,1
8,3,0,11,mixedType,1
9,1,0,10,mixedType,1
7,3,0,10,mixedType,1
6,3,0,9,mixedType,1
6,3,0,9,mixedType,1
5,3,0,8,mixedType,1
6,1,0,7,mixedType,0
5,3,0,8,mixedType,1
6,3,0,9,mixedType,1
8,2,0,10,mixedType,1
7,1,0,8,mixedType,1
8,2,0,10,mixedType,1
11,5,0,16,mixedType,2
8,1,0,9,mixedType,1
6,4,0,10,mixedType,1
2,7,0,9,mixedType,1
6,3,0,9,mixedType,1
9,3,0,12,mixedType,1
6,4,0,10,mixedType,1
3,6,0,9,mixedType,1
6,3,0,9,mixedType,1
14,2,0,16,mixedType,2
7,3,0,10,mixedType,1
6,3,0,9,mixedType,1
8,2,0,10,mixedType,1
2,8,0,10,mixedType,1
2,4,0,6,mixedType,0
5,7,0,12,mixedType,1
5,2,0,7,mixedType,0
5,3,0,8,mixedType,1
5,4,0,9,mixedType,1
8,3,0,11,mixedType,1
0,7,1,8,mixedType,1
6,2,0,8,mixedType,1
4,4,0,8,mixedType,1
9,2,0,11,mixedType,1
8,2,0,10,mixedType,1
8,2,0,10,mixedType,1
7,2,0,9,mixedType,1
1,8,0,9,mixedType,1
6,3,0,9,mixedType,1
3,5,0,8,mixedType,1
6,3,0,9,mixedType,1
8,2,0,10,mixedType,1
6,1,0,7,mixedType,0
10,2,0,12,mixedType,1
4,4,0,8,mixedType,1
6,3,0,9,mixedType,1
6,6,0,12,mixedType,1
7,2,0,9,mixedType,1
6,3,0,9,mixedType,1
6,4,0,10,mixedType,1
10,1,0,11,mixedType,1
11,3,0,14,mixedType,2
6,3,0,9,mixedType,1
7,2,0,9,mixedType,1
2,9,0,11,mixedType,1
7,2,0,9,mixedType,1
6,3,0,9,mixedType,1
8,1,0,9,mixedType,1
13,3,0,16,mixedType,2
5,3,0,8,mixedType,1
2,6,0,8,mixedType,1
7,3,0,10,mixedType,1
5,1,0,6,mixedType,0
6,3,0,9,mixedType,1
14,2,0,16,mixedType,2
6,1,0,7,mixedType,0
7,1,0,8,mixedType,1
8,3,0,11,mixedType,1
9,1,0,10,mixedType,1
8,4,0,12,mixedType,1
2,7,0,9,mixedType,1
6,2,0,8,mixedType,1
15,1,0,16,mixedType,2
6,2,0,8,mixedType,1
6,3,0,9,mixedType,1
7,2,0,9,mixedType,1
6,3,0,9,mixedType,1
7,2,0,9,mixedType,1
5,6,0,11,mixedType,1
8,2,0,10,mixedType,1
6,1,0,7,mixedType,0
6,3,0,9,mixedType,1
10,3,0,13,mixedType,1
14,2,0,16,mixedType,2
4,2,0,6,mixedType,0
5,2,0,7,mixedType,0
8,2,0,10,mixedType,1
2,6,0,8,mixedType,1
6,2,0,8,mixedType,1
7,2,0,9,mixedType,1
8,4,0,12,mixedType,1
3,7,0,10,mixedType,1
6,3,0,9,mixedType,1
6,3,0,9,mixedType,1
4,2,0,6,mixedType,0
7,3,0,10,mixedType,1
5,3,0,8,mixedType,1
5,2,0,7,mixedType,0
14,2,0,16,mixedType,2
5,2,0,7,mixedType,0
7,5,0,12,mixedType,1
10,2,0,12,mixedType,1
4,2,0,6,mixedType,0
10,2,0,12,mixedType,1
15,2,0,17,mixedType,2
6,3,0,9,mixedType,1
7,3,0,10,mixedType,1
9,3,0,12,mixedType,1
6,4,0,10,mixedType,1
4,6,0,10,mixedType,1
13,3,0,16,mixedType,2
5,5,0,10,mixedType,1
8,2,0,10,mixedType,1
7,3,0,10,mixedType,1
6,3,0,9,mixedType,1
6,3,0,9,mixedType,1
3,3,0,6,mixedType,0
6,1,0,7,mixedType,0
1,5,0,6,mixedType,0
4,4,0,8,mixedType,1
3,6,0,9,mixedType,1
5,3,0,8,mixedType,1
7,1,0,8,mixedType,1
9,3,0,12,mixedType,1
7,1,0,8,mixedType,1
7,2,0,9,mixedType,1
9,1,0,10,mixedType,1
6,3,0,9,mixedType,1
10,4,6,20,mixedType,2
7,3,0,10,mixedType,1
5,3,0,8,mixedType,1
12,4,0,16,mixedType,2
2,4,0,6,mixedType,0
15,1,0,16,mixedType,2
13,3,0,16,mixedType,2
1,7,0,8,mixedType,1
4,2,0,6,mixedType,0
5,2,0,7,mixedType,0
8,1,0,9,mixedType,1
7,2,0,9,mixedType,1
8,3,0,11,mixedType,1
7,1,0,8,mixedType,1
7,3,0,10,mixedType,1
4,4,0,8,mixedType,1
9,1,0,10,mixedType,1
15,1,0,16,mixedType,2
7,3,0,10,mixedType,1
9,1,0,10,mixedType,1
8,2,0,10,mixedType,1
7,3,0,10,mixedType,1
8,1,0,9,mixedType,1
5,4,0,9,mixedType,1
7,3,0,10,mixedType,1
8,1,0,9,mixedType,1
6,2,0,8,mixedType,1
12,4,0,16,mixedType,2
2,8,0,10,mixedType,1
6,1,0,7,mixedType,0
7,1,0,8,mixedType,1
7,4,0,11,mixedType,1
5,2,0,7,mixedType,0
6,3,0,9,mixedType,1
8,1,0,9,mixedType,1
15,1,0,16,mixedType,2
4,2,0,6,mixedType,0
2,8,0,10,mixedType,1
6,3,0,9,mixedType,1
5,3,0,8,mixedType,1
6,3,0,9,mixedType,1
7,3,0,10,mixedType,1
8,2,0,10,mixedType,1
10,2,0,12,mixedType,1
10,1,0,11,mixedType,1
5,1,0,6,mixedType,0
9,9,1,19,mixedType,2
9,3,0,12,mixedType,1
7,3,0,10,mixedType,1
7,4,0,11,mixedType,1
11,2,0,13,mixedType,1
11,1,0,12,mixedType,1
4,2,0,6,mixedType,0
5,3,0,8,mixedType,1
15,1,0,16,mixedType,2
15,1,0,16,mixedType,2
7,2,0,9,mixedType,1
13,3,0,16,mixedType,2
6,4,0,10,mixedType,1
7,2,0,9,mixedType,1
14,2,0,16,mixedType,2
7,2,0,9,mixedType,1
8,1,0,9,mixedType,1
6,4,0,10,mixedType,1
12,4,0,16,mixedType,2
13,8,0,21,mixedType,2
12,4,0,16,mixedType,2
5,6,0,11,mixedType,1
19,1,0,20,mixedType,2
1,8,0,9,mixedType,1
5,3,0,8,mixedType,1
8,1,0,9,mixedType,1
8,2,0,10,mixedType,1
8,2,0,10,mixedType,1
9,2,0,11,mixedType,1
9,1,0,10,mixedType,1
15,1,0,16,mixedType,2
8,2,0,10,mixedType,1
5,2,0,7,mixedType,0
8,4,0,12,mixedType,1
9,2,0,11,mixedType,1
11,3,0,14,mixedType,2
9,2,0,11,mixedType,1
7,2,0,9,mixedType,1
11,3,0,14,mixedType,2
6,2,0,8,mixedType,1
4,2,0,6,mixedType,0
5,3,0,8,mixedType,1
2,8,0,10,mixedType,1
14,2,0,16,mixedType,2
5,3,0,8,mixedType,1
4,2,0,6,mixedType,0
6,1,0,7,mixedType,0
10,1,0,11,mixedType,1
4,4,0,8,mixedType,1
6,3,0,9,mixedType,1
5,3,0,8,mixedType,1
8,2,0,10,mixedType,1
8,2,0,10,mixedType,1
13,3,0,16,mixedType,2
8,2,1,11,mixedType,1
4,4,0,8,mixedType,1
7,3,0,10,mixedType,1
8,2,0,10,mixedType,1
13,3,0,16,mixedType,2
6,4,0,10,mixedType,1
11,5,0,16,mixedType,2
5,3,0,8,mixedType,1
7,3,0,10,mixedType,1
18,3,2,23,mixedType,2
4,2,0,6,mixedType,0
8,1,0,9,mixedType,1
7,1,0,8,mixedType,1
6,4,0,10,mixedType,1
7,4,0,11,mixedType,1
14,2,0,16,mixedType,2
5,3,0,8,mixedType,1
7,1,0,8,mixedType,1
5,10,0,15,mixedType,2
8,2,0,10,mixedType,1
8,1,0,9,mixedType,1
7,1,0,8,mixedType,1
5,2,0,7,mixedType,0
6,1,0,7,mixedType,0
5,2,0,7,mixedType,0
8,3,0,11,mixedType,1
7,2,0,9,mixedType,1
10,2,0,12,mixedType,1
5,1,0,6,mixedType,0
5,4,0,9,mixedType,1
6,3,0,9,mixedType,1
2,4,0,6,mixedType,0
1,8,0,9,mixedType,1
2,6,0,8,mixedType,1
7,3,0,10,mixedType,1
4,2,0,6,mixedType,0
7,3,0,10,mixedType,1
5,3,0,8,mixedType,1
8,2,0,10,mixedType,1
6,1,0,7,mixedType,0
4,4,0,8,mixedType,1
2,4,0,6,mixedType,0
11,2,0,13,mixedType,1
6,1,0,7,mixedType,0
5,5,0,10,mixedType,1
10,1,0,11,mixedType,1
12,4,0,16,mixedType,2
8,2,0,10,mixedType,1
8,2,0,10,mixedType,1
8,2,0,10,mixedType,1
4,4,0,8,mixedType,1
5,4,0,9,mixedType,1
5,2,0,7,mixedType,0
6,2,0,8,mixedType,1
5,4,0,9,mixedType,1
6,6,0,12,mixedType,1
5,3,0,8,mixedType,1
3,7,0,10,mixedType,1
12,3,0,15,mixedType,2
6,3,0,9,mixedType,1
1,8,0,9,mixedType,1
3,7,0,10,mixedType,1
9,1,0,10,mixedType,1
7,2,0,9,mixedType,1
7,3,0,10,mixedType,1
6,5,0,11,mixedType,1
12,3,0,15,mixedType,2
8,1,0,9,mixedType,1
6,4,0,10,mixedType,1
2,7,0,9,mixedType,1
5,1,0,6,mixedType,0
4,4,0,8,mixedType,1
7,3,0,10,mixedType,1
6,1,0,7,mixedType,0
5,2,0,7,mixedType,0
7,4,0,11,mixedType,1
4,4,0,8,mixedType,1
12,4,0,16,mixedType,2
1,6,0,7,mixedType,0
3,9,0,12,mixedType,1
2,6,0,8,mixedType,1
5,4,0,9,mixedType,1
7,2,0,9,mixedType,1
15,1,0,16,mixedType,2
4,6,0,10,mixedType,1
10,2,0,12,mixedType,1
9,3,0,12,mixedType,1
8,1,0,9,mixedType,1
7,2,0,9,mixedType,1
3,3,0,6,mixedType,0
5,2,0,7,mixedType,0
10,0,1,11,mixedType,1
7,2,0,9,mixedType,1
14,2,0,16,mixedType,2
7,2,0,9,mixedType,1
3,6,0,9,mixedType,1
5,3,0,8,mixedType,1
7,1,0,8,mixedType,1
5,3,0,8,mixedType,1
11,4,0,15,mixedType,2
13,3,0,16,mixedType,2
15,1,1,17,mixedType,2
14,1,1,16,mixedType,2
1,11,0,12,mixedType,1
7,2,0,9,mixedType,1
6,4,0,10,mixedType,1
6,3,0,9,mixedType,1
6,4,0,10,mixedType,1
6,6,0,12,mixedType,1
6,4,0,10,mixedType,1
7,2,0,9,mixedType,1
5,4,0,9,mixedType,1
5,3,0,8,mixedType,1
6,4,0,10,mixedType,1
8,1,0,9,mixedType,1
3,6,0,9,mixedType,1
4,4,0,8,mixedType,1
5,5,0,10,mixedType,1
8,2,0,10,mixedType,1
8,3,0,11,mixedType,1
14,2,0,16,mixedType,2
2,7,0,9,mixedType,1
13,3,0,16,mixedType,2
4,8,0,12,mixedType,1
3,3,0,6,mixedType,0
5,8,0,13,mixedType,1
6,3,0,9,mixedType,1
6,2,0,8,mixedType,1
8,1,0,9,mixedType,1
14,2,0,16,mixedType,2
2,7,0,9,mixedType,1
9,4,0,13,mixedType,1
6,1,0,7,mixedType,0
7,5,0,12,mixedType,1
1,8,0,9,mixedType,1
7,3,0,10,mixedType,1
7,3,0,10,mixedType,1
4,2,0,6,mixedType,0
6,1,0,7,mixedType,0
7,4,0,11,mixedType,1
4,2,0,6,mixedType,0
9,2,0,11,mixedType,1
11,5,0,16,mixedType,2
12,3,0,15,mixedType,2
9,1,0,10,mixedType,1
5,4,0,9,mixedType,1
5,4,0,9,mixedType,1
14,2,0,16,mixedType,2
6,6,0,12,mixedType,1
5,4,0,9,mixedType,1
11,2,0,13,mixedType,1
6,1,0,7,mixedType,0
6,1,0,7,mixedType,0
3,10,0,13,mixedType,1
2,8,0,10,mixedType,1
6,2,0,8,mixedType,1
7,3,0,10,mixedType,1
5,6,0,11,mixedType,1
2,6,0,8,mixedType,1
5,2,0,7,mixedType,0
6,3,0,9,mixedType,1
6,3,0,9,mixedType,1
10,6,0,16,mixedType,2
5,2,0,7,mixedType,0
10,2,0,12,mixedType,1
14,2,0,16,mixedType,2
6,3,0,9,mixedType,1
6,4,0,10,mixedType,1
6,2,0,8,mixedType,1
8,2,0,10,mixedType,1
8,1,0,9,mixedType,1
6,2,0,8,mixedType,1
9,3,0,12,mixedType,1
8,1,0,9,mixedType,1
1,8,0,9,mixedType,1
7,4,0,11,mixedType,1
12,4,0,16,mixedType,2
10,3,0,13,mixedType,1
8,1,0,9,mixedType,1
7,5,0,12,mixedType,1
6,3,0,9,mixedType,1
5,4,0,9,mixedType,1
5,2,0,7,mixedType,0
3,6,0,9,mixedType,1
6,3,0,9,mixedType,1
14,2,0,16,mixedType,2
13,3,0,16,mixedType,2
7,1,0,8,mixedType,1
9,3,0,12,mixedType,1
6,2,0,8,mixedType,1
14,2,0,16,mixedType,2
2,6,0,8,mixedType,1
5,3,0,8,mixedType,1
6,3,0,9,mixedType,1
7,1,0,8,mixedType,1
4,2,0,6,mixedType,0
10,1,0,11,mixedType,1
6,4,0,10,mixedType,1
6,2,0,8,mixedType,1
6,3,0,9,mixedType,1
6,3,0,9,mixedType,1
6,3,0,9,mixedType,1
7,2,0,9,mixedType,1
7,2,0,9,mixedType,1
6,2,0,8,mixedType,1
8,4,0,12,mixedType,1
7,3,0,10,mixedType,1
12,3,0,15,mixedType,2
5,7,0,12,mixedType,1
4,2,0,6,mixedType,0
5,4,0,9,mixedType,1
5,2,0,7,mixedType,0
6,8,0,14,mixedType,2
6,3,0,9,mixedType,1
1,7,0,8,mixedType,1
6,4,0,10,mixedType,1
6,2,0,8,mixedType,1
8,2,0,10,mixedType,1
5,4,0,9,mixedType,1
5,4,0,9,mixedType,1
4,6,0,10,mixedType,1
7,1,0,8,mixedType,1
6,3,0,9,mixedType,1
5,2,0,7,mixedType,0
6,5,0,11,mixedType,1
9,1,0,10,mixedType,1
1,12,0,13,mixedType,1
6,6,0,12,mixedType,1
6,2,0,8,mixedType,1
7,2,0,9,mixedType,1
6,4,0,10,mixedType,1
12,4,0,16,mixedType,2
9,3,0,12,mixedType,1
7,3,0,10,mixedType,1
6,3,0,9,mixedType,1
4,8,0,12,mixedType,1
2,4,0,6,mixedType,0
3,8,0,11,mixedType,1
5,3,0,8,mixedType,1
2,6,0,8,mixedType,1
3,3,0,6,mixedType,0
6,5,0,11,mixedType,1
6,3,0,9,mixedType,1
3,6,0,9,mixedType,1
5,3,0,8,mixedType,1
6,2,0,8,mixedType,1
7,3,0,10,mixedType,1
6,3,0,9,mixedType,1
14,1,0,15,mixedType,2
8,1,0,9,mixedType,1
2,10,0,12,mixedType,1
2,8,0,10,mixedType,1
14,2,0,16,mixedType,2
9,2,0,11,mixedType,1
1,8,0,9,mixedType,1
7,2,0,9,mixedType,1
6,3,0,9,mixedType,1
6,2,0,8,mixedType,1
4,4,0,8,mixedType,1
8,2,0,10,mixedType,1
4,2,0,6,mixedType,0
9,1,0,10,mixedType,1
14,2,0,16,mixedType,2
7,2,0,9,mixedType,1
9,1,0,10,mixedType,1
8,1,0,9,mixedType,1
8,2,0,10,mixedType,1
6,1,0,7,mixedType,0
4,6,0,10,mixedType,1
5,3,0,8,mixedType,1
14,2,0,16,mixedType,2
6,4,0,10,mixedType,1
8,2,0,10,mixedType,1
13,3,0,16,mixedType,2
7,2,0,9,mixedType,1
8,1,0,9,mixedType,1
5,2,0,7,mixedType,0
7,3,0,10,mixedType,1
1,7,0,8,mixedType,1
5,4,0,9,mixedType,1
6,2,0,8,mixedType,1
10,1,0,11,mixedType,1
6,3,0,9,mixedType,1
9,2,0,11,mixedType,1
6,4,0,10,mixedType,1
10,4,0,14,mixedType,2
11,3,0,14,mixedType,2
7,3,0,10,mixedType,1
4,4,0,8,mixedType,1
8,3,0,11,mixedType,1
6,7,0,13,mixedType,1
7,1,0,8,mixedType,1
5,1,0,6,mixedType,0
2,9,0,11,mixedType,1
8,2,0,10,mixedType,1
5,4,0,9,mixedType,1
6,2,0,8,mixedType,1
5,1,0,6,mixedType,0
7,1,0,8,mixedType,1
8,2,0,10,mixedType,1
4,8,0,12,mixedType,1
8,1,0,9,mixedType,1
8,2,0,10,mixedType,1
6,3,0,9,mixedType,1
11,5,0,16,mixedType,2
7,3,0,10,mixedType,1
6,6,0,12,mixedType,1
5,4,0,9,mixedType,1
15,1,0,16,mixedType,2
5,1,0,6,mixedType,0
10,2,0,12,mixedType,1
6,1,0,7,mixedType,0
7,3,0,10,mixedType,1
1,7,0,8,mixedType,1
7,1,0,8,mixedType,1
11,5,0,16,mixedType,2
7,1,0,8,mixedType,1
6,3,0,9,mixedType,1
15,0,2,17,mixedType,2
5,2,0,7,mixedType,0
3,9,0,12,mixedType,1
7,3,0,10,mixedType,1
7,4,0,11,mixedType,1
4,4,0,8,mixedType,1
5,2,0,7,mixedType,0
8,1,0,9,mixedType,1
13,3,0,16,mixedType,2
5,3,0,8,mixedType,1
2,8,0,10,mixedType,1
8,2,0,10,mixedType,1
9,1,0,10,mixedType,1
6,4,0,10,mixedType,1
4,2,0,6,mixedType,0
5,4,0,9,mixedType,1
9,1,0,10,mixedType,1
6,4,0,10,mixedType,1
4,6,0,10,mixedType,1
15,1,0,16,mixedType,2
9,1,0,10,mixedType,1
7,1,0,8,mixedType,1
15,1,0,16,mixedType,2
2,6,0,8,mixedType,1
9,3,2,14,mixedType,2
7,3,0,10,mixedType,1
8,4,0,12,mixedType,1
4,6,0,10,mixedType,1
4,2,0,6,mixedType,0
5,4,0,9,mixedType,1
4,10,4,18,mixedType,2
5,3,0,8,mixedType,1
6,3,0,9,mixedType,1
8,3,0,11,mixedType,1
3,5,0,8,mixedType,1
6,3,0,9,mixedType,1
15,1,0,16,mixedType,2
3,6,0,9,mixedType,1
8,3,0,11,mixedType,1
1,7,0,8,mixedType,1
8,3,0,11,mixedType,1
9,4,1,14,mixedType,2
5,3,0,8,mixedType,1
7,3,0,10,mixedType,1
9,2,0,11,mixedType,1
5,0,0,5,sameType,0
5,1,0,6,mixedType,0
9,3,0,12,mixedType,1
6,2,0,8,mixedType,1
3,5,0,8,mixedType,1
13,3,0,16,mixedType,2
4,2,0,6,mixedType,0
6,4,0,10,mixedType,1
4,4,0,8,mixedType,1
6,3,0,9,mixedType,1
8,2,0,10,mixedType,1
5,2,0,7,mixedType,0
2,7,0,9,mixedType,1
14,2,0,16,mixedType,2
4,2,0,6,mixedType,0
1,8,0,9,mixedType,1
8,2,0,10,mixedType,1
3,6,0,9,mixedType,1
3,6,0,9,mixedType,1
3,6,0,9,mixedType,1
6,3,0,9,mixedType,1
6,4,0,10,mixedType,1
5,5,0,10,mixedType,1
6,2,0,8,mixedType,1
8,1,0,9,mixedType,1
7,3,0,10,mixedType,1
11,5,0,16,mixedType,2
3,6,0,9,mixedType,1
6,6,0,12,mixedType,1
1,11,0,12,mixedType,1
8,3,0,11,mixedType,1
0,6,2,8,mixedType,1
7,3,0,10,mixedType,1
4,4,0,8,mixedType,1
6,3,0,9,mixedType,1
9,1,0,10,mixedType,1
8,6,0,14,mixedType,2
6,2,0,8,mixedType,1
6,6,0,12,mixedType,1
4,4,0,8,mixedType,1
5,3,0,8,mixedType,1
8,2,0,10,mixedType,1
5,4,0,9,mixedType,1
7,3,0,10,mixedType,1
6,4,0,10,mixedType,1
11,3,0,14,mixedType,2
7,3,0,10,mixedType,1
11,5,0,16,mixedType,2
8,2,0,10,mixedType,1
5,2,0,7,mixedType,0
5,1,0,6,mixedType,0
7,3,0,10,mixedType,1
9,1,0,10,mixedType,1
6,3,0,9,mixedType,1
9,3,0,12,mixedType,1
7,3,0,10,mixedType,1
5,1,0,6,mixedType,0
8,2,0,10,mixedType,1
14,2,0,16,mixedType,2
7,2,0,9,mixedType,1
5,2,0,7,mixedType,0
6,1,0,7,mixedType,0
6,2,0,8,mixedType,1
4,2,0,6,mixedType,0
6,1,0,7,mixedType,0
4,9,0,13,mixedType,1
10,2,0,12,mixedType,1
4,9,0,13,mixedType,1
7,3,0,10,mixedType,1
8,1,0,9,mixedType,1
15,1,0,16,mixedType,2
3,3,0,6,mixedType,0
5,2,0,7,mixedType,0
7,2,0,9,mixedType,1
5,2,0,7,mixedType,0
5,6,0,11,mixedType,1
7,2,0,9,mixedType,1
7,3,0,10,mixedType,1
7,2,0,9,mixedType,1
7,2,0,9,mixedType,1
8,1,0,9,mixedType,1
4,5,0,9,mixedType,1
5,3,0,8,mixedType,1
13,3,0,16,mixedType,2
6,4,0,10,mixedType,1
7,4,0,11,mixedType,1
8,1,0,9,mixedType,1
14,2,0,16,mixedType,2
4,7,0,11,mixedType,1
2,7,0,9,mixedType,1
3,3,0,6,mixedType,0
5,3,0,8,mixedType,1
9,2,0,11,mixedType,1
5,6,0,11,mixedType,1
6,5,0,11,mixedType,1
7,3,0,10,mixedType,1
8,1,0,9,mixedType,1
8,3,0,11,mixedType,1
6,4,0,10,mixedType,1
7,3,0,10,mixedType,1
6,2,0,8,mixedType,1
6,4,0,10,mixedType,1
8,2,0,10,mixedType,1
3,6,0,9,mixedType,1
12,4,0,16,mixedType,2
5,0,1,6,mixedType,0
9,3,0,12,mixedType,1
6,3,0,9,mixedType,1
3,8,0,11,mixedType,1
1,11,0,12,mixedType,1
12,3,0,15,mixedType,2
11,1,0,12,mixedType,1
4,2,0,6,mixedType,0
2,6,0,8,mixedType,1
8,1,0,9,mixedType,1
9,5,1,15,mixedType,2
8,2,0,10,mixedType,1
8,2,0,10,mixedType,1
7,1,0,8,mixedType,1
7,1,0,8,mixedType,1
5,3,0,8,mixedType,1
14,2,0,16,mixedType,2
4,4,0,8,mixedType,1
1,7,0,8,mixedType,1
6,3,0,9,mixedType,1
5,6,0,11,mixedType,1
5,2,0,7,mixedType,0
6,1,0,7,mixedType,0
4,2,0,6,mixedType,0
5,2,0,7,mixedType,0
7,4,0,11,mixedType,1
9,3,0,12,mixedType,1
5,1,0,6,mixedType,0
3,3,0,6,mixedType,0
7,1,0,8,mixedType,1
10,1,0,11,mixedType,1
6,4,0,10,mixedType,1
2,4,0,6,mixedType,0
15,1,0,16,mixedType,2
6,1,0,7,mixedType,0
4,8,0,12,mixedType,1
4,6,0,10,mixedType,1
5,3,0,8,mixedType,1
7,2,0,9,mixedType,1
6,3,0,9,mixedType,1
15,1,0,16,mixedType,2
8,2,0,10,mixedType,1
5,3,0,8,mixedType,1
6,1,0,7,mixedType,0
9,1,0,10,mixedType,1
7,1,0,8,mixedType,1
14,2,0,16,mixedType,2
12,1,0,13,mixedType,1
7,2,0,9,mixedType,1
2,8,0,10,mixedType,1
14,2,0,16,mixedType,2
7,1,0,8,mixedType,1
5,2,0,7,mixedType,0
1,8,0,9,mixedType,1
3,6,0,9,mixedType,1
1,8,0,9,mixedType,1
7,3,0,10,mixedType,1
9,3,0,12,mixedType,1
6,6,0,12,mixedType,1
5,4,0,9,mixedType,1
7,1,0,8,mixedType,1
9,2,0,11,mixedType,1
4,4,0,8,mixedType,1
6,3,0,9,mixedType,1
8,3,0,11,mixedType,1
4,4,0,8,mixedType,1
7,2,0,9,mixedType,1
5,3,0,8,mixedType,1
7,2,0,9,mixedType,1
1,9,0,10,mixedType,1
6,2,0,8,mixedType,1
9,1,0,10,mixedType,1
5,2,0,7,mixedType,0
13,3,0,16,mixedType,2
10,1,0,11,mixedType,1
7,1,0,8,mixedType,1
8,2,0,10,mixedType,1
10,2,0,12,mixedType,1
6,2,0,8,mixedType,1
8,1,0,9,mixedType,1
14,2,0,16,mixedType,2
5,4,0,9,mixedType,1
4,4,0,8,mixedType,1
6,2,0,8,mixedType,1
7,3,0,10,mixedType,1
6,1,0,7,mixedType,0
10,2,0,12,mixedType,1
7,2,0,9,mixedType,1
12,3,0,15,mixedType,2
7,1,0,8,mixedType,1
9,1,0,10,mixedType,1
7,3,0,10,mixedType,1
8,3,0,11,mixedType,1
6,3,0,9,mixedType,1
5,4,0,9,mixedType,1
7,4,0,11,mixedType,1
6,3,0,9,mixedType,1
6,3,0,9,mixedType,1
8,3,0,11,mixedType,1
7,3,0,10,mixedType,1
7,4,0,11,mixedType,1
5,3,0,8,mixedType,1
7,4,0,11,mixedType,1
5,3,0,8,mixedType,1
13,3,0,16,mixedType,2
7,2,0,9,mixedType,1
7,5,0,12,mixedType,1
5,4,0,9,mixedType,1
6,2,0,8,mixedType,1
14,2,0,16,mixedType,2
6,3,0,9,mixedType,1
2,8,0,10,mixedType,1
9,1,0,10,mixedType,1
15,1,0,16,mixedType,2
7,2,0,9,mixedType,1
6,4,0,10,mixedType,1
8,3,0,11,mixedType,1
6,1,0,7,mixedType,0
6,4,0,10,mixedType,1
15,1,0,16,mixedType,2
2,9,0,11,mixedType,1
5,4,0,9,mixedType,1
6,1,0,7,mixedType,0
3,5,0,8,mixedType,1
6,3,0,9,mixedType,1
6,1,0,7,mixedType,0
7,3,0,10,mixedType,1
9,3,0,12,mixedType,1
11,5,0,16,mixedType,2
7,3,0,10,mixedType,1
3,8,0,11,mixedType,1
7,3,0,10,mixedType,1
6,2,0,8,mixedType,1
3,10,0,13,mixedType,1
7,3,0,10,mixedType,1
7,2,0,9,mixedType,1
9,0,3,12,mixedType,1
6,3,0,9,mixedType,1
5,8,0,13,mixedType,1
6,4,0,10,mixedType,1
7,3,0,10,mixedType,1
6,1,0,7,mixedType,0
12,3,0,15,mixedType,2
1,8,0,9,mixedType,1
6,2,0,8,mixedType,1
8,2,0,10,mixedType,1
5,4,0,9,mixedType,1
7,1,0,8,mixedType,1
6,2,0,8,mixedType,1
6,3,0,9,mixedType,1
11,3,0,14,mixedType,2
4,5,0,9,mixedType,1
11,3,0,14,mixedType,2
8,2,0,10,mixedType,1
4,4,0,8,mixedType,1
6,1,0,7,mixedType,0
2,6,0,8,mixedType,1
3,5,0,8,mixedType,1
9,1,0,10,mixedType,1
6,4,0,10,mixedType,1
5,5,0,10,mixedType,1
6,6,0,12,mixedType,1
11,5,0,16,mixedType,2
7,3,0,10,mixedType,1
2,7,0,9,mixedType,1
11,3,0,14,mixedType,2
8,2,0,10,mixedType,1
4,6,0,10,mixedType,1
6,2,0,8,mixedType,1
8,2,0,10,mixedType,1
9,4,0,13,mixedType,1
4,6,0,10,mixedType,1
4,4,0,8,mixedType,1
11,3,0,14,mixedType,2
2,6,0,8,mixedType,1
3,5,0,8,mixedType,1
1,7,0,8,mixedType,1
7,4,0,11,mixedType,1
7,4,0,11,mixedType,1
5,4,0,9,mixedType,1
7,4,0,11,mixedType,1
3,5,0,8,mixedType,1
9,2,0,11,mixedType,1
5,2,0,7,mixedType,0
8,1,0,9,mixedType,1
8,1,0,9,mixedType,1
7,2,0,9,mixedType,1
6,2,0,8,mixedType,1
6,2,0,8,mixedType,1
10,2,0,12,mixedType,1
6,1,0,7,mixedType,0
8,1,0,9,mixedType,1
6,1,0,7,mixedType,0
8,2,0,10,mixedType,1
14,2,0,16,mixedType,2
5,2,0,7,mixedType,0
7,3,0,10,mixedType,1
8,2,0,10,mixedType,1
12,4,0,16,mixedType,2
5,4,0,9,mixedType,1
2,8,0,10,mixedType,1
3,5,0,8,mixedType,1
9,3,0,12,mixedType,1
7,2,0,9,mixedType,1
11,1,0,12,mixedType,1
6,2,0,8,mixedType,1
9,1,0,10,mixedType,1
8,1,0,9,mixedType,1
5,2,0,7,mixedType,0
11,5,0,16,mixedType,2
9,1,0,10,mixedType,1
13,3,0,16,mixedType,2
8,1,0,9,mixedType,1
4,2,0,6,mixedType,0
5,2,0,7,mixedType,0
10,2,0,12,mixedType,1
9,1,0,10,mixedType,1
12,3,1,16,mixedType,2
6,5,0,11,mixedType,1
8,2,0,10,mixedType,1
8,2,0,10,mixedType,1
4,4,0,8,mixedType,1
4,6,0,10,mixedType,1
8,3,0,11,mixedType,1
2,7,0,9,mixedType,1
1,8,0,9,mixedType,1
9,1,0,10,mixedType,1
3,3,0,6,mixedType,0
7,3,0,10,mixedType,1
5,1,0,6,mixedType,0
5,3,0,8,mixedType,1
8,4,0,12,mixedType,1
4,6,0,10,mixedType,1
7,1,0,8,mixedType,1
6,4,0,10,mixedType,1
5,3,0,8,mixedType,1
9,1,0,10,mixedType,1
1,8,0,9,mixedType,1
12,4,0,16,mixedType,2
5,4,0,9,mixedType,1
6,2,0,8,mixedType,1
6,1,0,7,mixedType,0
3,6,0,9,mixedType,1
3,6,0,9,mixedType,1
8,1,0,9,mixedType,1
6,1,0,7,mixedType,0
4,6,0,10,mixedType,1
9,1,0,10,mixedType,1
4,2,0,6,mixedType,0
7,3,0,10,mixedType,1
9,1,0,10,mixedType,1
5,4,0,9,mixedType,1
8,2,0,10,mixedType,1
8,1,0,9,mixedType,1
11,5,0,16,mixedType,2
10,2,0,12,mixedType,1
8,3,0,11,mixedType,1
5,3,0,8,mixedType,1
5,2,0,7,mixedType,0
8,2,0,10,mixedType,1
7,3,0,10,mixedType,1
7,2,0,9,mixedType,1
1,8,0,9,mixedType,1
11,2,0,13,mixedType,1
6,3,0,9,mixedType,1
4,4,0,8,mixedType,1
5,3,0,8,mixedType,1
5,3,0,8,mixedType,1
13,3,0,16,mixedType,2
7,2,0,9,mixedType,1
3,5,0,8,mixedType,1
3,7,0,10,mixedType,1
9,1,0,10,mixedType,1
6,3,0,9,mixedType,1
6,3,0,9,mixedType,1
11,1,0,12,mixedType,1
6,3,0,9,mixedType,1
8,1,0,9,mixedType,1
8,1,0,9,mixedType,1
7,3,0,10,mixedType,1
6,3,0,9,mixedType,1
2,8,0,10,mixedType,1
4,4,0,8,mixedType,1
4,4,0,8,mixedType,1
6,2,0,8,mixedType,1
5,2,0,7,mixedType,0
6,2,0,8,mixedType,1
6,2,0,8,mixedType,1
5,1,0,6,mixedType,0
13,3,0,16,mixedType,2
11,2,0,13,mixedType,1
8,2,0,10,mixedType,1
7,1,0,8,mixedType,1
3,8,0,11,mixedType,1
9,1,0,10,mixedType,1
10,1,0,11,mixedType,1
5,1,0,6,mixedType,0
7,4,0,11,mixedType,1
4,2,0,6,mixedType,0
2,9,0,11,mixedType,1
6,3,0,9,mixedType,1
15,1,0,16,mixedType,2
6,4,0,10,mixedType,1
5,5,0,10,mixedType,1
6,3,0,9,mixedType,1
2,6,0,8,mixedType,1
11,1,0,12,mixedType,1
5,6,0,11,mixedType,1
14,4,0,18,mixedType,2
7,3,0,10,mixedType,1
5,3,0,8,mixedType,1
2,4,0,6,mixedType,0
7,3,0,10,mixedType,1
13,3,0,16,mixedType,2
5,3,0,8,mixedType,1
2,10,0,12,mixedType,1
1,10,0,11,mixedType,1
7,2,0,9,mixedType,1
7,1,0,8,mixedType,1
6,1,0,7,mixedType,0
11,2,0,13,mixedType,1
7,1,0,8,mixedType,1
5,6,0,11,mixedType,1
6,4,0,10,mixedType,1
11,3,0,14,mixedType,2
6,2,0,8,mixedType,1
4,4,0,8,mixedType,1
4,4,0,8,mixedType,1
5,2,0,7,mixedType,0
9,1,0,10,mixedType,1
1,11,0,12,mixedType,1
6,6,0,12,mixedType,1
9,3,0,12,mixedType,1
6,6,0,12,mixedType,1
12,4,0,16,mixedType,2
2,6,0,8,mixedType,1
7,5,0,12,mixedType,1
6,2,0,8,mixedType,1
7,2,0,9,mixedType,1
9,1,0,10,mixedType,1
13,3,0,16,mixedType,2
7,2,0,9,mixedType,1
5,2,0,7,mixedType,0
6,3,0,9,mixedType,1
7,2,0,9,mixedType,1
8,2,0,10,mixedType,1
5,5,0,10,mixedType,1
14,2,0,16,mixedType,2
11,3,0,14,mixedType,2
6,3,0,9,mixedType,1
6,1,0,7,mixedType,0
5,2,0,7,mixedType,0
8,2,0,10,mixedType,1
5,3,0,8,mixedType,1
8,3,0,11,mixedType,1
6,2,0,8,mixedType,1
7,2,0,9,mixedType,1
5,2,0,7,mixedType,0
8,1,0,9,mixedType,1
5,1,0,6,mixedType,0
4,4,0,8,mixedType,1
8,1,0,9,mixedType,1
6,3,0,9,mixedType,1
9,1,0,10,mixedType,1
4,5,0,9,mixedType,1
5,2,0,7,mixedType,0
6,3,0,9,mixedType,1
7,3,0,10,mixedType,1
6,1,0,7,mixedType,0
5,4,0,9,mixedType,1
9,1,0,10,mixedType,1
8,3,0,11,mixedType,1
7,1,0,8,mixedType,1
7,3,0,10,mixedType,1
8,3,0,11,mixedType,1
8,2,0,10,mixedType,1
6,2,0,8,mixedType,1
7,3,0,10,mixedType,1
4,2,0,6,mixedType,0
7,1,0,8,mixedType,1
5,3,0,8,mixedType,1
7,3,0,10,mixedType,1
8,2,0,10,mixedType,1
5,6,0,11,mixedType,1
7,1,0,8,mixedType,1
7,1,0,8,mixedType,1
6,1,0,7,mixedType,0
6,1,0,7,mixedType,0
19,11,0,30,mixedType,2
6,6,0,12,mixedType,1
9,4,0,13,mixedType,1
8,4,0,12,mixedType,1
2,10,0,12,mixedType,1
8,1,0,9,mixedType,1
5,2,0,7,mixedType,0
5,3,0,8,mixedType,1
7,2,0,9,mixedType,1
7,2,0,9,mixedType,1
8,2,0,10,mixedType,1
4,2,0,6,mixedType,0
8,2,0,10,mixedType,1
4,4,0,8,mixedType,1
7,4,0,11,mixedType,1
9,1,0,10,mixedType,1
13,3,0,16,mixedType,2
7,4,0,11,mixedType,1
8,4,0,12,mixedType,1
5,3,0,8,mixedType,1
6,5,0,11,mixedType,1
5,1,0,6,mixedType,0
6,4,0,10,mixedType,1
5,3,0,8,mixedType,1
4,4,0,8,mixedType,1
6,3,0,9,mixedType,1
12,4,0,16,mixedType,2
4,2,0,6,mixedType,0
5,1,0,6,mixedType,0
14,2,0,16,mixedType,2
7,3,0,10,mixedType,1
5,3,0,8,mixedType,1
7,3,0,10,mixedType,1
8,2,0,10,mixedType,1
14,2,0,16,mixedType,2
5,3,0,8,mixedType,1
14,2,0,16,mixedType,2
3,8,0,11,mixedType,1
5,2,0,7,mixedType,0
7,1,0,8,mixedType,1
6,3,0,9,mixedType,1
1,9,0,10,mixedType,1
7,3,0,10,mixedType,1
8,1,0,9,mixedType,1
8,2,0,10,mixedType,1
14,2,0,16,mixedType,2
5,7,0,12,mixedType,1
4,4,0,8,mixedType,1
9,1,0,10,mixedType,1
7,3,0,10,mixedType,1
12,4,0,16,mixedType,2
6,2,0,8,mixedType,1
5,2,0,7,mixedType,0
6,3,0,9,mixedType,1
6,2,0,8,mixedType,1
7,3,0,10,mixedType,1
11,5,0,16,mixedType,2
14,2,0,16,mixedType,2
12,4,0,16,mixedType,2
6,1,0,7,mixedType,0
6,2,0,8,mixedType,1
8,1,0,9,mixedType,1
8,4,0,12,mixedType,1
6,4,0,10,mixedType,1
7,4,0,11,mixedType,1
6,3,0,9,mixedType,1
8,1,0,9,mixedType,1
7,3,0,10,mixedType,1
8,5,1,14,mixedType,2
6,2,0,8,mixedType,1
8,1,0,9,mixedType,1
14,2,0,16,mixedType,2
7,2,0,9,mixedType,1
13,3,0,16,mixedType,2
15,1,0,16,mixedType,2
3,3,0,6,mixedType,0
8,2,0,10,mixedType,1
16,8,2,26,mixedType,2
15,1,0,16,mixedType,2
5,8,0,13,mixedType,1
3,6,0,9,mixedType,1
7,1,0,8,mixedType,1
11,2,0,13,mixedType,1
4,2,0,6,mixedType,0
5,3,0,8,mixedType,1
12,3,0,15,mixedType,2
5,2,0,7,mixedType,0
5,2,0,7,mixedType,0
5,2,0,7,mixedType,0
5,4,0,9,mixedType,1
13,3,0,16,mixedType,2
8,3,0,11,mixedType,1
5,2,0,7,mixedType,0
2,9,0,11,mixedType,1
4,4,0,8,mixedType,1
11,3,0,14,mixedType,2
5,4,0,9,mixedType,1
6,3,0,9,mixedType,1
7,2,0,9,mixedType,1
5,2,0,7,mixedType,0
7,3,0,10,mixedType,1
5,2,0,7,mixedType,0
10,3,0,13,mixedType,1
8,2,0,10,mixedType,1
2,8,0,10,mixedType,1
0,8,2,10,mixedType,1
11,3,1,15,mixedType,2
4,2,0,6,mixedType,0
6,2,0,8,mixedType,1
9,4,0,13,mixedType,1
5,2,0,7,mixedType,0
6,2,0,8,mixedType,1
7,3,0,10,mixedType,1
1,9,0,10,mixedType,1
6,2,0,8,mixedType,1
6,2,0,8,mixedType,1
5,4,0,9,mixedType,1
7,2,0,9,mixedType,1
1,8,0,9,mixedType,1
4,4,0,8,mixedType,1
6,3,0,9,mixedType,1
6,1,0,7,mixedType,0
6,6,0,12,mixedType,1
0,6,2,8,mixedType,1
6,1,0,7,mixedType,0
3,3,0,6,mixedType,0
5,4,0,9,mixedType,1
6,3,0,9,mixedType,1
8,2,0,10,mixedType,1
7,2,0,9,mixedType,1
6,3,0,9,mixedType,1
5,2,0,7,mixedType,0
3,5,0,8,mixedType,1
10,0,1,11,mixedType,1
4,4,0,8,mixedType,1
3,6,0,9,mixedType,1
6,3,0,9,mixedType,1
3,6,0,9,mixedType,1
6,3,0,9,mixedType,1
7,2,0,9,mixedType,1
6,3,0,9,mixedType,1
7,3,0,10,mixedType,1
5,4,0,9,mixedType,1
6,5,0,11,mixedType,1
6,0,1,7,mixedType,0
8,0,1,9,mixedType,1
7,3,0,10,mixedType,1
6,1,0,7,mixedType,0
6,4,0,10,mixedType,1
7,2,0,9,mixedType,1
8,1,0,9,mixedType,1
5,2,0,7,mixedType,0
7,1,0,8,mixedType,1
6,4,0,10,mixedType,1
6,1,0,7,mixedType,0
6,2,0,8,mixedType,1
6,4,0,10,mixedType,1
6,2,0,8,mixedType,1
14,2,0,16,mixedType,2
15,1,0,16,mixedType,2
7,3,0,10,mixedType,1
4,5,0,9,mixedType,1
4,2,0,6,mixedType,0
9,3,0,12,mixedType,1
6,4,0,10,mixedType,1
3,6,0,9,mixedType,1
10,2,0,12,mixedType,1
8,1,0,9,mixedType,1
1,10,0,11,mixedType,1
15,1,0,16,mixedType,2
12,3,0,15,mixedType,2
8,4,0,12,mixedType,1
8,3,0,11,mixedType,1
4,2,0,6,mixedType,0
4,4,0,8,mixedType,1
1,9,0,10,mixedType,1
5,3,0,8,mixedType,1
8,4,0,12,mixedType,1
7,1,0,8,mixedType,1
8,1,0,9,mixedType,1
5,4,0,9,mixedType,1
5,5,0,10,mixedType,1
6,4,0,10,mixedType,1
5,3,0,8,mixedType,1
5,3,0,8,mixedType,1
9,2,0,11,mixedType,1
7,2,0,9,mixedType,1
6,1,0,7,mixedType,0
6,3,0,9,mixedType,1
4,8,0,12,mixedType,1
5,3,0,8,mixedType,1
6,1,0,7,mixedType,0
8,2,0,10,mixedType,1
13,2,0,15,mixedType,2
5,4,0,9,mixedType,1
2,6,0,8,mixedType,1
6,1,0,7,mixedType,0
3,5,0,8,mixedType,1
4,6,0,10,mixedType,1
8,4,0,12,mixedType,1
10,3,0,13,mixedType,1
6,4,0,10,mixedType,1
5,3,0,8,mixedType,1
8,2,0,10,mixedType,1
7,4,0,11,mixedType,1
6,4,0,10,mixedType,1
2,6,0,8,mixedType,1
3,7,0,10,mixedType,1
2,9,0,11,mixedType,1
8,4,0,12,mixedType,1
7,3,0,10,mixedType,1
6,3,0,9,mixedType,1
15,1,0,16,mixedType,2
5,1,0,6,mixedType,0
8,4,0,12,mixedType,1
7,1,0,8,mixedType,1
6,4,0,10,mixedType,1
7,2,0,9,mixedType,1
9,7,0,16,mixedType,2
7,2,0,9,mixedType,1
5,2,0,7,mixedType,0
12,4,0,16,mixedType,2
6,3,0,9,mixedType,1
5,2,0,7,mixedType,0
12,2,1,15,mixedType,2
14,2,0,16,mixedType,2
5,2,0,7,mixedType,0
7,3,0,10,mixedType,1
8,3,0,11,mixedType,1
9,2,0,11,mixedType,1
6,2,0,8,mixedType,1
1,8,0,9,mixedType,1
9,3,0,12,mixedType,1
6,2,0,8,mixedType,1
6,3,0,9,mixedType,1
5,3,0,8,mixedType,1
7,1,0,8,mixedType,1
7,3,0,10,mixedType,1
7,3,0,10,mixedType,1
1,8,0,9,mixedType,1
6,3,0,9,mixedType,1
5,3,0,8,mixedType,1
6,3,0,9,mixedType,1
12,4,0,16,mixedType,2
6,1,0,7,mixedType,0
5,4,0,9,mixedType,1
5,1,0,6,mixedType,0
10,3,0,13,mixedType,1
2,6,0,8,mixedType,1
7,6,0,13,mixedType,1
1,10,0,11,mixedType,1
0,6,2,8,mixedType,1
5,8,0,13,mixedType,1
7,2,0,9,mixedType,1
7,2,0,9,mixedType,1
14,2,0,16,mixedType,2
7,2,0,9,mixedType,1
9,2,0,11,mixedType,1
5,3,0,8,mixedType,1
13,2,0,15,mixedType,2
6,3,0,9,mixedType,1
4,4,0,8,mixedType,1
7,2,0,9,mixedType,1
2,8,0,10,mixedType,1
13,3,0,16,mixedType,2
5,1,0,6,mixedType,0
4,5,0,9,mixedType,1
7,3,0,10,mixedType,1
4,4,0,8,mixedType,1
9,1,0,10,mixedType,1
6,6,0,12,mixedType,1
5,1,0,6,mixedType,0
11,5,0,16,mixedType,2
4,4,0,8,mixedType,1
10,2,0,12,mixedType,1
7,4,0,11,mixedType,1
7,2,0,9,mixedType,1
9,1,0,10,mixedType,1
5,4,0,9,mixedType,1
10,4,0,14,mixedType,2
6,1,0,7,mixedType,0
14,2,0,16,mixedType,2
8,2,0,10,mixedType,1
9,3,0,12,mixedType,1
5,2,0,7,mixedType,0
9,2,0,11,mixedType,1
6,3,0,9,mixedType,1
10,1,0,11,mixedType,1
5,1,0,6,mixedType,0
5,2,0,7,mixedType,0
7,4,0,11,mixedType,1
13,3,0,16,mixedType,2
4,4,0,8,mixedType,1
7,2,0,9,mixedType,1
3,5,0,8,mixedType,1
4,6,0,10,mixedType,1
8,2,0,10,mixedType,1
11,3,0,14,mixedType,2
6,1,0,7,mixedType,0
4,4,0,8,mixedType,1
4,6,0,10,mixedType,1
7,2,0,9,mixedType,1
5,2,0,7,mixedType,0
6,2,0,8,mixedType,1
6,3,0,9,mixedType,1
5,2,0,7,mixedType,0
11,3,0,14,mixedType,2
15,1,0,16,mixedType,2
9,2,0,11,mixedType,1
5,6,0,11,mixedType,1
7,2,0,9,mixedType,1
8,2,0,10,mixedType,1
4,4,0,8,mixedType,1
14,2,0,16,mixedType,2
5,2,0,7,mixedType,0
5,3,0,8,mixedType,1
1,7,0,8,mixedType,1
5,3,0,8,mixedType,1
8,2,0,10,mixedType,1
12,3,0,15,mixedType,2
3,6,0,9,mixedType,1
5,2,0,7,mixedType,0
5,2,0,7,mixedType,0
7,2,0,9,mixedType,1
5,4,0,9,mixedType,1
6,3,0,9,mixedType,1
3,6,0,9,mixedType,1
7,3,0,10,mixedType,1
8,2,0,10,mixedType,1
7,3,0,10,mixedType,1
6,1,0,7,mixedType,0
12,3,0,15,mixedType,2
6,4,0,10,mixedType,1
6,1,0,7,mixedType,0
6,1,0,7,mixedType,0
5,1,0,6,mixedType,0
6,3,0,9,mixedType,1
7,3,0,10,mixedType,1
14,2,0,16,mixedType,2
9,3,0,12,mixedType,1
9,1,0,10,mixedType,1
9,2,0,11,mixedType,1
7,2,0,9,mixedType,1
12,3,0,15,mixedType,2
6,3,0,9,mixedType,1
6,2,0,8,mixedType,1
6,1,0,7,mixedType,0
7,3,0,10,mixedType,1
4,2,0,6,mixedType,0
6,2,0,8,mixedType,1
5,3,0,8,mixedType,1
13,3,0,16,mixedType,2
6,1,0,7,mixedType,0
7,1,0,8,mixedType,1
5,3,0,8,mixedType,1
5,3,0,8,mixedType,1
14,2,0,16,mixedType,2
6,3,0,9,mixedType,1
6,1,0,7,mixedType,0
3,6,0,9,mixedType,1
12,3,0,15,mixedType,2
4,4,0,8,mixedType,1
5,3,0,8,mixedType,1
5,3,0,8,mixedType,1
8,1,0,9,mixedType,1
8,1,0,9,mixedType,1
1,7,0,8,mixedType,1
12,4,0,16,mixedType,2
7,3,0,10,mixedType,1
5,1,0,6,mixedType,0
7,2,0,9,mixedType,1
4,6,0,10,mixedType,1
5,1,0,6,mixedType,0
4,4,0,8,mixedType,1
6,2,0,8,mixedType,1
6,4,0,10,mixedType,1
6,4,0,10,mixedType,1
4,2,0,6,mixedType,0
2,8,0,10,mixedType,1
14,2,0,16,mixedType,2
4,6,0,10,mixedType,1
5,1,0,6,mixedType,0
3,6,0,9,mixedType,1
4,5,0,9,mixedType,1
2,6,0,8,mixedType,1
5,4,0,9,mixedType,1
10,2,0,12,mixedType,1
10,3,0,13,mixedType,1
6,4,0,10,mixedType,1
3,6,0,9,mixedType,1
14,2,0,16,mixedType,2
14,2,0,16,mixedType,2
12,3,5,20,mixedType,2
1,8,0,9,mixedType,1
6,3,0,9,mixedType,1
5,3,0,8,mixedType,1
9,3,0,12,mixedType,1
7,3,0,10,mixedType,1
5,2,0,7,mixedType,0
6,1,0,7,mixedType,0
3,6,0,9,mixedType,1
3,6,0,9,mixedType,1
15,1,0,16,mixedType,2
3,3,0,6,mixedType,0
6,2,0,8,mixedType,1
14,2,0,16,mixedType,2
13,3,0,16,mixedType,2
5,2,0,7,mixedType,0
3,10,0,13,mixedType,1
5,1,0,6,mixedType,0
4,4,0,8,mixedType,1
5,4,0,9,mixedType,1
8,4,0,12,mixedType,1
6,2,0,8,mixedType,1
1,8,0,9,mixedType,1
5,3,0,8,mixedType,1
2,8,0,10,mixedType,1
5,6,0,11,mixedType,1
7,4,0,11,mixedType,1
7,2,0,9,mixedType,1
6,2,0,8,mixedType,1
6,3,0,9,mixedType,1
7,9,1,17,mixedType,2
5,3,0,8,mixedType,1
7,3,0,10,mixedType,1
9,1,0,10,mixedType,1
14,2,0,16,mixedType,2
4,4,0,8,mixedType,1
6,1,0,7,mixedType,0
5,3,0,8,mixedType,1
8,1,0,9,mixedType,1
2,6,0,8,mixedType,1
8,1,0,9,mixedType,1
7,3,0,10,mixedType,1
7,4,0,11,mixedType,1
8,4,0,12,mixedType,1
7,3,0,10,mixedType,1
8,1,0,9,mixedType,1
9,2,0,11,mixedType,1
1,8,0,9,mixedType,1
6,4,0,10,mixedType,1
5,4,0,9,mixedType,1
7,3,0,10,mixedType,1
11,1,0,12,mixedType,1
12,3,0,15,mixedType,2
14,2,0,16,mixedType,2
7,1,0,8,mixedType,1
5,3,0,8,mixedType,1
6,4,0,10,mixedType,1
5,1,0,6,mixedType,0
0,6,0,6,sameType,0
8,2,0,10,mixedType,1
9,1,0,10,mixedType,1
6,4,0,10,mixedType,1
8,2,0,10,mixedType,1
6,4,0,10,mixedType,1
13,3,0,16,mixedType,2
6,3,0,9,mixedType,1
7,3,0,10,mixedType,1
12,4,0,16,mixedType,2
7,2,0,9,mixedType,1
14,2,0,16,mixedType,2
4,2,0,6,mixedType,0
5,4,0,9,mixedType,1
13,3,0,16,mixedType,2
4,4,0,8,mixedType,1
5,4,0,9,mixedType,1
8,2,0,10,mixedType,1
6,4,0,10,mixedType,1
3,6,0,9,mixedType,1
7,2,0,9,mixedType,1
5,3,0,8,mixedType,1
7,3,0,10,mixedType,1
5,4,0,9,mixedType,1
14,2,0,16,mixedType,2
12,4,0,16,mixedType,2
12,3,0,15,mixedType,2
6,4,0,10,mixedType,1
8,1,0,9,mixedType,1
9,4,0,13,mixedType,1
5,3,0,8,mixedType,1
5,2,0,7,mixedType,0
6,2,0,8,mixedType,1
6,6,0,12,mixedType,1
4,2,0,6,mixedType,0
9,1,0,10,mixedType,1
7,3,0,10,mixedType,1
8,2,0,10,mixedType,1
8,2,0,10,mixedType,1
7,3,0,10,mixedType,1
7,3,0,10,mixedType,1
15,1,0,16,mixedType,2
6,1,0,7,mixedType,0
7,2,0,9,mixedType,1
9,1,0,10,mixedType,1
6,3,0,9,mixedType,1
7,2,0,9,mixedType,1
5,2,0,7,mixedType,0
6,1,0,7,mixedType,0
13,3,0,16,mixedType,2
2,6,0,8,mixedType,1
4,2,0,6,mixedType,0
7,1,0,8,mixedType,1
9,3,0,12,mixedType,1
6,1,0,7,mixedType,0
3,10,0,13,mixedType,1
6,3,0,9,mixedType,1
4,6,0,10,mixedType,1
6,4,0,10,mixedType,1
8,2,0,10,mixedType,1
7,3,0,10,mixedType,1
3,6,0,9,mixedType,1
2,8,0,10,mixedType,1
5,8,0,13,mixedType,1
6,1,0,7,mixedType,0
5,3,0,8,mixedType,1
8,1,0,9,mixedType,1
8,2,0,10,mixedType,1
13,3,0,16,mixedType,2
6,2,0,8,mixedType,1
15,1,0,16,mixedType,2
5,3,0,8,mixedType,1
7,3,0,10,mixedType,1
9,2,0,11,mixedType,1
4,4,0,8,mixedType,1
6,4,0,10,mixedType,1
9,1,0,10,mixedType,1
6,2,0,8,mixedType,1
9,1,0,10,mixedType,1
5,3,0,8,mixedType,1
12,4,0,16,mixedType,2
6,3,0,9,mixedType,1
5,3,0,8,mixedType,1
8,2,0,10,mixedType,1
5,1,0,6,mixedType,0
8,4,0,12,mixedType,1
8,2,0,10,mixedType,1
8,2,0,10,mixedType,1
7,3,0,10,mixedType,1
13,3,0,16,mixedType,2
11,3,0,14,mixedType,2
5,3,0,8,mixedType,1
8,1,0,9,mixedType,1
6,3,0,9,mixedType,1
7,3,0,10,mixedType,1
8,3,0,11,mixedType,1
1,7,0,8,mixedType,1
6,2,0,8,mixedType,1
5,2,0,7,mixedType,0
7,3,0,10,mixedType,1
6,4,0,10,mixedType,1
5,2,0,7,mixedType,0
13,3,0,16,mixedType,2
7,3,0,10,mixedType,1
7,3,0,10,mixedType,1
9,3,0,12,mixedType,1
4,2,0,6,mixedType,0
9,2,0,11,mixedType,1
2,6,0,8,mixedType,1
7,3,0,10,mixedType,1
8,1,0,9,mixedType,1
15,1,0,16,mixedType,2
13,3,0,16,mixedType,2
3,7,0,10,mixedType,1
4,4,0,8,mixedType,1
6,1,0,7,mixedType,0
12,3,0,15,mixedType,2
5,3,0,8,mixedType,1
7,3,0,10,mixedType,1
6,3,0,9,mixedType,1
7,3,0,10,mixedType,1
5,3,0,8,mixedType,1
8,2,0,10,mixedType,1
5,2,0,7,mixedType,0
8,4,0,12,mixedType,1
6,4,0,10,mixedType,1
3,5,0,8,mixedType,1
11,2,1,14,mixedType,2
8,2,0,10,mixedType,1
8,4,0,12,mixedType,1
4,4,0,8,mixedType,1
6,6,0,12,mixedType,1
6,3,0,9,mixedType,1
6,3,0,9,mixedType,1
12,1,1,14,mixedType,2
7,3,0,10,mixedType,1
6,4,0,10,mixedType,1
6,4,0,10,mixedType,1
6,1,0,7,mixedType,0
8,1,0,9,mixedType,1
5,2,0,7,mixedType,0
8,3,0,11,mixedType,1
4,2,0,6,mixedType,0
5,1,0,6,mixedType,0
6,2,0,8,mixedType,1
3,6,0,9,mixedType,1
8,6,0,14,mixedType,2
5,3,0,8,mixedType,1
7,2,0,9,mixedType,1
5,4,0,9,mixedType,1
11,5,0,16,mixedType,2
6,4,0,10,mixedType,1
8,4,0,12,mixedType,1
11,2,0,13,mixedType,1
12,3,0,15,mixedType,2
3,3,0,6,mixedType,0
8,1,0,9,mixedType,1
3,6,0,9,mixedType,1
1,8,0,9,mixedType,1
14,2,0,16,mixedType,2
9,1,0,10,mixedType,1
10,3,0,13,mixedType,1
6,2,0,8,mixedType,1
4,2,0,6,mixedType,0
5,8,0,13,mixedType,1
6,3,0,9,mixedType,1
4,4,0,8,mixedType,1
5,2,0,7,mixedType,0
5,3,0,8,mixedType,1
6,5,0,11,mixedType,1
10,4,1,15,mixedType,2
6,2,0,8,mixedType,1
7,3,0,10,mixedType,1
10,2,0,12,mixedType,1
7,2,0,9,mixedType,1
10,2,0,12,mixedType,1
6,3,0,9,mixedType,1
3,10,0,13,mixedType,1
2,4,0,6,mixedType,0
6,1,0,7,mixedType,0
4,2,0,6,mixedType,0
13,3,0,16,mixedType,2
8,1,1,10,mixedType,1
8,2,0,10,mixedType,1
5,3,0,8,mixedType,1
8,1,0,9,mixedType,1
6,1,0,7,mixedType,0
7,2,0,9,mixedType,1
5,3,0,8,mixedType,1
2,6,0,8,mixedType,1
10,3,0,13,mixedType,1
14,2,0,16,mixedType,2
6,1,0,7,mixedType,0
6,6,0,12,mixedType,1
5,3,0,8,mixedType,1
7,1,0,8,mixedType,1
14,2,0,16,mixedType,2
7,4,0,11,mixedType,1
7,3,0,10,mixedType,1
7,3,0,10,mixedType,1
6,1,0,7,mixedType,0
3,6,0,9,mixedType,1
9,1,0,10,mixedType,1
6,1,0,7,mixedType,0
4,6,0,10,mixedType,1
6,1,0,7,mixedType,0
8,1,0,9,mixedType,1
12,4,0,16,mixedType,2
10,5,1,16,mixedType,2
6,6,0,12,mixedType,1
8,3,0,11,mixedType,1
5,3,0,8,mixedType,1
12,4,0,16,mixedType,2
6,3,0,9,mixedType,1
5,8,0,13,mixedType,1
7,3,0,10,mixedType,1
10,2,0,12,mixedType,1
6,1,0,7,mixedType,0
6,4,0,10,mixedType,1
6,4,0,10,mixedType,1
9,1,0,10,mixedType,1
2,8,0,10,mixedType,1
7,3,0,10,mixedType,1
11,1,0,12,mixedType,1
13,3,0,16,mixedType,2
6,4,0,10,mixedType,1
7,2,0,9,mixedType,1
5,3,0,8,mixedType,1
4,2,0,6,mixedType,0
13,3,0,16,mixedType,2
12,4,0,16,mixedType,2
6,2,0,8,mixedType,1
7,3,0,10,mixedType,1
5,6,0,11,mixedType,1
6,1,0,7,mixedType,0
7,4,0,11,mixedType,1
6,1,0,7,mixedType,0
7,2,0,9,mixedType,1
8,4,0,12,mixedType,1
14,2,0,16,mixedType,2
6,1,0,7,mixedType,0
4,2,0,6,mixedType,0
1,10,0,11,mixedType,1
1,8,0,9,mixedType,1
14,2,0,16,mixedType,2
7,3,0,10,mixedType,1
7,3,0,10,mixedType,1
1,8,0,9,mixedType,1
5,3,0,8,mixedType,1
7,3,0,10,mixedType,1
6,2,0,8,mixedType,1
6,4,0,10,mixedType,1
8,0,1,9,mixedType,1
4,5,0,9,mixedType,1
2,4,0,6,mixedType,0
3,6,0,9,mixedType,1
7,2,0,9,mixedType,1
6,4,0,10,mixedType,1
13,3,0,16,mixedType,2
4,4,0,8,mixedType,1
3,5,0,8,mixedType,1
10,8,0,18,mixedType,2
7,4,0,11,mixedType,1
4,2,0,6,mixedType,0
14,2,0,16,mixedType,2
9,2,0,11,mixedType,1
5,2,0,7,mixedType,0
7,2,0,9,mixedType,1
7,3,0,10,mixedType,1
5,3,0,8,mixedType,1
5,3,0,8,mixedType,1
6,3,6,15,mixedType,2
8,2,0,10,mixedType,1
4,2,0,6,mixedType,0
7,2,0,9,mixedType,1
7,3,0,10,mixedType,1
6,3,0,9,mixedType,1
9,1,0,10,mixedType,1
7,1,0,8,mixedType,1
8,4,0,12,mixedType,1
7,3,0,10,mixedType,1
5,8,0,13,mixedType,1
6,1,0,7,mixedType,0
8,2,0,10,mixedType,1
11,3,0,14,mixedType,2
2,8,0,10,mixedType,1
7,3,0,10,mixedType,1
4,6,0,10,mixedType,1
8,2,0,10,mixedType,1
15,1,0,16,mixedType,2
5,4,0,9,mixedType,1
6,3,0,9,mixedType,1
5,4,0,9,mixedType,1
11,2,0,13,mixedType,1
8,4,0,12,mixedType,1
8,2,0,10,mixedType,1
3,6,0,9,mixedType,1
5,2,0,7,mixedType,0
7,1,0,8,mixedType,1
11,2,0,13,mixedType,1
6,2,0,8,mixedType,1
8,4,0,12,mixedType,1
8,1,0,9,mixedType,1
6,3,0,9,mixedType,1
7,2,0,9,mixedType,1
6,3,0,9,mixedType,1
9,1,0,10,mixedType,1
14,2,0,16,mixedType,2
4,2,0,6,mixedType,0
5,2,0,7,mixedType,0
5,2,0,7,mixedType,0
6,1,0,7,mixedType,0
4,4,0,8,mixedType,1
6,3,0,9,mixedType,1
9,1,0,10,mixedType,1
7,2,0,9,mixedType,1
7,3,0,10,mixedType,1
5,4,0,9,mixedType,1
8,3,0,11,mixedType,1
2,6,0,8,mixedType,1
5,8,0,13,mixedType,1
7,1,0,8,mixedType,1
2,8,0,10,mixedType,1
0,6,0,6,sameType,0
13,3,0,16,mixedType,2
5,3,0,8,mixedType,1
4,2,0,6,mixedType,0
6,2,0,8,mixedType,1
14,2,0,16,mixedType,2
7,5,0,12,mixedType,1
5,1,0,6,mixedType,0
5,1,0,6,mixedType,0
1,7,0,8,mixedType,1
6,1,0,7,mixedType,0
8,4,0,12,mixedType,1
7,3,0,10,mixedType,1
5,4,0,9,mixedType,1
7,3,0,10,mixedType,1
7,2,0,9,mixedType,1
5,4,0,9,mixedType,1
5,3,0,8,mixedType,1
5,3,0,8,mixedType,1
4,4,0,8,mixedType,1
10,1,0,11,mixedType,1
6,1,0,7,mixedType,0
15,1,0,16,mixedType,2
6,3,0,9,mixedType,1
9,1,0,10,mixedType,1
16,2,0,18,mixedType,2
9,3,0,12,mixedType,1
10,2,0,12,mixedType,1
8,4,0,12,mixedType,1
5,2,0,7,mixedType,0
6,2,0,8,mixedType,1
5,3,0,8,mixedType,1
7,2,0,9,mixedType,1
4,6,0,10,mixedType,1
7,3,0,10,mixedType,1
7,6,0,13,mixedType,1
10,2,0,12,mixedType,1
6,4,0,10,mixedType,1
7,1,0,8,mixedType,1
7,2,0,9,mixedType,1
7,1,0,8,mixedType,1
8,1,0,9,mixedType,1
5,1,0,6,mixedType,0
1,8,0,9,mixedType,1
10,0,1,11,mixedType,1
14,2,0,16,mixedType,2
9,2,0,11,mixedType,1
7,3,0,10,mixedType,1
6,2,0,8,mixedType,1
5,4,0,9,mixedType,1
5,4,0,9,mixedType,1
5,2,0,7,mixedType,0
7,1,0,8,mixedType,1
8,5,0,13,mixedType,1
5,7,0,12,mixedType,1
7,3,0,10,mixedType,1
6,1,0,7,mixedType,0
5,2,0,7,mixedType,0
6,2,0,8,mixedType,1
1,9,0,10,mixedType,1
2,4,0,6,mixedType,0
6,1,0,7,mixedType,0
8,2,0,10,mixedType,1
6,2,0,8,mixedType,1
7,2,0,9,mixedType,1
4,2,0,6,mixedType,0
6,2,0,8,mixedType,1
5,2,0,7,mixedType,0
8,4,0,12,mixedType,1
6,1,0,7,mixedType,0
6,2,0,8,mixedType,1
10,1,0,11,mixedType,1
6,3,0,9,mixedType,1
7,2,0,9,mixedType,1
6,1,0,7,mixedType,0
6,1,0,7,mixedType,0
6,3,0,9,mixedType,1
6,2,0,8,mixedType,1
6,1,0,7,mixedType,0
8,2,0,10,mixedType,1
5,3,0,8,mixedType,1
7,3,0,10,mixedType,1
1,8,0,9,mixedType,1
8,2,0,10,mixedType,1
4,2,0,6,mixedType,0
5,1,0,6,mixedType,0
15,1,0,16,mixedType,2
7,2,0,9,mixedType,1
8,1,0,9,mixedType,1
8,3,0,11,mixedType,1
5,3,0,8,mixedType,1
6,3,0,9,mixedType,1
5,8,0,13,mixedType,1
3,7,0,10,mixedType,1
4,5,0,9,mixedType,1
7,3,0,10,mixedType,1
7,3,0,10,mixedType,1
11,3,0,14,mixedType,2
14,2,0,16,mixedType,2
12,3,0,15,mixedType,2
7,3,0,10,mixedType,1
5,1,0,6,mixedType,0
4,4,0,8,mixedType,1
6,2,0,8,mixedType,1
6,3,0,9,mixedType,1
4,2,0,6,mixedType,0
3,6,0,9,mixedType,1
9,3,0,12,mixedType,1
8,2,0,10,mixedType,1
4,5,0,9,mixedType,1
12,0,1,13,mixedType,1
10,4,1,15,mixedType,2
8,1,0,9,mixedType,1
8,4,0,12,mixedType,1
13,3,0,16,mixedType,2
5,3,0,8,mixedType,1
4,2,0,6,mixedType,0
3,7,0,10,mixedType,1
1,10,0,11,mixedType,1
6,4,0,10,mixedType,1
3,6,0,9,mixedType,1
4,2,0,6,mixedType,0
3,3,0,6,mixedType,0
5,4,0,9,mixedType,1
4,4,0,8,mixedType,1
3,8,0,11,mixedType,1
3,5,0,8,mixedType,1
3,6,0,9,mixedType,1
5,7,0,12,mixedType,1
6,3,0,9,mixedType,1
6,4,0,10,mixedType,1
4,6,0,10,mixedType,1
9,1,0,10,mixedType,1
3,6,0,9,mixedType,1
7,1,0,8,mixedType,1
6,1,0,7,mixedType,0
11,5,0,16,mixedType,2
8,2,0,10,mixedType,1
4,4,0,8,mixedType,1
9,2,0,11,mixedType,1
6,2,0,8,mixedType,1
7,4,0,11,mixedType,1
9,3,0,12,mixedType,1
10,0,1,11,mixedType,1
1,7,0,8,mixedType,1
4,4,0,8,mixedType,1
7,5,0,12,mixedType,1
14,2,0,16,mixedType,2
5,1,0,6,mixedType,0
3,6,0,9,mixedType,1
7,4,0,11,mixedType,1
15,1,0,16,mixedType,2
6,2,0,8,mixedType,1
4,6,0,10,mixedType,1
6,4,0,10,mixedType,1
8,2,0,10,mixedType,1
6,1,0,7,mixedType,0
7,2,0,9,mixedType,1
7,3,0,10,mixedType,1
8,4,0,12,mixedType,1
9,2,0,11,mixedType,1
8,4,3,15,mixedType,2
14,2,0,16,mixedType,2
6,2,0,8,mixedType,1
2,8,0,10,mixedType,1
9,3,0,12,mixedType,1
7,0,1,8,mixedType,1
3,5,0,8,mixedType,1
4,4,0,8,mixedType,1
6,6,0,12,mixedType,1
5,4,0,9,mixedType,1
9,1,0,10,mixedType,1
5,4,0,9,mixedType,1
6,3,0,9,mixedType,1
8,3,0,11,mixedType,1
10,2,0,12,mixedType,1
6,3,0,9,mixedType,1
5,8,0,13,mixedType,1
2,4,0,6,mixedType,0
8,1,0,9,mixedType,1
6,4,0,10,mixedType,1
9,1,0,10,mixedType,1
3,5,0,8,mixedType,1
13,3,0,16,mixedType,2
7,2,0,9,mixedType,1
14,2,0,16,mixedType,2
6,3,0,9,mixedType,1
8,2,0,10,mixedType,1
7,3,0,10,mixedType,1
13,3,1,17,mixedType,2
8,1,0,9,mixedType,1
5,2,0,7,mixedType,0
6,4,0,10,mixedType,1
8,1,0,9,mixedType,1
7,3,0,10,mixedType,1
5,2,0,7,mixedType,0
5,3,0,8,mixedType,1
8,2,0,10,mixedType,1
7,2,0,9,mixedType,1
6,6,0,12,mixedType,1
8,1,0,9,mixedType,1
14,2,0,16,mixedType,2
5,2,0,7,mixedType,0
7,3,0,10,mixedType,1
7,4,0,11,mixedType,1
2,8,0,10,mixedType,1
6,3,0,9,mixedType,1
10,2,0,12,mixedType,1
7,2,0,9,mixedType,1
5,4,0,9,mixedType,1
6,3,0,9,mixedType,1
8,1,0,9,mixedType,1
8,1,0,9,mixedType,1
11,3,0,14,mixedType,2
9,4,0,13,mixedType,1
4,2,0,6,mixedType,0
15,1,0,16,mixedType,2
5,1,0,6,mixedType,0
3,7,0,10,mixedType,1
8,5,0,13,mixedType,1
6,1,0,7,mixedType,0
2,9,0,11,mixedType,1
9,2,0,11,mixedType,1
4,4,0,8,mixedType,1
6,6,0,12,mixedType,1
12,3,0,15,mixedType,2
5,2,0,7,mixedType,0
5,4,0,9,mixedType,1
5,5,0,10,mixedType,1
8,1,0,9,mixedType,1
6,2,0,8,mixedType,1
8,1,0,9,mixedType,1
6,3,0,9,mixedType,1
6,1,0,7,mixedType,0
9,4,0,13,mixedType,1
5,3,0,8,mixedType,1
6,3,0,9,mixedType,1
14,2,0,16,mixedType,2
5,5,0,10,mixedType,1
5,3,0,8,mixedType,1
12,4,0,16,mixedType,2
8,2,0,10,mixedType,1
2,9,0,11,mixedType,1
7,2,0,9,mixedType,1
6,4,0,10,mixedType,1
2,8,0,10,mixedType,1
5,2,0,7,mixedType,0
10,1,0,11,mixedType,1
5,2,0,7,mixedType,0
5,4,0,9,mixedType,1
6,3,0,9,mixedType,1
9,3,0,12,mixedType,1
14,2,0,16,mixedType,2
7,3,0,10,mixedType,1
11,1,0,12,mixedType,1
8,2,0,10,mixedType,1
3,6,0,9,mixedType,1
7,3,0,10,mixedType,1
5,1,0,6,mixedType,0
6,6,0,12,mixedType,1
5,1,0,6,mixedType,0
14,2,0,16,mixedType,2
8,2,0,10,mixedType,1
5,1,0,6,mixedType,0
7,4,0,11,mixedType,1
6,3,0,9,mixedType,1
8,3,0,11,mixedType,1
4,4,0,8,mixedType,1
4,5,0,9,mixedType,1
2,4,0,6,mixedType,0
1,9,0,10,mixedType,1
14,2,0,16,mixedType,2
7,3,0,10,mixedType,1
3,5,0,8,mixedType,1
9,2,0,11,mixedType,1
6,3,0,9,mixedType,1
14,2,0,16,mixedType,2
2,8,0,10,mixedType,1
7,6,0,13,mixedType,1
6,2,0,8,mixedType,1
5,1,0,6,mixedType,0
5,1,0,6,mixedType,0
6,4,0,10,mixedType,1
8,4,0,12,mixedType,1
12,3,0,15,mixedType,2
7,3,0,10,mixedType,1
5,3,0,8,mixedType,1
6,3,0,9,mixedType,1
5,5,0,10,mixedType,1
15,1,0,16,mixedType,2
7,4,0,11,mixedType,1
9,1,0,10,mixedType,1
7,3,0,10,mixedType,1
6,2,0,8,mixedType,1
9,3,0,12,mixedType,1
2,8,0,10,mixedType,1
13,3,0,16,mixedType,2
6,4,0,10,mixedType,1
4,6,0,10,mixedType,1
10,1,0,11,mixedType,1
12,4,0,16,mixedType,2
6,4,0,10,mixedType,1
6,4,0,10,mixedType,1
8,1,0,9,mixedType,1
9,1,0,10,mixedType,1
7,3,0,10,mixedType,1
6,3,0,9,mixedType,1
1,8,0,9,mixedType,1
3,5,0,8,mixedType,1
6,3,0,9,mixedType,1
1,8,0,9,mixedType,1
7,3,0,10,mixedType,1
4,5,0,9,mixedType,1
5,4,0,9,mixedType,1
9,3,0,12,mixedType,1
8,4,0,12,mixedType,1
5,5,0,10,mixedType,1
9,1,0,10,mixedType,1
8,1,0,9,mixedType,1
6,4,0,10,mixedType,1
6,4,0,10,mixedType,1
7,3,0,10,mixedType,1
4,8,0,12,mixedType,1
7,1,0,8,mixedType,1
9,3,0,12,mixedType,1
2,7,0,9,mixedType,1
5,3,0,8,mixedType,1
12,3,0,15,mixedType,2
7,3,0,10,mixedType,1
7,2,0,9,mixedType,1
3,8,0,11,mixedType,1
3,6,0,9,mixedType,1
9,2,0,11,mixedType,1
8,2,0,10,mixedType,1
14,2,0,16,mixedType,2
10,1,0,11,mixedType,1
7,4,0,11,mixedType,1
4,4,0,8,mixedType,1
9,2,0,11,mixedType,1
10,3,0,13,mixedType,1
5,2,0,7,mixedType,0
12,4,0,16,mixedType,2
10,2,0,12,mixedType,1
6,3,0,9,mixedType,1
8,2,0,10,mixedType,1
6,3,0,9,mixedType,1
2,8,0,10,mixedType,1
9,4,0,13,mixedType,1
6,1,0,7,mixedType,0
12,4,0,16,mixedType,2
5,2,0,7,mixedType,0
4,2,0,6,mixedType,0
5,2,0,7,mixedType,0
6,3,0,9,mixedType,1
13,3,0,16,mixedType,2
7,3,0,10,mixedType,1
5,2,0,7,mixedType,0
5,2,0,7,mixedType,0
5,3,0,8,mixedType,1
8,1,0,9,mixedType,1
5,3,0,8,mixedType,1
2,6,0,8,mixedType,1
6,1,0,7,mixedType,0
6,1,0,7,mixedType,0
6,0,2,8,mixedType,1
6,4,0,10,mixedType,1
4,6,0,10,mixedType,1
5,3,0,8,mixedType,1
8,2,0,10,mixedType,1
7,1,0,8,mixedType,1
5,2,0,7,mixedType,0
4,2,0,6,mixedType,0
3,6,0,9,mixedType,1
6,1,0,7,mixedType,0
6,3,0,9,mixedType,1
8,2,0,10,mixedType,1
12,3,0,15,mixedType,2
8,1,0,9,mixedType,1
7,4,0,11,mixedType,1
7,2,0,9,mixedType,1
6,3,0,9,mixedType,1
4,2,0,6,mixedType,0
7,3,0,10,mixedType,1
14,4,0,18,mixedType,2
6,3,0,9,mixedType,1
7,3,0,10,mixedType,1
6,2,0,8,mixedType,1
4,2,0,6,mixedType,0
12,4,1,17,mixedType,2
7,1,0,8,mixedType,1
1,5,0,6,mixedType,0
5,5,0,10,mixedType,1
3,5,0,8,mixedType,1
6,8,0,14,mixedType,2
13,3,0,16,mixedType,2
5,3,0,8,mixedType,1
3,3,0,6,mixedType,0
5,1,0,6,mixedType,0
6,2,0,8,mixedType,1
6,2,0,8,mixedType,1
1,8,0,9,mixedType,1
6,2,0,8,mixedType,1
7,3,0,10,mixedType,1
3,3,0,6,mixedType,0
5,2,0,7,mixedType,0
13,3,0,16,mixedType,2
7,3,0,10,mixedType,1
4,8,0,12,mixedType,1
7,1,0,8,mixedType,1
1,7,0,8,mixedType,1
9,1,0,10,mixedType,1
5,3,0,8,mixedType,1
7,2,0,9,mixedType,1
6,1,0,7,mixedType,0
6,4,0,10,mixedType,1
4,4,0,8,mixedType,1
6,4,0,10,mixedType,1
9,1,0,10,mixedType,1
5,2,0,7,mixedType,0
5,4,0,9,mixedType,1
8,4,0,12,mixedType,1
15,1,0,16,mixedType,2
12,4,0,16,mixedType,2
14,2,0,16,mixedType,2
3,6,0,9,mixedType,1
6,3,0,9,mixedType,1
3,5,0,8,mixedType,1
1,8,0,9,mixedType,1
5,3,0,8,mixedType,1
6,4,0,10,mixedType,1
6,4,0,10,mixedType,1
6,3,0,9,mixedType,1
6,4,0,10,mixedType,1
19,1,0,20,mixedType,2
11,3,0,14,mixedType,2
6,6,0,12,mixedType,1
5,3,0,8,mixedType,1
6,6,0,12,mixedType,1
8,2,0,10,mixedType,1
4,5,0,9,mixedType,1
7,3,0,10,mixedType,1
11,2,0,13,mixedType,1
5,2,0,7,mixedType,0
6,2,0,8,mixedType,1
6,3,0,9,mixedType,1
15,1,0,16,mixedType,2
7,3,0,10,mixedType,1
5,3,0,8,mixedType,1
8,3,0,11,mixedType,1
5,2,0,7,mixedType,0
6,4,0,10,mixedType,1
9,4,0,13,mixedType,1
8,2,0,10,mixedType,1
10,1,0,11,mixedType,1
6,1,0,7,mixedType,0
4,2,0,6,mixedType,0
9,1,0,10,mixedType,1
8,2,0,10,mixedType,1
5,1,0,6,mixedType,0
6,1,0,7,mixedType,0
14,2,0,16,mixedType,2
2,8,0,10,mixedType,1
8,2,0,10,mixedType,1
7,1,0,8,mixedType,1
13,3,0,16,mixedType,2
5,1,0,6,mixedType,0
8,1,0,9,mixedType,1
8,2,0,10,mixedType,1
9,1,0,10,mixedType,1
9,4,0,13,mixedType,1
8,2,0,10,mixedType,1
6,4,0,10,mixedType,1
2,6,0,8,mixedType,1
6,3,0,9,mixedType,1
14,2,0,16,mixedType,2
8,2,0,10,mixedType,1
6,4,0,10,mixedType,1
8,4,0,12,mixedType,1
1,7,0,8,mixedType,1
6,1,0,7,mixedType,0
4,4,0,8,mixedType,1
4,7,0,11,mixedType,1
4,8,0,12,mixedType,1
6,4,0,10,mixedType,1
5,3,0,8,mixedType,1
1,8,0,9,mixedType,1
6,3,0,9,mixedType,1
2,7,0,9,mixedType,1
4,2,0,6,mixedType,0
4,6,0,10,mixedType,1
4,8,0,12,mixedType,1
7,3,0,10,mixedType,1
7,3,0,10,mixedType,1
8,2,0,10,mixedType,1
10,1,0,11,mixedType,1
6,1,0,7,mixedType,0
7,3,0,10,mixedType,1
12,4,0,16,mixedType,2
5,3,0,8,mixedType,1
10,2,2,14,mixedType,2
8,3,0,11,mixedType,1
5,2,0,7,mixedType,0
8,1,0,9,mixedType,1
5,1,0,6,mixedType,0
6,2,0,8,mixedType,1
6,3,0,9,mixedType,1
7,2,0,9,mixedType,1
6,2,0,8,mixedType,1
6,3,0,9,mixedType,1
7,5,0,12,mixedType,1
7,3,0,10,mixedType,1
7,1,0,8,mixedType,1
8,1,0,9,mixedType,1
6,1,0,7,mixedType,0
11,3,0,14,mixedType,2
8,2,0,10,mixedType,1
6,4,0,10,mixedType,1
6,2,0,8,mixedType,1
7,3,0,10,mixedType,1
9,1,0,10,mixedType,1
16,2,0,18,mixedType,2
6,3,0,9,mixedType,1
2,6,0,8,mixedType,1
7,3,0,10,mixedType,1
3,8,0,11,mixedType,1
5,1,0,6,mixedType,0
3,7,0,10,mixedType,1
4,4,0,8,mixedType,1
6,2,0,8,mixedType,1
6,4,0,10,mixedType,1
9,2,0,11,mixedType,1
3,5,0,8,mixedType,1
9,1,0,10,mixedType,1
7,3,0,10,mixedType,1
11,1,0,12,mixedType,1
5,2,0,7,mixedType,0
8,3,0,11,mixedType,1
6,1,0,7,mixedType,0
7,4,0,11,mixedType,1
8,2,0,10,mixedType,1
7,2,0,9,mixedType,1
13,3,0,16,mixedType,2
7,1,0,8,mixedType,1
8,1,0,9,mixedType,1
7,2,0,9,mixedType,1
3,6,0,9,mixedType,1
7,2,0,9,mixedType,1
9,1,0,10,mixedType,1
3,6,0,9,mixedType,1
8,1,0,9,mixedType,1
7,3,0,10,mixedType,1
6,5,0,11,mixedType,1
6,1,0,7,mixedType,0
9,1,0,10,mixedType,1
7,6,0,13,mixedType,1
7,2,0,9,mixedType,1
1,7,0,8,mixedType,1
7,3,0,10,mixedType,1
4,5,0,9,mixedType,1
7,4,0,11,mixedType,1
7,1,0,8,mixedType,1
6,5,0,11,mixedType,1
7,3,0,10,mixedType,1
7,2,0,9,mixedType,1
7,2,0,9,mixedType,1
12,4,0,16,mixedType,2
7,2,0,9,mixedType,1
6,3,0,9,mixedType,1
6,2,0,8,mixedType,1
13,3,0,16,mixedType,2
5,4,0,9,mixedType,1
7,2,0,9,mixedType,1
7,3,0,10,mixedType,1
6,3,0,9,mixedType,1
15,1,0,16,mixedType,2
4,4,0,8,mixedType,1
3,8,0,11,mixedType,1
4,6,0,10,mixedType,1
10,1,0,11,mixedType,1
5,3,0,8,mixedType,1
5,6,0,11,mixedType,1
8,2,0,10,mixedType,1
9,1,0,10,mixedType,1
6,3,0,9,mixedType,1
4,2,0,6,mixedType,0
5,2,0,7,mixedType,0
5,4,0,9,mixedType,1
4,2,0,6,mixedType,0
6,1,0,7,mixedType,0
5,2,0,7,mixedType,0
5,4,0,9,mixedType,1
6,3,0,9,mixedType,1
4,4,0,8,mixedType,1
5,4,0,9,mixedType,1
9,1,0,10,mixedType,1
6,3,0,9,mixedType,1
6,1,0,7,mixedType,0
13,3,0,16,mixedType,2
14,2,0,16,mixedType,2
7,3,0,10,mixedType,1
5,2,0,7,mixedType,0
5,3,0,8,mixedType,1
5,3,0,8,mixedType,1
5,1,0,6,mixedType,0
4,4,0,8,mixedType,1
7,3,0,10,mixedType,1
13,3,0,16,mixedType,2
11,5,0,16,mixedType,2
7,1,0,8,mixedType,1
7,10,1,18,mixedType,2
5,4,0,9,mixedType,1
5,3,0,8,mixedType,1
2,6,0,8,mixedType,1
7,5,0,12,mixedType,1
4,2,0,6,mixedType,0
4,4,0,8,mixedType,1
5,3,0,8,mixedType,1
6,1,0,7,mixedType,0
8,2,0,10,mixedType,1
4,8,0,12,mixedType,1
5,0,2,7,mixedType,0
10,1,0,11,mixedType,1
1,8,0,9,mixedType,1
5,1,0,6,mixedType,0
4,6,0,10,mixedType,1
5,8,0,13,mixedType,1
8,1,0,9,mixedType,1
14,2,0,16,mixedType,2
6,1,0,7,mixedType,0
6,2,0,8,mixedType,1
6,3,0,9,mixedType,1
6,2,0,8,mixedType,1
1,10,0,11,mixedType,1
13,3,0,16,mixedType,2
7,2,0,9,mixedType,1
6,3,0,9,mixedType,1
4,2,0,6,mixedType,0
6,4,0,10,mixedType,1
10,3,0,13,mixedType,1
1,9,0,10,mixedType,1
13,3,0,16,mixedType,2
2,8,0,10,mixedType,1
6,2,0,8,mixedType,1
5,2,0,7,mixedType,0
5,4,0,9,mixedType,1
6,4,0,10,mixedType,1
6,1,1,8,mixedType,1
11,1,0,12,mixedType,1
5,1,0,6,mixedType,0
14,2,0,16,mixedType,2
7,1,0,8,mixedType,1
1,8,0,9,mixedType,1
5,4,0,9,mixedType,1
6,2,0,8,mixedType,1
4,2,0,6,mixedType,0
7,3,0,10,mixedType,1
6,3,0,9,mixedType,1
1,8,0,9,mixedType,1
5,2,0,7,mixedType,0
15,1,0,16,mixedType,2
6,3,0,9,mixedType,1
8,2,0,10,mixedType,1
3,7,0,10,mixedType,1
15,1,0,16,mixedType,2
1,10,0,11,mixedType,1
6,2,0,8,mixedType,1
8,1,0,9,mixedType,1
10,4,0,14,mixedType,2
6,3,0,9,mixedType,1
5,2,0,7,mixedType,0
9,3,3,15,mixedType,2
14,2,0,16,mixedType,2
7,3,0,10,mixedType,1
5,3,0,8,mixedType,1
7,2,0,9,mixedType,1
19,6,0,25,mixedType,2
5,5,0,10,mixedType,1
7,3,0,10,mixedType,1
6,2,0,8,mixedType,1
10,2,0,12,mixedType,1
3,7,0,10,mixedType,1
6,4,0,10,mixedType,1
8,1,0,9,mixedType,1
1,7,0,8,mixedType,1
6,3,0,9,mixedType,1
4,2,0,6,mixedType,0
4,2,0,6,mixedType,0
7,2,0,9,mixedType,1
9,2,0,11,mixedType,1
12,3,0,15,mixedType,2
5,2,0,7,mixedType,0
5,3,0,8,mixedType,1
4,2,0,6,mixedType,0
7,3,0,10,mixedType,1
15,1,0,16,mixedType,2
11,5,0,16,mixedType,2
6,3,0,9,mixedType,1
8,1,0,9,mixedType,1
7,2,0,9,mixedType,1
6,3,0,9,mixedType,1
7,2,0,9,mixedType,1
7,1,0,8,mixedType,1
6,3,0,9,mixedType,1
11,4,0,15,mixedType,2
7,3,0,10,mixedType,1
8,4,0,12,mixedType,1
10,3,0,13,mixedType,1
6,3,0,9,mixedType,1
3,7,0,10,mixedType,1
7,2,0,9,mixedType,1
9,1,0,10,mixedType,1
8,1,0,9,mixedType,1
8,1,0,9,mixedType,1
6,3,0,9,mixedType,1
7,2,0,9,mixedType,1
7,3,0,10,mixedType,1
8,1,0,9,mixedType,1
6,3,0,9,mixedType,1
9,3,0,12,mixedType,1
7,1,0,8,mixedType,1
13,3,0,16,mixedType,2
8,1,0,9,mixedType,1
7,2,0,9,mixedType,1
6,2,0,8,mixedType,1
6,3,0,9,mixedType,1
5,2,0,7,mixedType,0
10,1,0,11,mixedType,1
7,2,0,9,mixedType,1
7,4,0,11,mixedType,1
9,3,0,12,mixedType,1
5,3,0,8,mixedType,1
14,2,0,16,mixedType,2
6,3,0,9,mixedType,1
8,2,0,10,mixedType,1
14,2,0,16,mixedType,2
4,4,0,8,mixedType,1
2,8,0,10,mixedType,1
6,2,0,8,mixedType,1
5,3,0,8,mixedType,1
4,2,0,6,mixedType,0
5,3,0,8,mixedType,1
14,2,0,16,mixedType,2
13,3,0,16,mixedType,2
5,2,0,7,mixedType,0
5,8,0,13,mixedType,1
4,6,0,10,mixedType,1
8,3,0,11,mixedType,1
8,3,0,11,mixedType,1
4,2,0,6,mixedType,0
6,6,0,12,mixedType,1
13,3,0,16,mixedType,2
14,2,0,16,mixedType,2
6,3,0,9,mixedType,1
6,4,0,10,mixedType,1
8,2,0,10,mixedType,1
5,3,0,8,mixedType,1
5,0,0,5,sameType,0
2,8,0,10,mixedType,1
8,1,0,9,mixedType,1
4,4,0,8,mixedType,1
6,4,0,10,mixedType,1
8,1,0,9,mixedType,1
9,3,0,12,mixedType,1
5,1,0,6,mixedType,0
14,2,0,16,mixedType,2
7,5,0,12,mixedType,1
13,3,0,16,mixedType,2
6,2,0,8,mixedType,1
7,1,0,8,mixedType,1
1,9,0,10,mixedType,1
8,4,0,12,mixedType,1
7,2,0,9,mixedType,1
7,3,0,10,mixedType,1
12,1,0,13,mixedType,1
1,10,0,11,mixedType,1
4,4,0,8,mixedType,1
11,2,0,13,mixedType,1
5,3,0,8,mixedType,1
4,2,0,6,mixedType,0
7,3,0,10,mixedType,1
9,1,0,10,mixedType,1
11,2,0,13,mixedType,1
9,4,0,13,mixedType,1
7,3,0,10,mixedType,1
9,1,0,10,mixedType,1
7,2,0,9,mixedType,1
5,1,0,6,mixedType,0
6,3,0,9,mixedType,1
7,4,0,11,mixedType,1
9,1,0,10,mixedType,1
6,1,0,7,mixedType,0
5,3,0,8,mixedType,1
7,2,0,9,mixedType,1
5,2,0,7,mixedType,0
4,4,0,8,mixedType,1
3,5,0,8,mixedType,1
7,2,0,9,mixedType,1
6,1,0,7,mixedType,0
3,9,0,12,mixedType,1
8,2,0,10,mixedType,1
4,6,0,10,mixedType,1
5,2,0,7,mixedType,0
4,5,0,9,mixedType,1
5,6,0,11,mixedType,1
8,1,0,9,mixedType,1
1,8,0,9,mixedType,1
8,1,0,9,mixedType,1
8,3,0,11,mixedType,1
8,2,0,10,mixedType,1
6,8,1,15,mixedType,2
4,7,0,11,mixedType,1
5,6,0,11,mixedType,1
7,3,0,10,mixedType,1
6,3,0,9,mixedType,1
13,3,0,16,mixedType,2
6,3,0,9,mixedType,1
13,3,0,16,mixedType,2
7,3,0,10,mixedType,1
3,9,0,12,mixedType,1
5,1,0,6,mixedType,0
6,6,0,12,mixedType,1
6,6,0,12,mixedType,1
6,1,0,7,mixedType,0
1,7,0,8,mixedType,1
4,2,0,6,mixedType,0
7,2,0,9,mixedType,1
7,1,0,8,mixedType,1
9,2,0,11,mixedType,1
12,4,0,16,mixedType,2
10,2,0,12,mixedType,1
5,6,0,11,mixedType,1
9,1,0,10,mixedType,1
6,3,0,9,mixedType,1
8,1,0,9,mixedType,1
7,3,0,10,mixedType,1
7,2,0,9,mixedType,1
4,2,0,6,mixedType,0
9,2,0,11,mixedType,1
7,3,0,10,mixedType,1
7,2,0,9,mixedType,1
6,1,0,7,mixedType,0
6,4,0,10,mixedType,1
4,4,0,8,mixedType,1
14,2,0,16,mixedType,2
14,2,0,16,mixedType,2
9,1,0,10,mixedType,1
5,2,0,7,mixedType,0
14,2,0,16,mixedType,2
8,2,0,10,mixedType,1
7,2,0,9,mixedType,1
15,1,0,16,mixedType,2
9,1,0,10,mixedType,1
13,3,0,16,mixedType,2
6,6,0,12,mixedType,1
3,7,0,10,mixedType,1
8,1,0,9,mixedType,1
12,3,0,15,mixedType,2
6,4,0,10,mixedType,1
6,4,0,10,mixedType,1
5,6,0,11,mixedType,1
6,3,0,9,mixedType,1
7,1,0,8,mixedType,1
5,3,0,8,mixedType,1
4,4,0,8,mixedType,1
14,2,0,16,mixedType,2
8,1,0,9,mixedType,1
15,1,0,16,mixedType,2
13,3,0,16,mixedType,2
2,6,0,8,mixedType,1
8,1,0,9,mixedType,1
4,4,0,8,mixedType,1
7,3,0,10,mixedType,1
7,2,0,9,mixedType,1
4,2,0,6,mixedType,0
9,1,0,10,mixedType,1
7,2,0,9,mixedType,1
7,3,0,10,mixedType,1
6,3,0,9,mixedType,1
6,2,0,8,mixedType,1
5,4,0,9,mixedType,1
4,2,0,6,mixedType,0
6,3,0,9,mixedType,1
3,3,0,6,mixedType,0
9,1,0,10,mixedType,1
4,2,0,6,mixedType,0
6,2,0,8,mixedType,1
2,8,0,10,mixedType,1
7,3,0,10,mixedType,1
8,3,0,11,mixedType,1
5,8,0,13,mixedType,1
7,3,0,10,mixedType,1
8,2,0,10,mixedType,1
13,3,0,16,mixedType,2
15,2,0,17,mixedType,2
7,2,0,9,mixedType,1
5,2,0,7,mixedType,0
3,7,0,10,mixedType,1
5,6,0,11,mixedType,1
6,3,0,9,mixedType,1
7,1,0,8,mixedType,1
4,2,0,6,mixedType,0
5,4,0,9,mixedType,1
9,2,0,11,mixedType,1
7,4,0,11,mixedType,1
9,3,0,12,mixedType,1
1,8,0,9,mixedType,1
8,3,0,11,mixedType,1
8,2,0,10,mixedType,1
4,7,0,11,mixedType,1
5,6,0,11,mixedType,1
4,6,0,10,mixedType,1
6,4,0,10,mixedType,1
9,2,0,11,mixedType,1
7,2,0,9,mixedType,1
8,2,0,10,mixedType,1
7,2,0,9,mixedType,1
8,1,0,9,mixedType,1
9,3,0,12,mixedType,1
5,3,0,8,mixedType,1
9,4,0,13,mixedType,1
5,2,0,7,mixedType,0
7,1,0,8,mixedType,1
5,4,0,9,mixedType,1
3,8,0,11,mixedType,1
1,8,0,9,mixedType,1
4,2,0,6,mixedType,0
2,6,0,8,mixedType,1
10,2,0,12,mixedType,1
14,2,0,16,mixedType,2
2,6,0,8,mixedType,1
10,1,0,11,mixedType,1
15,1,0,16,mixedType,2
6,4,0,10,mixedType,1
14,2,0,16,mixedType,2
6,1,0,7,mixedType,0
2,8,0,10,mixedType,1
5,1,0,6,mixedType,0
9,4,0,13,mixedType,1
7,2,0,9,mixedType,1
2,11,0,13,mixedType,1
7,3,0,10,mixedType,1
12,4,0,16,mixedType,2
11,3,0,14,mixedType,2
1,7,0,8,mixedType,1
8,4,0,12,mixedType,1
8,3,0,11,mixedType,1
5,4,0,9,mixedType,1
13,3,0,16,mixedType,2
4,4,0,8,mixedType,1
7,3,0,10,mixedType,1
14,2,0,16,mixedType,2
7,6,0,13,mixedType,1
5,6,0,11,mixedType,1
8,1,0,9,mixedType,1
4,2,0,6,mixedType,0
9,1,0,10,mixedType,1
6,3,0,9,mixedType,1
6,3,0,9,mixedType,1
6,1,0,7,mixedType,0
8,3,0,11,mixedType,1
7,1,0,8,mixedType,1
6,3,0,9,mixedType,1
12,4,0,16,mixedType,2
10,2,0,12,mixedType,1
3,5,0,8,mixedType,1
6,4,0,10,mixedType,1
3,5,0,8,mixedType,1
6,2,0,8,mixedType,1
5,3,0,8,mixedType,1
7,2,0,9,mixedType,1
2,7,0,9,mixedType,1
7,3,0,10,mixedType,1
11,3,0,14,mixedType,2
7,4,0,11,mixedType,1
6,2,0,8,mixedType,1
3,5,0,8,mixedType,1
1,7,0,8,mixedType,1
7,3,0,10,mixedType,1
6,3,0,9,mixedType,1
13,3,0,16,mixedType,2
6,1,0,7,mixedType,0
1,8,0,9,mixedType,1
2,4,0,6,mixedType,0
4,4,0,8,mixedType,1
4,2,0,6,mixedType,0
10,2,0,12,mixedType,1
8,2,0,10,mixedType,1
4,2,0,6,mixedType,0
4,2,0,6,mixedType,0
3,5,0,8,mixedType,1
9,2,0,11,mixedType,1
2,7,0,9,mixedType,1
1,11,0,12,mixedType,1
8,1,0,9,mixedType,1
5,1,0,6,mixedType,0
6,1,0,7,mixedType,0
4,4,0,8,mixedType,1
6,3,0,9,mixedType,1
9,1,0,10,mixedType,1
7,2,0,9,mixedType,1
8,1,0,9,mixedType,1
7,1,0,8,mixedType,1
12,4,0,16,mixedType,2
4,6,0,10,mixedType,1
6,1,0,7,mixedType,0
5,3,0,8,mixedType,1
6,3,0,9,mixedType,1
8,6,0,14,mixedType,2
4,4,0,8,mixedType,1
6,3,0,9,mixedType,1
9,2,0,11,mixedType,1
4,2,0,6,mixedType,0
11,1,0,12,mixedType,1
1,7,0,8,mixedType,1
9,4,0,13,mixedType,1
4,6,0,10,mixedType,1
7,6,0,13,mixedType,1
6,3,0,9,mixedType,1
9,3,0,12,mixedType,1
3,6,0,9,mixedType,1
7,3,0,10,mixedType,1
5,4,0,9,mixedType,1
6,1,0,7,mixedType,0
11,2,0,13,mixedType,1
6,7,0,13,mixedType,1
7,2,0,9,mixedType,1
10,2,0,12,mixedType,1
7,2,0,9,mixedType,1
3,6,0,9,mixedType,1
8,1,0,9,mixedType,1
9,3,0,12,mixedType,1
6,3,0,9,mixedType,1
12,3,0,15,mixedType,2
4,4,0,8,mixedType,1
10,4,0,14,mixedType,2
2,4,0,6,mixedType,0
7,3,0,10,mixedType,1
3,6,0,9,mixedType,1
9,1,0,10,mixedType,1
6,4,0,10,mixedType,1
8,1,0,9,mixedType,1
8,1,0,9,mixedType,1
5,3,0,8,mixedType,1
4,4,0,8,mixedType,1
5,3,0,8,mixedType,1
6,3,0,9,mixedType,1
15,1,0,16,mixedType,2
6,1,0,7,mixedType,0
8,1,0,9,mixedType,1
9,2,0,11,mixedType,1
8,2,0,10,mixedType,1
7,3,0,10,mixedType,1
7,3,0,10,mixedType,1
7,2,0,9,mixedType,1
15,1,0,16,mixedType,2
7,3,0,10,mixedType,1
4,6,0,10,mixedType,1
10,2,0,12,mixedType,1
6,4,0,10,mixedType,1
5,3,0,8,mixedType,1
5,4,0,9,mixedType,1
6,2,0,8,mixedType,1
9,4,0,13,mixedType,1
8,1,0,9,mixedType,1
6,3,0,9,mixedType,1
8,1,0,9,mixedType,1
14,2,0,16,mixedType,2
10,1,0,11,mixedType,1
2,7,0,9,mixedType,1
3,6,0,9,mixedType,1
6,3,0,9,mixedType,1
7,1,0,8,mixedType,1
14,2,0,16,mixedType,2
5,6,0,11,mixedType,1
5,2,0,7,mixedType,0
7,2,0,9,mixedType,1
9,7,0,16,mixedType,2
5,3,0,8,mixedType,1
13,3,0,16,mixedType,2
6,2,0,8,mixedType,1
3,3,0,6,mixedType,0
7,2,0,9,mixedType,1
9,2,0,11,mixedType,1
5,4,0,9,mixedType,1
4,5,0,9,mixedType,1
5,3,0,8,mixedType,1
5,3,0,8,mixedType,1
10,3,0,13,mixedType,1
6,1,0,7,mixedType,0
5,1,0,6,mixedType,0
7,1,0,8,mixedType,1
7,3,0,10,mixedType,1
4,4,0,8,mixedType,1
6,3,0,9,mixedType,1
4,4,0,8,mixedType,1
8,1,0,9,mixedType,1
9,2,0,11,mixedType,1
10,1,0,11,mixedType,1
5,2,0,7,mixedType,0
2,6,0,8,mixedType,1
7,3,0,10,mixedType,1
6,3,0,9,mixedType,1
7,3,0,10,mixedType,1
7,2,0,9,mixedType,1
6,3,0,9,mixedType,1
8,2,0,10,mixedType,1
3,6,0,9,mixedType,1
10,5,0,15,mixedType,2
5,2,0,7,mixedType,0
7,1,0,8,mixedType,1
5,3,0,8,mixedType,1
5,3,0,8,mixedType,1
10,2,0,12,mixedType,1
5,4,0,9,mixedType,1
5,2,0,7,mixedType,0
8,2,0,10,mixedType,1
8,1,0,9,mixedType,1
9,1,0,10,mixedType,1
6,3,0,9,mixedType,1
7,3,0,10,mixedType,1
9,1,0,10,mixedType,1
2,6,0,8,mixedType,1
9,2,0,11,mixedType,1
10,2,0,12,mixedType,1
14,2,0,16,mixedType,2
13,2,0,15,mixedType,2
8,1,0,9,mixedType,1
9,3,0,12,mixedType,1
6,2,0,8,mixedType,1
1,8,0,9,mixedType,1
4,6,0,10,mixedType,1
5,1,0,6,mixedType,0
13,3,0,16,mixedType,2
6,3,0,9,mixedType,1
5,3,0,8,mixedType,1
6,1,0,7,mixedType,0
7,3,0,10,mixedType,1
9,3,0,12,mixedType,1
6,3,0,9,mixedType,1
8,1,0,9,mixedType,1
13,3,0,16,mixedType,2
7,4,0,11,mixedType,1
14,2,0,16,mixedType,2
9,1,0,10,mixedType,1
7,3,0,10,mixedType,1
9,1,0,10,mixedType,1
8,2,0,10,mixedType,1
6,3,0,9,mixedType,1
8,0,1,9,mixedType,1
7,3,0,10,mixedType,1
5,3,0,8,mixedType,1
7,6,0,13,mixedType,1
6,4,0,10,mixedType,1
3,7,0,10,mixedType,1
2,6,0,8,mixedType,1
6,3,0,9,mixedType,1
15,1,0,16,mixedType,2
4,4,0,8,mixedType,1
5,3,0,8,mixedType,1
5,2,0,7,mixedType,0
4,2,0,6,mixedType,0
14,2,0,16,mixedType,2
1,8,0,9,mixedType,1
6,2,0,8,mixedType,1
5,2,0,7,mixedType,0
5,4,0,9,mixedType,1
8,4,0,12,mixedType,1
7,2,0,9,mixedType,1
11,1,0,12,mixedType,1
7,2,0,9,mixedType,1
12,4,0,16,mixedType,2
7,3,0,10,mixedType,1
4,4,0,8,mixedType,1
14,1,0,15,mixedType,2
6,1,0,7,mixedType,0
14,2,0,16,mixedType,2
4,2,0,6,mixedType,0
6,2,0,8,mixedType,1
6,2,0,8,mixedType,1
4,2,0,6,mixedType,0
9,4,0,13,mixedType,1
6,7,0,13,mixedType,1
5,2,0,7,mixedType,0
6,5,0,11,mixedType,1
4,4,0,8,mixedType,1
5,6,0,11,mixedType,1
12,3,0,15,mixedType,2
8,1,0,9,mixedType,1
5,5,0,10,mixedType,1
8,1,0,9,mixedType,1
12,3,0,15,mixedType,2
8,1,0,9,mixedType,1
8,2,0,10,mixedType,1
6,1,0,7,mixedType,0
9,2,0,11,mixedType,1
4,2,0,6,mixedType,0
14,2,0,16,mixedType,2
5,2,0,7,mixedType,0
8,1,0,9,mixedType,1
7,3,0,10,mixedType,1
8,4,0,12,mixedType,1
6,1,0,7,mixedType,0
6,3,0,9,mixedType,1
6,4,0,10,mixedType,1
10,4,0,14,mixedType,2
6,2,0,8,mixedType,1
5,3,0,8,mixedType,1
7,4,0,11,mixedType,1
6,3,0,9,mixedType,1
6,3,0,9,mixedType,1
13,3,0,16,mixedType,2
8,2,0,10,mixedType,1
4,4,0,8,mixedType,1
6,1,0,7,mixedType,0
8,2,0,10,mixedType,1
12,0,1,13,mixedType,1
6,3,0,9,mixedType,1
5,2,0,7,mixedType,0
5,3,0,8,mixedType,1
10,4,1,15,mixedType,2
7,4,0,11,mixedType,1
7,1,0,8,mixedType,1
6,3,0,9,mixedType,1
8,4,0,12,mixedType,1
7,6,0,13,mixedType,1
6,2,0,8,mixedType,1
7,3,0,10,mixedType,1
4,2,0,6,mixedType,0
6,3,0,9,mixedType,1
9,1,0,10,mixedType,1
13,3,0,16,mixedType,2
8,2,0,10,mixedType,1
9,1,0,10,mixedType,1
5,3,0,8,mixedType,1
9,4,0,13,mixedType,1
6,1,0,7,mixedType,0
6,3,0,9,mixedType,1
6,4,0,10,mixedType,1
7,2,0,9,mixedType,1
6,4,0,10,mixedType,1
7,2,0,9,mixedType,1
15,1,0,16,mixedType,2
6,3,0,9,mixedType,1
6,3,0,9,mixedType,1
11,1,0,12,mixedType,1
8,2,0,10,mixedType,1
3,6,0,9,mixedType,1
9,3,0,12,mixedType,1
7,3,0,10,mixedType,1
2,8,0,10,mixedType,1
10,6,0,16,mixedType,2
5,2,0,7,mixedType,0
11,3,0,14,mixedType,2
7,2,0,9,mixedType,1
6,3,0,9,mixedType,1
7,2,0,9,mixedType,1
7,2,0,9,mixedType,1
7,1,0,8,mixedType,1
6,3,0,9,mixedType,1
6,3,0,9,mixedType,1
6,4,0,10,mixedType,1
10,1,0,11,mixedType,1
6,6,0,12,mixedType,1
13,3,0,16,mixedType,2
2,6,0,8,mixedType,1
14,2,0,16,mixedType,2
6,3,0,9,mixedType,1
12,1,0,13,mixedType,1
5,2,0,7,mixedType,0
6,4,0,10,mixedType,1
6,1,0,7,mixedType,0
6,4,0,10,mixedType,1
7,2,0,9,mixedType,1
6,5,0,11,mixedType,1
14,2,0,16,mixedType,2
6,4,0,10,mixedType,1
5,3,0,8,mixedType,1
6,2,0,8,mixedType,1
5,3,0,8,mixedType,1
9,3,0,12,mixedType,1
15,1,0,16,mixedType,2
12,3,0,15,mixedType,2
4,2,0,6,mixedType,0
2,8,0,10,mixedType,1
7,2,0,9,mixedType,1
14,2,0,16,mixedType,2
5,3,0,8,mixedType,1
7,3,0,10,mixedType,1
5,2,0,7,mixedType,0
12,4,0,16,mixedType,2
5,1,0,6,mixedType,0
15,1,0,16,mixedType,2
6,3,0,9,mixedType,1
9,1,0,10,mixedType,1
6,3,0,9,mixedType,1
2,6,0,8,mixedType,1
9,1,0,10,mixedType,1
7,4,0,11,mixedType,1
5,2,0,7,mixedType,0
13,10,0,23,mixedType,2
8,2,0,10,mixedType,1
7,0,1,8,mixedType,1
7,3,0,10,mixedType,1
15,1,0,16,mixedType,2
7,2,0,9,mixedType,1
6,2,0,8,mixedType,1
1,8,0,9,mixedType,1
9,3,0,12,mixedType,1
10,4,0,14,mixedType,2
5,4,0,9,mixedType,1
5,4,0,9,mixedType,1
9,2,0,11,mixedType,1
5,2,0,7,mixedType,0
5,2,0,7,mixedType,0
6,3,0,9,mixedType,1
9,1,0,10,mixedType,1
6,4,0,10,mixedType,1
13,3,0,16,mixedType,2
15,1,0,16,mixedType,2
7,3,0,10,mixedType,1
5,4,0,9,mixedType,1
6,1,0,7,mixedType,0
1,8,0,9,mixedType,1
5,4,0,9,mixedType,1
7,3,0,10,mixedType,1
9,1,0,10,mixedType,1
6,3,0,9,mixedType,1
6,4,0,10,mixedType,1
5,3,0,8,mixedType,1
2,8,0,10,mixedType,1
5,3,0,8,mixedType,1
7,4,0,11,mixedType,1
8,1,0,9,mixedType,1
6,2,0,8,mixedType,1
15,1,0,16,mixedType,2
8,4,0,12,mixedType,1
7,3,0,10,mixedType,1
7,3,0,10,mixedType,1
8,2,0,10,mixedType,1
14,2,0,16,mixedType,2
11,3,0,14,mixedType,2
9,2,0,11,mixedType,1
7,2,0,9,mixedType,1
6,3,0,9,mixedType,1
15,1,0,16,mixedType,2
1,9,0,10,mixedType,1
6,6,0,12,mixedType,1
9,1,0,10,mixedType,1
4,4,0,8,mixedType,1
7,1,0,8,mixedType,1
6,1,0,7,mixedType,0
4,4,0,8,mixedType,1
14,2,0,16,mixedType,2
7,3,0,10,mixedType,1
9,1,0,10,mixedType,1
5,1,0,6,mixedType,0
7,5,0,12,mixedType,1
6,4,0,10,mixedType,1
4,2,0,6,mixedType,0
5,2,0,7,mixedType,0
6,1,0,7,mixedType,0
14,2,0,16,mixedType,2
10,3,0,13,mixedType,1
3,7,0,10,mixedType,1
7,8,0,15,mixedType,2
4,8,0,12,mixedType,1
7,3,0,10,mixedType,1
7,2,0,9,mixedType,1
9,1,0,10,mixedType,1
6,3,0,9,mixedType,1
3,6,0,9,mixedType,1
14,2,0,16,mixedType,2
10,2,0,12,mixedType,1
6,2,0,8,mixedType,1
5,2,0,7,mixedType,0
13,3,0,16,mixedType,2
4,4,0,8,mixedType,1
4,2,0,6,mixedType,0
6,1,0,7,mixedType,0
5,4,0,9,mixedType,1
5,2,0,7,mixedType,0
9,3,0,12,mixedType,1
3,6,0,9,mixedType,1
7,3,0,10,mixedType,1
9,2,0,11,mixedType,1
7,3,0,10,mixedType,1
6,2,0,8,mixedType,1
5,3,0,8,mixedType,1
6,3,0,9,mixedType,1
5,3,0,8,mixedType,1
6,1,0,7,mixedType,0
1,8,0,9,mixedType,1
11,1,0,12,mixedType,1
9,3,0,12,mixedType,1
3,6,0,9,mixedType,1
7,2,0,9,mixedType,1
9,4,0,13,mixedType,1
6,1,0,7,mixedType,0
8,4,0,12,mixedType,1
8,2,0,10,mixedType,1
3,5,0,8,mixedType,1
11,2,5,18,mixedType,2
6,3,0,9,mixedType,1
4,4,0,8,mixedType,1
6,2,0,8,mixedType,1
1,10,0,11,mixedType,1
4,2,0,6,mixedType,0
7,3,0,10,mixedType,1
5,2,0,7,mixedType,0
8,4,0,12,mixedType,1
6,1,0,7,mixedType,0
8,1,0,9,mixedType,1
15,1,0,16,mixedType,2
8,4,0,12,mixedType,1
7,3,0,10,mixedType,1
8,1,0,9,mixedType,1
6,4,0,10,mixedType,1
9,1,0,10,mixedType,1
13,3,0,16,mixedType,2
6,3,0,9,mixedType,1
7,3,0,10,mixedType,1
5,2,0,7,mixedType,0
5,3,0,8,mixedType,1
1,7,0,8,mixedType,1
8,0,1,9,mixedType,1
5,4,0,9,mixedType,1
6,2,0,8,mixedType,1
6,2,0,8,mixedType,1
10,1,0,11,mixedType,1
9,3,0,12,mixedType,1
13,3,0,16,mixedType,2
6,3,0,9,mixedType,1
2,6,0,8,mixedType,1
8,1,0,9,mixedType,1
7,1,0,8,mixedType,1
4,6,0,10,mixedType,1
6,4,0,10,mixedType,1
11,2,0,13,mixedType,1
4,2,0,6,mixedType,0
8,1,0,9,mixedType,1
5,1,0,6,mixedType,0
7,1,0,8,mixedType,1
5,4,0,9,mixedType,1
1,8,0,9,mixedType,1
8,3,0,11,mixedType,1
8,2,0,10,mixedType,1
9,4,1,14,mixedType,2
2,6,0,8,mixedType,1
5,2,0,7,mixedType,0
5,7,0,12,mixedType,1
7,2,0,9,mixedType,1
5,4,0,9,mixedType,1
9,3,0,12,mixedType,1
15,1,0,16,mixedType,2
6,1,0,7,mixedType,0
6,4,0,10,mixedType,1
6,2,0,8,mixedType,1
3,6,0,9,mixedType,1
13,3,0,16,mixedType,2
7,2,0,9,mixedType,1
6,3,0,9,mixedType,1
11,3,0,14,mixedType,2
5,2,0,7,mixedType,0
3,7,0,10,mixedType,1
6,1,0,7,mixedType,0
1,8,0,9,mixedType,1
1,8,0,9,mixedType,1
6,3,0,9,mixedType,1
7,3,0,10,mixedType,1
6,3,0,9,mixedType,1
5,2,0,7,mixedType,0
4,6,0,10,mixedType,1
14,2,0,16,mixedType,2
3,6,0,9,mixedType,1
5,2,0,7,mixedType,0
5,2,0,7,mixedType,0
5,2,0,7,mixedType,0
12,4,0,16,mixedType,2
5,4,0,9,mixedType,1
14,1,1,16,mixedType,2
14,2,0,16,mixedType,2
6,2,0,8,mixedType,1
7,5,0,12,mixedType,1
6,2,0,8,mixedType,1
6,2,0,8,mixedType,1
8,1,0,9,mixedType,1
5,3,0,8,mixedType,1
5,1,0,6,mixedType,0
6,1,0,7,mixedType,0
12,3,0,15,mixedType,2
7,2,0,9,mixedType,1
5,3,0,8,mixedType,1
7,1,0,8,mixedType,1
2,4,0,6,mixedType,0
6,1,0,7,mixedType,0
4,4,0,8,mixedType,1
7,2,0,9,mixedType,1
9,2,0,11,mixedType,1
3,5,0,8,mixedType,1
6,3,0,9,mixedType,1
6,3,0,9,mixedType,1
5,2,0,7,mixedType,0
6,1,0,7,mixedType,0
8,3,0,11,mixedType,1
1,12,0,13,mixedType,1
13,3,0,16,mixedType,2
9,2,0,11,mixedType,1
11,5,0,16,mixedType,2
5,1,0,6,mixedType,0
4,4,0,8,mixedType,1
5,3,0,8,mixedType,1
3,10,0,13,mixedType,1
8,2,0,10,mixedType,1
8,2,0,10,mixedType,1
6,2,0,8,mixedType,1
5,1,0,6,mixedType,0
6,6,0,12,mixedType,1
7,3,0,10,mixedType,1
3,6,0,9,mixedType,1
8,1,0,9,mixedType,1
1,8,0,9,mixedType,1
7,3,0,10,mixedType,1
8,3,0,11,mixedType,1
12,3,0,15,mixedType,2
5,2,0,7,mixedType,0
8,2,0,10,mixedType,1
5,4,0,9,mixedType,1
6,1,0,7,mixedType,0
1,7,0,8,mixedType,1
6,4,0,10,mixedType,1
15,1,0,16,mixedType,2
9,1,0,10,mixedType,1
9,1,0,10,mixedType,1
14,2,0,16,mixedType,2
5,2,0,7,mixedType,0
7,2,0,9,mixedType,1
10,1,0,11,mixedType,1
7,1,0,8,mixedType,1
7,3,0,10,mixedType,1
9,1,0,10,mixedType,1
3,6,0,9,mixedType,1
9,2,0,11,mixedType,1
8,1,0,9,mixedType,1
7,3,0,10,mixedType,1
13,3,0,16,mixedType,2
6,3,0,9,mixedType,1
6,3,0,9,mixedType,1
4,4,0,8,mixedType,1
5,6,0,11,mixedType,1
7,2,0,9,mixedType,1
1,7,0,8,mixedType,1
6,4,0,10,mixedType,1
7,3,0,10,mixedType,1
6,2,0,8,mixedType,1
1,9,0,10,mixedType,1
1,8,0,9,mixedType,1
10,7,1,18,mixedType,2
8,3,0,11,mixedType,1
6,3,0,9,mixedType,1
3,3,0,6,mixedType,0
8,1,0,9,mixedType,1
4,6,0,10,mixedType,1
9,1,0,10,mixedType,1
5,1,0,6,mixedType,0
6,3,0,9,mixedType,1
5,4,0,9,mixedType,1
8,3,0,11,mixedType,1
5,5,0,10,mixedType,1
4,4,0,8,mixedType,1
4,6,0,10,mixedType,1
6,3,0,9,mixedType,1
8,1,0,9,mixedType,1
6,3,0,9,mixedType,1
6,1,0,7,mixedType,0
5,2,0,7,mixedType,0
4,6,0,10,mixedType,1
6,3,0,9,mixedType,1
5,3,0,8,mixedType,1
10,3,0,13,mixedType,1
2,8,0,10,mixedType,1
9,2,0,11,mixedType,1
5,1,0,6,mixedType,0
6,3,0,9,mixedType,1
3,3,0,6,mixedType,0
4,9,0,13,mixedType,1
4,2,0,6,mixedType,0
4,4,0,8,mixedType,1
9,1,1,11,mixedType,1
6,2,0,8,mixedType,1
6,2,0,8,mixedType,1
7,2,0,9,mixedType,1
11,1,0,12,mixedType,1
4,4,0,8,mixedType,1
7,2,0,9,mixedType,1
7,4,0,11,mixedType,1
8,1,0,9,mixedType,1
2,6,0,8,mixedType,1
4,4,0,8,mixedType,1
3,6,0,9,mixedType,1
5,3,0,8,mixedType,1
6,4,0,10,mixedType,1
6,2,0,8,mixedType,1
8,2,0,10,mixedType,1
6,6,0,12,mixedType,1
6,3,0,9,mixedType,1
10,1,0,11,mixedType,1
4,5,0,9,mixedType,1
8,1,0,9,mixedType,1
6,1,0,7,mixedType,0
3,7,0,10,mixedType,1
5,3,0,8,mixedType,1
5,4,0,9,mixedType,1
5,1,0,6,mixedType,0
3,7,0,10,mixedType,1
6,4,0,10,mixedType,1
7,5,0,12,mixedType,1
2,10,0,12,mixedType,1
7,3,0,10,mixedType,1
6,2,0,8,mixedType,1
6,2,0,8,mixedType,1
12,4,0,16,mixedType,2
9,1,0,10,mixedType,1
12,4,0,16,mixedType,2
1,8,0,9,mixedType,1
6,4,0,10,mixedType,1
9,1,0,10,mixedType,1
3,6,0,9,mixedType,1
10,2,0,12,mixedType,1
14,2,0,16,mixedType,2
7,1,0,8,mixedType,1
5,1,0,6,mixedType,0
7,1,0,8,mixedType,1
5,3,0,8,mixedType,1
6,1,0,7,mixedType,0
16,4,0,20,mixedType,2
6,4,0,10,mixedType,1
5,2,0,7,mixedType,0
3,3,0,6,mixedType,0
12,4,0,16,mixedType,2
5,2,0,7,mixedType,0
4,4,0,8,mixedType,1
6,1,0,7,mixedType,0
6,4,0,10,mixedType,1
6,3,0,9,mixedType,1
10,5,0,15,mixedType,2
8,3,0,11,mixedType,1
5,4,0,9,mixedType,1
15,1,0,16,mixedType,2
8,1,0,9,mixedType,1
4,4,0,8,mixedType,1
6,3,0,9,mixedType,1
4,4,0,8,mixedType,1
5,1,0,6,mixedType,0
6,2,0,8,mixedType,1
6,1,0,7,mixedType,0
6,2,0,8,mixedType,1
7,1,0,8,mixedType,1
12,3,0,15,mixedType,2
1,8,0,9,mixedType,1
6,2,0,8,mixedType,1
9,2,0,11,mixedType,1
7,0,1,8,mixedType,1
4,2,0,6,mixedType,0
5,2,0,7,mixedType,0
4,2,0,6,mixedType,0
9,1,0,10,mixedType,1
6,3,0,9,mixedType,1
15,1,0,16,mixedType,2
5,2,0,7,mixedType,0
4,6,0,10,mixedType,1
7,4,0,11,mixedType,1
8,3,0,11,mixedType,1
9,0,1,10,mixedType,1
6,1,0,7,mixedType,0
6,4,0,10,mixedType,1
7,3,0,10,mixedType,1
5,2,0,7,mixedType,0
5,3,0,8,mixedType,1
5,2,0,7,mixedType,0
6,1,0,7,mixedType,0
9,1,0,10,mixedType,1
5,2,0,7,mixedType,0
9,2,0,11,mixedType,1
7,1,0,8,mixedType,1
6,2,0,8,mixedType,1
6,3,0,9,mixedType,1
7,2,0,9,mixedType,1
14,2,0,16,mixedType,2
15,1,0,16,mixedType,2
8,4,0,12,mixedType,1
6,4,0,10,mixedType,1
6,3,0,9,mixedType,1
7,2,0,9,mixedType,1
5,4,0,9,mixedType,1
16,4,0,20,mixedType,2
6,3,0,9,mixedType,1
6,4,0,10,mixedType,1
2,6,0,8,mixedType,1
9,2,0,11,mixedType,1
4,9,0,13,mixedType,1
6,1,0,7,mixedType,0
6,4,0,10,mixedType,1
7,3,0,10,mixedType,1
5,6,0,11,mixedType,1
7,2,0,9,mixedType,1
5,2,0,7,mixedType,0
8,2,0,10,mixedType,1
6,2,0,8,mixedType,1
7,4,0,11,mixedType,1
6,3,0,9,mixedType,1
5,1,0,6,mixedType,0
9,6,0,15,mixedType,2
6,2,0,8,mixedType,1
4,2,0,6,mixedType,0
6,6,0,12,mixedType,1
4,4,0,8,mixedType,1
7,3,0,10,mixedType,1
4,2,0,6,mixedType,0
11,1,0,12,mixedType,1
6,2,0,8,mixedType,1
11,3,0,14,mixedType,2
6,4,0,10,mixedType,1
5,4,0,9,mixedType,1
5,4,0,9,mixedType,1
7,1,0,8,mixedType,1
1,7,0,8,mixedType,1
5,4,0,9,mixedType,1
2,8,0,10,mixedType,1
3,7,0,10,mixedType,1
6,2,0,8,mixedType,1
6,2,0,8,mixedType,1
7,3,0,10,mixedType,1
13,3,0,16,mixedType,2
13,3,0,16,mixedType,2
15,1,0,16,mixedType,2
5,4,0,9,mixedType,1
4,2,0,6,mixedType,0
7,2,0,9,mixedType,1
9,1,0,10,mixedType,1
6,3,0,9,mixedType,1
9,3,0,12,mixedType,1
13,3,0,16,mixedType,2
7,5,0,12,mixedType,1
2,4,0,6,mixedType,0
10,2,0,12,mixedType,1
11,1,0,12,mixedType,1
6,3,0,9,mixedType,1
8,2,0,10,mixedType,1
5,7,0,12,mixedType,1
6,1,0,7,mixedType,0
6,2,0,8,mixedType,1
15,1,0,16,mixedType,2
7,4,0,11,mixedType,1
2,4,0,6,mixedType,0
9,2,0,11,mixedType,1
5,2,0,7,mixedType,0
6,1,0,7,mixedType,0
14,2,0,16,mixedType,2
5,1,0,6,mixedType,0
5,3,0,8,mixedType,1
6,3,0,9,mixedType,1
9,1,0,10,mixedType,1
7,3,0,10,mixedType,1
7,4,0,11,mixedType,1
6,2,0,8,mixedType,1
5,2,0,7,mixedType,0
5,1,0,6,mixedType,0
6,4,0,10,mixedType,1
9,3,0,12,mixedType,1
9,1,0,10,mixedType,1
13,3,0,16,mixedType,2
4,4,0,8,mixedType,1
5,4,0,9,mixedType,1
4,2,0,6,mixedType,0
5,2,0,7,mixedType,0
5,2,0,7,mixedType,0
6,2,0,8,mixedType,1
7,3,0,10,mixedType,1
6,3,0,9,mixedType,1
4,4,0,8,mixedType,1
9,4,0,13,mixedType,1
7,1,0,8,mixedType,1
8,1,0,9,mixedType,1
8,3,0,11,mixedType,1
6,1,0,7,mixedType,0
3,5,0,8,mixedType,1
9,1,0,10,mixedType,1
1,8,0,9,mixedType,1
8,1,0,9,mixedType,1
6,1,0,7,mixedType,0
6,2,0,8,mixedType,1
6,3,0,9,mixedType,1
15,1,0,16,mixedType,2
6,3,0,9,mixedType,1
8,2,0,10,mixedType,1
1,7,0,8,mixedType,1
4,5,0,9,mixedType,1
5,2,0,7,mixedType,0
7,2,0,9,mixedType,1
8,2,0,10,mixedType,1
4,4,0,8,mixedType,1
7,2,0,9,mixedType,1
5,6,0,11,mixedType,1
5,5,0,10,mixedType,1
6,3,0,9,mixedType,1
11,3,0,14,mixedType,2
5,4,0,9,mixedType,1
6,2,0,8,mixedType,1
5,5,0,10,mixedType,1
10,2,0,12,mixedType,1
6,2,0,8,mixedType,1
6,3,0,9,mixedType,1
7,3,0,10,mixedType,1
7,3,0,10,mixedType,1
7,3,0,10,mixedType,1
5,4,0,9,mixedType,1
8,1,0,9,mixedType,1
6,3,0,9,mixedType,1
4,4,0,8,mixedType,1
7,3,0,10,mixedType,1
1,9,0,10,mixedType,1
5,3,0,8,mixedType,1
14,2,0,16,mixedType,2
7,3,0,10,mixedType,1
8,3,0,11,mixedType,1
5,1,0,6,mixedType,0
8,3,0,11,mixedType,1
4,2,0,6,mixedType,0
3,7,0,10,mixedType,1
10,1,0,11,mixedType,1
3,7,0,10,mixedType,1
6,3,0,9,mixedType,1
10,2,0,12,mixedType,1
4,6,0,10,mixedType,1
4,2,0,6,mixedType,0
5,6,0,11,mixedType,1
4,4,0,8,mixedType,1
9,1,0,10,mixedType,1
6,2,0,8,mixedType,1
6,3,0,9,mixedType,1
13,3,0,16,mixedType,2
15,1,0,16,mixedType,2
3,10,1,14,mixedType,2
1,7,0,8,mixedType,1
6,3,0,9,mixedType,1
2,2,0,4,mixedType,0
8,1,0,9,mixedType,1
6,3,0,9,mixedType,1
5,2,0,7,mixedType,0
7,2,0,9,mixedType,1
7,2,0,9,mixedType,1
9,1,0,10,mixedType,1
6,3,0,9,mixedType,1
2,6,0,8,mixedType,1
4,4,0,8,mixedType,1
6,4,0,10,mixedType,1
5,3,0,8,mixedType,1
5,4,0,9,mixedType,1
8,3,0,11,mixedType,1
8,3,0,11,mixedType,1
14,2,0,16,mixedType,2
6,4,0,10,mixedType,1
6,3,0,9,mixedType,1
5,2,0,7,mixedType,0
5,4,0,9,mixedType,1
2,8,0,10,mixedType,1
9,2,0,11,mixedType,1
9,1,0,10,mixedType,1
8,3,0,11,mixedType,1
8,2,0,10,mixedType,1
3,6,0,9,mixedType,1
4,4,0,8,mixedType,1
4,6,0,10,mixedType,1
5,2,0,7,mixedType,0
7,3,0,10,mixedType,1
11,2,0,13,mixedType,1
8,3,0,11,mixedType,1
6,3,0,9,mixedType,1
6,4,0,10,mixedType,1
5,2,0,7,mixedType,0
14,2,0,16,mixedType,2
7,3,0,10,mixedType,1
0,8,2,10,mixedType,1
1,11,0,12,mixedType,1
7,3,0,10,mixedType,1
5,2,0,7,mixedType,0
5,1,0,6,mixedType,0
5,4,0,9,mixedType,1
4,4,0,8,mixedType,1
2,6,0,8,mixedType,1
5,3,0,8,mixedType,1
6,1,0,7,mixedType,0
7,1,0,8,mixedType,1
10,0,1,11,mixedType,1
4,4,0,8,mixedType,1
9,0,1,10,mixedType,1
5,4,0,9,mixedType,1
7,3,0,10,mixedType,1
13,3,0,16,mixedType,2
10,1,0,11,mixedType,1
8,3,0,11,mixedType,1
3,6,0,9,mixedType,1
5,4,0,9,mixedType,1
12,4,0,16,mixedType,2
7,6,0,13,mixedType,1
12,1,0,13,mixedType,1
7,1,0,8,mixedType,1
9,2,0,11,mixedType,1
7,3,0,10,mixedType,1
7,3,0,10,mixedType,1
5,3,0,8,mixedType,1
6,3,0,9,mixedType,1
6,5,0,11,mixedType,1
7,1,0,8,mixedType,1
6,3,0,9,mixedType,1
13,3,0,16,mixedType,2
14,2,0,16,mixedType,2
6,1,0,7,mixedType,0
2,9,0,11,mixedType,1
1,7,0,8,mixedType,1
5,3,0,8,mixedType,1
3,6,0,9,mixedType,1
14,2,0,16,mixedType,2
1,10,0,11,mixedType,1
7,2,0,9,mixedType,1
5,3,0,8,mixedType,1
8,3,0,11,mixedType,1
4,4,0,8,mixedType,1
6,2,0,8,mixedType,1
6,3,0,9,mixedType,1
8,2,0,10,mixedType,1
6,4,0,10,mixedType,1
7,4,0,11,mixedType,1
6,2,0,8,mixedType,1
7,3,0,10,mixedType,1
4,4,0,8,mixedType,1
2,6,0,8,mixedType,1
6,2,0,8,mixedType,1
6,4,0,10,mixedType,1
8,3,0,11,mixedType,1
6,2,0,8,mixedType,1
14,2,0,16,mixedType,2
6,3,0,9,mixedType,1
6,3,0,9,mixedType,1
4,4,0,8,mixedType,1
15,1,0,16,mixedType,2
2,6,0,8,mixedType,1
7,3,0,10,mixedType,1
15,1,0,16,mixedType,2
14,2,0,16,mixedType,2
6,0,1,7,mixedType,0
7,3,0,10,mixedType,1
7,2,0,9,mixedType,1
6,3,0,9,mixedType,1
11,3,0,14,mixedType,2
5,4,0,9,mixedType,1
7,2,0,9,mixedType,1
2,8,0,10,mixedType,1
9,4,0,13,mixedType,1
5,2,0,7,mixedType,0
5,2,0,7,mixedType,0
6,3,0,9,mixedType,1
12,0,1,13,mixedType,1
10,2,4,16,mixedType,2
5,3,0,8,mixedType,1
7,4,0,11,mixedType,1
5,4,0,9,mixedType,1
7,3,0,10,mixedType,1
5,2,0,7,mixedType,0
10,2,0,12,mixedType,1
5,4,0,9,mixedType,1
7,2,0,9,mixedType,1
5,1,0,6,mixedType,0
7,3,0,10,mixedType,1
15,1,0,16,mixedType,2
5,3,0,8,mixedType,1
7,3,0,10,mixedType,1
6,3,0,9,mixedType,1
7,3,0,10,mixedType,1
8,2,0,10,mixedType,1
12,4,0,16,mixedType,2
12,3,0,15,mixedType,2
8,2,0,10,mixedType,1
6,3,0,9,mixedType,1
6,3,0,9,mixedType,1
7,3,0,10,mixedType,1
4,2,0,6,mixedType,0
5,5,0,10,mixedType,1
6,3,0,9,mixedType,1
6,2,0,8,mixedType,1
18,1,1,20,mixedType,2
5,6,0,11,mixedType,1
7,6,0,13,mixedType,1
2,4,0,6,mixedType,0
10,2,0,12,mixedType,1
1,8,0,9,mixedType,1
5,2,0,7,mixedType,0
14,4,2,20,mixedType,2
6,3,0,9,mixedType,1
5,4,0,9,mixedType,1
4,6,0,10,mixedType,1
2,6,0,8,mixedType,1
8,0,2,10,mixedType,1
6,1,0,7,mixedType,0
7,3,0,10,mixedType,1
6,3,0,9,mixedType,1
8,3,0,11,mixedType,1
9,1,0,10,mixedType,1
14,7,0,21,mixedType,2
9,3,0,12,mixedType,1
9,2,0,11,mixedType,1
9,1,0,10,mixedType,1
6,1,0,7,mixedType,0
8,1,0,9,mixedType,1
9,3,0,12,mixedType,1
6,3,0,9,mixedType,1
7,3,0,10,mixedType,1
9,5,0,14,mixedType,2
1,5,0,6,mixedType,0
8,2,0,10,mixedType,1
14,2,0,16,mixedType,2
2,9,0,11,mixedType,1
3,3,0,6,mixedType,0
7,1,0,8,mixedType,1
4,6,0,10,mixedType,1
10,4,0,14,mixedType,2
2,4,0,6,mixedType,0
2,8,0,10,mixedType,1
4,2,0,6,mixedType,0
0,6,4,10,mixedType,1
12,3,0,15,mixedType,2
4,6,0,10,mixedType,1
7,3,0,10,mixedType,1
6,4,0,10,mixedType,1
5,5,0,10,mixedType,1
5,2,0,7,mixedType,0
8,1,0,9,mixedType,1
8,2,0,10,mixedType,1
7,4,0,11,mixedType,1
5,3,0,8,mixedType,1
5,6,0,11,mixedType,1
8,2,0,10,mixedType,1
9,2,0,11,mixedType,1
9,3,0,12,mixedType,1
5,4,0,9,mixedType,1
5,4,0,9,mixedType,1
15,1,0,16,mixedType,2
4,6,0,10,mixedType,1
5,2,0,7,mixedType,0
6,1,0,7,mixedType,0
6,2,0,8,mixedType,1
6,1,0,7,mixedType,0
7,4,0,11,mixedType,1
2,6,0,8,mixedType,1
7,1,0,8,mixedType,1
7,3,0,10,mixedType,1
6,3,0,9,mixedType,1
7,3,0,10,mixedType,1
4,4,0,8,mixedType,1
9,1,0,10,mixedType,1
8,2,0,10,mixedType,1
7,6,0,13,mixedType,1
4,4,0,8,mixedType,1
6,4,0,10,mixedType,1
6,4,0,10,mixedType,1
5,2,0,7,mixedType,0
6,4,0,10,mixedType,1
5,3,0,8,mixedType,1
3,3,0,6,mixedType,0
4,4,0,8,mixedType,1
11,5,0,16,mixedType,2
9,4,0,13,mixedType,1
9,3,0,12,mixedType,1
5,1,0,6,mixedType,0
9,2,0,11,mixedType,1
6,4,0,10,mixedType,1
8,4,0,12,mixedType,1
12,3,0,15,mixedType,2
3,5,0,8,mixedType,1
7,5,0,12,mixedType,1
9,1,0,10,mixedType,1
6,3,0,9,mixedType,1
10,3,0,13,mixedType,1
6,3,0,9,mixedType,1
4,2,0,6,mixedType,0
8,3,0,11,mixedType,1
8,2,0,10,mixedType,1
11,3,0,14,mixedType,2
5,3,0,8,mixedType,1
14,2,0,16,mixedType,2
7,3,0,10,mixedType,1
8,3,0,11,mixedType,1
7,4,0,11,mixedType,1
7,2,0,9,mixedType,1
14,2,0,16,mixedType,2
8,3,0,11,mixedType,1
6,3,0,9,mixedType,1
7,3,0,10,mixedType,1
5,2,0,7,mixedType,0
7,3,0,10,mixedType,1
8,4,0,12,mixedType,1
6,1,0,7,mixedType,0
1,8,0,9,mixedType,1
9,1,0,10,mixedType,1
3,5,0,8,mixedType,1
7,3,0,10,mixedType,1
3,3,0,6,mixedType,0
6,3,0,9,mixedType,1
5,4,0,9,mixedType,1
9,0,4,13,mixedType,1
7,2,0,9,mixedType,1
7,6,0,13,mixedType,1
9,1,0,10,mixedType,1
8,2,0,10,mixedType,1
5,3,0,8,mixedType,1
7,2,0,9,mixedType,1
9,4,0,13,mixedType,1
8,2,0,10,mixedType,1
4,2,0,6,mixedType,0
5,7,0,12,mixedType,1
5,3,0,8,mixedType,1
5,3,0,8,mixedType,1
7,3,0,10,mixedType,1
6,6,0,12,mixedType,1
15,1,0,16,mixedType,2
7,3,0,10,mixedType,1
5,8,0,13,mixedType,1
13,3,0,16,mixedType,2
6,2,0,8,mixedType,1
6,4,0,10,mixedType,1
6,2,0,8,mixedType,1
8,4,0,12,mixedType,1
5,3,0,8,mixedType,1
6,2,0,8,mixedType,1
6,3,0,9,mixedType,1
6,4,0,10,mixedType,1
10,0,1,11,mixedType,1
13,3,0,16,mixedType,2
7,3,0,10,mixedType,1
6,4,0,10,mixedType,1
6,7,0,13,mixedType,1
6,2,0,8,mixedType,1
4,6,0,10,mixedType,1
6,3,0,9,mixedType,1
8,1,0,9,mixedType,1
6,1,0,7,mixedType,0
9,3,0,12,mixedType,1
9,2,0,11,mixedType,1
7,3,0,10,mixedType,1
11,3,0,14,mixedType,2
5,3,0,8,mixedType,1
13,3,0,16,mixedType,2
4,7,0,11,mixedType,1
7,4,0,11,mixedType,1
7,3,0,10,mixedType,1
10,1,0,11,mixedType,1
7,1,0,8,mixedType,1
13,3,0,16,mixedType,2
6,1,0,7,mixedType,0
5,1,0,6,mixedType,0
6,5,0,11,mixedType,1
10,2,0,12,mixedType,1
5,2,0,7,mixedType,0
9,4,0,13,mixedType,1
1,9,0,10,mixedType,1
15,2,0,17,mixedType,2
2,6,0,8,mixedType,1
9,1,0,10,mixedType,1
8,2,0,10,mixedType,1
3,5,0,8,mixedType,1
6,2,0,8,mixedType,1
7,4,0,11,mixedType,1
13,3,0,16,mixedType,2
5,4,0,9,mixedType,1
6,4,0,10,mixedType,1
6,1,0,7,mixedType,0
8,3,0,11,mixedType,1
9,2,0,11,mixedType,1
5,1,0,6,mixedType,0
5,1,0,6,mixedType,0
5,6,0,11,mixedType,1
13,3,0,16,mixedType,2
11,0,1,12,mixedType,1
5,3,0,8,mixedType,1
6,4,0,10,mixedType,1
1,9,0,10,mixedType,1
6,4,0,10,mixedType,1
12,3,0,15,mixedType,2
14,2,0,16,mixedType,2
5,1,0,6,mixedType,0
5,2,0,7,mixedType,0
9,1,0,10,mixedType,1
2,6,0,8,mixedType,1
6,3,0,9,mixedType,1
5,1,0,6,mixedType,0
7,3,0,10,mixedType,1
5,5,0,10,mixedType,1
7,3,0,10,mixedType,1
9,4,0,13,mixedType,1
6,2,0,8,mixedType,1
8,1,0,9,mixedType,1
4,4,0,8,mixedType,1
8,1,0,9,mixedType,1
7,2,0,9,mixedType,1
7,2,0,9,mixedType,1
7,3,0,10,mixedType,1
11,2,0,13,mixedType,1
6,2,0,8,mixedType,1
5,1,0,6,mixedType,0
7,3,0,10,mixedType,1
3,6,0,9,mixedType,1
3,6,0,9,mixedType,1
5,4,0,9,mixedType,1
6,3,0,9,mixedType,1
7,2,0,9,mixedType,1
6,5,0,11,mixedType,1
7,2,0,9,mixedType,1
5,3,0,8,mixedType,1
5,2,0,7,mixedType,0
4,2,0,6,mixedType,0
7,3,0,10,mixedType,1
8,4,0,12,mixedType,1
5,3,0,8,mixedType,1
1,10,0,11,mixedType,1
14,2,0,16,mixedType,2
4,6,0,10,mixedType,1
3,6,0,9,mixedType,1
8,2,0,10,mixedType,1
6,3,0,9,mixedType,1
9,3,0,12,mixedType,1
10,3,0,13,mixedType,1
5,4,0,9,mixedType,1
6,1,0,7,mixedType,0
8,3,0,11,mixedType,1
5,3,0,8,mixedType,1
7,1,0,8,mixedType,1
8,2,0,10,mixedType,1
4,4,0,8,mixedType,1
6,4,0,10,mixedType,1
9,2,0,11,mixedType,1
4,2,0,6,mixedType,0
9,1,0,10,mixedType,1
6,3,0,9,mixedType,1
5,3,0,8,mixedType,1
4,2,0,6,mixedType,0
9,2,0,11,mixedType,1
11,4,0,15,mixedType,2
8,1,0,9,mixedType,1
15,1,0,16,mixedType,2
6,3,0,9,mixedType,1
4,4,0,8,mixedType,1
2,8,0,10,mixedType,1
5,3,0,8,mixedType,1
5,4,0,9,mixedType,1
3,9,0,12,mixedType,1
8,4,0,12,mixedType,1
4,2,0,6,mixedType,0
6,2,0,8,mixedType,1
6,3,0,9,mixedType,1
4,4,0,8,mixedType,1
5,2,0,7,mixedType,0
8,3,0,11,mixedType,1
7,3,0,10,mixedType,1
5,4,0,9,mixedType,1
9,1,0,10,mixedType,1
2,11,0,13,mixedType,1
6,1,0,7,mixedType,0
7,2,0,9,mixedType,1
14,2,0,16,mixedType,2
7,2,0,9,mixedType,1
4,4,0,8,mixedType,1
2,4,0,6,mixedType,0
6,1,0,7,mixedType,0
15,1,0,16,mixedType,2
8,3,0,11,mixedType,1
12,4,0,16,mixedType,2
8,1,0,9,mixedType,1
5,4,0,9,mixedType,1
6,4,0,10,mixedType,1
4,6,0,10,mixedType,1
1,7,0,8,mixedType,1
13,3,0,16,mixedType,2
1,8,0,9,mixedType,1
5,4,0,9,mixedType,1
8,2,0,10,mixedType,1
8,3,0,11,mixedType,1
6,3,0,9,mixedType,1
12,1,0,13,mixedType,1
6,3,0,9,mixedType,1
4,4,0,8,mixedType,1
7,1,0,8,mixedType,1
6,3,0,9,mixedType,1
1,7,0,8,mixedType,1
6,1,0,7,mixedType,0
6,3,0,9,mixedType,1
5,4,0,9,mixedType,1
6,1,0,7,mixedType,0
9,3,0,12,mixedType,1
6,4,0,10,mixedType,1
6,1,0,7,mixedType,0
6,4,0,10,mixedType,1
7,3,0,10,mixedType,1
6,3,0,9,mixedType,1
6,3,0,9,mixedType,1
6,2,0,8,mixedType,1
6,2,0,8,mixedType,1
3,5,0,8,mixedType,1
5,3,0,8,mixedType,1
5,3,0,8,mixedType,1
13,3,0,16,mixedType,2
6,1,0,7,mixedType,0
13,3,0,16,mixedType,2
5,3,0,8,mixedType,1
7,6,0,13,mixedType,1
4,2,0,6,mixedType,0
8,2,0,10,mixedType,1
8,1,0,9,mixedType,1
8,2,0,10,mixedType,1
4,4,0,8,mixedType,1
7,1,0,8,mixedType,1
9,1,0,10,mixedType,1
5,5,0,10,mixedType,1
1,7,0,8,mixedType,1
2,7,0,9,mixedType,1
4,6,0,10,mixedType,1
1,8,0,9,mixedType,1
11,3,0,14,mixedType,2
4,4,0,8,mixedType,1
6,1,0,7,mixedType,0
4,6,0,10,mixedType,1
6,3,0,9,mixedType,1
10,4,0,14,mixedType,2
6,3,0,9,mixedType,1
6,2,0,8,mixedType,1
7,3,0,10,mixedType,1
9,1,0,10,mixedType,1
7,3,0,10,mixedType,1
12,4,0,16,mixedType,2
4,2,0,6,mixedType,0
6,4,0,10,mixedType,1
6,3,0,9,mixedType,1
9,4,0,13,mixedType,1
1,8,0,9,mixedType,1
6,2,0,8,mixedType,1
6,3,0,9,mixedType,1
4,7,0,11,mixedType,1
4,6,0,10,mixedType,1
9,1,0,10,mixedType,1
5,3,0,8,mixedType,1
5,3,0,8,mixedType,1
6,3,0,9,mixedType,1
5,4,0,9,mixedType,1
6,3,0,9,mixedType,1
6,2,0,8,mixedType,1
7,5,0,12,mixedType,1
4,2,0,6,mixedType,0
16,6,1,23,mixedType,2
14,2,0,16,mixedType,2
6,5,0,11,mixedType,1
4,4,0,8,mixedType,1
4,6,0,10,mixedType,1
5,4,0,9,mixedType,1
6,2,0,8,mixedType,1
5,2,0,7,mixedType,0
4,2,0,6,mixedType,0
10,1,0,11,mixedType,1
5,2,0,7,mixedType,0
9,4,0,13,mixedType,1
5,4,0,9,mixedType,1
7,1,0,8,mixedType,1
7,2,0,9,mixedType,1
4,4,0,8,mixedType,1
8,1,0,9,mixedType,1
5,3,0,8,mixedType,1
6,4,0,10,mixedType,1
9,3,0,12,mixedType,1
6,6,0,12,mixedType,1
4,2,0,6,mixedType,0
8,1,0,9,mixedType,1
8,3,0,11,mixedType,1
5,1,0,6,mixedType,0
6,4,0,10,mixedType,1
4,5,0,9,mixedType,1
3,6,0,9,mixedType,1
12,3,0,15,mixedType,2
5,4,0,9,mixedType,1
9,2,0,11,mixedType,1
5,4,0,9,mixedType,1
6,3,0,9,mixedType,1
5,3,0,8,mixedType,1
8,2,0,10,mixedType,1
4,6,0,10,mixedType,1
6,1,0,7,mixedType,0
5,4,0,9,mixedType,1
4,4,0,8,mixedType,1
2,8,0,10,mixedType,1
8,4,0,12,mixedType,1
3,3,0,6,mixedType,0
7,3,0,10,mixedType,1
4,4,0,8,mixedType,1
7,2,0,9,mixedType,1
8,2,0,10,mixedType,1
7,4,0,11,mixedType,1
9,1,0,10,mixedType,1
8,2,0,10,mixedType,1
4,4,0,8,mixedType,1
4,4,0,8,mixedType,1
7,6,0,13,mixedType,1
10,1,0,11,mixedType,1
1,9,0,10,mixedType,1
11,3,0,14,mixedType,2
5,3,0,8,mixedType,1
6,3,0,9,mixedType,1
8,1,0,9,mixedType,1
5,4,0,9,mixedType,1
2,8,0,10,mixedType,1
6,2,0,8,mixedType,1
10,2,0,12,mixedType,1
1,10,0,11,mixedType,1
3,6,0,9,mixedType,1
6,4,0,10,mixedType,1
4,2,0,6,mixedType,0
6,0,0,6,sameType,0
15,1,0,16,mixedType,2
5,4,0,9,mixedType,1
5,3,0,8,mixedType,1
7,3,0,10,mixedType,1
3,6,0,9,mixedType,1
7,2,0,9,mixedType,1
10,2,0,12,mixedType,1
7,4,0,11,mixedType,1
7,3,0,10,mixedType,1
11,3,0,14,mixedType,2
7,2,0,9,mixedType,1
10,6,0,16,mixedType,2
8,2,0,10,mixedType,1
6,1,0,7,mixedType,0
6,1,0,7,mixedType,0
8,1,0,9,mixedType,1
13,3,0,16,mixedType,2
7,3,0,10,mixedType,1
6,6,0,12,mixedType,1
3,3,0,6,mixedType,0
5,8,0,13,mixedType,1
5,6,0,11,mixedType,1
5,4,0,9,mixedType,1
5,5,0,10,mixedType,1
8,2,0,10,mixedType,1
13,3,0,16,mixedType,2
1,8,0,9,mixedType,1
4,4,0,8,mixedType,1
12,3,0,15,mixedType,2
6,2,0,8,mixedType,1
8,2,0,10,mixedType,1
8,2,0,10,mixedType,1
9,2,0,11,mixedType,1
7,2,0,9,mixedType,1
6,2,0,8,mixedType,1
8,1,0,9,mixedType,1
9,1,0,10,mixedType,1
6,4,0,10,mixedType,1
7,3,0,10,mixedType,1
7,1,0,8,mixedType,1
9,1,0,10,mixedType,1
4,4,0,8,mixedType,1
3,3,0,6,mixedType,0
11,2,0,13,mixedType,1
15,1,0,16,mixedType,2
8,2,0,10,mixedType,1
2,8,0,10,mixedType,1
7,4,0,11,mixedType,1
12,3,0,15,mixedType,2
9,1,0,10,mixedType,1
6,1,0,7,mixedType,0
6,4,0,10,mixedType,1
5,2,0,7,mixedType,0
9,4,0,13,mixedType,1
9,2,0,11,mixedType,1
6,3,0,9,mixedType,1
5,3,0,8,mixedType,1
6,3,0,9,mixedType,1
4,5,0,9,mixedType,1
3,7,0,10,mixedType,1
11,2,0,13,mixedType,1
7,3,0,10,mixedType,1
4,2,0,6,mixedType,0
3,6,0,9,mixedType,1
6,7,0,13,mixedType,1
6,1,0,7,mixedType,0
7,3,0,10,mixedType,1
9,1,0,10,mixedType,1
4,4,0,8,mixedType,1
3,6,0,9,mixedType,1
5,3,0,8,mixedType,1
4,2,0,6,mixedType,0
15,1,0,16,mixedType,2
6,3,0,9,mixedType,1
6,1,0,7,mixedType,0
6,4,0,10,mixedType,1
5,2,0,7,mixedType,0
7,4,0,11,mixedType,1
11,3,0,14,mixedType,2
1,11,0,12,mixedType,1
5,4,0,9,mixedType,1
5,2,0,7,mixedType,0
7,3,0,10,mixedType,1
6,3,0,9,mixedType,1
6,2,0,8,mixedType,1
2,4,0,6,mixedType,0
8,1,0,9,mixedType,1
10,2,0,12,mixedType,1
7,6,0,13,mixedType,1
8,2,0,10,mixedType,1
8,1,0,9,mixedType,1
5,1,0,6,mixedType,0
6,6,0,12,mixedType,1
6,3,0,9,mixedType,1
14,2,0,16,mixedType,2
9,4,0,13,mixedType,1
7,5,0,12,mixedType,1
6,3,0,9,mixedType,1
14,2,0,16,mixedType,2
8,2,0,10,mixedType,1
4,7,0,11,mixedType,1
6,7,0,13,mixedType,1
6,2,0,8,mixedType,1
5,3,0,8,mixedType,1
4,4,0,8,mixedType,1
5,4,0,9,mixedType,1
9,1,0,10,mixedType,1
8,2,0,10,mixedType,1
7,1,0,8,mixedType,1
6,3,0,9,mixedType,1
2,8,0,10,mixedType,1
7,2,0,9,mixedType,1
3,6,0,9,mixedType,1
5,3,0,8,mixedType,1
7,3,0,10,mixedType,1
8,2,0,10,mixedType,1
6,3,0,9,mixedType,1
1,9,0,10,mixedType,1
8,1,0,9,mixedType,1
6,1,0,7,mixedType,0
8,1,0,9,mixedType,1
6,2,0,8,mixedType,1
7,1,0,8,mixedType,1
7,2,0,9,mixedType,1
3,5,0,8,mixedType,1
8,3,0,11,mixedType,1
5,3,0,8,mixedType,1
5,1,0,6,mixedType,0
6,4,0,10,mixedType,1
6,3,0,9,mixedType,1
11,5,0,16,mixedType,2
7,3,0,10,mixedType,1
2,7,0,9,mixedType,1
8,2,0,10,mixedType,1
1,10,0,11,mixedType,1
8,1,0,9,mixedType,1
6,3,0,9,mixedType,1
5,8,2,15,mixedType,2
13,3,0,16,mixedType,2
7,2,0,9,mixedType,1
14,2,0,16,mixedType,2
11,5,0,16,mixedType,2
8,2,0,10,mixedType,1
6,4,0,10,mixedType,1
7,3,0,10,mixedType,1
5,4,0,9,mixedType,1
5,2,0,7,mixedType,0
12,1,0,13,mixedType,1
6,3,0,9,mixedType,1
4,2,0,6,mixedType,0
7,1,0,8,mixedType,1
12,4,0,16,mixedType,2
5,1,0,6,mixedType,0
5,2,0,7,mixedType,0
6,2,0,8,mixedType,1
6,4,0,10,mixedType,1
5,1,0,6,mixedType,0
14,2,0,16,mixedType,2
7,1,0,8,mixedType,1
7,3,0,10,mixedType,1
6,1,0,7,mixedType,0
9,1,0,10,mixedType,1
5,2,0,7,mixedType,0
9,5,0,14,mixedType,2
7,3,0,10,mixedType,1
6,2,0,8,mixedType,1
7,4,0,11,mixedType,1
6,1,0,7,mixedType,0
9,1,0,10,mixedType,1
6,4,0,10,mixedType,1
7,3,0,10,mixedType,1
6,3,0,9,mixedType,1
1,8,0,9,mixedType,1
8,1,0,9,mixedType,1
6,4,0,10,mixedType,1
9,1,0,10,mixedType,1
6,3,0,9,mixedType,1
3,8,0,11,mixedType,1
6,1,0,7,mixedType,0
4,5,0,9,mixedType,1
6,2,0,8,mixedType,1
0,7,0,7,sameType,1
6,1,0,7,mixedType,0
7,3,0,10,mixedType,1
6,3,0,9,mixedType,1
4,7,0,11,mixedType,1
6,1,0,7,mixedType,0
6,5,0,11,mixedType,1
7,9,0,16,mixedType,2
6,1,0,7,mixedType,0
9,1,0,10,mixedType,1
1,7,0,8,mixedType,1
7,1,0,8,mixedType,1
1,7,0,8,mixedType,1
3,6,0,9,mixedType,1
6,3,0,9,mixedType,1
13,3,0,16,mixedType,2
8,4,0,12,mixedType,1
8,1,0,9,mixedType,1
3,5,0,8,mixedType,1
7,6,0,13,mixedType,1
8,3,0,11,mixedType,1
7,3,0,10,mixedType,1
5,4,0,9,mixedType,1
3,3,0,6,mixedType,0
8,2,0,10,mixedType,1
6,2,0,8,mixedType,1
9,1,0,10,mixedType,1
15,1,0,16,mixedType,2
8,1,0,9,mixedType,1
6,4,0,10,mixedType,1
10,2,0,12,mixedType,1
9,2,0,11,mixedType,1
5,4,0,9,mixedType,1
6,5,0,11,mixedType,1
2,11,2,15,mixedType,2
3,5,0,8,mixedType,1
11,1,0,12,mixedType,1
8,3,0,11,mixedType,1
7,2,0,9,mixedType,1
4,4,0,8,mixedType,1
11,3,0,14,mixedType,2
1,8,0,9,mixedType,1
4,4,0,8,mixedType,1
2,6,0,8,mixedType,1
4,5,0,9,mixedType,1
5,1,0,6,mixedType,0
6,2,0,8,mixedType,1
8,2,0,10,mixedType,1
5,2,0,7,mixedType,0
1,7,0,8,mixedType,1
6,3,0,9,mixedType,1
9,1,0,10,mixedType,1
6,4,0,10,mixedType,1
7,3,0,10,mixedType,1
6,4,0,10,mixedType,1
10,2,0,12,mixedType,1
5,2,0,7,mixedType,0
4,6,0,10,mixedType,1
6,3,0,9,mixedType,1
6,3,0,9,mixedType,1
5,4,0,9,mixedType,1
9,2,0,11,mixedType,1
6,3,0,9,mixedType,1
9,3,0,12,mixedType,1
10,3,0,13,mixedType,1
9,3,0,12,mixedType,1
6,2,0,8,mixedType,1
6,2,0,8,mixedType,1
9,1,0,10,mixedType,1
4,5,0,9,mixedType,1
6,3,0,9,mixedType,1
8,2,0,10,mixedType,1
6,2,0,8,mixedType,1
6,2,0,8,mixedType,1
7,1,0,8,mixedType,1
9,2,0,11,mixedType,1
6,2,0,8,mixedType,1
7,2,0,9,mixedType,1
3,6,0,9,mixedType,1
7,3,0,10,mixedType,1
4,2,0,6,mixedType,0
8,1,0,9,mixedType,1
3,5,0,8,mixedType,1
13,3,0,16,mixedType,2
14,2,0,16,mixedType,2
7,3,0,10,mixedType,1
9,1,0,10,mixedType,1
3,6,0,9,mixedType,1
4,6,0,10,mixedType,1
5,6,0,11,mixedType,1
15,1,1,17,mixedType,2
14,2,0,16,mixedType,2
3,6,0,9,mixedType,1
7,3,0,10,mixedType,1
3,5,0,8,mixedType,1
6,4,0,10,mixedType,1
7,3,0,10,mixedType,1
6,4,0,10,mixedType,1
8,6,0,14,mixedType,2
4,6,0,10,mixedType,1
3,8,0,11,mixedType,1
5,2,0,7,mixedType,0
1,8,0,9,mixedType,1
4,6,0,10,mixedType,1
7,3,0,10,mixedType,1
2,8,0,10,mixedType,1
14,2,0,16,mixedType,2
6,3,0,9,mixedType,1
6,2,0,8,mixedType,1
9,1,0,10,mixedType,1
6,4,0,10,mixedType,1
6,4,0,10,mixedType,1
5,4,0,9,mixedType,1
4,4,0,8,mixedType,1
10,2,0,12,mixedType,1
3,6,0,9,mixedType,1
5,5,0,10,mixedType,1
6,2,0,8,mixedType,1
8,1,0,9,mixedType,1
5,2,0,7,mixedType,0
5,7,0,12,mixedType,1
5,7,0,12,mixedType,1
9,1,0,10,mixedType,1
2,6,0,8,mixedType,1
6,3,0,9,mixedType,1
6,2,0,8,mixedType,1
9,1,0,10,mixedType,1
6,3,0,9,mixedType,1
2,8,0,10,mixedType,1
2,4,0,6,mixedType,0
4,2,0,6,mixedType,0
6,3,0,9,mixedType,1
4,4,0,8,mixedType,1
3,8,0,11,mixedType,1
6,4,0,10,mixedType,1
5,2,0,7,mixedType,0
9,3,0,12,mixedType,1
4,5,0,9,mixedType,1
7,1,0,8,mixedType,1
9,1,0,10,mixedType,1
6,2,0,8,mixedType,1
6,2,0,8,mixedType,1
2,6,0,8,mixedType,1
5,4,0,9,mixedType,1
5,2,0,7,mixedType,0
7,8,0,15,mixedType,2
6,2,0,8,mixedType,1
4,4,0,8,mixedType,1
8,2,0,10,mixedType,1
8,1,0,9,mixedType,1
6,2,0,8,mixedType,1
3,7,0,10,mixedType,1
10,2,0,12,mixedType,1
13,3,0,16,mixedType,2
5,7,0,12,mixedType,1
5,4,0,9,mixedType,1
7,3,0,10,mixedType,1
11,4,0,15,mixedType,2
2,8,0,10,mixedType,1
1,9,0,10,mixedType,1
8,2,0,10,mixedType,1
4,2,0,6,mixedType,0
1,7,0,8,mixedType,1
3,7,0,10,mixedType,1
15,1,0,16,mixedType,2
6,3,0,9,mixedType,1
6,2,0,8,mixedType,1
6,4,0,10,mixedType,1
5,4,0,9,mixedType,1
6,4,0,10,mixedType,1
8,1,0,9,mixedType,1
5,2,0,7,mixedType,0
7,0,1,8,mixedType,1
6,1,0,7,mixedType,0
7,3,0,10,mixedType,1
4,4,0,8,mixedType,1
6,4,0,10,mixedType,1
6,3,0,9,mixedType,1
13,3,0,16,mixedType,2
15,1,0,16,mixedType,2
7,3,0,10,mixedType,1
5,3,0,8,mixedType,1
7,3,0,10,mixedType,1
15,1,0,16,mixedType,2
5,3,0,8,mixedType,1
9,3,0,12,mixedType,1
7,1,0,8,mixedType,1
14,2,0,16,mixedType,2
5,3,0,8,mixedType,1
8,4,0,12,mixedType,1
9,2,0,11,mixedType,1
7,1,0,8,mixedType,1
11,2,0,13,mixedType,1
6,3,0,9,mixedType,1
7,1,0,8,mixedType,1
8,1,0,9,mixedType,1
5,3,0,8,mixedType,1
8,1,0,9,mixedType,1
9,3,0,12,mixedType,1
5,2,0,7,mixedType,0
6,2,0,8,mixedType,1
7,4,0,11,mixedType,1
10,2,0,12,mixedType,1
5,5,0,10,mixedType,1
6,2,0,8,mixedType,1
6,5,0,11,mixedType,1
6,2,0,8,mixedType,1
8,3,0,11,mixedType,1
5,4,0,9,mixedType,1
7,2,0,9,mixedType,1
6,4,0,10,mixedType,1
7,3,0,10,mixedType,1
6,2,0,8,mixedType,1
4,2,0,6,mixedType,0
5,1,0,6,mixedType,0
9,1,0,10,mixedType,1
8,2,0,10,mixedType,1
6,2,0,8,mixedType,1
0,7,1,8,mixedType,1
6,1,0,7,mixedType,0
6,2,0,8,mixedType,1
8,1,0,9,mixedType,1
10,1,0,11,mixedType,1
12,1,0,13,mixedType,1
5,4,0,9,mixedType,1
9,3,0,12,mixedType,1
11,3,0,14,mixedType,2
6,1,0,7,mixedType,0
5,3,0,8,mixedType,1
8,2,0,10,mixedType,1
8,1,0,9,mixedType,1
2,9,0,11,mixedType,1
6,2,0,8,mixedType,1
7,2,0,9,mixedType,1
6,6,0,12,mixedType,1
2,7,0,9,mixedType,1
6,3,0,9,mixedType,1
7,3,0,10,mixedType,1
7,4,0,11,mixedType,1
6,3,0,9,mixedType,1
4,4,0,8,mixedType,1
15,1,0,16,mixedType,2
7,2,0,9,mixedType,1
6,3,0,9,mixedType,1
1,9,0,10,mixedType,1
8,4,0,12,mixedType,1
6,4,0,10,mixedType,1
4,2,0,6,mixedType,0
14,2,0,16,mixedType,2
7,6,0,13,mixedType,1
4,4,0,8,mixedType,1
1,6,0,7,mixedType,0
8,1,0,9,mixedType,1
4,4,0,8,mixedType,1
9,1,0,10,mixedType,1
5,3,0,8,mixedType,1
7,2,0,9,mixedType,1
5,4,0,9,mixedType,1
7,2,0,9,mixedType,1
7,3,0,10,mixedType,1
5,2,0,7,mixedType,0
5,2,0,7,mixedType,0
10,2,0,12,mixedType,1
2,6,0,8,mixedType,1
7,2,0,9,mixedType,1
7,5,0,12,mixedType,1
8,2,0,10,mixedType,1
6,1,0,7,mixedType,0
5,2,0,7,mixedType,0
7,3,0,10,mixedType,1
6,2,0,8,mixedType,1
7,1,0,8,mixedType,1
13,3,0,16,mixedType,2
7,2,0,9,mixedType,1
2,6,0,8,mixedType,1
8,2,0,10,mixedType,1
13,3,0,16,mixedType,2
13,1,1,15,mixedType,2
10,2,0,12,mixedType,1
4,6,0,10,mixedType,1
4,2,0,6,mixedType,0
6,3,0,9,mixedType,1
6,3,0,9,mixedType,1
6,1,0,7,mixedType,0
5,2,0,7,mixedType,0
8,2,0,10,mixedType,1
5,2,0,7,mixedType,0
7,3,0,10,mixedType,1
5,2,0,7,mixedType,0
7,2,0,9,mixedType,1
6,4,0,10,mixedType,1
8,2,0,10,mixedType,1
5,1,0,6,mixedType,0
12,0,1,13,mixedType,1
5,3,0,8,mixedType,1
4,4,0,8,mixedType,1
5,1,0,6,mixedType,0
4,2,0,6,mixedType,0
7,2,0,9,mixedType,1
2,11,0,13,mixedType,1
3,7,0,10,mixedType,1
6,1,0,7,mixedType,0
6,3,0,9,mixedType,1
5,4,0,9,mixedType,1
5,4,0,9,mixedType,1
1,9,0,10,mixedType,1
12,4,0,16,mixedType,2
4,6,0,10,mixedType,1
4,2,0,6,mixedType,0
7,3,0,10,mixedType,1
2,8,0,10,mixedType,1
4,4,0,8,mixedType,1
12,4,0,16,mixedType,2
4,5,0,9,mixedType,1
5,4,0,9,mixedType,1
6,4,0,10,mixedType,1
6,2,0,8,mixedType,1
7,1,0,8,mixedType,1
1,10,0,11,mixedType,1
7,2,0,9,mixedType,1
6,1,0,7,mixedType,0
8,2,0,10,mixedType,1
8,1,0,9,mixedType,1
11,3,0,14,mixedType,2
6,2,0,8,mixedType,1
8,3,0,11,mixedType,1
1,9,0,10,mixedType,1
6,3,0,9,mixedType,1
3,7,0,10,mixedType,1
7,2,0,9,mixedType,1
3,6,0,9,mixedType,1
15,1,0,16,mixedType,2
7,3,0,10,mixedType,1
17,3,0,20,mixedType,2
7,2,0,9,mixedType,1
7,3,0,10,mixedType,1
7,2,0,9,mixedType,1
12,1,0,13,mixedType,1
3,6,0,9,mixedType,1
8,2,0,10,mixedType,1
11,3,0,14,mixedType,2
8,1,0,9,mixedType,1
5,2,0,7,mixedType,0
7,3,0,10,mixedType,1
6,1,0,7,mixedType,0
3,6,0,9,mixedType,1
5,2,0,7,mixedType,0
6,4,0,10,mixedType,1
6,1,0,7,mixedType,0
7,3,0,10,mixedType,1
12,4,0,16,mixedType,2
15,1,0,16,mixedType,2
13,2,0,15,mixedType,2
3,3,0,6,mixedType,0
5,4,0,9,mixedType,1
7,7,0,14,mixedType,2
8,1,0,9,mixedType,1
6,2,0,8,mixedType,1
5,1,0,6,mixedType,0
7,3,0,10,mixedType,1
7,2,0,9,mixedType,1
5,3,0,8,mixedType,1
3,6,0,9,mixedType,1
6,3,0,9,mixedType,1
6,3,0,9,mixedType,1
13,3,0,16,mixedType,2
6,4,0,10,mixedType,1
6,3,0,9,mixedType,1
8,1,0,9,mixedType,1
5,4,0,9,mixedType,1
8,1,0,9,mixedType,1
5,2,0,7,mixedType,0
5,4,0,9,mixedType,1
12,4,0,16,mixedType,2
13,3,0,16,mixedType,2
15,1,0,16,mixedType,2
4,4,0,8,mixedType,1
7,1,0,8,mixedType,1
3,3,0,6,mixedType,0
7,2,0,9,mixedType,1
4,2,0,6,mixedType,0
1,8,0,9,mixedType,1
6,4,0,10,mixedType,1
4,6,0,10,mixedType,1
7,3,0,10,mixedType,1
5,2,0,7,mixedType,0
6,1,0,7,mixedType,0
7,1,0,8,mixedType,1
4,2,0,6,mixedType,0
8,1,0,9,mixedType,1
5,2,0,7,mixedType,0
9,1,0,10,mixedType,1
6,2,0,8,mixedType,1
5,3,0,8,mixedType,1
9,2,0,11,mixedType,1
14,2,0,16,mixedType,2
5,2,0,7,mixedType,0
3,5,0,8,mixedType,1
4,6,0,10,mixedType,1
3,9,0,12,mixedType,1
12,4,0,16,mixedType,2
4,4,0,8,mixedType,1
4,2,0,6,mixedType,0
2,4,0,6,mixedType,0
5,4,0,9,mixedType,1
9,1,0,10,mixedType,1
3,5,0,8,mixedType,1
7,2,0,9,mixedType,1
2,6,0,8,mixedType,1
10,3,0,13,mixedType,1
6,4,0,10,mixedType,1
11,1,2,14,mixedType,2
5,2,0,7,mixedType,0
5,3,0,8,mixedType,1
8,2,0,10,mixedType,1
7,3,0,10,mixedType,1
9,2,0,11,mixedType,1
7,1,0,8,mixedType,1
6,1,0,7,mixedType,0
7,2,0,9,mixedType,1
6,3,0,9,mixedType,1
4,2,0,6,mixedType,0
5,4,0,9,mixedType,1
8,3,0,11,mixedType,1
2,8,0,10,mixedType,1
6,3,0,9,mixedType,1
11,1,0,12,mixedType,1
10,1,0,11,mixedType,1
4,7,0,11,mixedType,1
7,3,0,10,mixedType,1
12,4,0,16,mixedType,2
13,3,0,16,mixedType,2
8,2,0,10,mixedType,1
5,5,0,10,mixedType,1
14,2,0,16,mixedType,2
7,5,0,12,mixedType,1
7,6,1,14,mixedType,2
7,1,0,8,mixedType,1
15,1,0,16,mixedType,2
8,2,0,10,mixedType,1
6,2,0,8,mixedType,1
5,2,0,7,mixedType,0
6,3,0,9,mixedType,1
9,1,0,10,mixedType,1
3,6,0,9,mixedType,1
2,6,0,8,mixedType,1
5,4,0,9,mixedType,1
2,6,0,8,mixedType,1
8,2,0,10,mixedType,1
5,3,0,8,mixedType,1
6,1,0,7,mixedType,0
7,4,0,11,mixedType,1
2,4,0,6,mixedType,0
1,8,0,9,mixedType,1
8,2,0,10,mixedType,1
8,1,0,9,mixedType,1
5,2,0,7,mixedType,0
2,8,0,10,mixedType,1
6,3,0,9,mixedType,1
6,3,0,9,mixedType,1
3,3,0,6,mixedType,0
15,1,0,16,mixedType,2
8,1,0,9,mixedType,1
7,3,0,10,mixedType,1
9,3,0,12,mixedType,1
5,2,0,7,mixedType,0
6,2,0,8,mixedType,1
5,4,0,9,mixedType,1
7,2,0,9,mixedType,1
14,2,0,16,mixedType,2
8,2,0,10,mixedType,1
7,2,0,9,mixedType,1
4,4,0,8,mixedType,1
14,2,0,16,mixedType,2
7,1,0,8,mixedType,1
2,8,0,10,mixedType,1
6,3,0,9,mixedType,1
8,1,0,9,mixedType,1
9,4,1,14,mixedType,2
8,2,0,10,mixedType,1
5,1,0,6,mixedType,0
7,3,0,10,mixedType,1
6,1,0,7,mixedType,0
5,5,0,10,mixedType,1
1,7,0,8,mixedType,1
15,1,0,16,mixedType,2
5,3,0,8,mixedType,1
15,1,0,16,mixedType,2
6,1,0,7,mixedType,0
5,5,0,10,mixedType,1
7,3,0,10,mixedType,1
10,3,1,14,mixedType,2
7,3,0,10,mixedType,1
6,6,0,12,mixedType,1
7,3,0,10,mixedType,1
6,3,0,9,mixedType,1
7,2,0,9,mixedType,1
2,4,0,6,mixedType,0
5,1,0,6,mixedType,0
3,6,0,9,mixedType,1
4,2,0,6,mixedType,0
6,1,0,7,mixedType,0
7,2,0,9,mixedType,1
6,2,0,8,mixedType,1
6,3,0,9,mixedType,1
5,5,0,10,mixedType,1
3,7,0,10,mixedType,1
5,2,0,7,mixedType,0
6,2,0,8,mixedType,1
5,2,0,7,mixedType,0
6,3,0,9,mixedType,1
8,2,0,10,mixedType,1
8,1,0,9,mixedType,1
6,2,0,8,mixedType,1
6,3,0,9,mixedType,1
5,3,0,8,mixedType,1
3,3,0,6,mixedType,0
8,3,0,11,mixedType,1
9,1,0,10,mixedType,1
8,2,0,10,mixedType,1
4,4,0,8,mixedType,1
6,8,0,14,mixedType,2
6,1,0,7,mixedType,0
5,1,0,6,mixedType,0
8,2,0,10,mixedType,1
8,2,0,10,mixedType,1
9,1,0,10,mixedType,1
7,2,0,9,mixedType,1
4,6,0,10,mixedType,1
6,3,0,9,mixedType,1
9,5,0,14,mixedType,2
5,3,0,8,mixedType,1
9,1,0,10,mixedType,1
7,3,0,10,mixedType,1
7,3,0,10,mixedType,1
12,3,0,15,mixedType,2
4,2,0,6,mixedType,0
10,3,0,13,mixedType,1
4,2,0,6,mixedType,0
8,2,0,10,mixedType,1
5,5,0,10,mixedType,1
6,3,0,9,mixedType,1
8,2,0,10,mixedType,1
7,6,0,13,mixedType,1
10,1,0,11,mixedType,1
9,0,1,10,mixedType,1
6,3,0,9,mixedType,1
8,1,0,9,mixedType,1
5,3,0,8,mixedType,1
8,1,0,9,mixedType,1
1,5,0,6,mixedType,0
8,2,0,10,mixedType,1
10,1,0,11,mixedType,1
13,3,0,16,mixedType,2
8,4,0,12,mixedType,1
3,6,0,9,mixedType,1
2,8,0,10,mixedType,1
7,1,0,8,mixedType,1
14,2,0,16,mixedType,2
4,8,0,12,mixedType,1
7,3,0,10,mixedType,1
8,2,0,10,mixedType,1
4,2,0,6,mixedType,0
5,1,0,6,mixedType,0
7,3,0,10,mixedType,1
3,10,0,13,mixedType,1
3,6,0,9,mixedType,1
6,3,0,9,mixedType,1
5,1,0,6,mixedType,0
9,3,0,12,mixedType,1
5,6,0,11,mixedType,1
7,3,0,10,mixedType,1
14,2,0,16,mixedType,2
8,2,0,10,mixedType,1
4,2,0,6,mixedType,0
5,2,0,7,mixedType,0
8,3,0,11,mixedType,1
6,3,0,9,mixedType,1
6,3,0,9,mixedType,1
7,3,0,10,mixedType,1
6,1,0,7,mixedType,0
7,2,0,9,mixedType,1
7,2,0,9,mixedType,1
6,1,0,7,mixedType,0
2,6,0,8,mixedType,1
7,2,0,9,mixedType,1
6,6,0,12,mixedType,1
6,4,0,10,mixedType,1
6,1,0,7,mixedType,0
2,4,0,6,mixedType,0
9,2,0,11,mixedType,1
5,4,0,9,mixedType,1
7,3,0,10,mixedType,1
9,1,0,10,mixedType,1
6,2,0,8,mixedType,1
7,2,0,9,mixedType,1
2,6,0,8,mixedType,1
1,10,0,11,mixedType,1
6,4,0,10,mixedType,1
8,4,0,12,mixedType,1
5,1,0,6,mixedType,0
5,2,0,7,mixedType,0
8,4,0,12,mixedType,1
6,3,0,9,mixedType,1
15,1,0,16,mixedType,2
6,4,0,10,mixedType,1
2,8,0,10,mixedType,1
15,1,0,16,mixedType,2
9,3,0,12,mixedType,1
5,3,0,8,mixedType,1
6,3,0,9,mixedType,1
6,1,0,7,mixedType,0
4,2,0,6,mixedType,0
15,1,0,16,mixedType,2
7,3,0,10,mixedType,1
6,3,0,9,mixedType,1
14,2,0,16,mixedType,2
6,2,0,8,mixedType,1
9,1,0,10,mixedType,1
14,2,1,17,mixedType,2
8,2,0,10,mixedType,1
8,1,0,9,mixedType,1
7,3,0,10,mixedType,1
5,2,0,7,mixedType,0
3,3,0,6,mixedType,0
3,6,0,9,mixedType,1
9,1,0,10,mixedType,1
6,5,0,11,mixedType,1
7,4,0,11,mixedType,1
8,2,0,10,mixedType,1
7,4,0,11,mixedType,1
4,2,0,6,mixedType,0
7,3,0,10,mixedType,1
8,2,0,10,mixedType,1
9,2,0,11,mixedType,1
7,6,0,13,mixedType,1
5,1,0,6,mixedType,0
6,3,0,9,mixedType,1
7,3,0,10,mixedType,1
8,0,1,9,mixedType,1
4,4,0,8,mixedType,1
6,1,0,7,mixedType,0
13,3,0,16,mixedType,2
3,6,0,9,mixedType,1
9,1,0,10,mixedType,1
4,4,0,8,mixedType,1
8,2,0,10,mixedType,1
13,3,0,16,mixedType,2
14,2,0,16,mixedType,2
1,7,0,8,mixedType,1
7,3,0,10,mixedType,1
16,1,0,17,mixedType,2
8,4,0,12,mixedType,1
5,3,0,8,mixedType,1
6,1,0,7,mixedType,0
8,3,0,11,mixedType,1
2,3,0,5,mixedType,0
6,1,0,7,mixedType,0
7,2,0,9,mixedType,1
5,4,0,9,mixedType,1
6,3,0,9,mixedType,1
7,3,0,10,mixedType,1
1,9,0,10,mixedType,1
9,1,0,10,mixedType,1
15,1,0,16,mixedType,2
14,2,0,16,mixedType,2
7,1,0,8,mixedType,1
7,1,0,8,mixedType,1
17,3,0,20,mixedType,2
7,3,0,10,mixedType,1
8,2,0,10,mixedType,1
8,0,1,9,mixedType,1
8,5,0,13,mixedType,1
8,2,0,10,mixedType,1
4,2,0,6,mixedType,0
3,6,0,9,mixedType,1
7,3,0,10,mixedType,1
5,3,0,8,mixedType,1
6,4,0,10,mixedType,1
5,4,0,9,mixedType,1
2,8,0,10,mixedType,1
12,4,0,16,mixedType,2
6,2,0,8,mixedType,1
4,2,0,6,mixedType,0
14,2,0,16,mixedType,2
5,4,0,9,mixedType,1
6,3,0,9,mixedType,1
7,1,0,8,mixedType,1
11,1,0,12,mixedType,1
6,1,0,7,mixedType,0
6,1,0,7,mixedType,0
7,1,0,8,mixedType,1
7,1,0,8,mixedType,1
13,1,1,15,mixedType,2
5,2,0,7,mixedType,0
5,3,0,8,mixedType,1
12,0,1,13,mixedType,1
3,8,0,11,mixedType,1
8,4,0,12,mixedType,1
4,4,0,8,mixedType,1
6,3,0,9,mixedType,1
5,3,0,8,mixedType,1
1,8,0,9,mixedType,1
6,1,0,7,mixedType,0
8,0,1,9,mixedType,1
7,3,0,10,mixedType,1
7,4,0,11,mixedType,1
5,3,0,8,mixedType,1
7,2,0,9,mixedType,1
5,2,0,7,mixedType,0
8,1,0,9,mixedType,1
6,2,0,8,mixedType,1
6,4,0,10,mixedType,1
7,1,0,8,mixedType,1
8,3,0,11,mixedType,1
3,8,0,11,mixedType,1
6,1,0,7,mixedType,0
5,6,0,11,mixedType,1
4,2,0,6,mixedType,0
6,3,0,9,mixedType,1
9,1,0,10,mixedType,1
7,3,0,10,mixedType,1
6,3,0,9,mixedType,1
6,1,0,7,mixedType,0
5,2,0,7,mixedType,0
6,4,0,10,mixedType,1
6,4,0,10,mixedType,1
1,10,0,11,mixedType,1
9,2,0,11,mixedType,1
14,2,0,16,mixedType,2
6,2,0,8,mixedType,1
6,4,0,10,mixedType,1
15,1,0,16,mixedType,2
10,1,0,11,mixedType,1
6,1,0,7,mixedType,0
5,6,0,11,mixedType,1
5,4,0,9,mixedType,1
9,1,0,10,mixedType,1
6,5,0,11,mixedType,1
9,1,0,10,mixedType,1
16,4,0,20,mixedType,2
6,1,0,7,mixedType,0
5,1,0,6,mixedType,0
5,2,0,7,mixedType,0
7,2,0,9,mixedType,1
4,4,0,8,mixedType,1
7,3,0,10,mixedType,1
4,8,0,12,mixedType,1
4,2,0,6,mixedType,0
6,1,0,7,mixedType,0
12,0,1,13,mixedType,1
6,1,0,7,mixedType,0
6,3,0,9,mixedType,1
11,5,0,16,mixedType,2
9,3,0,12,mixedType,1
7,2,0,9,mixedType,1
14,2,0,16,mixedType,2
7,3,0,10,mixedType,1
8,4,0,12,mixedType,1
14,2,0,16,mixedType,2
9,1,0,10,mixedType,1
7,3,0,10,mixedType,1
11,6,0,17,mixedType,2
2,7,0,9,mixedType,1
5,0,1,6,mixedType,0
1,5,0,6,mixedType,0
5,3,0,8,mixedType,1
7,3,0,10,mixedType,1
7,2,0,9,mixedType,1
8,3,0,11,mixedType,1
7,1,0,8,mixedType,1
7,1,0,8,mixedType,1
15,1,0,16,mixedType,2
7,3,0,10,mixedType,1
10,3,0,13,mixedType,1
5,3,0,8,mixedType,1
12,4,0,16,mixedType,2
15,1,0,16,mixedType,2
4,8,0,12,mixedType,1
4,2,0,6,mixedType,0
8,2,0,10,mixedType,1
11,2,0,13,mixedType,1
6,2,0,8,mixedType,1
5,4,0,9,mixedType,1
6,1,0,7,mixedType,0
5,4,0,9,mixedType,1
7,3,0,10,mixedType,1
15,1,0,16,mixedType,2
7,1,0,8,mixedType,1
4,8,0,12,mixedType,1
6,3,0,9,mixedType,1
8,2,0,10,mixedType,1
6,2,0,8,mixedType,1
8,4,0,12,mixedType,1
14,2,0,16,mixedType,2
6,1,0,7,mixedType,0
4,2,0,6,mixedType,0
5,4,0,9,mixedType,1
5,3,0,8,mixedType,1
5,2,0,7,mixedType,0
6,1,0,7,mixedType,0
4,9,0,13,mixedType,1
2,11,0,13,mixedType,1
6,6,0,12,mixedType,1
7,2,0,9,mixedType,1
2,7,0,9,mixedType,1
5,3,0,8,mixedType,1
7,2,0,9,mixedType,1
3,3,0,6,mixedType,0
5,3,0,8,mixedType,1
4,6,0,10,mixedType,1
6,2,0,8,mixedType,1
6,3,0,9,mixedType,1
4,2,0,6,mixedType,0
9,1,0,10,mixedType,1
8,1,0,9,mixedType,1
6,7,0,13,mixedType,1
8,1,0,9,mixedType,1
13,3,0,16,mixedType,2
7,1,0,8,mixedType,1
9,1,0,10,mixedType,1
6,1,0,7,mixedType,0
13,3,0,16,mixedType,2
7,3,0,10,mixedType,1
8,3,0,11,mixedType,1
4,4,0,8,mixedType,1
11,3,0,14,mixedType,2
6,2,0,8,mixedType,1
9,3,0,12,mixedType,1
10,4,0,14,mixedType,2
6,1,0,7,mixedType,0
5,3,0,8,mixedType,1
11,5,0,16,mixedType,2
2,6,0,8,mixedType,1
6,3,0,9,mixedType,1
7,2,0,9,mixedType,1
8,1,0,9,mixedType,1
8,2,0,10,mixedType,1
4,4,0,8,mixedType,1
8,4,0,12,mixedType,1
6,9,0,15,mixedType,2
5,4,0,9,mixedType,1
6,1,0,7,mixedType,0
9,3,0,12,mixedType,1
10,2,0,12,mixedType,1
7,2,0,9,mixedType,1
2,6,0,8,mixedType,1
5,3,0,8,mixedType,1
7,3,0,10,mixedType,1
9,2,0,11,mixedType,1
6,4,0,10,mixedType,1
4,2,0,6,mixedType,0
13,3,0,16,mixedType,2
5,4,0,9,mixedType,1
4,2,0,6,mixedType,0
9,4,0,13,mixedType,1
2,4,0,6,mixedType,0
6,6,0,12,mixedType,1
8,1,0,9,mixedType,1
9,1,0,10,mixedType,1
7,2,0,9,mixedType,1
14,2,0,16,mixedType,2
6,2,0,8,mixedType,1
9,1,0,10,mixedType,1
6,2,0,8,mixedType,1
7,2,0,9,mixedType,1
16,1,1,18,mixedType,2
7,2,0,9,mixedType,1
7,1,0,8,mixedType,1
7,3,0,10,mixedType,1
1,8,0,9,mixedType,1
6,3,0,9,mixedType,1
9,3,0,12,mixedType,1
5,1,0,6,mixedType,0
10,1,0,11,mixedType,1
5,5,0,10,mixedType,1
7,2,0,9,mixedType,1
7,3,0,10,mixedType,1
7,1,0,8,mixedType,1
8,4,0,12,mixedType,1
5,3,0,8,mixedType,1
3,6,0,9,mixedType,1
9,6,1,16,mixedType,2
3,6,0,9,mixedType,1
7,1,0,8,mixedType,1
7,2,0,9,mixedType,1
6,3,0,9,mixedType,1
12,3,0,15,mixedType,2
7,1,0,8,mixedType,1
9,2,0,11,mixedType,1
5,4,0,9,mixedType,1
8,3,0,11,mixedType,1
6,3,0,9,mixedType,1
1,9,0,10,mixedType,1
9,2,0,11,mixedType,1
14,2,0,16,mixedType,2
7,2,0,9,mixedType,1
13,3,0,16,mixedType,2
11,4,0,15,mixedType,2
2,6,0,8,mixedType,1
5,5,0,10,mixedType,1
6,1,0,7,mixedType,0
8,1,0,9,mixedType,1
10,1,0,11,mixedType,1
4,8,0,12,mixedType,1
4,2,0,6,mixedType,0
6,1,0,7,mixedType,0
8,4,0,12,mixedType,1
2,7,0,9,mixedType,1
8,2,0,10,mixedType,1
5,1,0,6,mixedType,0
2,4,0,6,mixedType,0
8,3,0,11,mixedType,1
8,2,0,10,mixedType,1
13,3,0,16,mixedType,2
13,3,0,16,mixedType,2
7,3,0,10,mixedType,1
13,3,0,16,mixedType,2
5,4,0,9,mixedType,1
6,1,0,7,mixedType,0
6,3,0,9,mixedType,1
4,6,0,10,mixedType,1
9,2,0,11,mixedType,1
2,4,0,6,mixedType,0
5,3,0,8,mixedType,1
5,1,0,6,mixedType,0
6,4,0,10,mixedType,1
3,7,0,10,mixedType,1
12,2,1,15,mixedType,2
7,3,0,10,mixedType,1
7,2,0,9,mixedType,1
6,3,0,9,mixedType,1
7,1,0,8,mixedType,1
10,0,1,11,mixedType,1
7,3,0,10,mixedType,1
1,8,0,9,mixedType,1
7,1,0,8,mixedType,1
7,2,0,9,mixedType,1
5,2,0,7,mixedType,0
3,6,0,9,mixedType,1
4,2,0,6,mixedType,0
6,2,0,8,mixedType,1
6,2,0,8,mixedType,1
4,4,0,8,mixedType,1
8,1,0,9,mixedType,1
7,3,0,10,mixedType,1
5,3,0,8,mixedType,1
6,3,0,9,mixedType,1
10,2,0,12,mixedType,1
7,3,0,10,mixedType,1
5,3,0,8,mixedType,1
5,5,0,10,mixedType,1
10,1,0,11,mixedType,1
3,6,0,9,mixedType,1
7,8,0,15,mixedType,2
7,8,1,16,mixedType,2
5,2,0,7,mixedType,0
6,3,0,9,mixedType,1
5,1,0,6,mixedType,0
6,3,0,9,mixedType,1
9,2,0,11,mixedType,1
6,4,0,10,mixedType,1
7,5,0,12,mixedType,1
5,2,0,7,mixedType,0
4,4,0,8,mixedType,1
7,2,0,9,mixedType,1
9,1,0,10,mixedType,1
6,1,0,7,mixedType,0
7,4,0,11,mixedType,1
9,4,0,13,mixedType,1
6,3,0,9,mixedType,1
13,3,0,16,mixedType,2
6,4,0,10,mixedType,1
15,1,0,16,mixedType,2
14,2,0,16,mixedType,2
7,2,0,9,mixedType,1
13,3,0,16,mixedType,2
6,2,0,8,mixedType,1
7,3,0,10,mixedType,1
4,6,0,10,mixedType,1
5,3,0,8,mixedType,1
5,2,0,7,mixedType,0
7,2,0,9,mixedType,1
5,2,0,7,mixedType,0
4,6,0,10,mixedType,1
13,3,0,16,mixedType,2
6,4,0,10,mixedType,1
7,2,0,9,mixedType,1
2,8,0,10,mixedType,1
4,8,0,12,mixedType,1
6,7,1,14,mixedType,2
11,2,0,13,mixedType,1
0,8,2,10,mixedType,1
7,2,0,9,mixedType,1
6,2,0,8,mixedType,1
5,7,0,12,mixedType,1
14,2,0,16,mixedType,2
7,2,0,9,mixedType,1
8,6,0,14,mixedType,2
10,2,0,12,mixedType,1
6,3,0,9,mixedType,1
13,3,0,16,mixedType,2
13,2,0,15,mixedType,2
8,4,0,12,mixedType,1
9,2,0,11,mixedType,1
7,1,0,8,mixedType,1
2,6,0,8,mixedType,1
5,2,0,7,mixedType,0
5,1,0,6,mixedType,0
6,3,0,9,mixedType,1
14,2,0,16,mixedType,2
4,2,0,6,mixedType,0
3,3,0,6,mixedType,0
1,8,0,9,mixedType,1
2,4,0,6,mixedType,0
7,1,0,8,mixedType,1
7,4,0,11,mixedType,1
6,2,0,8,mixedType,1
6,3,0,9,mixedType,1
6,3,0,9,mixedType,1
9,2,0,11,mixedType,1
7,2,0,9,mixedType,1
8,2,0,10,mixedType,1
2,8,0,10,mixedType,1
8,2,0,10,mixedType,1
6,4,0,10,mixedType,1
12,3,0,15,mixedType,2
8,3,0,11,mixedType,1
8,1,0,9,mixedType,1
6,5,0,11,mixedType,1
6,3,0,9,mixedType,1
5,3,0,8,mixedType,1
6,3,0,9,mixedType,1
8,1,0,9,mixedType,1
2,8,0,10,mixedType,1
5,3,0,8,mixedType,1
6,3,0,9,mixedType,1
7,2,0,9,mixedType,1
8,2,0,10,mixedType,1
9,4,0,13,mixedType,1
5,2,0,7,mixedType,0
6,3,0,9,mixedType,1
9,1,0,10,mixedType,1
8,2,0,10,mixedType,1
9,2,0,11,mixedType,1
4,4,0,8,mixedType,1
14,1,1,16,mixedType,2
8,2,0,10,mixedType,1
6,3,0,9,mixedType,1
4,7,0,11,mixedType,1
6,2,0,8,mixedType,1
9,2,0,11,mixedType,1
8,2,0,10,mixedType,1
6,4,0,10,mixedType,1
6,3,0,9,mixedType,1
8,2,0,10,mixedType,1
3,5,0,8,mixedType,1
8,4,0,12,mixedType,1
5,3,0,8,mixedType,1
6,3,0,9,mixedType,1
6,3,0,9,mixedType,1
5,4,0,9,mixedType,1
7,3,0,10,mixedType,1
15,1,0,16,mixedType,2
7,2,0,9,mixedType,1
6,3,0,9,mixedType,1
12,3,0,15,mixedType,2
6,1,0,7,mixedType,0
4,6,0,10,mixedType,1
6,2,0,8,mixedType,1
15,1,0,16,mixedType,2
5,3,0,8,mixedType,1
3,6,0,9,mixedType,1
8,4,0,12,mixedType,1
6,3,0,9,mixedType,1
6,4,0,10,mixedType,1
5,6,0,11,mixedType,1
7,1,0,8,mixedType,1
6,3,0,9,mixedType,1
7,1,0,8,mixedType,1
7,2,0,9,mixedType,1
14,2,0,16,mixedType,2
5,4,0,9,mixedType,1
6,4,0,10,mixedType,1
4,4,0,8,mixedType,1
9,1,0,10,mixedType,1
7,1,0,8,mixedType,1
8,4,0,12,mixedType,1
8,2,0,10,mixedType,1
7,6,0,13,mixedType,1
8,1,0,9,mixedType,1
7,3,0,10,mixedType,1
7,3,0,10,mixedType,1
9,1,0,10,mixedType,1
6,3,0,9,mixedType,1
12,6,0,18,mixedType,2
7,3,0,10,mixedType,1
14,2,0,16,mixedType,2
10,1,0,11,mixedType,1
6,2,0,8,mixedType,1
14,2,0,16,mixedType,2
7,3,0,10,mixedType,1
6,1,0,7,mixedType,0
5,2,0,7,mixedType,0
7,3,0,10,mixedType,1
5,2,0,7,mixedType,0
4,2,0,6,mixedType,0
6,2,0,8,mixedType,1
8,4,0,12,mixedType,1
5,1,0,6,mixedType,0
8,1,0,9,mixedType,1
7,1,0,8,mixedType,1
13,3,0,16,mixedType,2
4,4,0,8,mixedType,1
6,4,0,10,mixedType,1
15,1,0,16,mixedType,2
6,3,0,9,mixedType,1
6,2,0,8,mixedType,1
7,1,0,8,mixedType,1
5,6,0,11,mixedType,1
10,4,0,14,mixedType,2
6,5,0,11,mixedType,1
6,1,0,7,mixedType,0
9,1,0,10,mixedType,1
7,2,0,9,mixedType,1
7,1,0,8,mixedType,1
5,2,0,7,mixedType,0
4,2,0,6,mixedType,0
7,1,0,8,mixedType,1
10,3,0,13,mixedType,1
6,1,0,7,mixedType,0
9,2,0,11,mixedType,1
2,6,0,8,mixedType,1
9,5,0,14,mixedType,2
5,3,0,8,mixedType,1
9,1,0,10,mixedType,1
2,7,0,9,mixedType,1
14,2,0,16,mixedType,2
10,3,0,13,mixedType,1
7,2,0,9,mixedType,1
12,4,0,16,mixedType,2
9,8,0,17,mixedType,2
5,2,0,7,mixedType,0
6,3,0,9,mixedType,1
5,4,0,9,mixedType,1
6,3,0,9,mixedType,1
13,3,0,16,mixedType,2
4,4,0,8,mixedType,1
8,1,0,9,mixedType,1
7,3,0,10,mixedType,1
1,8,0,9,mixedType,1
8,2,0,10,mixedType,1
7,3,0,10,mixedType,1
6,2,0,8,mixedType,1
12,4,0,16,mixedType,2
9,2,0,11,mixedType,1
6,2,0,8,mixedType,1
11,3,0,14,mixedType,2
6,3,0,9,mixedType,1
14,2,0,16,mixedType,2
9,0,4,13,mixedType,1
6,3,0,9,mixedType,1
6,3,0,9,mixedType,1
4,4,0,8,mixedType,1
12,3,0,15,mixedType,2
3,6,0,9,mixedType,1
13,3,0,16,mixedType,2
5,3,0,8,mixedType,1
7,2,0,9,mixedType,1
8,2,0,10,mixedType,1
9,4,0,13,mixedType,1
15,1,0,16,mixedType,2
3,5,0,8,mixedType,1
6,3,0,9,mixedType,1
4,8,0,12,mixedType,1
4,4,0,8,mixedType,1
5,3,0,8,mixedType,1
8,4,0,12,mixedType,1
5,2,0,7,mixedType,0
6,4,0,10,mixedType,1
4,2,0,6,mixedType,0
15,1,0,16,mixedType,2
4,4,0,8,mixedType,1
3,5,0,8,mixedType,1
15,1,0,16,mixedType,2
6,1,0,7,mixedType,0
15,1,1,17,mixedType,2
5,7,0,12,mixedType,1
13,3,0,16,mixedType,2
7,1,0,8,mixedType,1
8,2,0,10,mixedType,1
7,3,0,10,mixedType,1
6,3,0,9,mixedType,1
5,3,0,8,mixedType,1
4,5,0,9,mixedType,1
3,5,0,8,mixedType,1
9,4,0,13,mixedType,1
8,7,0,15,mixedType,2
4,4,0,8,mixedType,1
2,8,0,10,mixedType,1
14,1,0,15,mixedType,2
7,3,0,10,mixedType,1
15,1,0,16,mixedType,2
14,2,0,16,mixedType,2
9,2,0,11,mixedType,1
7,2,0,9,mixedType,1
7,3,0,10,mixedType,1
4,4,0,8,mixedType,1
6,1,0,7,mixedType,0
7,2,0,9,mixedType,1
4,2,0,6,mixedType,0
8,1,0,9,mixedType,1
6,2,0,8,mixedType,1
12,1,0,13,mixedType,1
8,2,0,10,mixedType,1
8,2,0,10,mixedType,1
4,2,0,6,mixedType,0
2,8,0,10,mixedType,1
2,6,0,8,mixedType,1
10,1,0,11,mixedType,1
6,5,0,11,mixedType,1
8,2,0,10,mixedType,1
3,9,0,12,mixedType,1
11,3,0,14,mixedType,2
7,1,0,8,mixedType,1
2,4,0,6,mixedType,0
14,2,0,16,mixedType,2
8,2,0,10,mixedType,1
5,1,0,6,mixedType,0
5,6,0,11,mixedType,1
9,2,0,11,mixedType,1
4,2,0,6,mixedType,0
6,3,0,9,mixedType,1
8,2,0,10,mixedType,1
6,2,0,8,mixedType,1
6,1,0,7,mixedType,0
8,1,0,9,mixedType,1
14,2,0,16,mixedType,2
9,2,0,11,mixedType,1
6,2,0,8,mixedType,1
3,6,0,9,mixedType,1
6,4,0,10,mixedType,1
8,3,0,11,mixedType,1
6,2,0,8,mixedType,1
9,1,0,10,mixedType,1
8,4,0,12,mixedType,1
7,3,0,10,mixedType,1
8,2,0,10,mixedType,1
5,2,0,7,mixedType,0
13,3,0,16,mixedType,2
8,4,0,12,mixedType,1
6,2,0,8,mixedType,1
8,1,0,9,mixedType,1
7,1,0,8,mixedType,1
6,4,0,10,mixedType,1
4,2,0,6,mixedType,0
10,1,0,11,mixedType,1
7,2,0,9,mixedType,1
8,1,0,9,mixedType,1
7,1,0,8,mixedType,1
17,1,1,19,mixedType,2
5,4,0,9,mixedType,1
3,5,0,8,mixedType,1
8,1,0,9,mixedType,1
6,2,0,8,mixedType,1
1,8,0,9,mixedType,1
6,6,0,12,mixedType,1
5,3,0,8,mixedType,1
4,2,0,6,mixedType,0
9,1,0,10,mixedType,1
8,2,0,10,mixedType,1
5,3,0,8,mixedType,1
6,4,0,10,mixedType,1
4,4,0,8,mixedType,1
8,2,0,10,mixedType,1
1,6,0,7,mixedType,0
6,2,0,8,mixedType,1
6,4,0,10,mixedType,1
5,2,0,7,mixedType,0
4,9,0,13,mixedType,1
10,3,1,14,mixedType,2
7,2,0,9,mixedType,1
4,8,0,12,mixedType,1
9,1,0,10,mixedType,1
11,5,0,16,mixedType,2
7,6,0,13,mixedType,1
5,3,0,8,mixedType,1
4,2,0,6,mixedType,0
10,2,0,12,mixedType,1
6,3,0,9,mixedType,1
6,6,0,12,mixedType,1
3,5,0,8,mixedType,1
5,4,0,9,mixedType,1
9,2,0,11,mixedType,1
7,3,0,10,mixedType,1
6,2,0,8,mixedType,1
5,2,0,7,mixedType,0
9,1,0,10,mixedType,1
1,8,0,9,mixedType,1
2,4,0,6,mixedType,0
2,14,1,17,mixedType,2
5,3,0,8,mixedType,1
5,4,0,9,mixedType,1
6,2,0,8,mixedType,1
5,2,0,7,mixedType,0
7,3,0,10,mixedType,1
1,8,0,9,mixedType,1
7,1,0,8,mixedType,1
15,1,0,16,mixedType,2
6,1,0,7,mixedType,0
5,4,0,9,mixedType,1
9,3,0,12,mixedType,1
8,1,0,9,mixedType,1
7,2,0,9,mixedType,1
5,2,0,7,mixedType,0
7,1,0,8,mixedType,1
14,2,0,16,mixedType,2
4,4,0,8,mixedType,1
4,4,0,8,mixedType,1
10,1,0,11,mixedType,1
7,3,0,10,mixedType,1
8,2,0,10,mixedType,1
13,3,0,16,mixedType,2
3,3,0,6,mixedType,0
6,4,0,10,mixedType,1
7,3,0,10,mixedType,1
7,5,0,12,mixedType,1
15,1,0,16,mixedType,2
4,2,0,6,mixedType,0
6,3,0,9,mixedType,1
6,4,0,10,mixedType,1
7,2,0,9,mixedType,1
14,2,0,16,mixedType,2
8,1,0,9,mixedType,1
8,2,0,10,mixedType,1
7,2,0,9,mixedType,1
8,0,1,9,mixedType,1
1,9,0,10,mixedType,1
7,1,0,8,mixedType,1
6,2,0,8,mixedType,1
4,6,0,10,mixedType,1
6,4,0,10,mixedType,1
6,2,0,8,mixedType,1
8,2,0,10,mixedType,1
7,1,0,8,mixedType,1
6,1,0,7,mixedType,0
6,1,0,7,mixedType,0
8,3,0,11,mixedType,1
6,3,0,9,mixedType,1
14,2,0,16,mixedType,2
8,2,0,10,mixedType,1
4,5,0,9,mixedType,1
6,1,0,7,mixedType,0
5,2,0,7,mixedType,0
4,7,0,11,mixedType,1
14,2,0,16,mixedType,2
8,1,0,9,mixedType,1
4,5,0,9,mixedType,1
4,4,0,8,mixedType,1
6,3,0,9,mixedType,1
7,2,0,9,mixedType,1
9,2,0,11,mixedType,1
6,3,0,9,mixedType,1
8,1,0,9,mixedType,1
4,4,0,8,mixedType,1
6,3,0,9,mixedType,1
4,2,0,6,mixedType,0
6,2,0,8,mixedType,1
7,2,0,9,mixedType,1
11,2,0,13,mixedType,1
7,2,0,9,mixedType,1
10,1,0,11,mixedType,1
4,4,0,8,mixedType,1
12,4,0,16,mixedType,2
9,1,0,10,mixedType,1
12,3,0,15,mixedType,2
8,2,0,10,mixedType,1
6,2,0,8,mixedType,1
7,1,0,8,mixedType,1
8,2,0,10,mixedType,1
6,2,0,8,mixedType,1
14,2,0,16,mixedType,2
14,2,0,16,mixedType,2
1,7,0,8,mixedType,1
15,3,1,19,mixedType,2
7,2,0,9,mixedType,1
7,1,0,8,mixedType,1
14,2,0,16,mixedType,2
4,4,0,8,mixedType,1
5,2,0,7,mixedType,0
7,5,0,12,mixedType,1
3,7,0,10,mixedType,1
7,6,0,13,mixedType,1
4,5,0,9,mixedType,1
6,3,0,9,mixedType,1
7,1,0,8,mixedType,1
7,3,0,10,mixedType,1
1,8,0,9,mixedType,1
5,3,0,8,mixedType,1
7,3,0,10,mixedType,1
5,3,0,8,mixedType,1
5,3,0,8,mixedType,1
8,2,0,10,mixedType,1
4,4,0,8,mixedType,1
5,3,0,8,mixedType,1
6,4,0,10,mixedType,1
6,1,0,7,mixedType,0
4,8,0,12,mixedType,1
5,2,0,7,mixedType,0
5,2,0,7,mixedType,0
13,3,0,16,mixedType,2
8,1,0,9,mixedType,1
7,3,0,10,mixedType,1
6,3,0,9,mixedType,1
2,4,0,6,mixedType,0
6,1,0,7,mixedType,0
6,3,0,9,mixedType,1
7,3,0,10,mixedType,1
12,4,0,16,mixedType,2
8,1,0,9,mixedType,1
2,6,0,8,mixedType,1
5,4,0,9,mixedType,1
8,2,0,10,mixedType,1
6,3,0,9,mixedType,1
7,2,0,9,mixedType,1
9,2,0,11,mixedType,1
8,4,0,12,mixedType,1
6,4,0,10,mixedType,1
7,3,0,10,mixedType,1
9,3,0,12,mixedType,1
5,2,0,7,mixedType,0
5,3,0,8,mixedType,1
15,1,0,16,mixedType,2
5,2,0,7,mixedType,0
15,1,0,16,mixedType,2
5,4,0,9,mixedType,1
8,4,0,12,mixedType,1
5,6,0,11,mixedType,1
7,3,0,10,mixedType,1
7,2,0,9,mixedType,1
5,2,0,7,mixedType,0
4,4,0,8,mixedType,1
11,2,0,13,mixedType,1
6,3,0,9,mixedType,1
13,3,0,16,mixedType,2
10,1,0,11,mixedType,1
0,8,1,9,mixedType,1
11,3,0,14,mixedType,2
9,1,0,10,mixedType,1
7,3,0,10,mixedType,1
5,3,0,8,mixedType,1
9,3,0,12,mixedType,1
7,3,0,10,mixedType,1
0,6,1,7,mixedType,0
5,3,0,8,mixedType,1
7,3,0,10,mixedType,1
5,3,0,8,mixedType,1
3,3,0,6,mixedType,0
5,2,0,7,mixedType,0
5,2,0,7,mixedType,0
5,5,0,10,mixedType,1
5,4,0,9,mixedType,1
8,2,0,10,mixedType,1
6,3,0,9,mixedType,1
9,2,0,11,mixedType,1
7,3,0,10,mixedType,1
2,4,0,6,mixedType,0
7,1,0,8,mixedType,1
6,1,0,7,mixedType,0
4,2,0,6,mixedType,0
5,3,0,8,mixedType,1
6,3,0,9,mixedType,1
3,7,0,10,mixedType,1
9,3,3,15,mixedType,2
8,1,0,9,mixedType,1
6,1,0,7,mixedType,0
1,9,0,10,mixedType,1
5,2,0,7,mixedType,0
3,6,0,9,mixedType,1
12,4,0,16,mixedType,2
4,8,0,12,mixedType,1
9,3,0,12,mixedType,1
6,2,0,8,mixedType,1
14,2,0,16,mixedType,2
6,4,0,10,mixedType,1
5,3,0,8,mixedType,1
7,3,0,10,mixedType,1
8,3,0,11,mixedType,1
8,1,0,9,mixedType,1
6,4,0,10,mixedType,1
9,2,0,11,mixedType,1
1,8,0,9,mixedType,1
13,3,0,16,mixedType,2
10,2,0,12,mixedType,1
6,2,0,8,mixedType,1
7,3,0,10,mixedType,1
5,1,0,6,mixedType,0
6,2,0,8,mixedType,1
6,3,0,9,mixedType,1
6,1,0,7,mixedType,0
5,2,0,7,mixedType,0
6,4,0,10,mixedType,1
14,2,0,16,mixedType,2
5,1,0,6,mixedType,0
9,2,0,11,mixedType,1
3,6,0,9,mixedType,1
1,8,0,9,mixedType,1
8,2,0,10,mixedType,1
6,4,0,10,mixedType,1
7,3,0,10,mixedType,1
5,4,0,9,mixedType,1
6,1,0,7,mixedType,0
13,3,0,16,mixedType,2
13,3,0,16,mixedType,2
8,1,0,9,mixedType,1
7,2,0,9,mixedType,1
6,3,0,9,mixedType,1
6,0,0,6,sameType,0
4,4,0,8,mixedType,1
3,5,0,8,mixedType,1
7,3,0,10,mixedType,1
1,8,0,9,mixedType,1
7,3,0,10,mixedType,1
4,2,0,6,mixedType,0
8,1,0,9,mixedType,1
4,2,0,6,mixedType,0
8,4,0,12,mixedType,1
7,4,0,11,mixedType,1
6,3,0,9,mixedType,1
7,4,0,11,mixedType,1
5,5,0,10,mixedType,1
9,2,0,11,mixedType,1
7,2,0,9,mixedType,1
6,3,0,9,mixedType,1
7,1,0,8,mixedType,1
4,5,0,9,mixedType,1
6,2,0,8,mixedType,1
12,4,0,16,mixedType,2
6,2,0,8,mixedType,1
6,1,0,7,mixedType,0
6,2,0,8,mixedType,1
9,3,0,12,mixedType,1
9,2,0,11,mixedType,1
7,1,0,8,mixedType,1
3,6,0,9,mixedType,1
7,3,0,10,mixedType,1
14,2,0,16,mixedType,2
2,8,0,10,mixedType,1
6,1,0,7,mixedType,0
5,3,0,8,mixedType,1
6,1,0,7,mixedType,0
4,4,0,8,mixedType,1
3,6,0,9,mixedType,1
6,5,0,11,mixedType,1
6,1,0,7,mixedType,0
5,1,0,6,mixedType,0
6,1,0,7,mixedType,0
4,2,0,6,mixedType,0
8,2,0,10,mixedType,1
6,4,0,10,mixedType,1
6,2,0,8,mixedType,1
6,2,0,8,mixedType,1
10,2,0,12,mixedType,1
6,1,0,7,mixedType,0
9,2,0,11,mixedType,1
5,5,0,10,mixedType,1
9,1,0,10,mixedType,1
8,1,0,9,mixedType,1
5,4,0,9,mixedType,1
7,3,0,10,mixedType,1
2,4,0,6,mixedType,0
2,6,0,8,mixedType,1
6,4,0,10,mixedType,1
15,1,0,16,mixedType,2
6,4,0,10,mixedType,1
8,2,0,10,mixedType,1
2,8,0,10,mixedType,1
6,4,0,10,mixedType,1
4,2,0,6,mixedType,0
6,2,0,8,mixedType,1
7,1,0,8,mixedType,1
11,5,0,16,mixedType,2
13,3,0,16,mixedType,2
7,3,0,10,mixedType,1
5,6,0,11,mixedType,1
5,10,0,15,mixedType,2
3,5,0,8,mixedType,1
5,4,0,9,mixedType,1
12,0,1,13,mixedType,1
8,2,0,10,mixedType,1
6,4,0,10,mixedType,1
1,9,0,10,mixedType,1
3,7,0,10,mixedType,1
7,1,0,8,mixedType,1
5,2,0,7,mixedType,0
7,2,0,9,mixedType,1
10,2,0,12,mixedType,1
6,3,0,9,mixedType,1
7,1,0,8,mixedType,1
7,3,0,10,mixedType,1
7,1,0,8,mixedType,1
3,6,0,9,mixedType,1
8,2,0,10,mixedType,1
10,3,0,13,mixedType,1
3,5,0,8,mixedType,1
6,4,0,10,mixedType,1
7,2,0,9,mixedType,1
9,3,0,12,mixedType,1
2,8,0,10,mixedType,1
12,2,1,15,mixedType,2
3,6,0,9,mixedType,1
9,1,0,10,mixedType,1
4,4,0,8,mixedType,1
7,6,0,13,mixedType,1
6,2,0,8,mixedType,1
6,3,0,9,mixedType,1
15,1,0,16,mixedType,2
8,2,0,10,mixedType,1
5,10,0,15,mixedType,2
5,2,0,7,mixedType,0
6,7,0,13,mixedType,1
15,1,0,16,mixedType,2
8,2,0,10,mixedType,1
12,4,0,16,mixedType,2
7,2,0,9,mixedType,1
7,2,0,9,mixedType,1
6,3,0,9,mixedType,1
3,7,0,10,mixedType,1
4,4,0,8,mixedType,1
12,4,0,16,mixedType,2
8,1,0,9,mixedType,1
8,1,0,9,mixedType,1
13,3,0,16,mixedType,2
8,2,0,10,mixedType,1
2,9,0,11,mixedType,1
4,4,0,8,mixedType,1
4,4,0,8,mixedType,1
7,1,0,8,mixedType,1
7,2,0,9,mixedType,1
6,6,0,12,mixedType,1
7,3,0,10,mixedType,1
9,2,0,11,mixedType,1
15,1,0,16,mixedType,2
14,2,0,16,mixedType,2
7,3,0,10,mixedType,1
14,2,0,16,mixedType,2
2,6,0,8,mixedType,1
5,4,0,9,mixedType,1
6,1,0,7,mixedType,0
7,4,0,11,mixedType,1
10,2,0,12,mixedType,1
12,3,0,15,mixedType,2
7,3,0,10,mixedType,1
4,6,0,10,mixedType,1
6,2,0,8,mixedType,1
6,3,0,9,mixedType,1
3,7,0,10,mixedType,1
8,2,0,10,mixedType,1
8,2,0,10,mixedType,1
6,3,0,9,mixedType,1
5,1,0,6,mixedType,0
10,2,0,12,mixedType,1
12,3,0,15,mixedType,2
5,4,0,9,mixedType,1
7,3,0,10,mixedType,1
12,4,0,16,mixedType,2
6,4,0,10,mixedType,1
7,2,0,9,mixedType,1
5,4,0,9,mixedType,1
3,7,0,10,mixedType,1
5,1,0,6,mixedType,0
5,3,0,8,mixedType,1
9,2,0,11,mixedType,1
9,1,0,10,mixedType,1
5,1,0,6,mixedType,0
7,2,0,9,mixedType,1
2,6,0,8,mixedType,1
14,2,0,16,mixedType,2
8,3,0,11,mixedType,1
12,1,0,13,mixedType,1
7,3,0,10,mixedType,1
7,1,0,8,mixedType,1
12,3,0,15,mixedType,2
5,4,0,9,mixedType,1
8,5,0,13,mixedType,1
6,2,0,8,mixedType,1
8,1,0,9,mixedType,1
14,2,0,16,mixedType,2
6,4,0,10,mixedType,1
12,3,0,15,mixedType,2
6,3,0,9,mixedType,1
8,2,0,10,mixedType,1
9,1,0,10,mixedType,1
7,4,0,11,mixedType,1
4,2,0,6,mixedType,0
5,3,0,8,mixedType,1
4,6,0,10,mixedType,1
6,4,0,10,mixedType,1
10,1,0,11,mixedType,1
10,1,0,11,mixedType,1
1,9,0,10,mixedType,1
9,1,0,10,mixedType,1
11,3,0,14,mixedType,2
7,3,0,10,mixedType,1
8,1,0,9,mixedType,1
1,11,0,12,mixedType,1
8,3,0,11,mixedType,1
8,1,0,9,mixedType,1
6,6,0,12,mixedType,1
1,7,0,8,mixedType,1
1,7,0,8,mixedType,1
7,3,0,10,mixedType,1
5,3,0,8,mixedType,1
8,2,0,10,mixedType,1
5,2,0,7,mixedType,0
4,2,0,6,mixedType,0
6,3,0,9,mixedType,1
6,2,0,8,mixedType,1
4,2,0,6,mixedType,0
10,3,0,13,mixedType,1
4,2,0,6,mixedType,0
2,7,0,9,mixedType,1
8,1,0,9,mixedType,1
8,1,0,9,mixedType,1
10,3,0,13,mixedType,1
12,3,0,15,mixedType,2
13,3,0,16,mixedType,2
4,2,0,6,mixedType,0
4,7,0,11,mixedType,1
6,3,0,9,mixedType,1
2,10,0,12,mixedType,1
6,3,0,9,mixedType,1
6,3,0,9,mixedType,1
6,1,0,7,mixedType,0
12,3,0,15,mixedType,2
6,3,0,9,mixedType,1
6,3,0,9,mixedType,1
14,2,0,16,mixedType,2
6,4,0,10,mixedType,1
7,2,0,9,mixedType,1
8,2,0,10,mixedType,1
13,3,0,16,mixedType,2
7,2,0,9,mixedType,1
7,3,0,10,mixedType,1
5,4,0,9,mixedType,1
6,1,0,7,mixedType,0
7,6,0,13,mixedType,1
14,2,0,16,mixedType,2
12,4,0,16,mixedType,2
2,6,0,8,mixedType,1
12,3,0,15,mixedType,2
7,2,0,9,mixedType,1
7,2,0,9,mixedType,1
7,5,0,12,mixedType,1
7,3,0,10,mixedType,1
7,4,0,11,mixedType,1
5,2,0,7,mixedType,0
5,4,0,9,mixedType,1
2,8,0,10,mixedType,1
2,6,0,8,mixedType,1
6,2,0,8,mixedType,1
5,6,0,11,mixedType,1
9,3,0,12,mixedType,1
14,2,0,16,mixedType,2
7,2,0,9,mixedType,1
12,1,0,13,mixedType,1
5,1,0,6,mixedType,0
6,3,0,9,mixedType,1
7,3,0,10,mixedType,1
10,2,0,12,mixedType,1
5,1,0,6,mixedType,0
8,3,0,11,mixedType,1
6,4,0,10,mixedType,1
7,4,0,11,mixedType,1
15,1,0,16,mixedType,2
10,3,0,13,mixedType,1
9,3,0,12,mixedType,1
5,4,0,9,mixedType,1
6,2,0,8,mixedType,1
11,2,0,13,mixedType,1
5,2,0,7,mixedType,0
7,2,0,9,mixedType,1
6,1,0,7,mixedType,0
3,6,0,9,mixedType,1
7,4,0,11,mixedType,1
6,1,0,7,mixedType,0
9,1,0,10,mixedType,1
14,2,0,16,mixedType,2
14,2,0,16,mixedType,2
4,4,0,8,mixedType,1
8,2,0,10,mixedType,1
8,4,0,12,mixedType,1
14,2,0,16,mixedType,2
9,3,0,12,mixedType,1
15,1,0,16,mixedType,2
5,1,0,6,mixedType,0
2,8,0,10,mixedType,1
5,3,0,8,mixedType,1
14,2,0,16,mixedType,2
9,5,1,15,mixedType,2
6,1,0,7,mixedType,0
10,2,0,12,mixedType,1
6,3,0,9,mixedType,1
4,4,0,8,mixedType,1
7,1,0,8,mixedType,1
14,2,0,16,mixedType,2
4,8,0,12,mixedType,1
11,5,0,16,mixedType,2
7,3,0,10,mixedType,1
5,2,0,7,mixedType,0
5,3,0,8,mixedType,1
8,3,0,11,mixedType,1
7,3,0,10,mixedType,1
6,4,0,10,mixedType,1
7,2,0,9,mixedType,1
3,8,0,11,mixedType,1
4,4,0,8,mixedType,1
14,2,0,16,mixedType,2
9,3,0,12,mixedType,1
4,6,0,10,mixedType,1
3,3,0,6,mixedType,0
7,3,0,10,mixedType,1
9,1,0,10,mixedType,1
13,3,0,16,mixedType,2
6,4,0,10,mixedType,1
4,2,0,6,mixedType,0
6,4,0,10,mixedType,1
6,1,0,7,mixedType,0
11,1,0,12,mixedType,1
6,2,0,8,mixedType,1
8,2,0,10,mixedType,1
6,2,0,8,mixedType,1
8,1,0,9,mixedType,1
8,1,0,9,mixedType,1
15,1,0,16,mixedType,2
4,4,0,8,mixedType,1
5,3,0,8,mixedType,1
7,3,0,10,mixedType,1
6,3,0,9,mixedType,1
7,2,0,9,mixedType,1
8,1,0,9,mixedType,1
8,2,0,10,mixedType,1
3,7,0,10,mixedType,1
7,2,0,9,mixedType,1
12,1,0,13,mixedType,1
6,3,0,9,mixedType,1
4,4,0,8,mixedType,1
8,3,0,11,mixedType,1
1,7,0,8,mixedType,1
6,2,0,8,mixedType,1
5,2,0,7,mixedType,0
5,2,0,7,mixedType,0
7,2,0,9,mixedType,1
6,2,0,8,mixedType,1
8,1,0,9,mixedType,1
7,2,0,9,mixedType,1
10,6,0,16,mixedType,2
7,1,0,8,mixedType,1
11,2,0,13,mixedType,1
15,1,0,16,mixedType,2
5,2,0,7,mixedType,0
8,3,0,11,mixedType,1
6,2,0,8,mixedType,1
6,4,0,10,mixedType,1
3,6,0,9,mixedType,1
7,3,0,10,mixedType,1
7,3,0,10,mixedType,1
5,1,0,6,mixedType,0
11,5,0,16,mixedType,2
3,3,0,6,mixedType,0
6,6,0,12,mixedType,1
5,4,0,9,mixedType,1
5,2,0,7,mixedType,0
6,4,0,10,mixedType,1
7,4,0,11,mixedType,1
11,2,1,14,mixedType,2
5,4,0,9,mixedType,1
5,3,0,8,mixedType,1
8,2,0,10,mixedType,1
1,8,0,9,mixedType,1
6,3,0,9,mixedType,1
7,1,0,8,mixedType,1
6,2,0,8,mixedType,1
8,2,0,10,mixedType,1
7,1,0,8,mixedType,1
4,5,0,9,mixedType,1
2,4,0,6,mixedType,0
8,1,0,9,mixedType,1
4,4,0,8,mixedType,1
6,2,0,8,mixedType,1
1,8,0,9,mixedType,1
6,4,0,10,mixedType,1
9,3,0,12,mixedType,1
8,1,0,9,mixedType,1
14,2,0,16,mixedType,2
4,6,0,10,mixedType,1
5,2,0,7,mixedType,0
8,4,0,12,mixedType,1
8,4,0,12,mixedType,1
2,4,0,6,mixedType,0
9,1,0,10,mixedType,1
8,2,0,10,mixedType,1
8,3,0,11,mixedType,1
2,4,0,6,mixedType,0
12,4,0,16,mixedType,2
7,2,0,9,mixedType,1
7,2,0,9,mixedType,1
7,4,0,11,mixedType,1
5,4,0,9,mixedType,1
5,7,0,12,mixedType,1
6,2,0,8,mixedType,1
5,1,0,6,mixedType,0
14,2,0,16,mixedType,2
14,2,0,16,mixedType,2
8,4,0,12,mixedType,1
2,6,0,8,mixedType,1
7,2,0,9,mixedType,1
9,1,0,10,mixedType,1
5,3,0,8,mixedType,1
4,4,0,8,mixedType,1
6,1,0,7,mixedType,0
7,4,0,11,mixedType,1
5,1,0,6,mixedType,0
6,2,0,8,mixedType,1
5,4,0,9,mixedType,1
5,2,0,7,mixedType,0
2,6,0,8,mixedType,1
13,3,0,16,mixedType,2
7,2,0,9,mixedType,1
5,4,0,9,mixedType,1
6,4,0,10,mixedType,1
7,1,0,8,mixedType,1
6,4,0,10,mixedType,1
15,1,0,16,mixedType,2
8,1,0,9,mixedType,1
5,4,0,9,mixedType,1
6,2,0,8,mixedType,1
9,4,0,13,mixedType,1
6,2,0,8,mixedType,1
13,3,0,16,mixedType,2
5,1,0,6,mixedType,0
6,4,0,10,mixedType,1
7,3,0,10,mixedType,1
10,1,0,11,mixedType,1
8,4,0,12,mixedType,1
15,1,0,16,mixedType,2
9,1,0,10,mixedType,1
5,1,0,6,mixedType,0
5,2,0,7,mixedType,0
5,1,0,6,mixedType,0
2,6,0,8,mixedType,1
14,2,0,16,mixedType,2
9,2,0,11,mixedType,1
8,2,0,10,mixedType,1
8,1,0,9,mixedType,1
3,9,0,12,mixedType,1
4,4,0,8,mixedType,1
13,3,0,16,mixedType,2
1,9,0,10,mixedType,1
4,9,0,13,mixedType,1
7,3,0,10,mixedType,1
5,4,0,9,mixedType,1
7,3,0,10,mixedType,1
11,3,0,14,mixedType,2
4,2,0,6,mixedType,0
9,4,0,13,mixedType,1
12,4,0,16,mixedType,2
4,4,0,8,mixedType,1
6,4,0,10,mixedType,1
6,3,0,9,mixedType,1
5,2,0,7,mixedType,0
13,3,0,16,mixedType,2
6,3,0,9,mixedType,1
3,8,0,11,mixedType,1
11,3,0,14,mixedType,2
8,2,0,10,mixedType,1
7,2,0,9,mixedType,1
4,2,0,6,mixedType,0
6,3,0,9,mixedType,1
13,3,0,16,mixedType,2
6,3,0,9,mixedType,1
8,3,0,11,mixedType,1
6,7,0,13,mixedType,1
9,1,0,10,mixedType,1
7,3,0,10,mixedType,1
7,1,0,8,mixedType,1
6,3,0,9,mixedType,1
6,3,0,9,mixedType,1
10,2,0,12,mixedType,1
9,1,0,10,mixedType,1
9,2,0,11,mixedType,1
4,4,0,8,mixedType,1
9,4,0,13,mixedType,1
8,2,0,10,mixedType,1
4,4,0,8,mixedType,1
6,2,0,8,mixedType,1
4,2,0,6,mixedType,0
5,5,0,10,mixedType,1
8,3,0,11,mixedType,1
4,4,0,8,mixedType,1
11,2,2,15,mixedType,2
6,3,0,9,mixedType,1
8,1,0,9,mixedType,1
4,2,0,6,mixedType,0
4,6,0,10,mixedType,1
8,2,0,10,mixedType,1
9,3,0,12,mixedType,1
7,3,0,10,mixedType,1
5,4,0,9,mixedType,1
6,3,0,9,mixedType,1
7,2,0,9,mixedType,1
3,5,0,8,mixedType,1
6,1,0,7,mixedType,0
1,8,0,9,mixedType,1
3,6,0,9,mixedType,1
5,3,0,8,mixedType,1
12,4,0,16,mixedType,2
5,3,0,8,mixedType,1
6,4,0,10,mixedType,1
11,0,1,12,mixedType,1
8,1,0,9,mixedType,1
5,2,0,7,mixedType,0
6,3,0,9,mixedType,1
5,3,0,8,mixedType,1
9,1,0,10,mixedType,1
6,2,0,8,mixedType,1
7,1,0,8,mixedType,1
6,3,0,9,mixedType,1
2,4,0,6,mixedType,0
8,2,0,10,mixedType,1
9,3,0,12,mixedType,1
15,1,0,16,mixedType,2
8,2,0,10,mixedType,1
1,9,0,10,mixedType,1
5,2,0,7,mixedType,0
1,8,0,9,mixedType,1
8,2,0,10,mixedType,1
6,3,0,9,mixedType,1
4,4,0,8,mixedType,1
8,1,0,9,mixedType,1
7,3,0,10,mixedType,1
0,8,1,9,mixedType,1
7,2,0,9,mixedType,1
6,4,0,10,mixedType,1
6,1,0,7,mixedType,0
4,2,0,6,mixedType,0
4,4,0,8,mixedType,1
10,3,0,13,mixedType,1
3,9,0,12,mixedType,1
3,6,0,9,mixedType,1
6,3,0,9,mixedType,1
6,3,0,9,mixedType,1
1,8,0,9,mixedType,1
5,3,0,8,mixedType,1
5,2,0,7,mixedType,0
8,3,0,11,mixedType,1
1,8,0,9,mixedType,1
13,3,0,16,mixedType,2
5,2,0,7,mixedType,0
9,1,0,10,mixedType,1
3,6,0,9,mixedType,1
10,1,0,11,mixedType,1
5,4,0,9,mixedType,1
6,2,0,8,mixedType,1
4,2,0,6,mixedType,0
4,4,0,8,mixedType,1
8,4,0,12,mixedType,1
10,2,0,12,mixedType,1
14,2,0,16,mixedType,2
11,2,0,13,mixedType,1
3,10,0,13,mixedType,1
8,2,0,10,mixedType,1
5,3,0,8,mixedType,1
14,2,0,16,mixedType,2
6,3,0,9,mixedType,1
7,3,0,10,mixedType,1
10,3,0,13,mixedType,1
4,4,0,8,mixedType,1
9,2,0,11,mixedType,1
7,2,0,9,mixedType,1
7,2,0,9,mixedType,1
5,8,0,13,mixedType,1
4,6,0,10,mixedType,1
7,5,0,12,mixedType,1
7,2,0,9,mixedType,1
2,4,0,6,mixedType,0
6,4,0,10,mixedType,1
4,4,0,8,mixedType,1
13,3,0,16,mixedType,2
12,4,0,16,mixedType,2
11,4,2,17,mixedType,2
8,2,0,10,mixedType,1
5,2,0,7,mixedType,0
6,3,0,9,mixedType,1
9,2,0,11,mixedType,1
5,5,0,10,mixedType,1
7,3,0,10,mixedType,1
8,2,0,10,mixedType,1
4,6,0,10,mixedType,1
7,3,0,10,mixedType,1
6,3,0,9,mixedType,1
11,3,0,14,mixedType,2
15,1,0,16,mixedType,2
5,4,0,9,mixedType,1
7,2,0,9,mixedType,1
10,1,0,11,mixedType,1
7,5,0,12,mixedType,1
7,2,0,9,mixedType,1
4,2,0,6,mixedType,0
7,3,0,10,mixedType,1
5,2,0,7,mixedType,0
3,5,0,8,mixedType,1
9,2,0,11,mixedType,1
8,1,0,9,mixedType,1
7,3,0,10,mixedType,1
6,2,0,8,mixedType,1
2,7,0,9,mixedType,1
9,1,0,10,mixedType,1
7,3,0,10,mixedType,1
0,7,1,8,mixedType,1
5,2,0,7,mixedType,0
9,3,0,12,mixedType,1
6,2,0,8,mixedType,1
3,7,0,10,mixedType,1
2,8,0,10,mixedType,1
6,4,0,10,mixedType,1
6,2,0,8,mixedType,1
3,6,0,9,mixedType,1
5,2,0,7,mixedType,0
11,1,0,12,mixedType,1
9,3,0,12,mixedType,1
6,3,0,9,mixedType,1
6,3,0,9,mixedType,1
14,2,0,16,mixedType,2
7,2,0,9,mixedType,1
13,3,0,16,mixedType,2
3,3,0,6,mixedType,0
9,1,0,10,mixedType,1
6,4,0,10,mixedType,1
11,1,0,12,mixedType,1
3,3,0,6,mixedType,0
8,3,0,11,mixedType,1
9,3,0,12,mixedType,1
2,7,0,9,mixedType,1
7,2,0,9,mixedType,1
4,9,0,13,mixedType,1
12,0,1,13,mixedType,1
7,4,0,11,mixedType,1
6,3,0,9,mixedType,1
6,1,0,7,mixedType,0
12,3,0,15,mixedType,2
13,3,0,16,mixedType,2
7,1,0,8,mixedType,1
7,2,0,9,mixedType,1
2,8,0,10,mixedType,1
7,6,2,15,mixedType,2
4,4,0,8,mixedType,1
8,1,0,9,mixedType,1
1,8,0,9,mixedType,1
9,1,0,10,mixedType,1
5,2,0,7,mixedType,0
5,3,0,8,mixedType,1
6,1,0,7,mixedType,0
9,3,0,12,mixedType,1
5,2,0,7,mixedType,0
3,8,0,11,mixedType,1
7,2,0,9,mixedType,1
3,5,0,8,mixedType,1
9,2,0,11,mixedType,1
5,2,0,7,mixedType,0
6,6,0,12,mixedType,1
14,1,0,15,mixedType,2
5,3,0,8,mixedType,1
7,3,0,10,mixedType,1
7,3,0,10,mixedType,1
5,2,0,7,mixedType,0
7,3,0,10,mixedType,1
10,4,0,14,mixedType,2
13,3,0,16,mixedType,2
6,4,0,10,mixedType,1
7,3,0,10,mixedType,1
12,4,0,16,mixedType,2
9,1,0,10,mixedType,1
5,3,0,8,mixedType,1
6,4,0,10,mixedType,1
9,1,0,10,mixedType,1
13,3,0,16,mixedType,2
5,4,0,9,mixedType,1
2,10,0,12,mixedType,1
5,3,0,8,mixedType,1
5,2,0,7,mixedType,0
8,4,0,12,mixedType,1
8,1,0,9,mixedType,1
6,2,0,8,mixedType,1
7,3,0,10,mixedType,1
7,2,0,9,mixedType,1
5,4,0,9,mixedType,1
14,2,0,16,mixedType,2
8,4,0,12,mixedType,1
14,2,0,16,mixedType,2
0,6,1,7,mixedType,0
3,3,0,6,mixedType,0
2,7,0,9,mixedType,1
7,1,0,8,mixedType,1
6,4,0,10,mixedType,1
4,4,0,8,mixedType,1
5,3,0,8,mixedType,1
7,2,0,9,mixedType,1
9,5,0,14,mixedType,2
3,6,0,9,mixedType,1
9,1,0,10,mixedType,1
13,3,0,16,mixedType,2
4,4,0,8,mixedType,1
5,2,0,7,mixedType,0
7,3,0,10,mixedType,1
4,6,0,10,mixedType,1
6,7,0,13,mixedType,1
13,3,0,16,mixedType,2
7,3,0,10,mixedType,1
2,6,0,8,mixedType,1
5,8,0,13,mixedType,1
9,3,0,12,mixedType,1
7,1,0,8,mixedType,1
3,6,0,9,mixedType,1
8,2,0,10,mixedType,1
7,1,0,8,mixedType,1
7,3,0,10,mixedType,1
5,2,0,7,mixedType,0
7,1,0,8,mixedType,1
10,2,0,12,mixedType,1
9,1,0,10,mixedType,1
5,5,0,10,mixedType,1
7,3,0,10,mixedType,1
1,7,0,8,mixedType,1
5,3,0,8,mixedType,1
6,3,0,9,mixedType,1
6,4,0,10,mixedType,1
8,1,0,9,mixedType,1
1,7,0,8,mixedType,1
5,4,0,9,mixedType,1
6,1,0,7,mixedType,0
9,3,0,12,mixedType,1
4,2,0,6,mixedType,0
4,4,0,8,mixedType,1
6,3,0,9,mixedType,1
6,2,0,8,mixedType,1
15,1,0,16,mixedType,2
13,3,0,16,mixedType,2
15,1,0,16,mixedType,2
5,1,0,6,mixedType,0
3,9,0,12,mixedType,1
3,6,0,9,mixedType,1
6,1,0,7,mixedType,0
8,2,0,10,mixedType,1
15,1,0,16,mixedType,2
5,4,0,9,mixedType,1
2,10,0,12,mixedType,1
14,2,0,16,mixedType,2
14,2,0,16,mixedType,2
8,2,0,10,mixedType,1
4,2,0,6,mixedType,0
4,2,0,6,mixedType,0
6,6,0,12,mixedType,1
3,6,0,9,mixedType,1
9,2,0,11,mixedType,1
4,2,0,6,mixedType,0
7,3,0,10,mixedType,1
8,2,0,10,mixedType,1
7,1,0,8,mixedType,1
8,2,0,10,mixedType,1
6,3,0,9,mixedType,1
5,2,0,7,mixedType,0
9,3,0,12,mixedType,1
7,2,0,9,mixedType,1
7,2,0,9,mixedType,1
6,3,0,9,mixedType,1
11,5,0,16,mixedType,2
6,2,0,8,mixedType,1
9,4,0,13,mixedType,1
7,4,0,11,mixedType,1
6,1,0,7,mixedType,0
8,2,0,10,mixedType,1
6,1,0,7,mixedType,0
3,6,0,9,mixedType,1
1,9,0,10,mixedType,1
14,2,0,16,mixedType,2
7,1,0,8,mixedType,1
7,3,0,10,mixedType,1
4,2,0,6,mixedType,0
8,3,0,11,mixedType,1
6,4,0,10,mixedType,1
13,3,0,16,mixedType,2
9,3,0,12,mixedType,1
1,9,0,10,mixedType,1
5,1,0,6,mixedType,0
6,4,0,10,mixedType,1
7,2,0,9,mixedType,1
4,2,0,6,mixedType,0
8,2,0,10,mixedType,1
15,1,0,16,mixedType,2
14,2,0,16,mixedType,2
4,2,0,6,mixedType,0
7,4,0,11,mixedType,1
14,2,0,16,mixedType,2
8,1,0,9,mixedType,1
2,8,0,10,mixedType,1
1,9,0,10,mixedType,1
5,1,0,6,mixedType,0
5,3,0,8,mixedType,1
6,3,0,9,mixedType,1
6,3,0,9,mixedType,1
2,6,0,8,mixedType,1
4,2,0,6,mixedType,0
10,2,0,12,mixedType,1
7,3,0,10,mixedType,1
2,7,0,9,mixedType,1
9,1,0,10,mixedType,1
6,1,0,7,mixedType,0
5,2,0,7,mixedType,0
5,2,0,7,mixedType,0
9,1,0,10,mixedType,1
8,2,0,10,mixedType,1
2,6,0,8,mixedType,1
6,3,0,9,mixedType,1
6,3,0,9,mixedType,1
3,6,0,9,mixedType,1
8,2,0,10,mixedType,1
5,5,0,10,mixedType,1
6,3,0,9,mixedType,1
8,2,0,10,mixedType,1
6,3,0,9,mixedType,1
10,6,0,16,mixedType,2
3,7,0,10,mixedType,1
8,4,0,12,mixedType,1
11,1,0,12,mixedType,1
4,6,0,10,mixedType,1
5,3,0,8,mixedType,1
10,6,2,18,mixedType,2
7,4,0,11,mixedType,1
4,4,0,8,mixedType,1
8,3,0,11,mixedType,1
9,1,0,10,mixedType,1
10,2,0,12,mixedType,1
10,2,0,12,mixedType,1
14,2,0,16,mixedType,2
4,8,0,12,mixedType,1
7,3,0,10,mixedType,1
6,1,0,7,mixedType,0
6,4,0,10,mixedType,1
6,2,0,8,mixedType,1
14,2,0,16,mixedType,2
5,4,0,9,mixedType,1
10,0,2,12,mixedType,1
6,4,0,10,mixedType,1
7,2,0,9,mixedType,1
6,3,0,9,mixedType,1
5,3,0,8,mixedType,1
8,2,0,10,mixedType,1
6,3,0,9,mixedType,1
12,4,0,16,mixedType,2
7,2,0,9,mixedType,1
7,4,0,11,mixedType,1
12,4,0,16,mixedType,2
5,2,0,7,mixedType,0
3,5,0,8,mixedType,1
10,3,0,13,mixedType,1
6,3,0,9,mixedType,1
7,2,0,9,mixedType,1
8,2,0,10,mixedType,1
6,5,0,11,mixedType,1
9,1,0,10,mixedType,1
5,4,0,9,mixedType,1
10,3,0,13,mixedType,1
6,2,0,8,mixedType,1
14,2,0,16,mixedType,2
8,2,0,10,mixedType,1
7,3,0,10,mixedType,1
6,4,0,10,mixedType,1
5,1,0,6,mixedType,0
5,3,0,8,mixedType,1
5,3,0,8,mixedType,1
9,2,0,11,mixedType,1
1,10,0,11,mixedType,1
5,3,0,8,mixedType,1
5,4,0,9,mixedType,1
6,4,0,10,mixedType,1
6,3,0,9,mixedType,1
11,3,0,14,mixedType,2
4,6,0,10,mixedType,1
5,3,0,8,mixedType,1
3,6,0,9,mixedType,1
6,1,0,7,mixedType,0
13,3,0,16,mixedType,2
8,3,0,11,mixedType,1
14,2,0,16,mixedType,2
6,2,0,8,mixedType,1
5,2,0,7,mixedType,0
10,1,0,11,mixedType,1
8,4,0,12,mixedType,1
7,1,0,8,mixedType,1
8,2,0,10,mixedType,1
5,4,0,9,mixedType,1
12,0,2,14,mixedType,2
9,1,0,10,mixedType,1
7,3,0,10,mixedType,1
8,2,0,10,mixedType,1
13,3,0,16,mixedType,2
5,5,0,10,mixedType,1
4,5,0,9,mixedType,1
14,2,0,16,mixedType,2
6,3,0,9,mixedType,1
12,3,0,15,mixedType,2
6,2,0,8,mixedType,1
4,4,0,8,mixedType,1
1,9,0,10,mixedType,1
9,4,0,13,mixedType,1
10,2,0,12,mixedType,1
5,3,0,8,mixedType,1
1,10,0,11,mixedType,1
8,2,0,10,mixedType,1
5,3,0,8,mixedType,1
6,3,0,9,mixedType,1
12,3,0,15,mixedType,2
2,10,0,12,mixedType,1
4,2,0,6,mixedType,0
8,0,1,9,mixedType,1
8,5,0,13,mixedType,1
6,3,0,9,mixedType,1
6,3,0,9,mixedType,1
6,1,0,7,mixedType,0
6,1,0,7,mixedType,0
6,2,0,8,mixedType,1
4,4,0,8,mixedType,1
7,3,0,10,mixedType,1
1,10,0,11,mixedType,1
7,3,0,10,mixedType,1
2,4,0,6,mixedType,0
4,6,0,10,mixedType,1
6,3,0,9,mixedType,1
4,2,0,6,mixedType,0
7,2,0,9,mixedType,1
6,2,0,8,mixedType,1
6,3,0,9,mixedType,1
8,2,0,10,mixedType,1
5,4,0,9,mixedType,1
3,6,0,9,mixedType,1
6,4,0,10,mixedType,1
4,8,0,12,mixedType,1
14,2,0,16,mixedType,2
5,3,0,8,mixedType,1
4,4,0,8,mixedType,1
7,2,0,9,mixedType,1
8,3,0,11,mixedType,1
5,4,0,9,mixedType,1
4,6,0,10,mixedType,1
6,2,0,8,mixedType,1
9,2,0,11,mixedType,1
7,2,0,9,mixedType,1
7,3,0,10,mixedType,1
11,3,0,14,mixedType,2
8,3,0,11,mixedType,1
6,3,0,9,mixedType,1
8,3,0,11,mixedType,1
9,2,0,11,mixedType,1
7,1,0,8,mixedType,1
7,3,0,10,mixedType,1
5,1,0,6,mixedType,0
6,3,0,9,mixedType,1
3,8,0,11,mixedType,1
5,4,0,9,mixedType,1
12,4,0,16,mixedType,2
2,9,0,11,mixedType,1
8,4,0,12,mixedType,1
6,3,0,9,mixedType,1
0,4,2,6,mixedType,0
3,5,0,8,mixedType,1
5,5,0,10,mixedType,1
2,8,0,10,mixedType,1
6,4,0,10,mixedType,1
14,2,0,16,mixedType,2
4,2,0,6,mixedType,0
3,8,0,11,mixedType,1
11,2,0,13,mixedType,1
6,4,0,10,mixedType,1
5,2,0,7,mixedType,0
4,8,0,12,mixedType,1
5,4,0,9,mixedType,1
13,3,0,16,mixedType,2
8,2,0,10,mixedType,1
12,4,0,16,mixedType,2
4,4,0,8,mixedType,1
9,3,0,12,mixedType,1
4,7,0,11,mixedType,1
8,2,0,10,mixedType,1
7,4,0,11,mixedType,1
7,2,0,9,mixedType,1
3,8,0,11,mixedType,1
3,5,0,8,mixedType,1
9,1,0,10,mixedType,1
7,2,0,9,mixedType,1
8,2,0,10,mixedType,1
5,2,0,7,mixedType,0
1,8,0,9,mixedType,1
4,8,0,12,mixedType,1
2,6,0,8,mixedType,1
6,5,0,11,mixedType,1
8,1,0,9,mixedType,1
6,4,0,10,mixedType,1
5,2,0,7,mixedType,0
2,6,0,8,mixedType,1
7,2,0,9,mixedType,1
7,4,0,11,mixedType,1
5,5,0,10,mixedType,1
7,6,0,13,mixedType,1
7,2,0,9,mixedType,1
2,8,0,10,mixedType,1
8,2,0,10,mixedType,1
5,1,0,6,mixedType,0
5,3,0,8,mixedType,1
7,3,0,10,mixedType,1
9,2,0,11,mixedType,1
6,3,0,9,mixedType,1
12,4,0,16,mixedType,2
10,1,0,11,mixedType,1
6,4,0,10,mixedType,1
4,8,0,12,mixedType,1
7,3,0,10,mixedType,1
8,2,0,10,mixedType,1
6,1,0,7,mixedType,0
3,8,0,11,mixedType,1
7,3,0,10,mixedType,1
6,1,0,7,mixedType,0
6,3,0,9,mixedType,1
3,6,0,9,mixedType,1
6,3,0,9,mixedType,1
5,2,0,7,mixedType,0
6,3,0,9,mixedType,1
6,1,0,7,mixedType,0
5,5,0,10,mixedType,1
4,5,0,9,mixedType,1
6,4,0,10,mixedType,1
4,4,0,8,mixedType,1
11,3,0,14,mixedType,2
12,4,0,16,mixedType,2
4,2,0,6,mixedType,0
2,10,0,12,mixedType,1
5,5,0,10,mixedType,1
5,3,0,8,mixedType,1
10,1,0,11,mixedType,1
5,4,0,9,mixedType,1
8,2,0,10,mixedType,1
7,2,0,9,mixedType,1
20,2,1,23,mixedType,2
7,3,0,10,mixedType,1
3,3,0,6,mixedType,0
5,2,0,7,mixedType,0
3,6,0,9,mixedType,1
4,2,0,6,mixedType,0
9,2,0,11,mixedType,1
8,4,0,12,mixedType,1
5,3,0,8,mixedType,1
5,3,0,8,mixedType,1
6,3,0,9,mixedType,1
4,2,0,6,mixedType,0
7,2,0,9,mixedType,1
8,2,0,10,mixedType,1
11,1,0,12,mixedType,1
6,5,0,11,mixedType,1
12,3,0,15,mixedType,2
10,3,0,13,mixedType,1
5,1,0,6,mixedType,0
15,1,0,16,mixedType,2
15,1,0,16,mixedType,2
14,4,0,18,mixedType,2
7,4,0,11,mixedType,1
7,2,0,9,mixedType,1
7,2,0,9,mixedType,1
8,3,0,11,mixedType,1
1,7,0,8,mixedType,1
1,8,0,9,mixedType,1
7,2,0,9,mixedType,1
6,2,0,8,mixedType,1
5,1,0,6,mixedType,0
3,7,0,10,mixedType,1
11,5,0,16,mixedType,2
7,2,0,9,mixedType,1
7,3,0,10,mixedType,1
5,3,0,8,mixedType,1
8,1,0,9,mixedType,1
11,3,0,14,mixedType,2
6,5,0,11,mixedType,1
4,2,0,6,mixedType,0
3,3,0,6,mixedType,0
3,8,0,11,mixedType,1
8,2,0,10,mixedType,1
8,1,0,9,mixedType,1
7,1,0,8,mixedType,1
4,4,0,8,mixedType,1
3,5,0,8,mixedType,1
8,1,0,9,mixedType,1
7,3,0,10,mixedType,1
6,3,0,9,mixedType,1
6,1,0,7,mixedType,0
13,3,0,16,mixedType,2
7,2,0,9,mixedType,1
7,3,0,10,mixedType,1
5,4,0,9,mixedType,1
1,8,0,9,mixedType,1
5,4,0,9,mixedType,1
9,1,0,10,mixedType,1
5,2,0,7,mixedType,0
9,3,0,12,mixedType,1
9,1,0,10,mixedType,1
5,3,0,8,mixedType,1
4,4,0,8,mixedType,1
5,3,0,8,mixedType,1
7,1,0,8,mixedType,1
8,2,0,10,mixedType,1
13,3,0,16,mixedType,2
3,6,0,9,mixedType,1
8,1,0,9,mixedType,1
9,1,0,10,mixedType,1
4,5,0,9,mixedType,1
7,3,0,10,mixedType,1
7,2,0,9,mixedType,1
6,4,0,10,mixedType,1
6,2,0,8,mixedType,1
15,1,0,16,mixedType,2
9,2,0,11,mixedType,1
6,2,0,8,mixedType,1
10,2,0,12,mixedType,1
4,4,0,8,mixedType,1
8,1,0,9,mixedType,1
10,3,0,13,mixedType,1
6,3,0,9,mixedType,1
6,3,0,9,mixedType,1
10,1,0,11,mixedType,1
2,6,0,8,mixedType,1
7,2,0,9,mixedType,1
2,10,0,12,mixedType,1
4,2,0,6,mixedType,0
7,3,0,10,mixedType,1
12,4,0,16,mixedType,2
12,4,0,16,mixedType,2
8,5,0,13,mixedType,1
13,3,0,16,mixedType,2
11,2,0,13,mixedType,1
7,3,0,10,mixedType,1
5,8,0,13,mixedType,1
7,2,0,9,mixedType,1
14,2,0,16,mixedType,2
7,4,0,11,mixedType,1
6,3,0,9,mixedType,1
5,3,0,8,mixedType,1
7,2,0,9,mixedType,1
9,4,0,13,mixedType,1
14,2,0,16,mixedType,2
7,3,0,10,mixedType,1
5,4,0,9,mixedType,1
4,2,0,6,mixedType,0
5,3,0,8,mixedType,1
5,3,0,8,mixedType,1
13,3,0,16,mixedType,2
6,3,0,9,mixedType,1
5,3,0,8,mixedType,1
7,3,0,10,mixedType,1
14,2,0,16,mixedType,2
3,3,0,6,mixedType,0
2,8,0,10,mixedType,1
3,6,0,9,mixedType,1
6,3,0,9,mixedType,1
13,3,0,16,mixedType,2
2,8,0,10,mixedType,1
6,4,0,10,mixedType,1
6,3,0,9,mixedType,1
8,2,0,10,mixedType,1
6,2,0,8,mixedType,1
6,4,0,10,mixedType,1
8,2,0,10,mixedType,1
1,8,0,9,mixedType,1
8,3,0,11,mixedType,1
3,3,0,6,mixedType,0
9,3,0,12,mixedType,1
1,8,0,9,mixedType,1
3,3,0,6,mixedType,0
4,4,0,8,mixedType,1
2,6,0,8,mixedType,1
10,3,0,13,mixedType,1
15,1,0,16,mixedType,2
10,3,0,13,mixedType,1
4,6,0,10,mixedType,1
2,8,0,10,mixedType,1
7,1,0,8,mixedType,1
9,3,0,12,mixedType,1
3,6,0,9,mixedType,1
7,2,0,9,mixedType,1
6,4,0,10,mixedType,1
15,1,0,16,mixedType,2
6,2,0,8,mixedType,1
5,4,0,9,mixedType,1
6,3,0,9,mixedType,1
9,2,0,11,mixedType,1
8,4,0,12,mixedType,1
1,9,0,10,mixedType,1
2,6,0,8,mixedType,1
6,1,0,7,mixedType,0
15,1,0,16,mixedType,2
2,6,0,8,mixedType,1
9,2,0,11,mixedType,1
7,6,0,13,mixedType,1
3,6,0,9,mixedType,1
3,5,0,8,mixedType,1
5,3,0,8,mixedType,1
12,1,0,13,mixedType,1
3,5,0,8,mixedType,1
4,2,0,6,mixedType,0
6,1,0,7,mixedType,0
7,3,0,10,mixedType,1
4,5,0,9,mixedType,1
4,4,0,8,mixedType,1
6,7,0,13,mixedType,1
4,2,0,6,mixedType,0
5,4,0,9,mixedType,1
7,3,0,10,mixedType,1
12,4,0,16,mixedType,2
6,4,0,10,mixedType,1
14,2,0,16,mixedType,2
12,4,0,16,mixedType,2
9,1,0,10,mixedType,1
7,3,0,10,mixedType,1
4,4,0,8,mixedType,1
4,5,0,9,mixedType,1
6,2,0,8,mixedType,1
7,1,0,8,mixedType,1
12,4,0,16,mixedType,2
6,3,0,9,mixedType,1
4,2,0,6,mixedType,0
6,3,0,9,mixedType,1
3,6,0,9,mixedType,1
7,2,0,9,mixedType,1
8,2,0,10,mixedType,1
6,3,0,9,mixedType,1
4,2,0,6,mixedType,0
7,3,0,10,mixedType,1
5,1,0,6,mixedType,0
9,2,0,11,mixedType,1
2,7,0,9,mixedType,1
7,2,0,9,mixedType,1
9,2,0,11,mixedType,1
11,5,0,16,mixedType,2
12,4,0,16,mixedType,2
6,3,0,9,mixedType,1
5,7,0,12,mixedType,1
7,3,0,10,mixedType,1
4,4,0,8,mixedType,1
6,4,0,10,mixedType,1
5,2,0,7,mixedType,0
6,2,0,8,mixedType,1
6,3,0,9,mixedType,1
8,1,0,9,mixedType,1
6,1,0,7,mixedType,0
7,3,0,10,mixedType,1
4,2,0,6,mixedType,0
7,3,0,10,mixedType,1
15,1,0,16,mixedType,2
7,2,0,9,mixedType,1
7,3,0,10,mixedType,1
8,3,0,11,mixedType,1
2,8,0,10,mixedType,1
8,2,0,10,mixedType,1
8,2,0,10,mixedType,1
0,6,3,9,mixedType,1
5,1,0,6,mixedType,0
12,4,0,16,mixedType,2
1,7,0,8,mixedType,1
7,3,0,10,mixedType,1
9,2,0,11,mixedType,1
9,1,0,10,mixedType,1
6,4,0,10,mixedType,1
7,2,0,9,mixedType,1
8,2,0,10,mixedType,1
3,7,0,10,mixedType,1
9,3,0,12,mixedType,1
4,2,0,6,mixedType,0
11,3,0,14,mixedType,2
7,3,0,10,mixedType,1
4,2,0,6,mixedType,0
8,2,0,10,mixedType,1
4,2,0,6,mixedType,0
6,2,0,8,mixedType,1
4,6,0,10,mixedType,1
2,6,0,8,mixedType,1
5,4,0,9,mixedType,1
8,2,0,10,mixedType,1
3,5,0,8,mixedType,1
5,2,0,7,mixedType,0
7,6,0,13,mixedType,1
14,2,0,16,mixedType,2
8,1,0,9,mixedType,1
5,3,0,8,mixedType,1
7,2,0,9,mixedType,1
8,2,0,10,mixedType,1
1,10,0,11,mixedType,1
6,3,0,9,mixedType,1
9,2,0,11,mixedType,1
4,6,0,10,mixedType,1
11,5,0,16,mixedType,2
12,3,0,15,mixedType,2
6,1,0,7,mixedType,0
9,1,0,10,mixedType,1
8,1,0,9,mixedType,1
3,7,0,10,mixedType,1
6,2,0,8,mixedType,1
7,1,0,8,mixedType,1
2,8,0,10,mixedType,1
3,6,0,9,mixedType,1
6,2,0,8,mixedType,1
6,2,0,8,mixedType,1
4,2,0,6,mixedType,0
7,3,0,10,mixedType,1
8,0,1,9,mixedType,1
9,4,0,13,mixedType,1
10,4,0,14,mixedType,2
5,1,0,6,mixedType,0
8,2,0,10,mixedType,1
6,4,0,10,mixedType,1
5,2,0,7,mixedType,0
3,6,0,9,mixedType,1
4,2,0,6,mixedType,0
4,4,0,8,mixedType,1
6,3,0,9,mixedType,1
6,3,0,9,mixedType,1
7,0,1,8,mixedType,1
5,7,0,12,mixedType,1
9,2,0,11,mixedType,1
5,2,0,7,mixedType,0
4,4,0,8,mixedType,1
9,3,0,12,mixedType,1
7,3,0,10,mixedType,1
7,3,0,10,mixedType,1
8,1,0,9,mixedType,1
6,3,0,9,mixedType,1
5,4,0,9,mixedType,1
16,1,1,18,mixedType,2
8,2,0,10,mixedType,1
6,3,0,9,mixedType,1
8,2,0,10,mixedType,1
15,1,0,16,mixedType,2
3,7,0,10,mixedType,1
7,4,0,11,mixedType,1
14,2,0,16,mixedType,2
12,4,0,16,mixedType,2
5,2,0,7,mixedType,0
7,2,0,9,mixedType,1
13,3,0,16,mixedType,2
14,2,0,16,mixedType,2
8,3,0,11,mixedType,1
4,6,0,10,mixedType,1
15,1,0,16,mixedType,2
1,8,0,9,mixedType,1
6,4,0,10,mixedType,1
6,3,0,9,mixedType,1
4,6,0,10,mixedType,1
14,2,0,16,mixedType,2
7,3,0,10,mixedType,1
7,2,0,9,mixedType,1
2,6,0,8,mixedType,1
8,1,0,9,mixedType,1
6,1,0,7,mixedType,0
14,2,0,16,mixedType,2
5,3,0,8,mixedType,1
5,2,0,7,mixedType,0
9,1,0,10,mixedType,1
5,2,0,7,mixedType,0
7,4,0,11,mixedType,1
4,8,0,12,mixedType,1
7,3,0,10,mixedType,1
6,4,0,10,mixedType,1
1,8,0,9,mixedType,1
9,2,0,11,mixedType,1
9,4,0,13,mixedType,1
7,2,0,9,mixedType,1
5,3,0,8,mixedType,1
6,0,2,8,mixedType,0
3,8,0,11,mixedType,1
9,4,0,13,mixedType,1
5,7,0,12,mixedType,1
3,8,0,11,mixedType,1
4,6,0,10,mixedType,1
9,2,0,11,mixedType,1
6,1,0,7,mixedType,0
14,2,0,16,mixedType,2
5,2,0,7,mixedType,0
1,7,0,8,mixedType,1
6,3,0,9,mixedType,1
12,3,0,15,mixedType,2
7,2,0,9,mixedType,1
6,4,0,10,mixedType,1
6,1,0,7,mixedType,0
4,4,0,8,mixedType,1
5,3,0,8,mixedType,1
6,4,0,10,mixedType,1
6,2,0,8,mixedType,1
11,3,1,15,mixedType,2
6,6,0,12,mixedType,1
5,6,0,11,mixedType,1
9,3,0,12,mixedType,1
4,2,0,6,mixedType,0
6,2,0,8,mixedType,1
2,6,0,8,mixedType,1
7,3,0,10,mixedType,1
6,4,0,10,mixedType,1
6,7,0,13,mixedType,1
3,6,0,9,mixedType,1
5,2,0,7,mixedType,0
6,2,0,8,mixedType,1
8,4,0,12,mixedType,1
5,5,0,10,mixedType,1
15,1,0,16,mixedType,2
14,2,0,16,mixedType,2
7,3,0,10,mixedType,1
7,2,0,9,mixedType,1
6,4,0,10,mixedType,1
8,2,0,10,mixedType,1
6,5,0,11,mixedType,1
1,8,0,9,mixedType,1
1,8,0,9,mixedType,1
8,4,0,12,mixedType,1
6,4,0,10,mixedType,1
7,2,0,9,mixedType,1
14,2,0,16,mixedType,2
7,4,0,11,mixedType,1
9,1,0,10,mixedType,1
2,6,0,8,mixedType,1
15,1,0,16,mixedType,2
7,4,0,11,mixedType,1
5,4,0,9,mixedType,1
7,2,0,9,mixedType,1
7,1,0,8,mixedType,1
7,3,0,10,mixedType,1
6,3,0,9,mixedType,1
6,1,0,7,mixedType,0
1,6,0,7,mixedType,0
5,4,0,9,mixedType,1
3,10,0,13,mixedType,1
8,4,0,12,mixedType,1
8,1,0,9,mixedType,1
2,7,0,9,mixedType,1
1,8,0,9,mixedType,1
5,4,0,9,mixedType,1
7,2,0,9,mixedType,1
3,3,0,6,mixedType,0
2,4,0,6,mixedType,0
7,5,0,12,mixedType,1
5,5,0,10,mixedType,1
6,3,0,9,mixedType,1
4,6,0,10,mixedType,1
2,6,0,8,mixedType,1
6,3,0,9,mixedType,1
5,3,0,8,mixedType,1
11,2,0,13,mixedType,1
6,1,0,7,mixedType,0
6,2,0,8,mixedType,1
2,6,0,8,mixedType,1
8,1,0,9,mixedType,1
5,3,0,8,mixedType,1
10,2,0,12,mixedType,1
4,10,0,14,mixedType,2
2,8,0,10,mixedType,1
3,6,0,9,mixedType,1
3,6,0,9,mixedType,1
6,3,0,9,mixedType,1
3,3,0,6,mixedType,0
8,2,0,10,mixedType,1
9,2,0,11,mixedType,1
10,4,1,15,mixedType,2
3,3,0,6,mixedType,0
6,2,0,8,mixedType,1
1,9,0,10,mixedType,1
4,2,0,6,mixedType,0
11,3,0,14,mixedType,2
8,3,0,11,mixedType,1
15,1,0,16,mixedType,2
5,4,0,9,mixedType,1
6,4,0,10,mixedType,1
8,2,0,10,mixedType,1
7,1,0,8,mixedType,1
7,4,0,11,mixedType,1
9,6,0,15,mixedType,2
7,1,0,8,mixedType,1
7,3,0,10,mixedType,1
7,3,0,10,mixedType,1
6,3,0,9,mixedType,1
3,9,0,12,mixedType,1
4,6,0,10,mixedType,1
14,2,0,16,mixedType,2
5,5,0,10,mixedType,1
8,2,0,10,mixedType,1
14,2,0,16,mixedType,2
5,2,0,7,mixedType,0
6,2,0,8,mixedType,1
6,4,0,10,mixedType,1
15,1,0,16,mixedType,2
7,2,0,9,mixedType,1
7,1,0,8,mixedType,1
4,2,0,6,mixedType,0
8,2,0,10,mixedType,1
8,2,0,10,mixedType,1
9,1,0,10,mixedType,1
1,7,0,8,mixedType,1
14,2,0,16,mixedType,2
6,4,0,10,mixedType,1
5,2,0,7,mixedType,0
15,1,0,16,mixedType,2
8,8,0,16,mixedType,2
3,8,0,11,mixedType,1
2,8,0,10,mixedType,1
7,3,0,10,mixedType,1
6,2,0,8,mixedType,1
5,3,0,8,mixedType,1
6,2,0,8,mixedType,1
1,8,0,9,mixedType,1
4,4,0,8,mixedType,1
9,1,0,10,mixedType,1
7,3,0,10,mixedType,1
3,6,0,9,mixedType,1
10,2,0,12,mixedType,1
5,1,0,6,mixedType,0
11,1,0,12,mixedType,1
13,3,0,16,mixedType,2
7,3,0,10,mixedType,1
6,1,0,7,mixedType,0
6,1,0,7,mixedType,0
6,3,0,9,mixedType,1
4,2,0,6,mixedType,0
7,3,0,10,mixedType,1
10,3,0,13,mixedType,1
7,3,0,10,mixedType,1
5,3,0,8,mixedType,1
8,1,0,9,mixedType,1
6,3,0,9,mixedType,1
5,2,0,7,mixedType,0
6,4,0,10,mixedType,1
5,2,0,7,mixedType,0
6,3,0,9,mixedType,1
8,2,0,10,mixedType,1
12,4,0,16,mixedType,2
6,2,0,8,mixedType,1
5,4,0,9,mixedType,1
13,3,0,16,mixedType,2
4,4,0,8,mixedType,1
15,1,0,16,mixedType,2
9,3,0,12,mixedType,1
4,2,0,6,mixedType,0
5,4,0,9,mixedType,1
7,3,0,10,mixedType,1
7,1,0,8,mixedType,1
9,1,0,10,mixedType,1
5,4,0,9,mixedType,1
3,9,0,12,mixedType,1
6,1,0,7,mixedType,0
6,2,0,8,mixedType,1
3,7,0,10,mixedType,1
6,4,0,10,mixedType,1
5,2,0,7,mixedType,0
4,5,0,9,mixedType,1
4,8,0,12,mixedType,1
2,8,0,10,mixedType,1
13,3,0,16,mixedType,2
9,3,0,12,mixedType,1
5,4,0,9,mixedType,1
6,3,0,9,mixedType,1
6,3,0,9,mixedType,1
6,4,0,10,mixedType,1
6,1,0,7,mixedType,0
1,8,0,9,mixedType,1
6,4,0,10,mixedType,1
3,3,0,6,mixedType,0
8,2,0,10,mixedType,1
7,2,0,9,mixedType,1
6,4,0,10,mixedType,1
8,3,0,11,mixedType,1
7,1,0,8,mixedType,1
15,1,0,16,mixedType,2
6,2,0,8,mixedType,1
8,2,0,10,mixedType,1
9,3,0,12,mixedType,1
6,3,0,9,mixedType,1
0,6,1,7,mixedType,0
10,2,0,12,mixedType,1
5,3,0,8,mixedType,1
7,2,0,9,mixedType,1
4,2,0,6,mixedType,0
2,9,0,11,mixedType,1
6,3,0,9,mixedType,1
8,2,0,10,mixedType,1
4,6,0,10,mixedType,1
9,3,0,12,mixedType,1
7,2,0,9,mixedType,1
6,3,0,9,mixedType,1
7,3,0,10,mixedType,1
9,1,0,10,mixedType,1
6,2,0,8,mixedType,1
3,6,0,9,mixedType,1
7,3,0,10,mixedType,1
8,2,0,10,mixedType,1
4,2,0,6,mixedType,0
11,1,0,12,mixedType,1
7,3,0,10,mixedType,1
8,4,0,12,mixedType,1
5,2,0,7,mixedType,0
15,1,0,16,mixedType,2
7,3,0,10,mixedType,1
7,3,0,10,mixedType,1
3,10,0,13,mixedType,1
2,6,0,8,mixedType,1
9,1,0,10,mixedType,1
6,2,0,8,mixedType,1
7,2,0,9,mixedType,1
7,3,0,10,mixedType,1
6,3,0,9,mixedType,1
5,3,0,8,mixedType,1
4,2,0,6,mixedType,0
7,3,0,10,mixedType,1
7,3,0,10,mixedType,1
7,2,0,9,mixedType,1
1,10,0,11,mixedType,1
12,3,0,15,mixedType,2
6,6,0,12,mixedType,1
4,4,0,8,mixedType,1
2,6,0,8,mixedType,1
8,1,0,9,mixedType,1
12,4,0,16,mixedType,2
6,3,0,9,mixedType,1
8,2,0,10,mixedType,1
4,4,0,8,mixedType,1
8,1,0,9,mixedType,1
4,4,0,8,mixedType,1
9,2,0,11,mixedType,1
4,4,0,8,mixedType,1
9,3,0,12,mixedType,1
6,4,0,10,mixedType,1
6,2,0,8,mixedType,1
3,8,0,11,mixedType,1
10,3,0,13,mixedType,1
2,10,0,12,mixedType,1
4,4,0,8,mixedType,1
4,8,0,12,mixedType,1
4,2,0,6,mixedType,0
7,2,0,9,mixedType,1
5,3,0,8,mixedType,1
5,4,0,9,mixedType,1
6,4,0,10,mixedType,1
5,2,0,7,mixedType,0
12,4,0,16,mixedType,2
4,2,0,6,mixedType,0
13,3,0,16,mixedType,2
4,4,0,8,mixedType,1
3,5,0,8,mixedType,1
5,4,0,9,mixedType,1
10,1,0,11,mixedType,1
9,3,0,12,mixedType,1
8,2,0,10,mixedType,1
6,2,0,8,mixedType,1
6,4,0,10,mixedType,1
6,2,0,8,mixedType,1
11,5,0,16,mixedType,2
7,5,0,12,mixedType,1
16,2,0,18,mixedType,2
8,2,0,10,mixedType,1
9,1,0,10,mixedType,1
5,4,0,9,mixedType,1
12,4,0,16,mixedType,2
6,3,0,9,mixedType,1
5,5,0,10,mixedType,1
6,3,0,9,mixedType,1
6,3,0,9,mixedType,1
6,1,0,7,mixedType,0
6,3,0,9,mixedType,1
11,3,0,14,mixedType,2
6,1,0,7,mixedType,0
6,4,0,10,mixedType,1
6,3,0,9,mixedType,1
5,2,0,7,mixedType,0
6,2,0,8,mixedType,1
12,4,0,16,mixedType,2
14,2,0,16,mixedType,2
12,4,0,16,mixedType,2
5,2,0,7,mixedType,0
9,3,0,12,mixedType,1
6,6,0,12,mixedType,1
4,2,0,6,mixedType,0
5,3,0,8,mixedType,1
12,4,0,16,mixedType,2
3,9,0,12,mixedType,1
5,3,0,8,mixedType,1
4,4,0,8,mixedType,1
6,2,0,8,mixedType,1
5,2,0,7,mixedType,0
6,2,0,8,mixedType,1
3,8,0,11,mixedType,1
7,3,0,10,mixedType,1
9,2,0,11,mixedType,1
3,6,0,9,mixedType,1
4,2,0,6,mixedType,0
6,4,0,10,mixedType,1
7,2,0,9,mixedType,1
9,2,0,11,mixedType,1
5,3,0,8,mixedType,1
5,3,0,8,mixedType,1
5,3,0,8,mixedType,1
5,4,0,9,mixedType,1
8,2,0,10,mixedType,1
5,3,0,8,mixedType,1
8,2,0,10,mixedType,1
7,4,0,11,mixedType,1
12,1,0,13,mixedType,1
9,4,0,13,mixedType,1
7,3,0,10,mixedType,1
6,3,0,9,mixedType,1
5,4,0,9,mixedType,1
5,6,0,11,mixedType,1
11,1,0,12,mixedType,1
6,4,0,10,mixedType,1
15,1,0,16,mixedType,2
10,3,0,13,mixedType,1
10,2,0,12,mixedType,1
4,2,0,6,mixedType,0
11,5,0,16,mixedType,2
9,1,0,10,mixedType,1
3,3,0,6,mixedType,0
13,3,0,16,mixedType,2
5,4,0,9,mixedType,1
13,3,0,16,mixedType,2
6,1,0,7,mixedType,0
6,3,0,9,mixedType,1
9,1,0,10,mixedType,1
14,2,0,16,mixedType,2
8,3,0,11,mixedType,1
2,8,0,10,mixedType,1
13,3,0,16,mixedType,2
9,3,0,12,mixedType,1
14,2,0,16,mixedType,2
8,1,0,9,mixedType,1
4,2,0,6,mixedType,0
13,3,0,16,mixedType,2
7,1,0,8,mixedType,1
8,1,0,9,mixedType,1
3,8,0,11,mixedType,1
5,3,0,8,mixedType,1
5,3,0,8,mixedType,1
0,9,1,10,mixedType,1
15,1,0,16,mixedType,2
9,1,0,10,mixedType,1
7,3,0,10,mixedType,1
4,2,0,6,mixedType,0
14,2,0,16,mixedType,2
12,4,0,16,mixedType,2
1,7,0,8,mixedType,1
1,11,0,12,mixedType,1
4,2,0,6,mixedType,0
7,3,0,10,mixedType,1
1,7,0,8,mixedType,1
6,1,0,7,mixedType,0
7,2,0,9,mixedType,1
9,1,0,10,mixedType,1
7,3,0,10,mixedType,1
3,5,0,8,mixedType,1
9,1,0,10,mixedType,1
6,2,0,8,mixedType,1
5,2,0,7,mixedType,0
8,1,0,9,mixedType,1
5,2,0,7,mixedType,0
5,2,0,7,mixedType,0
9,2,0,11,mixedType,1
5,2,0,7,mixedType,0
6,1,0,7,mixedType,0
14,2,0,16,mixedType,2
7,3,0,10,mixedType,1
13,3,0,16,mixedType,2
5,3,0,8,mixedType,1
14,2,0,16,mixedType,2
2,7,0,9,mixedType,1
10,2,0,12,mixedType,1
15,1,0,16,mixedType,2
7,2,0,9,mixedType,1
12,14,0,26,mixedType,2
2,8,0,10,mixedType,1
7,3,0,10,mixedType,1
1,8,0,9,mixedType,1
5,3,0,8,mixedType,1
7,1,0,8,mixedType,1
5,2,0,7,mixedType,0
7,2,0,9,mixedType,1
4,4,0,8,mixedType,1
10,3,0,13,mixedType,1
9,1,0,10,mixedType,1
6,1,0,7,mixedType,0
5,2,0,7,mixedType,0
4,4,0,8,mixedType,1
2,4,0,6,mixedType,0
7,1,0,8,mixedType,1
5,2,0,7,mixedType,0
7,1,0,8,mixedType,1
14,2,0,16,mixedType,2
7,3,0,10,mixedType,1
9,2,0,11,mixedType,1
4,4,0,8,mixedType,1
6,3,0,9,mixedType,1
7,3,0,10,mixedType,1
4,2,0,6,mixedType,0
7,5,0,12,mixedType,1
5,3,0,8,mixedType,1
6,4,0,10,mixedType,1
5,4,0,9,mixedType,1
7,3,0,10,mixedType,1
6,2,0,8,mixedType,1
6,4,0,10,mixedType,1
5,4,0,9,mixedType,1
8,1,0,9,mixedType,1
6,6,0,12,mixedType,1
5,2,0,7,mixedType,0
10,1,0,11,mixedType,1
7,3,0,10,mixedType,1
5,3,0,8,mixedType,1
7,3,0,10,mixedType,1
8,2,0,10,mixedType,1
9,1,0,10,mixedType,1
5,1,0,6,mixedType,0
5,2,0,7,mixedType,0
13,3,0,16,mixedType,2
6,3,0,9,mixedType,1
12,1,0,13,mixedType,1
6,3,0,9,mixedType,1
6,3,0,9,mixedType,1
8,3,0,11,mixedType,1
5,6,0,11,mixedType,1
7,3,0,10,mixedType,1
4,4,0,8,mixedType,1
5,9,0,14,mixedType,2
6,2,0,8,mixedType,1
5,4,0,9,mixedType,1
13,3,0,16,mixedType,2
11,2,0,13,mixedType,1
6,2,0,8,mixedType,1
9,1,0,10,mixedType,1
6,2,0,8,mixedType,1
7,3,0,10,mixedType,1
4,5,0,9,mixedType,1
3,7,0,10,mixedType,1
7,1,0,8,mixedType,1
13,3,0,16,mixedType,2
5,2,0,7,mixedType,0
6,1,0,7,mixedType,0
6,3,0,9,mixedType,1
8,1,0,9,mixedType,1
8,2,0,10,mixedType,1
6,1,0,7,mixedType,0
9,3,0,12,mixedType,1
6,2,0,8,mixedType,1
2,8,0,10,mixedType,1
8,2,0,10,mixedType,1
1,8,0,9,mixedType,1
11,2,0,13,mixedType,1
7,1,0,8,mixedType,1
8,1,0,9,mixedType,1
4,2,0,6,mixedType,0
6,3,0,9,mixedType,1
6,3,0,9,mixedType,1
3,6,0,9,mixedType,1
6,2,0,8,mixedType,1
8,1,0,9,mixedType,1
8,2,0,10,mixedType,1
4,6,0,10,mixedType,1
9,1,0,10,mixedType,1
7,4,0,11,mixedType,1
4,4,0,8,mixedType,1
5,3,0,8,mixedType,1
4,2,0,6,mixedType,0
5,5,0,10,mixedType,1
4,5,0,9,mixedType,1
5,5,0,10,mixedType,1
6,3,0,9,mixedType,1
5,3,0,8,mixedType,1
4,4,0,8,mixedType,1
8,2,0,10,mixedType,1
5,3,0,8,mixedType,1
7,2,0,9,mixedType,1
6,1,0,7,mixedType,0
9,1,0,10,mixedType,1
5,3,0,8,mixedType,1
15,1,0,16,mixedType,2
6,4,0,10,mixedType,1
5,3,0,8,mixedType,1
9,1,0,10,mixedType,1
12,3,0,15,mixedType,2
7,4,0,11,mixedType,1
7,1,0,8,mixedType,1
5,3,0,8,mixedType,1
7,4,0,11,mixedType,1
5,1,0,6,mixedType,0
6,1,0,7,mixedType,0
6,14,0,20,mixedType,2
5,4,0,9,mixedType,1
7,3,0,10,mixedType,1
2,6,0,8,mixedType,1
1,7,0,8,mixedType,1
7,3,0,10,mixedType,1
5,6,0,11,mixedType,1
5,3,0,8,mixedType,1
6,2,0,8,mixedType,1
5,1,0,6,mixedType,0
6,4,0,10,mixedType,1
8,4,0,12,mixedType,1
4,2,0,6,mixedType,0
6,1,0,7,mixedType,0
2,6,0,8,mixedType,1
8,3,0,11,mixedType,1
5,3,0,8,mixedType,1
7,0,1,8,mixedType,1
7,3,0,10,mixedType,1
5,4,0,9,mixedType,1
6,3,0,9,mixedType,1
6,1,0,7,mixedType,0
2,7,0,9,mixedType,1
9,1,0,10,mixedType,1
10,3,0,13,mixedType,1
6,3,0,9,mixedType,1
4,4,0,8,mixedType,1
2,6,0,8,mixedType,1
9,1,0,10,mixedType,1
5,4,0,9,mixedType,1
3,10,0,13,mixedType,1
10,2,0,12,mixedType,1
8,2,0,10,mixedType,1
9,4,0,13,mixedType,1
4,4,0,8,mixedType,1
15,1,0,16,mixedType,2
6,3,0,9,mixedType,1
10,4,0,14,mixedType,2
11,3,1,15,mixedType,2
5,1,0,6,mixedType,0
4,4,0,8,mixedType,1
5,1,0,6,mixedType,0
5,2,0,7,mixedType,0
9,1,0,10,mixedType,1
8,1,0,9,mixedType,1
8,1,0,9,mixedType,1
8,2,0,10,mixedType,1
10,1,0,11,mixedType,1
6,4,0,10,mixedType,1
7,2,0,9,mixedType,1
8,2,0,10,mixedType,1
2,10,0,12,mixedType,1
8,1,0,9,mixedType,1
13,2,0,15,mixedType,2
7,1,0,8,mixedType,1
7,3,0,10,mixedType,1
9,2,0,11,mixedType,1
8,4,0,12,mixedType,1
8,2,0,10,mixedType,1
3,6,0,9,mixedType,1
6,3,0,9,mixedType,1
5,3,0,8,mixedType,1
10,1,0,11,mixedType,1
8,2,0,10,mixedType,1
7,3,0,10,mixedType,1
4,2,0,6,mixedType,0
10,3,0,13,mixedType,1
7,4,0,11,mixedType,1
8,1,0,9,mixedType,1
9,1,0,10,mixedType,1
7,2,0,9,mixedType,1
8,1,0,9,mixedType,1
7,3,0,10,mixedType,1
4,4,0,8,mixedType,1
6,2,0,8,mixedType,1
6,3,0,9,mixedType,1
5,2,0,7,mixedType,0
8,1,0,9,mixedType,1
12,3,0,15,mixedType,2
1,9,0,10,mixedType,1
5,1,0,6,mixedType,0
1,8,0,9,mixedType,1
0,6,0,6,sameType,0
11,5,0,16,mixedType,2
6,4,0,10,mixedType,1
2,4,0,6,mixedType,0
6,3,0,9,mixedType,1
6,3,0,9,mixedType,1
14,2,0,16,mixedType,2
4,2,0,6,mixedType,0
8,1,0,9,mixedType,1
7,3,0,10,mixedType,1
15,1,0,16,mixedType,2
5,4,0,9,mixedType,1
3,6,0,9,mixedType,1
5,2,0,7,mixedType,0
4,2,0,6,mixedType,0
9,5,4,18,mixedType,2
9,3,0,12,mixedType,1
8,2,0,10,mixedType,1
13,1,1,15,mixedType,2
8,3,0,11,mixedType,1
2,9,0,11,mixedType,1
5,2,0,7,mixedType,0
8,4,0,12,mixedType,1
8,2,0,10,mixedType,1
7,3,0,10,mixedType,1
8,1,0,9,mixedType,1
4,2,0,6,mixedType,0
5,1,0,6,mixedType,0
6,6,0,12,mixedType,1
6,1,0,7,mixedType,0
7,2,0,9,mixedType,1
13,3,0,16,mixedType,2
5,4,0,9,mixedType,1
7,4,0,11,mixedType,1
8,2,0,10,mixedType,1
7,2,0,9,mixedType,1
5,2,0,7,mixedType,0
6,6,0,12,mixedType,1
9,1,0,10,mixedType,1
13,3,0,16,mixedType,2
14,2,0,16,mixedType,2
15,1,0,16,mixedType,2
3,2,0,5,mixedType,0
1,8,0,9,mixedType,1
3,7,0,10,mixedType,1
9,3,0,12,mixedType,1
6,3,0,9,mixedType,1
14,2,0,16,mixedType,2
12,3,0,15,mixedType,2
1,9,0,10,mixedType,1
7,2,0,9,mixedType,1
7,1,0,8,mixedType,1
4,6,0,10,mixedType,1
4,2,0,6,mixedType,0
5,6,0,11,mixedType,1
9,1,0,10,mixedType,1
5,3,0,8,mixedType,1
13,3,0,16,mixedType,2
7,4,0,11,mixedType,1
2,6,0,8,mixedType,1
6,7,0,13,mixedType,1
3,9,0,12,mixedType,1
8,2,0,10,mixedType,1
11,5,0,16,mixedType,2
14,2,0,16,mixedType,2
5,2,0,7,mixedType,0
7,3,0,10,mixedType,1
6,4,0,10,mixedType,1
5,8,0,13,mixedType,1
6,4,0,10,mixedType,1
5,5,0,10,mixedType,1
5,3,0,8,mixedType,1
7,2,0,9,mixedType,1
6,3,0,9,mixedType,1
6,1,0,7,mixedType,0
8,6,1,15,mixedType,2
9,1,0,10,mixedType,1
14,2,0,16,mixedType,2
8,1,0,9,mixedType,1
4,4,0,8,mixedType,1
7,2,0,9,mixedType,1
9,1,0,10,mixedType,1
5,4,0,9,mixedType,1
8,2,0,10,mixedType,1
7,7,0,14,mixedType,2
4,5,0,9,mixedType,1
8,1,0,9,mixedType,1
15,1,0,16,mixedType,2
7,3,0,10,mixedType,1
2,4,0,6,mixedType,0
7,3,0,10,mixedType,1
8,1,0,9,mixedType,1
3,5,0,8,mixedType,1
8,1,0,9,mixedType,1
6,3,0,9,mixedType,1
13,3,0,16,mixedType,2
4,2,0,6,mixedType,0
6,4,0,10,mixedType,1
4,2,0,6,mixedType,0
14,2,0,16,mixedType,2
8,2,0,10,mixedType,1
8,2,0,10,mixedType,1
10,1,0,11,mixedType,1
5,4,0,9,mixedType,1
5,2,0,7,mixedType,0
9,0,3,12,mixedType,1
6,1,0,7,mixedType,0
5,4,0,9,mixedType,1
8,1,0,9,mixedType,1
6,3,0,9,mixedType,1
13,3,0,16,mixedType,2
6,2,0,8,mixedType,1
7,2,0,9,mixedType,1
7,3,0,10,mixedType,1
11,3,2,16,mixedType,2
6,1,0,7,mixedType,0
7,3,0,10,mixedType,1
9,1,0,10,mixedType,1
7,2,0,9,mixedType,1
7,2,0,9,mixedType,1
6,1,0,7,mixedType,0
8,4,0,12,mixedType,1
7,1,0,8,mixedType,1
1,9,0,10,mixedType,1
6,1,0,7,mixedType,0
5,3,0,8,mixedType,1
8,2,0,10,mixedType,1
2,6,0,8,mixedType,1
1,8,0,9,mixedType,1
13,3,0,16,mixedType,2
7,3,0,10,mixedType,1
8,2,0,10,mixedType,1
6,4,0,10,mixedType,1
6,4,0,10,mixedType,1
6,4,0,10,mixedType,1
6,3,0,9,mixedType,1
2,8,0,10,mixedType,1
11,1,3,15,mixedType,2
14,2,0,16,mixedType,2
4,2,0,6,mixedType,0
8,1,0,9,mixedType,1
10,2,0,12,mixedType,1
6,6,0,12,mixedType,1
4,4,0,8,mixedType,1
8,3,0,11,mixedType,1
4,6,0,10,mixedType,1
6,2,0,8,mixedType,1
7,1,0,8,mixedType,1
5,4,0,9,mixedType,1
3,4,0,7,mixedType,0
8,1,0,9,mixedType,1
15,1,0,16,mixedType,2
7,3,0,10,mixedType,1
7,2,0,9,mixedType,1
8,3,0,11,mixedType,1
14,2,0,16,mixedType,2
6,2,0,8,mixedType,1
6,0,2,8,mixedType,1
6,2,0,8,mixedType,1
9,1,0,10,mixedType,1
9,1,0,10,mixedType,1
3,3,0,6,mixedType,0
8,1,0,9,mixedType,1
6,1,0,7,mixedType,0
5,4,0,9,mixedType,1
12,8,0,20,mixedType,2
11,5,0,16,mixedType,2
14,2,0,16,mixedType,2
1,7,0,8,mixedType,1
4,8,0,12,mixedType,1
5,4,0,9,mixedType,1
4,6,0,10,mixedType,1
5,3,0,8,mixedType,1
3,6,0,9,mixedType,1
13,3,0,16,mixedType,2
5,5,0,10,mixedType,1
13,3,0,16,mixedType,2
14,2,0,16,mixedType,2
3,6,0,9,mixedType,1
8,3,0,11,mixedType,1
9,2,0,11,mixedType,1
1,8,0,9,mixedType,1
7,1,0,8,mixedType,1
11,3,0,14,mixedType,2
7,2,0,9,mixedType,1
6,2,0,8,mixedType,1
4,2,0,6,mixedType,0
5,3,0,8,mixedType,1
5,4,0,9,mixedType,1
5,1,0,6,mixedType,0
2,4,0,6,mixedType,0
2,6,0,8,mixedType,1
4,4,0,8,mixedType,1
8,3,0,11,mixedType,1
2,6,0,8,mixedType,1
4,2,0,6,mixedType,0
8,1,0,9,mixedType,1
5,3,0,8,mixedType,1
6,2,0,8,mixedType,1
4,2,0,6,mixedType,0
6,3,0,9,mixedType,1
2,6,0,8,mixedType,1
12,4,0,16,mixedType,2
2,6,0,8,mixedType,1
5,4,0,9,mixedType,1
7,3,0,10,mixedType,1
6,3,0,9,mixedType,1
4,4,0,8,mixedType,1
6,3,0,9,mixedType,1
5,4,0,9,mixedType,1
13,3,0,16,mixedType,2
4,6,0,10,mixedType,1
2,10,0,12,mixedType,1
4,4,0,8,mixedType,1
4,2,0,6,mixedType,0
5,2,0,7,mixedType,0
8,3,0,11,mixedType,1
8,3,0,11,mixedType,1
6,3,0,9,mixedType,1
2,6,0,8,mixedType,1
7,3,0,10,mixedType,1
6,4,0,10,mixedType,1
7,3,0,10,mixedType,1
4,4,0,8,mixedType,1
9,5,1,15,mixedType,2
4,5,0,9,mixedType,1
6,3,0,9,mixedType,1
13,3,0,16,mixedType,2
6,4,0,10,mixedType,1
6,1,0,7,mixedType,0
15,1,0,16,mixedType,2
4,5,0,9,mixedType,1
13,2,5,20,mixedType,2
6,2,0,8,mixedType,1
6,2,0,8,mixedType,1
14,2,0,16,mixedType,2
5,4,0,9,mixedType,1
1,9,0,10,mixedType,1
8,3,0,11,mixedType,1
6,3,0,9,mixedType,1
7,2,0,9,mixedType,1
7,3,0,10,mixedType,1
11,5,0,16,mixedType,2
10,3,0,13,mixedType,1
14,2,0,16,mixedType,2
3,5,0,8,mixedType,1
7,1,0,8,mixedType,1
2,6,0,8,mixedType,1
1,8,0,9,mixedType,1
11,1,0,12,mixedType,1
8,4,0,12,mixedType,1
7,3,0,10,mixedType,1
7,2,0,9,mixedType,1
9,2,0,11,mixedType,1
5,2,0,7,mixedType,0
8,3,0,11,mixedType,1
8,1,0,9,mixedType,1
7,3,0,10,mixedType,1
10,2,0,12,mixedType,1
4,5,0,9,mixedType,1
8,1,0,9,mixedType,1
4,6,0,10,mixedType,1
5,1,0,6,mixedType,0
8,2,0,10,mixedType,1
1,9,0,10,mixedType,1
7,3,0,10,mixedType,1
8,1,0,9,mixedType,1
5,3,0,8,mixedType,1
9,3,0,12,mixedType,1
8,1,0,9,mixedType,1
9,1,0,10,mixedType,1
7,2,0,9,mixedType,1
6,2,0,8,mixedType,1
5,3,0,8,mixedType,1
6,4,0,10,mixedType,1
5,2,0,7,mixedType,0
12,3,0,15,mixedType,2
4,2,0,6,mixedType,0
6,2,0,8,mixedType,1
13,2,0,15,mixedType,2
15,1,0,16,mixedType,2
5,2,0,7,mixedType,0
5,1,0,6,mixedType,0
6,7,0,13,mixedType,1
6,3,0,9,mixedType,1
14,2,0,16,mixedType,2
3,7,0,10,mixedType,1
6,4,0,10,mixedType,1
2,6,0,8,mixedType,1
6,4,0,10,mixedType,1
4,2,0,6,mixedType,0
6,3,0,9,mixedType,1
3,6,0,9,mixedType,1
6,1,0,7,mixedType,0
7,6,0,13,mixedType,1
5,3,0,8,mixedType,1
6,1,0,7,mixedType,0
2,10,0,12,mixedType,1
8,3,0,11,mixedType,1
6,3,0,9,mixedType,1
5,2,0,7,mixedType,0
7,2,0,9,mixedType,1
12,4,0,16,mixedType,2
5,4,0,9,mixedType,1
7,1,0,8,mixedType,1
6,3,0,9,mixedType,1
7,2,0,9,mixedType,1
5,1,0,6,mixedType,0
6,4,0,10,mixedType,1
5,3,0,8,mixedType,1
4,2,0,6,mixedType,0
7,4,0,11,mixedType,1
8,3,0,11,mixedType,1
3,5,0,8,mixedType,1
5,1,0,6,mixedType,0
8,2,0,10,mixedType,1
8,3,0,11,mixedType,1
14,2,0,16,mixedType,2
7,2,0,9,mixedType,1
2,6,0,8,mixedType,1
1,7,0,8,mixedType,1
4,7,0,11,mixedType,1
5,2,0,7,mixedType,0
9,3,0,12,mixedType,1
6,2,0,8,mixedType,1
8,2,0,10,mixedType,1
5,2,0,7,mixedType,0
6,4,0,10,mixedType,1
4,4,0,8,mixedType,1
7,1,0,8,mixedType,1
8,2,0,10,mixedType,1
6,2,0,8,mixedType,1
4,5,0,9,mixedType,1
5,4,0,9,mixedType,1
2,4,0,6,mixedType,0
6,1,0,7,mixedType,0
5,4,0,9,mixedType,1
6,4,0,10,mixedType,1
6,1,0,7,mixedType,0
6,3,0,9,mixedType,1
17,3,4,24,mixedType,2
4,5,0,9,mixedType,1
3,6,0,9,mixedType,1
4,2,0,6,mixedType,0
6,3,0,9,mixedType,1
14,2,0,16,mixedType,2
4,2,0,6,mixedType,0
8,4,0,12,mixedType,1
4,4,0,8,mixedType,1
9,3,0,12,mixedType,1
7,3,0,10,mixedType,1
9,2,0,11,mixedType,1
3,6,0,9,mixedType,1
7,6,0,13,mixedType,1
5,1,0,6,mixedType,0
8,2,0,10,mixedType,1
7,2,0,9,mixedType,1
5,2,0,7,mixedType,0
6,3,0,9,mixedType,1
4,2,0,6,mixedType,0
6,2,0,8,mixedType,1
8,2,4,14,mixedType,1
3,6,0,9,mixedType,1
5,2,0,7,mixedType,0
5,2,0,7,mixedType,0
13,3,0,16,mixedType,2
5,3,0,8,mixedType,1
14,2,0,16,mixedType,2
7,3,0,10,mixedType,1
6,3,0,9,mixedType,1
5,4,0,9,mixedType,1
5,3,0,8,mixedType,1
6,3,0,9,mixedType,1
7,2,0,9,mixedType,1
5,4,0,9,mixedType,1
7,1,0,8,mixedType,1
8,2,0,10,mixedType,1
6,4,0,10,mixedType,1
6,4,0,10,mixedType,1
7,2,0,9,mixedType,1
8,2,0,10,mixedType,1
7,3,0,10,mixedType,1
6,4,0,10,mixedType,1
10,1,0,11,mixedType,1
6,3,0,9,mixedType,1
5,2,0,7,mixedType,0
5,1,0,6,mixedType,0
7,2,0,9,mixedType,1
8,3,0,11,mixedType,1
7,2,0,9,mixedType,1
4,4,0,8,mixedType,1
6,1,0,7,mixedType,0
5,4,0,9,mixedType,1
4,4,0,8,mixedType,1
8,3,0,11,mixedType,1
11,1,0,12,mixedType,1
3,7,0,10,mixedType,1
4,2,0,6,mixedType,0
5,4,0,9,mixedType,1
4,2,0,6,mixedType,0
14,2,0,16,mixedType,2
1,6,0,7,mixedType,0
9,4,0,13,mixedType,1
7,2,0,9,mixedType,1
6,3,0,9,mixedType,1
9,2,0,11,mixedType,1
6,4,0,10,mixedType,1
9,1,0,10,mixedType,1
10,2,0,12,mixedType,1
5,3,0,8,mixedType,1
9,1,0,10,mixedType,1
11,2,0,13,mixedType,1
8,1,0,9,mixedType,1
7,3,0,10,mixedType,1
10,2,0,12,mixedType,1
6,3,0,9,mixedType,1
14,2,0,16,mixedType,2
2,8,0,10,mixedType,1
4,2,0,6,mixedType,0
5,3,0,8,mixedType,1
3,6,0,9,mixedType,1
12,1,0,13,mixedType,1
9,1,0,10,mixedType,1
1,8,0,9,mixedType,1
4,2,0,6,mixedType,0
5,5,0,10,mixedType,1
8,2,0,10,mixedType,1
10,4,0,14,mixedType,2
6,6,0,12,mixedType,1
8,1,0,9,mixedType,1
2,6,0,8,mixedType,1
8,4,0,12,mixedType,1
13,3,0,16,mixedType,2
6,2,0,8,mixedType,1
6,2,0,8,mixedType,1
1,8,0,9,mixedType,1
8,2,0,10,mixedType,1
4,4,0,8,mixedType,1
4,6,0,10,mixedType,1
8,3,0,11,mixedType,1
11,4,0,15,mixedType,2
5,3,0,8,mixedType,1
5,3,0,8,mixedType,1
8,3,0,11,mixedType,1
10,3,1,14,mixedType,2
5,4,0,9,mixedType,1
4,5,0,9,mixedType,1
6,1,0,7,mixedType,0
2,8,0,10,mixedType,1
4,5,0,9,mixedType,1
3,6,0,9,mixedType,1
6,2,0,8,mixedType,1
15,1,0,16,mixedType,2
7,2,0,9,mixedType,1
7,4,0,11,mixedType,1
6,2,0,8,mixedType,1
5,2,0,7,mixedType,0
7,2,0,9,mixedType,1
13,2,1,16,mixedType,2
3,3,0,6,mixedType,0
5,2,0,7,mixedType,0
9,1,0,10,mixedType,1
6,2,0,8,mixedType,1
12,4,0,16,mixedType,2
6,2,0,8,mixedType,1
11,3,0,14,mixedType,2
9,1,0,10,mixedType,1
7,3,0,10,mixedType,1
2,8,0,10,mixedType,1
5,1,0,6,mixedType,0
5,4,0,9,mixedType,1
3,5,0,8,mixedType,1
7,3,0,10,mixedType,1
4,2,0,6,mixedType,0
7,5,0,12,mixedType,1
5,4,0,9,mixedType,1
9,4,0,13,mixedType,1
5,4,0,9,mixedType,1
7,2,0,9,mixedType,1
5,3,0,8,mixedType,1
8,1,0,9,mixedType,1
14,2,0,16,mixedType,2
7,1,0,8,mixedType,1
1,8,0,9,mixedType,1
7,3,0,10,mixedType,1
7,3,0,10,mixedType,1
7,3,0,10,mixedType,1
5,3,0,8,mixedType,1
1,7,0,8,mixedType,1
4,4,0,8,mixedType,1
7,1,0,8,mixedType,1
9,1,0,10,mixedType,1
8,0,1,9,mixedType,1
14,2,0,16,mixedType,2
6,1,0,7,mixedType,0
9,1,0,10,mixedType,1
6,3,0,9,mixedType,1
5,1,0,6,mixedType,0
6,3,0,9,mixedType,1
4,6,0,10,mixedType,1
5,2,0,7,mixedType,0
15,1,0,16,mixedType,2
7,3,0,10,mixedType,1
13,3,0,16,mixedType,2
7,6,0,13,mixedType,1
5,2,0,7,mixedType,0
7,3,0,10,mixedType,1
6,3,0,9,mixedType,1
5,2,0,7,mixedType,0
3,6,0,9,mixedType,1
5,3,0,8,mixedType,1
7,1,0,8,mixedType,1
4,4,0,8,mixedType,1
8,2,0,10,mixedType,1
6,3,0,9,mixedType,1
5,2,0,7,mixedType,0
7,3,0,10,mixedType,1
7,4,0,11,mixedType,1
7,2,0,9,mixedType,1
5,6,0,11,mixedType,1
5,3,0,8,mixedType,1
5,3,0,8,mixedType,1
3,5,0,8,mixedType,1
5,1,0,6,mixedType,0
3,4,0,7,mixedType,0
9,2,0,11,mixedType,1
13,3,0,16,mixedType,2
9,1,0,10,mixedType,1
1,7,0,8,mixedType,1
5,1,0,6,mixedType,0
4,4,0,8,mixedType,1
4,6,0,10,mixedType,1
1,9,0,10,mixedType,1
9,2,0,11,mixedType,1
7,3,0,10,mixedType,1
6,1,0,7,mixedType,0
5,2,0,7,mixedType,0
5,1,0,6,mixedType,0
5,4,0,9,mixedType,1
15,1,4,20,mixedType,2
14,2,0,16,mixedType,2
8,1,0,9,mixedType,1
6,5,0,11,mixedType,1
7,2,0,9,mixedType,1
7,2,0,9,mixedType,1
6,2,0,8,mixedType,1
5,1,0,6,mixedType,0
11,3,0,14,mixedType,2
2,8,0,10,mixedType,1
7,2,0,9,mixedType,1
2,6,0,8,mixedType,1
7,3,0,10,mixedType,1
13,3,0,16,mixedType,2
5,3,0,8,mixedType,1
15,1,0,16,mixedType,2
12,4,0,16,mixedType,2
6,2,0,8,mixedType,1
5,1,0,6,mixedType,0
9,2,0,11,mixedType,1
5,5,0,10,mixedType,1
7,6,0,13,mixedType,1
4,9,0,13,mixedType,1
8,1,0,9,mixedType,1
11,1,0,12,mixedType,1
6,4,0,10,mixedType,1
6,2,0,8,mixedType,1
5,4,0,9,mixedType,1
9,3,0,12,mixedType,1
10,6,0,16,mixedType,2
7,2,0,9,mixedType,1
7,3,0,10,mixedType,1
5,1,0,6,mixedType,0
11,2,0,13,mixedType,1
5,2,0,7,mixedType,0
4,4,0,8,mixedType,1
6,1,0,7,mixedType,0
7,2,0,9,mixedType,1
4,6,0,10,mixedType,1
8,2,0,10,mixedType,1
8,2,0,10,mixedType,1
6,1,0,7,mixedType,0
6,1,0,7,mixedType,0
7,1,0,8,mixedType,1
18,2,0,20,mixedType,2
7,3,0,10,mixedType,1
7,2,0,9,mixedType,1
3,7,0,10,mixedType,1
5,7,0,12,mixedType,1
4,4,0,8,mixedType,1
5,2,0,7,mixedType,0
6,4,0,10,mixedType,1
5,3,0,8,mixedType,1
3,3,0,6,mixedType,0
6,3,0,9,mixedType,1
11,3,0,14,mixedType,2
5,2,0,7,mixedType,0
12,4,0,16,mixedType,2
11,3,0,14,mixedType,2
3,5,0,8,mixedType,1
5,2,0,7,mixedType,0
8,3,0,11,mixedType,1
5,6,0,11,mixedType,1
5,2,0,7,mixedType,0
8,3,0,11,mixedType,1
7,3,0,10,mixedType,1
12,3,0,15,mixedType,2
15,1,0,16,mixedType,2
3,6,0,9,mixedType,1
3,6,0,9,mixedType,1
5,5,0,10,mixedType,1
6,2,0,8,mixedType,1
4,2,0,6,mixedType,0
12,3,0,15,mixedType,2
10,1,0,11,mixedType,1
7,5,0,12,mixedType,1
8,2,0,10,mixedType,1
4,2,0,6,mixedType,0
5,3,0,8,mixedType,1
5,3,0,8,mixedType,1
4,2,0,6,mixedType,0
6,2,0,8,mixedType,1
2,8,0,10,mixedType,1
3,7,0,10,mixedType,1
15,1,0,16,mixedType,2
7,3,0,10,mixedType,1
4,4,0,8,mixedType,1
9,2,0,11,mixedType,1
6,2,0,8,mixedType,1
7,2,0,9,mixedType,1
6,1,0,7,mixedType,0
6,2,0,8,mixedType,1
14,2,0,16,mixedType,2
2,6,0,8,mixedType,1
5,1,0,6,mixedType,0
9,5,0,14,mixedType,2
2,6,0,8,mixedType,1
9,1,0,10,mixedType,1
5,4,0,9,mixedType,1
6,4,0,10,mixedType,1
5,2,0,7,mixedType,0
9,0,1,10,mixedType,1
9,2,0,11,mixedType,1
10,4,0,14,mixedType,2
3,6,0,9,mixedType,1
5,5,0,10,mixedType,1
14,2,0,16,mixedType,2
4,9,0,13,mixedType,1
6,2,0,8,mixedType,1
8,2,0,10,mixedType,1
3,8,0,11,mixedType,1
8,3,0,11,mixedType,1
7,1,0,8,mixedType,1
2,7,0,9,mixedType,1
9,1,0,10,mixedType,1
11,3,1,15,mixedType,2
9,1,0,10,mixedType,1
5,8,0,13,mixedType,1
8,1,0,9,mixedType,1
9,3,0,12,mixedType,1
3,7,0,10,mixedType,1
5,2,0,7,mixedType,0
5,2,0,7,mixedType,0
8,3,0,11,mixedType,1
5,3,0,8,mixedType,1
7,3,0,10,mixedType,1
6,2,0,8,mixedType,1
6,3,0,9,mixedType,1
7,1,0,8,mixedType,1
13,3,3,19,mixedType,2
13,3,0,16,mixedType,2
13,1,1,15,mixedType,2
6,1,0,7,mixedType,0
8,1,0,9,mixedType,1
6,4,0,10,mixedType,1
6,3,0,9,mixedType,1
2,7,0,9,mixedType,1
14,2,0,16,mixedType,2
4,6,0,10,mixedType,1
7,1,0,8,mixedType,1
7,2,0,9,mixedType,1
6,4,0,10,mixedType,1
4,4,0,8,mixedType,1
15,1,0,16,mixedType,2
10,11,0,21,mixedType,2
7,3,0,10,mixedType,1
5,3,0,8,mixedType,1
1,8,0,9,mixedType,1
9,2,0,11,mixedType,1
4,6,0,10,mixedType,1
14,2,0,16,mixedType,2
2,4,0,6,mixedType,0
11,3,0,14,mixedType,2
9,2,0,11,mixedType,1
8,1,0,9,mixedType,1
4,4,0,8,mixedType,1
1,7,0,8,mixedType,1
4,4,0,8,mixedType,1
6,1,0,7,mixedType,0
4,4,0,8,mixedType,1
5,2,0,7,mixedType,0
11,3,0,14,mixedType,2
6,1,0,7,mixedType,0
9,2,0,11,mixedType,1
14,2,0,16,mixedType,2
9,1,0,10,mixedType,1
7,4,0,11,mixedType,1
6,3,0,9,mixedType,1
12,1,0,13,mixedType,1
5,3,0,8,mixedType,1
4,4,0,8,mixedType,1
5,4,0,9,mixedType,1
7,1,0,8,mixedType,1
9,3,0,12,mixedType,1
5,3,0,8,mixedType,1
8,2,0,10,mixedType,1
8,1,0,9,mixedType,1
1,9,0,10,mixedType,1
12,1,0,13,mixedType,1
4,7,0,11,mixedType,1
7,3,0,10,mixedType,1
10,4,0,14,mixedType,2
4,4,0,8,mixedType,1
9,3,0,12,mixedType,1
7,1,0,8,mixedType,1
6,2,0,8,mixedType,1
14,2,0,16,mixedType,2
7,3,0,10,mixedType,1
2,6,0,8,mixedType,1
9,1,0,10,mixedType,1
14,2,0,16,mixedType,2
7,1,0,8,mixedType,1
7,2,0,9,mixedType,1
3,3,0,6,mixedType,0
8,3,0,11,mixedType,1
9,1,0,10,mixedType,1
14,2,0,16,mixedType,2
6,0,1,7,mixedType,0
8,4,0,12,mixedType,1
3,6,0,9,mixedType,1
11,3,0,14,mixedType,2
8,2,0,10,mixedType,1
9,2,0,11,mixedType,1
7,3,0,10,mixedType,1
10,2,0,12,mixedType,1
6,3,0,9,mixedType,1
6,4,0,10,mixedType,1
7,2,0,9,mixedType,1
4,4,0,8,mixedType,1
11,2,0,13,mixedType,1
6,3,0,9,mixedType,1
5,3,0,8,mixedType,1
6,2,0,8,mixedType,1
14,2,0,16,mixedType,2
7,1,0,8,mixedType,1
8,2,0,10,mixedType,1
8,2,0,10,mixedType,1
9,1,0,10,mixedType,1
6,3,0,9,mixedType,1
5,2,0,7,mixedType,0
8,2,0,10,mixedType,1
6,3,0,9,mixedType,1
13,3,0,16,mixedType,2
5,1,0,6,mixedType,0
7,6,0,13,mixedType,1
5,3,0,8,mixedType,1
7,3,0,10,mixedType,1
9,1,0,10,mixedType,1
1,7,0,8,mixedType,1
3,6,0,9,mixedType,1
7,4,0,11,mixedType,1
4,7,0,11,mixedType,1
5,3,0,8,mixedType,1
8,3,0,11,mixedType,1
3,6,0,9,mixedType,1
1,8,0,9,mixedType,1
5,2,0,7,mixedType,0
7,2,0,9,mixedType,1
6,1,0,7,mixedType,0
11,5,0,16,mixedType,2
6,1,0,7,mixedType,0
5,3,0,8,mixedType,1
7,3,0,10,mixedType,1
7,3,0,10,mixedType,1
7,3,0,10,mixedType,1
5,3,0,8,mixedType,1
8,4,0,12,mixedType,1
5,4,0,9,mixedType,1
14,2,0,16,mixedType,2
12,4,0,16,mixedType,2
7,2,0,9,mixedType,1
4,2,0,6,mixedType,0
7,3,0,10,mixedType,1
1,7,0,8,mixedType,1
9,4,1,14,mixedType,2
1,5,0,6,mixedType,0
7,3,0,10,mixedType,1
5,4,0,9,mixedType,1
6,4,0,10,mixedType,1
7,3,0,10,mixedType,1
7,2,0,9,mixedType,1
6,2,0,8,mixedType,1
9,6,0,15,mixedType,2
2,8,0,10,mixedType,1
6,2,0,8,mixedType,1
8,2,0,10,mixedType,1
7,3,0,10,mixedType,1
8,3,0,11,mixedType,1
7,2,0,9,mixedType,1
8,1,0,9,mixedType,1
2,6,0,8,mixedType,1
7,4,0,11,mixedType,1
5,1,0,6,mixedType,0
1,11,0,12,mixedType,1
6,2,0,8,mixedType,1
2,6,0,8,mixedType,1
5,1,0,6,mixedType,0
11,3,0,14,mixedType,2
13,10,0,23,mixedType,2
11,3,0,14,mixedType,2
10,2,0,12,mixedType,1
2,6,0,8,mixedType,1
6,1,0,7,mixedType,0
6,3,0,9,mixedType,1
5,4,0,9,mixedType,1
3,6,0,9,mixedType,1
5,3,0,8,mixedType,1
7,7,0,14,mixedType,2
5,4,0,9,mixedType,1
6,4,0,10,mixedType,1
11,5,0,16,mixedType,2
5,2,0,7,mixedType,0
6,3,0,9,mixedType,1
9,1,0,10,mixedType,1
6,1,0,7,mixedType,0
8,1,0,9,mixedType,1
8,4,0,12,mixedType,1
9,3,0,12,mixedType,1
4,4,0,8,mixedType,1
6,2,0,8,mixedType,1
2,8,0,10,mixedType,1
8,2,0,10,mixedType,1
7,2,0,9,mixedType,1
14,2,0,16,mixedType,2
4,4,0,8,mixedType,1
8,2,0,10,mixedType,1
7,3,0,10,mixedType,1
8,3,0,11,mixedType,1
14,2,0,16,mixedType,2
10,2,3,15,mixedType,2
7,1,0,8,mixedType,1
5,3,0,8,mixedType,1
12,1,0,13,mixedType,1
6,3,0,9,mixedType,1
7,1,0,8,mixedType,1
4,5,0,9,mixedType,1
1,8,0,9,mixedType,1
7,2,0,9,mixedType,1
5,6,0,11,mixedType,1
9,2,0,11,mixedType,1
4,4,0,8,mixedType,1
5,3,0,8,mixedType,1
3,6,0,9,mixedType,1
4,6,0,10,mixedType,1
7,3,0,10,mixedType,1
6,4,0,10,mixedType,1
7,3,0,10,mixedType,1
5,3,0,8,mixedType,1
6,2,0,8,mixedType,1
6,3,0,9,mixedType,1
6,3,0,9,mixedType,1
7,3,0,10,mixedType,1
13,3,0,16,mixedType,2
5,3,0,8,mixedType,1
7,3,0,10,mixedType,1
1,10,0,11,mixedType,1
9,3,0,12,mixedType,1
5,2,0,7,mixedType,0
5,2,0,7,mixedType,0
7,1,0,8,mixedType,1
7,3,0,10,mixedType,1
7,7,0,14,mixedType,2
15,1,0,16,mixedType,2
9,1,0,10,mixedType,1
4,2,0,6,mixedType,0
13,3,0,16,mixedType,2
3,8,0,11,mixedType,1
6,1,0,7,mixedType,0
12,3,0,15,mixedType,2
6,3,0,9,mixedType,1
7,1,0,8,mixedType,1
11,3,0,14,mixedType,2
13,3,0,16,mixedType,2
18,2,0,20,mixedType,2
6,2,0,8,mixedType,1
6,4,0,10,mixedType,1
8,2,0,10,mixedType,1
1,8,0,9,mixedType,1
12,4,0,16,mixedType,2
8,2,0,10,mixedType,1
7,3,0,10,mixedType,1
15,1,0,16,mixedType,2
3,6,0,9,mixedType,1
6,3,0,9,mixedType,1
7,3,0,10,mixedType,1
8,2,0,10,mixedType,1
9,2,0,11,mixedType,1
15,1,0,16,mixedType,2
6,3,0,9,mixedType,1
5,4,0,9,mixedType,1
7,2,0,9,mixedType,1
7,2,0,9,mixedType,1
10,2,0,12,mixedType,1
5,3,0,8,mixedType,1
9,3,0,12,mixedType,1
6,3,0,9,mixedType,1
2,6,0,8,mixedType,1
9,1,0,10,mixedType,1
6,1,0,7,mixedType,0
1,6,0,7,mixedType,0
15,1,0,16,mixedType,2
7,3,0,10,mixedType,1
5,3,0,8,mixedType,1
8,2,0,10,mixedType,1
2,8,0,10,mixedType,1
3,8,0,11,mixedType,1
7,2,0,9,mixedType,1
12,8,0,20,mixedType,2
9,4,0,13,mixedType,1
6,4,0,10,mixedType,1
6,3,0,9,mixedType,1
6,2,0,8,mixedType,1
5,3,0,8,mixedType,1
4,4,0,8,mixedType,1
5,4,0,9,mixedType,1
12,1,0,13,mixedType,1
7,3,0,10,mixedType,1
5,4,0,9,mixedType,1
7,3,0,10,mixedType,1
10,8,1,19,mixedType,2
1,7,0,8,mixedType,1
5,4,0,9,mixedType,1
1,9,0,10,mixedType,1
10,1,0,11,mixedType,1
6,2,0,8,mixedType,1
2,4,0,6,mixedType,0
5,2,0,7,mixedType,0
7,3,0,10,mixedType,1
6,3,0,9,mixedType,1
8,1,0,9,mixedType,1
6,4,0,10,mixedType,1
11,5,0,16,mixedType,2
6,3,0,9,mixedType,1
3,9,0,12,mixedType,1
8,1,0,9,mixedType,1
6,1,0,7,mixedType,0
3,7,0,10,mixedType,1
4,5,0,9,mixedType,1
7,3,0,10,mixedType,1
3,3,0,6,mixedType,0
2,6,0,8,mixedType,1
7,2,0,9,mixedType,1
5,3,0,8,mixedType,1
6,3,0,9,mixedType,1
15,1,0,16,mixedType,2
8,2,0,10,mixedType,1
6,6,0,12,mixedType,1
5,3,0,8,mixedType,1
9,2,0,11,mixedType,1
8,1,0,9,mixedType,1
12,4,0,16,mixedType,2
8,2,0,10,mixedType,1
4,5,0,9,mixedType,1
3,3,0,6,mixedType,0
7,4,0,11,mixedType,1
12,4,0,16,mixedType,2
8,3,0,11,mixedType,1
7,4,0,11,mixedType,1
5,2,0,7,mixedType,0
14,2,0,16,mixedType,2
6,3,0,9,mixedType,1
6,4,0,10,mixedType,1
13,3,0,16,mixedType,2
6,2,0,8,mixedType,1
13,3,0,16,mixedType,2
9,7,0,16,mixedType,2
7,3,0,10,mixedType,1
4,4,0,8,mixedType,1
6,4,0,10,mixedType,1
8,1,0,9,mixedType,1
7,1,0,8,mixedType,1
9,4,1,14,mixedType,2
8,1,0,9,mixedType,1
7,3,0,10,mixedType,1
9,8,1,18,mixedType,2
7,2,0,9,mixedType,1
9,1,0,10,mixedType,1
6,4,0,10,mixedType,1
14,2,0,16,mixedType,2
8,1,0,9,mixedType,1
3,5,0,8,mixedType,1
14,2,0,16,mixedType,2
6,4,0,10,mixedType,1
6,3,0,9,mixedType,1
5,2,0,7,mixedType,0
11,2,1,14,mixedType,2
8,1,0,9,mixedType,1
5,8,0,13,mixedType,1
13,3,0,16,mixedType,2
5,2,0,7,mixedType,0
3,7,0,10,mixedType,1
6,3,0,9,mixedType,1
4,4,0,8,mixedType,1
6,2,0,8,mixedType,1
15,1,0,16,mixedType,2
9,2,0,11,mixedType,1
6,3,0,9,mixedType,1
5,3,0,8,mixedType,1
11,1,0,12,mixedType,1
6,3,0,9,mixedType,1
8,1,0,9,mixedType,1
4,7,0,11,mixedType,1
5,1,0,6,mixedType,0
9,1,0,10,mixedType,1
9,3,0,12,mixedType,1
14,2,0,16,mixedType,2
8,1,0,9,mixedType,1
6,3,0,9,mixedType,1
9,1,0,10,mixedType,1
4,4,0,8,mixedType,1
4,4,0,8,mixedType,1
4,6,0,10,mixedType,1
6,4,0,10,mixedType,1
9,3,0,12,mixedType,1
3,5,0,8,mixedType,1
7,2,0,9,mixedType,1
9,1,0,10,mixedType,1
7,2,0,9,mixedType,1
2,8,0,10,mixedType,1
7,1,0,8,mixedType,1
3,7,0,10,mixedType,1
14,2,0,16,mixedType,2
6,1,0,7,mixedType,0
3,7,0,10,mixedType,1
8,3,0,11,mixedType,1
6,1,0,7,mixedType,0
4,2,0,6,mixedType,0
7,3,0,10,mixedType,1
6,7,0,13,mixedType,1
5,1,0,6,mixedType,0
7,3,0,10,mixedType,1
7,3,0,10,mixedType,1
7,1,0,8,mixedType,1
8,1,0,9,mixedType,1
0,6,1,7,mixedType,0
2,9,0,11,mixedType,1
1,7,0,8,mixedType,1
15,1,0,16,mixedType,2
1,5,0,6,mixedType,0
10,5,0,15,mixedType,2
7,3,0,10,mixedType,1
9,1,0,10,mixedType,1
4,4,0,8,mixedType,1
4,4,0,8,mixedType,1
5,6,0,11,mixedType,1
7,4,0,11,mixedType,1
8,3,0,11,mixedType,1
13,0,2,15,mixedType,2
5,4,0,9,mixedType,1
8,5,0,13,mixedType,1
3,5,0,8,mixedType,1
12,4,0,16,mixedType,2
9,4,0,13,mixedType,1
5,3,0,8,mixedType,1
4,4,0,8,mixedType,1
6,3,0,9,mixedType,1
6,2,0,8,mixedType,1
7,2,0,9,mixedType,1
4,5,0,9,mixedType,1
7,1,0,8,mixedType,1
9,2,0,11,mixedType,1
7,3,0,10,mixedType,1
6,4,0,10,mixedType,1
15,1,0,16,mixedType,2
6,2,0,8,mixedType,1
0,7,1,8,mixedType,1
15,1,0,16,mixedType,2
2,6,0,8,mixedType,1
5,6,0,11,mixedType,1
4,4,0,8,mixedType,1
15,1,0,16,mixedType,2
7,2,0,9,mixedType,1
7,2,0,9,mixedType,1
5,4,0,9,mixedType,1
9,3,0,12,mixedType,1
3,6,0,9,mixedType,1
6,3,0,9,mixedType,1
10,2,0,12,mixedType,1
6,5,0,11,mixedType,1
6,3,0,9,mixedType,1
6,4,0,10,mixedType,1
5,2,0,7,mixedType,0
6,4,0,10,mixedType,1
2,4,0,6,mixedType,0
7,3,0,10,mixedType,1
12,3,0,15,mixedType,2
11,2,0,13,mixedType,1
5,4,0,9,mixedType,1
8,4,0,12,mixedType,1
8,4,0,12,mixedType,1
2,6,0,8,mixedType,1
8,4,0,12,mixedType,1
15,1,0,16,mixedType,2
2,8,0,10,mixedType,1
6,3,0,9,mixedType,1
12,3,0,15,mixedType,2
17,1,1,19,mixedType,2
5,3,0,8,mixedType,1
6,2,0,8,mixedType,1
7,2,0,9,mixedType,1
6,1,0,7,mixedType,0
2,7,0,9,mixedType,1
7,3,0,10,mixedType,1
2,9,0,11,mixedType,1
12,1,0,13,mixedType,1
7,1,0,8,mixedType,1
4,5,0,9,mixedType,1
5,4,0,9,mixedType,1
5,2,0,7,mixedType,0
2,4,0,6,mixedType,0
5,4,0,9,mixedType,1
6,2,0,8,mixedType,1
3,3,0,6,mixedType,0
7,2,0,9,mixedType,1
5,4,0,9,mixedType,1
6,1,0,7,mixedType,0
7,1,0,8,mixedType,1
4,2,0,6,mixedType,0
5,3,0,8,mixedType,1
9,1,0,10,mixedType,1
6,1,0,7,mixedType,0
7,3,0,10,mixedType,1
15,1,0,16,mixedType,2
9,3,0,12,mixedType,1
3,8,0,11,mixedType,1
8,1,0,9,mixedType,1
8,2,0,10,mixedType,1
15,1,0,16,mixedType,2
10,2,0,12,mixedType,1
4,4,0,8,mixedType,1
14,1,0,15,mixedType,2
7,1,0,8,mixedType,1
8,4,0,12,mixedType,1
8,2,0,10,mixedType,1
13,3,0,16,mixedType,2
6,1,0,7,mixedType,0
2,6,0,8,mixedType,1
3,6,0,9,mixedType,1
2,8,0,10,mixedType,1
7,1,0,8,mixedType,1
5,1,0,6,mixedType,0
8,1,0,9,mixedType,1
17,1,1,19,mixedType,2
5,2,0,7,mixedType,0
13,3,3,19,mixedType,2
1,12,0,13,mixedType,1
4,4,0,8,mixedType,1
6,3,0,9,mixedType,1
9,4,0,13,mixedType,1
5,1,0,6,mixedType,0
6,1,0,7,mixedType,0
5,3,0,8,mixedType,1
14,2,0,16,mixedType,2
7,4,0,11,mixedType,1
8,1,0,9,mixedType,1
7,2,0,9,mixedType,1
7,3,0,10,mixedType,1
7,2,0,9,mixedType,1
15,1,0,16,mixedType,2
7,3,0,10,mixedType,1
5,6,0,11,mixedType,1
5,3,0,8,mixedType,1
6,2,0,8,mixedType,1
8,1,0,9,mixedType,1
14,2,0,16,mixedType,2
4,2,0,6,mixedType,0
6,3,0,9,mixedType,1
10,2,0,12,mixedType,1
15,1,0,16,mixedType,2
11,2,0,13,mixedType,1
3,10,0,13,mixedType,1
5,3,0,8,mixedType,1
12,4,0,16,mixedType,2
5,1,0,6,mixedType,0
5,1,0,6,mixedType,0
8,3,0,11,mixedType,1
4,6,0,10,mixedType,1
7,3,0,10,mixedType,1
3,5,0,8,mixedType,1
22,1,1,24,mixedType,2
8,3,0,11,mixedType,1
8,2,0,10,mixedType,1
8,1,0,9,mixedType,1
15,1,0,16,mixedType,2
13,3,0,16,mixedType,2
9,1,0,10,mixedType,1
1,8,0,9,mixedType,1
6,3,0,9,mixedType,1
10,4,0,14,mixedType,2
8,2,0,10,mixedType,1
9,4,0,13,mixedType,1
4,6,0,10,mixedType,1
8,1,0,9,mixedType,1
5,4,0,9,mixedType,1
9,4,0,13,mixedType,1
8,1,0,9,mixedType,1
5,2,0,7,mixedType,0
4,2,0,6,mixedType,0
14,2,0,16,mixedType,2
4,2,0,6,mixedType,0
5,2,0,7,mixedType,0
4,2,0,6,mixedType,0
4,2,0,6,mixedType,0
3,4,0,7,mixedType,0
8,2,0,10,mixedType,1
15,1,0,16,mixedType,2
11,4,0,15,mixedType,2
2,7,0,9,mixedType,1
8,1,0,9,mixedType,1
15,1,0,16,mixedType,2
5,2,0,7,mixedType,0
3,10,0,13,mixedType,1
8,2,0,10,mixedType,1
15,1,0,16,mixedType,2
8,3,0,11,mixedType,1
6,4,0,10,mixedType,1
8,1,0,9,mixedType,1
5,3,0,8,mixedType,1
5,2,0,7,mixedType,0
4,2,0,6,mixedType,0
2,6,0,8,mixedType,1
14,2,0,16,mixedType,2
3,8,0,11,mixedType,1
6,1,0,7,mixedType,0
14,2,0,16,mixedType,2
6,3,0,9,mixedType,1
5,3,0,8,mixedType,1
7,3,0,10,mixedType,1
8,1,0,9,mixedType,1
2,7,0,9,mixedType,1
6,4,0,10,mixedType,1
8,4,0,12,mixedType,1
8,3,0,11,mixedType,1
7,2,0,9,mixedType,1
4,6,0,10,mixedType,1
12,4,0,16,mixedType,2
11,2,0,13,mixedType,1
11,3,0,14,mixedType,2
13,3,0,16,mixedType,2
14,2,0,16,mixedType,2
4,6,0,10,mixedType,1
4,5,0,9,mixedType,1
11,3,0,14,mixedType,2
3,10,0,13,mixedType,1
9,4,0,13,mixedType,1
7,3,0,10,mixedType,1
5,3,0,8,mixedType,1
9,2,0,11,mixedType,1
6,3,0,9,mixedType,1
6,3,0,9,mixedType,1
10,1,0,11,mixedType,1
11,3,0,14,mixedType,2
13,3,0,16,mixedType,2
3,6,0,9,mixedType,1
11,1,0,12,mixedType,1
5,4,0,9,mixedType,1
3,5,0,8,mixedType,1
6,4,0,10,mixedType,1
2,7,0,9,mixedType,1
5,3,0,8,mixedType,1
6,4,0,10,mixedType,1
11,3,0,14,mixedType,2
5,4,0,9,mixedType,1
5,8,0,13,mixedType,1
1,9,0,10,mixedType,1
7,1,0,8,mixedType,1
4,8,0,12,mixedType,1
9,2,0,11,mixedType,1
6,3,0,9,mixedType,1
4,2,0,6,mixedType,0
1,8,0,9,mixedType,1
8,1,0,9,mixedType,1
7,2,0,9,mixedType,1
5,2,0,7,mixedType,0
8,4,0,12,mixedType,1
6,3,0,9,mixedType,1
6,4,0,10,mixedType,1
8,3,0,11,mixedType,1
7,3,0,10,mixedType,1
13,3,0,16,mixedType,2
6,6,0,12,mixedType,1
6,1,0,7,mixedType,0
4,2,0,6,mixedType,0
6,2,0,8,mixedType,1
15,1,0,16,mixedType,2
7,3,0,10,mixedType,1
13,3,0,16,mixedType,2
6,1,0,7,mixedType,0
6,2,0,8,mixedType,1
9,3,0,12,mixedType,1
7,2,0,9,mixedType,1
5,4,0,9,mixedType,1
9,3,0,12,mixedType,1
14,2,0,16,mixedType,2
6,4,0,10,mixedType,1
7,1,0,8,mixedType,1
10,1,0,11,mixedType,1
5,2,0,7,mixedType,0
4,2,0,6,mixedType,0
11,3,0,14,mixedType,2
9,3,0,12,mixedType,1
9,1,0,10,mixedType,1
6,3,0,9,mixedType,1
8,4,0,12,mixedType,1
5,2,0,7,mixedType,0
6,4,0,10,mixedType,1
7,3,0,10,mixedType,1
3,6,0,9,mixedType,1
8,2,0,10,mixedType,1
13,3,0,16,mixedType,2
8,2,0,10,mixedType,1
6,3,0,9,mixedType,1
5,6,0,11,mixedType,1
9,4,0,13,mixedType,1
5,4,0,9,mixedType,1
5,3,0,8,mixedType,1
11,3,0,14,mixedType,2
6,3,0,9,mixedType,1
4,4,0,8,mixedType,1
6,8,1,15,mixedType,2
6,4,0,10,mixedType,1
5,3,0,8,mixedType,1
7,3,0,10,mixedType,1
5,3,0,8,mixedType,1
11,3,0,14,mixedType,2
5,2,0,7,mixedType,0
7,3,0,10,mixedType,1
7,2,0,9,mixedType,1
3,7,0,10,mixedType,1
2,8,0,10,mixedType,1
4,2,0,6,mixedType,0
3,5,0,8,mixedType,1
5,3,0,8,mixedType,1
7,3,0,10,mixedType,1
4,5,0,9,mixedType,1
4,4,0,8,mixedType,1
2,6,0,8,mixedType,1
8,2,0,10,mixedType,1
9,1,0,10,mixedType,1
8,2,0,10,mixedType,1
6,3,0,9,mixedType,1
12,3,0,15,mixedType,2
15,1,0,16,mixedType,2
5,1,0,6,mixedType,0
5,2,0,7,mixedType,0
1,8,0,9,mixedType,1
6,3,0,9,mixedType,1
6,3,0,9,mixedType,1
4,6,0,10,mixedType,1
7,3,0,10,mixedType,1
15,1,0,16,mixedType,2
1,6,0,7,mixedType,0
6,3,0,9,mixedType,1
3,6,0,9,mixedType,1
14,2,0,16,mixedType,2
6,6,0,12,mixedType,1
3,6,0,9,mixedType,1
5,3,0,8,mixedType,1
4,4,0,8,mixedType,1
3,6,0,9,mixedType,1
4,6,0,10,mixedType,1
7,4,0,11,mixedType,1
7,3,0,10,mixedType,1
12,3,0,15,mixedType,2
6,3,0,9,mixedType,1
5,4,0,9,mixedType,1
7,3,0,10,mixedType,1
11,3,0,14,mixedType,2
8,1,0,9,mixedType,1
7,3,0,10,mixedType,1
11,5,0,16,mixedType,2
7,3,0,10,mixedType,1
9,1,0,10,mixedType,1
1,9,0,10,mixedType,1
7,1,0,8,mixedType,1
4,5,0,9,mixedType,1
7,3,0,10,mixedType,1
8,1,0,9,mixedType,1
11,3,0,14,mixedType,2
6,3,0,9,mixedType,1
9,1,0,10,mixedType,1
8,1,0,9,mixedType,1
8,1,0,9,mixedType,1
14,7,0,21,mixedType,2
5,2,0,7,mixedType,0
4,4,0,8,mixedType,1
7,2,0,9,mixedType,1
4,4,0,8,mixedType,1
5,7,0,12,mixedType,1
9,4,0,13,mixedType,1
9,3,0,12,mixedType,1
15,1,0,16,mixedType,2
6,2,0,8,mixedType,1
4,4,0,8,mixedType,1
4,2,0,6,mixedType,0
7,1,0,8,mixedType,1
6,4,0,10,mixedType,1
13,3,0,16,mixedType,2
7,2,0,9,mixedType,1
2,6,0,8,mixedType,1
6,4,0,10,mixedType,1
7,1,0,8,mixedType,1
5,2,0,7,mixedType,0
6,2,0,8,mixedType,1
5,2,0,7,mixedType,0
14,2,0,16,mixedType,2
7,1,0,8,mixedType,1
5,3,0,8,mixedType,1
6,3,0,9,mixedType,1
4,2,0,6,mixedType,0
6,4,0,10,mixedType,1
9,1,0,10,mixedType,1
4,2,0,6,mixedType,0
8,4,0,12,mixedType,1
8,3,0,11,mixedType,1
8,1,0,9,mixedType,1
7,3,0,10,mixedType,1
1,7,0,8,mixedType,1
10,2,0,12,mixedType,1
4,4,0,8,mixedType,1
4,4,0,8,mixedType,1
1,7,0,8,mixedType,1
6,3,0,9,mixedType,1
8,1,0,9,mixedType,1
6,1,0,7,mixedType,0
6,2,0,8,mixedType,1
11,1,0,12,mixedType,1
8,3,0,11,mixedType,1
2,8,0,10,mixedType,1
5,3,0,8,mixedType,1
6,1,0,7,mixedType,0
8,4,0,12,mixedType,1
6,3,0,9,mixedType,1
3,7,0,10,mixedType,1
10,2,0,12,mixedType,1
7,3,0,10,mixedType,1
7,4,0,11,mixedType,1
9,1,0,10,mixedType,1
6,3,0,9,mixedType,1
5,0,1,6,mixedType,0
7,1,0,8,mixedType,1
3,3,0,6,mixedType,0
8,2,0,10,mixedType,1
3,6,0,9,mixedType,1
8,2,0,10,mixedType,1
16,1,0,17,mixedType,2
14,2,0,16,mixedType,2
9,2,0,11,mixedType,1
4,2,0,6,mixedType,0
6,2,0,8,mixedType,1
1,10,0,11,mixedType,1
15,1,0,16,mixedType,2
8,1,0,9,mixedType,1
14,1,1,16,mixedType,2
8,3,0,11,mixedType,1
1,9,0,10,mixedType,1
4,2,0,6,mixedType,0
2,8,0,10,mixedType,1
1,8,0,9,mixedType,1
4,2,0,6,mixedType,0
5,3,0,8,mixedType,1
8,1,0,9,mixedType,1
4,4,0,8,mixedType,1
4,4,0,8,mixedType,1
7,1,0,8,mixedType,1
4,2,0,6,mixedType,0
8,2,0,10,mixedType,1
7,4,0,11,mixedType,1
7,4,0,11,mixedType,1
3,6,0,9,mixedType,1
15,1,0,16,mixedType,2
12,1,0,13,mixedType,1
9,1,0,10,mixedType,1
13,3,0,16,mixedType,2
4,6,0,10,mixedType,1
2,10,0,12,mixedType,1
6,3,0,9,mixedType,1
6,1,0,7,mixedType,0
8,2,0,10,mixedType,1
7,1,0,8,mixedType,1
7,3,0,10,mixedType,1
9,3,0,12,mixedType,1
9,1,0,10,mixedType,1
6,4,0,10,mixedType,1
14,2,0,16,mixedType,2
5,4,0,9,mixedType,1
7,2,0,9,mixedType,1
8,2,0,10,mixedType,1
15,1,0,16,mixedType,2
9,2,0,11,mixedType,1
5,2,0,7,mixedType,0
1,7,0,8,mixedType,1
6,4,0,10,mixedType,1
6,1,0,7,mixedType,0
6,1,0,7,mixedType,0
2,6,0,8,mixedType,1
8,4,0,12,mixedType,1
7,3,0,10,mixedType,1
13,3,0,16,mixedType,2
7,3,0,10,mixedType,1
8,2,0,10,mixedType,1
6,1,0,7,mixedType,0
7,2,0,9,mixedType,1
6,2,0,8,mixedType,1
5,2,0,7,mixedType,0
6,4,0,10,mixedType,1
5,1,0,6,mixedType,0
4,4,0,8,mixedType,1
1,5,0,6,mixedType,0
3,6,0,9,mixedType,1
5,2,0,7,mixedType,0
6,2,0,8,mixedType,1
6,3,0,9,mixedType,1
14,2,0,16,mixedType,2
8,2,0,10,mixedType,1
6,3,0,9,mixedType,1
8,2,0,10,mixedType,1
6,1,0,7,mixedType,0
6,2,0,8,mixedType,1
10,4,0,14,mixedType,2
2,6,0,8,mixedType,1
6,2,0,8,mixedType,1
7,1,0,8,mixedType,1
8,2,0,10,mixedType,1
7,3,0,10,mixedType,1
11,5,0,16,mixedType,2
12,3,0,15,mixedType,2
6,3,0,9,mixedType,1
6,2,0,8,mixedType,1
5,4,0,9,mixedType,1
6,4,0,10,mixedType,1
6,4,0,10,mixedType,1
6,6,0,12,mixedType,1
5,3,0,8,mixedType,1
12,3,0,15,mixedType,2
5,4,0,9,mixedType,1
6,1,0,7,mixedType,0
12,3,0,15,mixedType,2
6,2,0,8,mixedType,1
4,4,0,8,mixedType,1
8,2,0,10,mixedType,1
9,1,0,10,mixedType,1
7,4,0,11,mixedType,1
8,2,0,10,mixedType,1
6,1,0,7,mixedType,0
7,2,0,9,mixedType,1
14,2,0,16,mixedType,2
6,1,0,7,mixedType,0
6,2,0,8,mixedType,1
6,3,0,9,mixedType,1
6,2,0,8,mixedType,1
8,2,0,10,mixedType,1
8,2,0,10,mixedType,1
9,3,0,12,mixedType,1
13,3,0,16,mixedType,2
5,4,0,9,mixedType,1
5,1,0,6,mixedType,0
9,1,0,10,mixedType,1
9,2,0,11,mixedType,1
5,5,0,10,mixedType,1
1,7,0,8,mixedType,1
5,8,0,13,mixedType,1
10,2,0,12,mixedType,1
5,3,0,8,mixedType,1
5,3,0,8,mixedType,1
7,3,0,10,mixedType,1
7,4,0,11,mixedType,1
7,3,0,10,mixedType,1
9,2,0,11,mixedType,1
7,2,0,9,mixedType,1
8,1,0,9,mixedType,1
6,3,0,9,mixedType,1
6,2,0,8,mixedType,1
5,3,0,8,mixedType,1
6,2,0,8,mixedType,1
9,4,0,13,mixedType,1
4,2,0,6,mixedType,0
11,3,0,14,mixedType,2
13,3,0,16,mixedType,2
15,1,0,16,mixedType,2
7,2,0,9,mixedType,1
7,3,0,10,mixedType,1
4,4,0,8,mixedType,1
8,1,0,9,mixedType,1
6,3,0,9,mixedType,1
6,4,0,10,mixedType,1
4,4,0,8,mixedType,1
2,7,0,9,mixedType,1
2,6,0,8,mixedType,1
3,6,0,9,mixedType,1
9,3,0,12,mixedType,1
4,2,0,6,mixedType,0
14,1,0,15,mixedType,2
7,3,0,10,mixedType,1
3,5,0,8,mixedType,1
7,3,0,10,mixedType,1
9,1,0,10,mixedType,1
5,3,0,8,mixedType,1
6,4,0,10,mixedType,1
7,3,0,10,mixedType,1
9,2,0,11,mixedType,1
12,4,0,16,mixedType,2
8,2,0,10,mixedType,1
11,5,0,16,mixedType,2
4,2,0,6,mixedType,0
4,6,0,10,mixedType,1
7,2,0,9,mixedType,1
10,4,0,14,mixedType,2
4,7,0,11,mixedType,1
8,1,0,9,mixedType,1
5,3,0,8,mixedType,1
6,3,0,9,mixedType,1
5,4,0,9,mixedType,1
7,1,0,8,mixedType,1
8,1,0,9,mixedType,1
7,1,0,8,mixedType,1
7,3,0,10,mixedType,1
12,0,1,13,mixedType,1
5,4,0,9,mixedType,1
5,3,0,8,mixedType,1
4,2,0,6,mixedType,0
5,1,0,6,mixedType,0
7,2,0,9,mixedType,1
1,9,0,10,mixedType,1
6,1,0,7,mixedType,0
3,3,0,6,mixedType,0
8,1,0,9,mixedType,1
5,3,0,8,mixedType,1
15,1,0,16,mixedType,2
3,6,0,9,mixedType,1
2,6,0,8,mixedType,1
7,3,0,10,mixedType,1
2,4,0,6,mixedType,0
4,2,0,6,mixedType,0
7,2,0,9,mixedType,1
8,2,0,10,mixedType,1
8,2,0,10,mixedType,1
6,3,0,9,mixedType,1
4,5,0,9,mixedType,1
6,3,0,9,mixedType,1
8,3,0,11,mixedType,1
8,1,0,9,mixedType,1
6,2,0,8,mixedType,1
10,2,0,12,mixedType,1
4,4,0,8,mixedType,1
7,3,0,10,mixedType,1
12,4,0,16,mixedType,2
15,1,0,16,mixedType,2
3,5,0,8,mixedType,1
7,3,0,10,mixedType,1
7,3,0,10,mixedType,1
7,2,0,9,mixedType,1
5,2,0,7,mixedType,0
7,3,0,10,mixedType,1
7,2,0,9,mixedType,1
4,6,0,10,mixedType,1
14,2,0,16,mixedType,2
8,4,0,12,mixedType,1
8,2,0,10,mixedType,1
5,3,0,8,mixedType,1
7,3,0,10,mixedType,1
8,2,0,10,mixedType,1
13,3,0,16,mixedType,2
6,3,0,9,mixedType,1
9,1,0,10,mixedType,1
5,4,0,9,mixedType,1
5,1,0,6,mixedType,0
9,1,0,10,mixedType,1
6,1,0,7,mixedType,0
5,3,0,8,mixedType,1
6,3,0,9,mixedType,1
8,2,0,10,mixedType,1
5,6,0,11,mixedType,1
12,4,0,16,mixedType,2
5,2,0,7,mixedType,0
9,3,0,12,mixedType,1
8,2,0,10,mixedType,1
7,2,0,9,mixedType,1
5,4,0,9,mixedType,1
6,1,0,7,mixedType,0
8,3,0,11,mixedType,1
1,8,0,9,mixedType,1
9,3,0,12,mixedType,1
8,4,0,12,mixedType,1
7,4,0,11,mixedType,1
6,1,0,7,mixedType,0
8,2,0,10,mixedType,1
8,1,0,9,mixedType,1
4,2,0,6,mixedType,0
5,4,0,9,mixedType,1
4,2,0,6,mixedType,0
11,3,1,15,mixedType,2
5,2,0,7,mixedType,0
8,2,0,10,mixedType,1
8,2,0,10,mixedType,1
8,1,0,9,mixedType,1
9,5,0,14,mixedType,2
4,4,0,8,mixedType,1
5,4,0,9,mixedType,1
5,3,0,8,mixedType,1
8,4,0,12,mixedType,1
8,2,0,10,mixedType,1
8,2,0,10,mixedType,1
8,2,0,10,mixedType,1
14,2,0,16,mixedType,2
15,1,0,16,mixedType,2
7,3,0,10,mixedType,1
9,2,0,11,mixedType,1
9,3,0,12,mixedType,1
7,1,0,8,mixedType,1
5,1,0,6,mixedType,0
6,2,0,8,mixedType,1
8,2,0,10,mixedType,1
8,4,0,12,mixedType,1
6,2,0,8,mixedType,1
6,1,0,7,mixedType,0
10,2,0,12,mixedType,1
7,2,0,9,mixedType,1
6,3,0,9,mixedType,1
15,1,0,16,mixedType,2
6,3,0,9,mixedType,1
6,3,0,9,mixedType,1
7,2,0,9,mixedType,1
8,2,0,10,mixedType,1
6,1,0,7,mixedType,0
15,2,0,17,mixedType,2
7,1,0,8,mixedType,1
5,6,0,11,mixedType,1
8,2,0,10,mixedType,1
5,3,0,8,mixedType,1
4,2,0,6,mixedType,0
5,4,0,9,mixedType,1
2,6,0,8,mixedType,1
1,8,0,9,mixedType,1
11,1,0,12,mixedType,1
6,2,0,8,mixedType,1
12,3,0,15,mixedType,2
4,2,0,6,mixedType,0
6,3,0,9,mixedType,1
7,2,0,9,mixedType,1
8,2,0,10,mixedType,1
11,2,0,13,mixedType,1
9,2,0,11,mixedType,1
7,3,0,10,mixedType,1
9,1,0,10,mixedType,1
5,1,0,6,mixedType,0
9,4,0,13,mixedType,1
7,4,0,11,mixedType,1
1,8,0,9,mixedType,1
11,1,0,12,mixedType,1
7,2,0,9,mixedType,1
1,9,0,10,mixedType,1
8,2,0,10,mixedType,1
6,2,0,8,mixedType,1
5,4,0,9,mixedType,1
8,4,0,12,mixedType,1
8,1,0,9,mixedType,1
9,3,0,12,mixedType,1
7,4,0,11,mixedType,1
5,2,0,7,mixedType,0
5,2,0,7,mixedType,0
3,5,0,8,mixedType,1
6,3,0,9,mixedType,1
2,6,0,8,mixedType,1
4,6,0,10,mixedType,1
14,2,0,16,mixedType,2
6,3,0,9,mixedType,1
1,9,0,10,mixedType,1
13,3,0,16,mixedType,2
6,3,0,9,mixedType,1
9,4,0,13,mixedType,1
4,4,0,8,mixedType,1
4,2,0,6,mixedType,0
5,2,0,7,mixedType,0
8,4,0,12,mixedType,1
8,3,0,11,mixedType,1
8,4,0,12,mixedType,1
7,3,0,10,mixedType,1
7,2,0,9,mixedType,1
5,6,0,11,mixedType,1
11,2,0,13,mixedType,1
4,8,0,12,mixedType,1
7,3,0,10,mixedType,1
11,1,0,12,mixedType,1
7,2,0,9,mixedType,1
9,2,0,11,mixedType,1
10,2,0,12,mixedType,1
6,2,0,8,mixedType,1
8,3,0,11,mixedType,1
10,1,0,11,mixedType,1
3,7,0,10,mixedType,1
6,3,0,9,mixedType,1
9,3,0,12,mixedType,1
9,3,0,12,mixedType,1
5,2,0,7,mixedType,0
8,2,0,10,mixedType,1
11,2,0,13,mixedType,1
3,6,0,9,mixedType,1
13,3,0,16,mixedType,2
9,3,0,12,mixedType,1
2,8,0,10,mixedType,1
8,1,0,9,mixedType,1
1,8,0,9,mixedType,1
7,2,0,9,mixedType,1
9,2,0,11,mixedType,1
5,4,0,9,mixedType,1
7,3,0,10,mixedType,1
4,4,0,8,mixedType,1
11,0,1,12,mixedType,1
7,3,0,10,mixedType,1
6,3,0,9,mixedType,1
7,1,0,8,mixedType,1
5,4,0,9,mixedType,1
8,1,0,9,mixedType,1
7,0,1,8,mixedType,1
2,8,0,10,mixedType,1
5,2,0,7,mixedType,0
7,1,0,8,mixedType,1
6,2,0,8,mixedType,1
7,3,0,10,mixedType,1
5,4,0,9,mixedType,1
9,2,0,11,mixedType,1
9,2,0,11,mixedType,1
6,1,0,7,mixedType,0
1,5,0,6,mixedType,0
2,6,0,8,mixedType,1
11,0,1,12,mixedType,1
5,2,0,7,mixedType,0
7,2,0,9,mixedType,1
6,3,0,9,mixedType,1
13,3,0,16,mixedType,2
6,1,0,7,mixedType,0
13,3,0,16,mixedType,2
4,2,0,6,mixedType,0
7,1,0,8,mixedType,1
6,4,0,10,mixedType,1
3,5,0,8,mixedType,1
6,2,0,8,mixedType,1
11,5,0,16,mixedType,2
6,2,0,8,mixedType,1
5,3,0,8,mixedType,1
10,3,0,13,mixedType,1
1,8,0,9,mixedType,1
6,4,0,10,mixedType,1
1,8,0,9,mixedType,1
8,3,0,11,mixedType,1
6,2,0,8,mixedType,1
3,3,0,6,mixedType,0
7,1,0,8,mixedType,1
7,3,0,10,mixedType,1
8,1,0,9,mixedType,1
1,8,0,9,mixedType,1
14,2,0,16,mixedType,2
12,3,0,15,mixedType,2
11,5,0,16,mixedType,2
8,3,0,11,mixedType,1
6,2,0,8,mixedType,1
2,7,0,9,mixedType,1
9,1,0,10,mixedType,1
6,2,0,8,mixedType,1
11,2,0,13,mixedType,1
5,4,0,9,mixedType,1
6,4,0,10,mixedType,1
1,8,0,9,mixedType,1
7,3,0,10,mixedType,1
7,2,0,9,mixedType,1
2,10,0,12,mixedType,1
15,1,0,16,mixedType,2
5,2,0,7,mixedType,0
7,4,0,11,mixedType,1
13,3,0,16,mixedType,2
8,2,0,10,mixedType,1
11,2,0,13,mixedType,1
7,3,0,10,mixedType,1
4,4,0,8,mixedType,1
7,2,0,9,mixedType,1
7,2,0,9,mixedType,1
7,3,0,10,mixedType,1
5,1,0,6,mixedType,0
9,3,0,12,mixedType,1
7,1,0,8,mixedType,1
5,6,0,11,mixedType,1
7,3,0,10,mixedType,1
6,1,0,7,mixedType,0
6,1,0,7,mixedType,0
6,3,0,9,mixedType,1
12,4,0,16,mixedType,2
2,6,0,8,mixedType,1
5,2,0,7,mixedType,0
4,2,0,6,mixedType,0
11,2,0,13,mixedType,1
7,4,0,11,mixedType,1
9,1,0,10,mixedType,1
9,1,0,10,mixedType,1
4,4,0,8,mixedType,1
7,2,0,9,mixedType,1
7,2,0,9,mixedType,1
5,2,0,7,mixedType,0
9,4,0,13,mixedType,1
7,2,0,9,mixedType,1
7,3,0,10,mixedType,1
3,6,0,9,mixedType,1
7,3,0,10,mixedType,1
6,2,0,8,mixedType,1
6,1,0,7,mixedType,0
1,7,0,8,mixedType,1
8,1,0,9,mixedType,1
7,3,0,10,mixedType,1
10,3,0,13,mixedType,1
6,3,0,9,mixedType,1
5,2,0,7,mixedType,0
5,3,0,8,mixedType,1
7,3,0,10,mixedType,1
11,1,0,12,mixedType,1
7,3,0,10,mixedType,1
4,2,0,6,mixedType,0
9,2,0,11,mixedType,1
7,3,0,10,mixedType,1
10,1,0,11,mixedType,1
7,1,0,8,mixedType,1
2,6,0,8,mixedType,1
9,1,0,10,mixedType,1
5,2,0,7,mixedType,0
5,1,0,6,mixedType,0
5,1,0,6,mixedType,0
4,4,0,8,mixedType,1
6,3,0,9,mixedType,1
6,3,0,9,mixedType,1
6,3,0,9,mixedType,1
6,2,0,8,mixedType,1
6,3,0,9,mixedType,1
1,8,0,9,mixedType,1
2,6,0,8,mixedType,1
11,5,0,16,mixedType,2
5,2,0,7,mixedType,0
7,2,0,9,mixedType,1
10,2,0,12,mixedType,1
6,3,0,9,mixedType,1
8,1,0,9,mixedType,1
5,2,0,7,mixedType,0
8,3,0,11,mixedType,1
8,1,0,9,mixedType,1
9,2,0,11,mixedType,1
5,2,0,7,mixedType,0
5,3,0,8,mixedType,1
3,7,0,10,mixedType,1
1,10,0,11,mixedType,1
7,3,0,10,mixedType,1
7,4,0,11,mixedType,1
5,2,0,7,mixedType,0
4,4,0,8,mixedType,1
4,2,0,6,mixedType,0
9,3,0,12,mixedType,1
6,3,0,9,mixedType,1
9,3,0,12,mixedType,1
9,2,0,11,mixedType,1
10,1,0,11,mixedType,1
7,3,0,10,mixedType,1
6,3,0,9,mixedType,1
6,2,0,8,mixedType,1
5,4,0,9,mixedType,1
9,3,0,12,mixedType,1
6,3,0,9,mixedType,1
7,6,0,13,mixedType,1
15,1,0,16,mixedType,2
4,2,0,6,mixedType,0
11,1,0,12,mixedType,1
6,4,0,10,mixedType,1
6,2,0,8,mixedType,1
7,4,0,11,mixedType,1
7,3,0,10,mixedType,1
1,8,0,9,mixedType,1
4,4,0,8,mixedType,1
5,2,0,7,mixedType,0
6,3,0,9,mixedType,1
13,3,0,16,mixedType,2
7,2,0,9,mixedType,1
5,4,0,9,mixedType,1
5,3,0,8,mixedType,1
4,4,0,8,mixedType,1
9,2,0,11,mixedType,1
8,3,0,11,mixedType,1
2,8,0,10,mixedType,1
4,5,0,9,mixedType,1
11,1,0,12,mixedType,1
8,2,0,10,mixedType,1
5,3,0,8,mixedType,1
6,3,0,9,mixedType,1
6,3,0,9,mixedType,1
6,3,0,9,mixedType,1
7,2,0,9,mixedType,1
7,2,0,9,mixedType,1
3,8,0,11,mixedType,1
8,1,0,9,mixedType,1
6,3,0,9,mixedType,1
7,3,0,10,mixedType,1
3,8,0,11,mixedType,1
3,3,0,6,mixedType,0
5,4,0,9,mixedType,1
3,3,0,6,mixedType,0
6,3,0,9,mixedType,1
6,6,0,12,mixedType,1
17,1,0,18,mixedType,2
5,4,0,9,mixedType,1
4,4,0,8,mixedType,1
9,1,0,10,mixedType,1
9,4,0,13,mixedType,1
9,3,0,12,mixedType,1
8,1,0,9,mixedType,1
15,1,0,16,mixedType,2
6,2,0,8,mixedType,1
5,3,0,8,mixedType,1
6,1,0,7,mixedType,0
1,10,0,11,mixedType,1
0,8,2,10,mixedType,1
6,3,0,9,mixedType,1
4,4,0,8,mixedType,1
6,2,0,8,mixedType,1
4,6,0,10,mixedType,1
5,7,0,12,mixedType,1
6,2,0,8,mixedType,1
7,2,0,9,mixedType,1
7,2,0,9,mixedType,1
6,2,0,8,mixedType,1
6,4,0,10,mixedType,1
8,4,0,12,mixedType,1
5,0,2,7,mixedType,0
3,5,0,8,mixedType,1
8,1,0,9,mixedType,1
8,1,0,9,mixedType,1
7,2,0,9,mixedType,1
6,4,0,10,mixedType,1
9,1,0,10,mixedType,1
6,2,0,8,mixedType,1
1,7,0,8,mixedType,1
13,3,0,16,mixedType,2
6,2,0,8,mixedType,1
4,4,0,8,mixedType,1
5,3,0,8,mixedType,1
5,3,0,8,mixedType,1
7,2,0,9,mixedType,1
2,8,0,10,mixedType,1
3,3,0,6,mixedType,0
5,2,0,7,mixedType,0
8,2,0,10,mixedType,1
4,2,0,6,mixedType,0
6,3,0,9,mixedType,1
5,4,0,9,mixedType,1
1,11,0,12,mixedType,1
4,2,0,6,mixedType,0
6,2,0,8,mixedType,1
7,1,0,8,mixedType,1
9,1,0,10,mixedType,1
7,2,0,9,mixedType,1
6,2,0,8,mixedType,1
7,3,0,10,mixedType,1
5,2,0,7,mixedType,0
5,2,0,7,mixedType,0
4,4,0,8,mixedType,1
5,3,0,8,mixedType,1
7,2,0,9,mixedType,1
5,4,0,9,mixedType,1
8,2,0,10,mixedType,1
6,3,0,9,mixedType,1
5,5,0,10,mixedType,1
6,1,0,7,mixedType,0
4,4,0,8,mixedType,1
4,2,0,6,mixedType,0
7,2,0,9,mixedType,1
6,4,0,10,mixedType,1
5,4,0,9,mixedType,1
7,3,0,10,mixedType,1
7,1,0,8,mixedType,1
7,3,0,10,mixedType,1
11,3,0,14,mixedType,2
6,2,0,8,mixedType,1
8,1,0,9,mixedType,1
11,2,0,13,mixedType,1
2,6,0,8,mixedType,1
7,3,0,10,mixedType,1
11,5,0,16,mixedType,2
5,4,0,9,mixedType,1
7,2,0,9,mixedType,1
12,4,0,16,mixedType,2
8,1,0,9,mixedType,1
5,3,0,8,mixedType,1
6,1,0,7,mixedType,0
6,6,0,12,mixedType,1
9,1,0,10,mixedType,1
12,3,0,15,mixedType,2
9,3,0,12,mixedType,1
15,1,0,16,mixedType,2
6,1,0,7,mixedType,0
9,3,0,12,mixedType,1
5,4,0,9,mixedType,1
3,6,0,9,mixedType,1
4,4,0,8,mixedType,1
8,3,0,11,mixedType,1
7,3,0,10,mixedType,1
5,2,0,7,mixedType,0
5,2,0,7,mixedType,0
8,2,0,10,mixedType,1
7,3,0,10,mixedType,1
5,4,0,9,mixedType,1
6,2,0,8,mixedType,1
5,4,0,9,mixedType,1
12,4,0,16,mixedType,2
5,5,0,10,mixedType,1
6,7,0,13,mixedType,1
1,7,0,8,mixedType,1
12,4,0,16,mixedType,2
5,4,0,9,mixedType,1
8,1,0,9,mixedType,1
7,3,0,10,mixedType,1
8,2,0,10,mixedType,1
14,2,0,16,mixedType,2
1,7,0,8,mixedType,1
14,2,0,16,mixedType,2
6,2,0,8,mixedType,1
15,1,0,16,mixedType,2
5,2,0,7,mixedType,0
6,4,0,10,mixedType,1
9,2,0,11,mixedType,1
10,1,0,11,mixedType,1
6,2,0,8,mixedType,1
5,4,0,9,mixedType,1
8,1,0,9,mixedType,1
5,3,0,8,mixedType,1
7,3,0,10,mixedType,1
5,4,0,9,mixedType,1
15,1,0,16,mixedType,2
7,2,0,9,mixedType,1
5,5,0,10,mixedType,1
5,4,0,9,mixedType,1
6,2,0,8,mixedType,1
11,5,0,16,mixedType,2
10,2,0,12,mixedType,1
2,7,0,9,mixedType,1
6,4,0,10,mixedType,1
6,4,0,10,mixedType,1
7,3,0,10,mixedType,1
3,6,0,9,mixedType,1
7,3,0,10,mixedType,1
10,2,0,12,mixedType,1
3,6,0,9,mixedType,1
6,2,0,8,mixedType,1
5,2,0,7,mixedType,0
5,4,0,9,mixedType,1
8,1,0,9,mixedType,1
8,2,0,10,mixedType,1
10,1,0,11,mixedType,1
7,4,0,11,mixedType,1
7,3,0,10,mixedType,1
1,8,0,9,mixedType,1
5,1,0,6,mixedType,0
8,2,0,10,mixedType,1
14,2,0,16,mixedType,2
5,3,0,8,mixedType,1
8,2,0,10,mixedType,1
5,2,0,7,mixedType,0
8,2,0,10,mixedType,1
12,2,1,15,mixedType,2
5,2,0,7,mixedType,0
5,3,0,8,mixedType,1
6,6,0,12,mixedType,1
7,2,0,9,mixedType,1
4,6,0,10,mixedType,1
8,2,0,10,mixedType,1
4,5,0,9,mixedType,1
1,8,0,9,mixedType,1
12,3,0,15,mixedType,2
7,3,0,10,mixedType,1
9,2,0,11,mixedType,1
7,1,0,8,mixedType,1
9,3,0,12,mixedType,1
14,2,0,16,mixedType,2
5,8,0,13,mixedType,1
7,3,0,10,mixedType,1
5,2,0,7,mixedType,0
5,4,0,9,mixedType,1
7,1,0,8,mixedType,1
8,2,0,10,mixedType,1
14,2,0,16,mixedType,2
4,4,0,8,mixedType,1
5,4,0,9,mixedType,1
5,1,0,6,mixedType,0
2,7,0,9,mixedType,1
5,3,0,8,mixedType,1
8,2,0,10,mixedType,1
3,8,0,11,mixedType,1
7,3,0,10,mixedType,1
7,3,0,10,mixedType,1
4,4,0,8,mixedType,1
9,2,0,11,mixedType,1
3,6,0,9,mixedType,1
5,2,0,7,mixedType,0
4,6,0,10,mixedType,1
9,2,0,11,mixedType,1
6,2,0,8,mixedType,1
5,2,0,7,mixedType,0
7,1,0,8,mixedType,1
7,1,0,8,mixedType,1
5,4,0,9,mixedType,1
6,5,0,11,mixedType,1
8,1,0,9,mixedType,1
5,4,0,9,mixedType,1
14,2,0,16,mixedType,2
5,3,0,8,mixedType,1
7,1,0,8,mixedType,1
9,1,0,10,mixedType,1
6,4,0,10,mixedType,1
5,5,0,10,mixedType,1
10,7,1,18,mixedType,2
7,3,0,10,mixedType,1
6,1,0,7,mixedType,0
8,1,0,9,mixedType,1
9,1,0,10,mixedType,1
9,3,0,12,mixedType,1
6,1,0,7,mixedType,0
6,3,0,9,mixedType,1
9,3,0,12,mixedType,1
11,1,0,12,mixedType,1
6,3,0,9,mixedType,1
9,1,0,10,mixedType,1
6,4,0,10,mixedType,1
9,4,0,13,mixedType,1
9,2,0,11,mixedType,1
10,4,1,15,mixedType,2
7,5,0,12,mixedType,1
6,2,0,8,mixedType,1
6,2,0,8,mixedType,1
5,3,0,8,mixedType,1
5,1,0,6,mixedType,0
3,8,0,11,mixedType,1
5,4,0,9,mixedType,1
8,1,0,9,mixedType,1
6,6,0,12,mixedType,1
6,2,0,8,mixedType,1
13,3,0,16,mixedType,2
6,3,0,9,mixedType,1
6,3,0,9,mixedType,1
7,2,0,9,mixedType,1
6,0,2,8,mixedType,0
6,1,0,7,mixedType,0
6,10,0,16,mixedType,2
7,2,0,9,mixedType,1
4,4,0,8,mixedType,1
7,3,0,10,mixedType,1
7,2,0,9,mixedType,1
5,2,0,7,mixedType,0
5,2,0,7,mixedType,0
12,4,0,16,mixedType,2
15,1,0,16,mixedType,2
7,2,0,9,mixedType,1
9,2,0,11,mixedType,1
2,6,0,8,mixedType,1
5,4,0,9,mixedType,1
8,1,0,9,mixedType,1
8,3,0,11,mixedType,1
6,3,0,9,mixedType,1
5,4,0,9,mixedType,1
8,1,0,9,mixedType,1
12,4,0,16,mixedType,2
9,2,0,11,mixedType,1
7,3,0,10,mixedType,1
3,5,0,8,mixedType,1
14,2,0,16,mixedType,2
10,6,0,16,mixedType,2
5,2,0,7,mixedType,0
6,6,0,12,mixedType,1
2,8,0,10,mixedType,1
6,2,0,8,mixedType,1
14,2,0,16,mixedType,2
9,1,0,10,mixedType,1
6,3,0,9,mixedType,1
8,1,0,9,mixedType,1
4,4,0,8,mixedType,1
6,6,0,12,mixedType,1
12,4,0,16,mixedType,2
1,8,0,9,mixedType,1
13,1,1,15,mixedType,2
13,3,0,16,mixedType,2
6,2,0,8,mixedType,1
15,1,0,16,mixedType,2
9,1,0,10,mixedType,1
0,11,1,12,mixedType,1
6,5,0,11,mixedType,1
8,1,0,9,mixedType,1
11,3,0,14,mixedType,2
2,7,0,9,mixedType,1
6,2,0,8,mixedType,1
8,2,0,10,mixedType,1
8,4,0,12,mixedType,1
9,1,0,10,mixedType,1
10,2,0,12,mixedType,1
6,4,0,10,mixedType,1
2,6,0,8,mixedType,1
5,2,0,7,mixedType,0
14,2,0,16,mixedType,2
7,3,0,10,mixedType,1
9,1,0,10,mixedType,1
2,8,0,10,mixedType,1
9,5,0,14,mixedType,2
6,1,0,7,mixedType,0
2,8,0,10,mixedType,1
7,3,0,10,mixedType,1
4,4,0,8,mixedType,1
8,1,0,9,mixedType,1
10,3,0,13,mixedType,1
6,4,0,10,mixedType,1
1,7,0,8,mixedType,1
4,4,0,8,mixedType,1
13,3,0,16,mixedType,2
7,3,0,10,mixedType,1
5,1,0,6,mixedType,0
8,2,0,10,mixedType,1
8,1,0,9,mixedType,1
9,1,0,10,mixedType,1
3,9,0,12,mixedType,1
7,1,0,8,mixedType,1
7,3,0,10,mixedType,1
6,3,0,9,mixedType,1
6,7,0,13,mixedType,1
6,2,0,8,mixedType,1
3,6,0,9,mixedType,1
15,1,0,16,mixedType,2
5,3,0,8,mixedType,1
5,4,0,9,mixedType,1
8,2,0,10,mixedType,1
6,3,0,9,mixedType,1
7,3,0,10,mixedType,1
7,4,0,11,mixedType,1
5,2,0,7,mixedType,0
7,3,0,10,mixedType,1
14,2,0,16,mixedType,2
5,3,0,8,mixedType,1
4,4,0,8,mixedType,1
8,2,0,10,mixedType,1
1,8,0,9,mixedType,1
8,5,0,13,mixedType,1
14,2,0,16,mixedType,2
9,2,0,11,mixedType,1
8,4,0,12,mixedType,1
4,2,0,6,mixedType,0
9,2,0,11,mixedType,1
8,2,0,10,mixedType,1
7,1,0,8,mixedType,1
13,3,0,16,mixedType,2
8,2,0,10,mixedType,1
11,4,1,16,mixedType,2
7,3,0,10,mixedType,1
2,7,0,9,mixedType,1
7,2,0,9,mixedType,1
12,4,0,16,mixedType,2
4,2,0,6,mixedType,0
8,3,0,11,mixedType,1
1,9,0,10,mixedType,1
3,5,0,8,mixedType,1
12,3,0,15,mixedType,2
10,2,0,12,mixedType,1
9,4,0,13,mixedType,1
4,2,0,6,mixedType,0
4,2,0,6,mixedType,0
7,1,0,8,mixedType,1
7,2,0,9,mixedType,1
6,1,0,7,mixedType,0
8,1,0,9,mixedType,1
6,4,0,10,mixedType,1
7,5,0,12,mixedType,1
8,1,0,9,mixedType,1
2,7,0,9,mixedType,1
5,6,0,11,mixedType,1
10,1,0,11,mixedType,1
6,2,0,8,mixedType,1
4,5,0,9,mixedType,1
4,9,0,13,mixedType,1
8,1,0,9,mixedType,1
12,3,0,15,mixedType,2
2,6,0,8,mixedType,1
3,7,0,10,mixedType,1
7,3,0,10,mixedType,1
6,2,0,8,mixedType,1
3,8,0,11,mixedType,1
1,10,0,11,mixedType,1
13,3,0,16,mixedType,2
5,4,0,9,mixedType,1
9,2,0,11,mixedType,1
5,3,0,8,mixedType,1
5,4,0,9,mixedType,1
12,4,0,16,mixedType,2
8,3,0,11,mixedType,1
10,2,0,12,mixedType,1
9,3,0,12,mixedType,1
5,6,0,11,mixedType,1
3,6,0,9,mixedType,1
5,5,0,10,mixedType,1
7,1,0,8,mixedType,1
10,4,1,15,mixedType,2
6,2,0,8,mixedType,1
2,7,0,9,mixedType,1
1,8,0,9,mixedType,1
5,6,0,11,mixedType,1
8,1,0,9,mixedType,1
6,1,0,7,mixedType,0
12,0,1,13,mixedType,1
4,4,0,8,mixedType,1
9,2,0,11,mixedType,1
8,2,0,10,mixedType,1
5,4,0,9,mixedType,1
7,2,0,9,mixedType,1
8,0,1,9,mixedType,1
6,3,0,9,mixedType,1
4,6,0,10,mixedType,1
6,2,0,8,mixedType,1
4,4,0,8,mixedType,1
7,3,0,10,mixedType,1
7,1,0,8,mixedType,1
7,6,0,13,mixedType,1
4,6,0,10,mixedType,1
7,5,0,12,mixedType,1
8,4,0,12,mixedType,1
15,1,0,16,mixedType,2
6,2,0,8,mixedType,1
7,3,0,10,mixedType,1
7,3,0,10,mixedType,1
5,5,0,10,mixedType,1
7,3,0,10,mixedType,1
2,7,0,9,mixedType,1
7,4,0,11,mixedType,1
7,2,0,9,mixedType,1
8,2,0,10,mixedType,1
8,3,0,11,mixedType,1
4,9,1,14,mixedType,2
7,1,0,8,mixedType,1
9,4,0,13,mixedType,1
9,1,0,10,mixedType,1
1,8,0,9,mixedType,1
9,1,0,10,mixedType,1
12,3,0,15,mixedType,2
5,4,0,9,mixedType,1
8,1,0,9,mixedType,1
5,4,0,9,mixedType,1
4,4,0,8,mixedType,1
6,6,0,12,mixedType,1
7,1,0,8,mixedType,1
6,4,0,10,mixedType,1
7,2,0,9,mixedType,1
6,1,0,7,mixedType,0
5,3,0,8,mixedType,1
6,4,0,10,mixedType,1
7,3,0,10,mixedType,1
7,1,0,8,mixedType,1
7,3,0,10,mixedType,1
15,1,0,16,mixedType,2
9,2,0,11,mixedType,1
6,2,0,8,mixedType,1
7,2,0,9,mixedType,1
6,1,0,7,mixedType,0
7,1,0,8,mixedType,1
8,3,0,11,mixedType,1
12,4,0,16,mixedType,2
4,2,0,6,mixedType,0
10,12,0,22,mixedType,2
2,11,0,13,mixedType,1
5,2,0,7,mixedType,0
7,2,0,9,mixedType,1
3,6,0,9,mixedType,1
5,1,0,6,mixedType,0
4,2,0,6,mixedType,0
5,2,0,7,mixedType,0
5,5,0,10,mixedType,1
8,2,0,10,mixedType,1
9,3,0,12,mixedType,1
4,5,0,9,mixedType,1
15,1,0,16,mixedType,2
8,1,0,9,mixedType,1
4,6,0,10,mixedType,1
14,2,0,16,mixedType,2
5,2,0,7,mixedType,0
8,1,0,9,mixedType,1
6,2,0,8,mixedType,1
8,2,0,10,mixedType,1
13,3,0,16,mixedType,2
5,1,0,6,mixedType,0
12,1,0,13,mixedType,1
5,2,0,7,mixedType,0
6,3,0,9,mixedType,1
2,8,0,10,mixedType,1
5,2,0,7,mixedType,0
8,2,0,10,mixedType,1
5,3,0,8,mixedType,1
8,2,0,10,mixedType,1
5,1,0,6,mixedType,0
7,1,0,8,mixedType,1
2,7,0,9,mixedType,1
4,8,0,12,mixedType,1
4,5,0,9,mixedType,1
1,8,0,9,mixedType,1
7,3,0,10,mixedType,1
3,6,0,9,mixedType,1
6,4,0,10,mixedType,1
13,3,0,16,mixedType,2
8,1,0,9,mixedType,1
6,1,0,7,mixedType,0
3,5,0,8,mixedType,1
15,1,0,16,mixedType,2
6,2,0,8,mixedType,1
8,3,0,11,mixedType,1
8,2,0,10,mixedType,1
8,1,0,9,mixedType,1
7,3,0,10,mixedType,1
9,1,0,10,mixedType,1
7,3,0,10,mixedType,1
7,1,0,8,mixedType,1
7,2,0,9,mixedType,1
10,3,0,13,mixedType,1
6,3,0,9,mixedType,1
7,2,0,9,mixedType,1
9,1,0,10,mixedType,1
9,3,0,12,mixedType,1
5,4,0,9,mixedType,1
12,4,0,16,mixedType,2
3,5,0,8,mixedType,1
8,3,0,11,mixedType,1
8,2,0,10,mixedType,1
9,7,0,16,mixedType,2
7,1,0,8,mixedType,1
2,4,0,6,mixedType,0
9,1,0,10,mixedType,1
6,3,0,9,mixedType,1
12,4,0,16,mixedType,2
8,2,0,10,mixedType,1
13,3,0,16,mixedType,2
1,9,0,10,mixedType,1
4,2,0,6,mixedType,0
4,4,0,8,mixedType,1
7,3,0,10,mixedType,1
4,4,0,8,mixedType,1
7,2,0,9,mixedType,1
13,3,0,16,mixedType,2
5,4,0,9,mixedType,1
7,9,1,17,mixedType,2
17,1,1,19,mixedType,2
9,3,0,12,mixedType,1
4,4,0,8,mixedType,1
6,2,0,8,mixedType,1
6,4,0,10,mixedType,1
10,3,0,13,mixedType,1
10,2,0,12,mixedType,1
6,3,0,9,mixedType,1
5,3,0,8,mixedType,1
4,4,0,8,mixedType,1
4,2,0,6,mixedType,0
7,3,0,10,mixedType,1
8,2,0,10,mixedType,1
7,3,0,10,mixedType,1
9,2,0,11,mixedType,1
7,2,0,9,mixedType,1
5,2,0,7,mixedType,0
6,4,0,10,mixedType,1
7,1,0,8,mixedType,1
6,2,0,8,mixedType,1
6,3,0,9,mixedType,1
5,2,0,7,mixedType,0
7,2,0,9,mixedType,1
5,4,0,9,mixedType,1
6,1,0,7,mixedType,0
5,1,0,6,mixedType,0
6,1,0,7,mixedType,0
3,3,0,6,mixedType,0
5,2,0,7,mixedType,0
1,6,0,7,mixedType,0
6,3,0,9,mixedType,1
4,4,0,8,mixedType,1
11,3,0,14,mixedType,2
7,3,0,10,mixedType,1
5,3,0,8,mixedType,1
7,2,0,9,mixedType,1
6,2,0,8,mixedType,1
6,4,0,10,mixedType,1
8,1,0,9,mixedType,1
8,2,0,10,mixedType,1
6,2,0,8,mixedType,1
5,3,0,8,mixedType,1
6,1,0,7,mixedType,0
7,2,0,9,mixedType,1
7,3,0,10,mixedType,1
5,3,0,8,mixedType,1
7,4,0,11,mixedType,1
5,2,0,7,mixedType,0
8,1,0,9,mixedType,1
8,2,0,10,mixedType,1
5,6,0,11,mixedType,1
7,2,0,9,mixedType,1
9,2,0,11,mixedType,1
6,3,0,9,mixedType,1
5,2,0,7,mixedType,0
2,7,0,9,mixedType,1
5,2,0,7,mixedType,0
7,1,0,8,mixedType,1
2,4,0,6,mixedType,0
6,2,0,8,mixedType,1
6,3,0,9,mixedType,1
4,6,0,10,mixedType,1
11,2,0,13,mixedType,1
9,1,0,10,mixedType,1
1,8,0,9,mixedType,1
14,2,0,16,mixedType,2
5,4,0,9,mixedType,1
8,1,0,9,mixedType,1
15,1,0,16,mixedType,2
10,2,0,12,mixedType,1
2,8,0,10,mixedType,1
5,2,0,7,mixedType,0
8,2,0,10,mixedType,1
7,3,0,10,mixedType,1
6,3,0,9,mixedType,1
3,6,0,9,mixedType,1
2,4,0,6,mixedType,0
4,4,0,8,mixedType,1
5,1,0,6,mixedType,0
4,4,0,8,mixedType,1
8,2,0,10,mixedType,1
1,7,0,8,mixedType,1
6,1,0,7,mixedType,0
5,7,0,12,mixedType,1
7,3,0,10,mixedType,1
8,1,0,9,mixedType,1
7,3,0,10,mixedType,1
8,2,0,10,mixedType,1
5,2,0,7,mixedType,0
2,7,0,9,mixedType,1
5,1,0,6,mixedType,0
8,4,0,12,mixedType,1
7,3,0,10,mixedType,1
8,1,0,9,mixedType,1
5,2,0,7,mixedType,0
8,1,0,9,mixedType,1
1,6,0,7,mixedType,0
7,2,0,9,mixedType,1
1,7,0,8,mixedType,1
9,3,0,12,mixedType,1
5,4,0,9,mixedType,1
6,6,0,12,mixedType,1
6,4,0,10,mixedType,1
5,4,0,9,mixedType,1
7,2,0,9,mixedType,1
6,1,0,7,mixedType,0
8,2,0,10,mixedType,1
7,2,0,9,mixedType,1
5,4,0,9,mixedType,1
9,4,0,13,mixedType,1
9,2,0,11,mixedType,1
5,4,0,9,mixedType,1
5,3,0,8,mixedType,1
5,4,0,9,mixedType,1
3,7,0,10,mixedType,1
5,3,0,8,mixedType,1
7,3,0,10,mixedType,1
2,4,0,6,mixedType,0
6,3,0,9,mixedType,1
13,3,0,16,mixedType,2
6,1,0,7,mixedType,0
8,2,0,10,mixedType,1
2,4,0,6,mixedType,0
8,2,0,10,mixedType,1
6,3,0,9,mixedType,1
6,3,0,9,mixedType,1
4,2,0,6,mixedType,0
9,4,0,13,mixedType,1
8,2,0,10,mixedType,1
5,2,0,7,mixedType,0
12,4,0,16,mixedType,2
8,1,0,9,mixedType,1
6,2,0,8,mixedType,1
6,3,0,9,mixedType,1
4,4,0,8,mixedType,1
7,1,0,8,mixedType,1
13,3,0,16,mixedType,2
8,4,0,12,mixedType,1
6,1,0,7,mixedType,0
4,7,3,14,mixedType,2
5,2,0,7,mixedType,0
4,4,0,8,mixedType,1
5,4,0,9,mixedType,1
3,6,0,9,mixedType,1
13,3,0,16,mixedType,2
5,5,0,10,mixedType,1
8,2,0,10,mixedType,1
9,1,0,10,mixedType,1
8,0,1,9,mixedType,1
7,2,0,9,mixedType,1
1,7,0,8,mixedType,1
6,2,0,8,mixedType,1
15,1,0,16,mixedType,2
5,3,0,8,mixedType,1
9,1,0,10,mixedType,1
6,6,0,12,mixedType,1
3,6,0,9,mixedType,1
5,4,0,9,mixedType,1
6,1,0,7,mixedType,0
6,2,0,8,mixedType,1
6,3,0,9,mixedType,1
8,2,0,10,mixedType,1
6,3,0,9,mixedType,1
5,3,0,8,mixedType,1
9,3,0,12,mixedType,1
6,3,0,9,mixedType,1
5,2,0,7,mixedType,0
5,2,0,7,mixedType,0
10,2,0,12,mixedType,1
3,6,0,9,mixedType,1
8,4,0,12,mixedType,1
6,14,0,20,mixedType,2
6,3,0,9,mixedType,1
10,2,0,12,mixedType,1
6,3,0,9,mixedType,1
8,4,2,14,mixedType,2
4,2,0,6,mixedType,0
13,2,0,15,mixedType,2
10,1,0,11,mixedType,1
13,2,3,18,mixedType,2
5,3,0,8,mixedType,1
5,5,0,10,mixedType,1
13,3,0,16,mixedType,2
4,2,0,6,mixedType,0
5,3,0,8,mixedType,1
7,6,0,13,mixedType,1
8,3,0,11,mixedType,1
6,6,0,12,mixedType,1
3,7,0,10,mixedType,1
8,2,0,10,mixedType,1
5,4,0,9,mixedType,1
7,3,0,10,mixedType,1
11,3,0,14,mixedType,2
6,3,0,9,mixedType,1
9,1,0,10,mixedType,1
5,3,0,8,mixedType,1
10,0,1,11,mixedType,1
10,2,0,12,mixedType,1
6,3,0,9,mixedType,1
6,6,0,12,mixedType,1
1,7,0,8,mixedType,1
5,3,0,8,mixedType,1
7,4,0,11,mixedType,1
1,8,0,9,mixedType,1
7,2,0,9,mixedType,1
2,4,0,6,mixedType,0
6,3,0,9,mixedType,1
7,3,0,10,mixedType,1
10,2,0,12,mixedType,1
6,3,0,9,mixedType,1
14,2,0,16,mixedType,2
10,3,0,13,mixedType,1
2,8,0,10,mixedType,1
6,3,0,9,mixedType,1
4,4,0,8,mixedType,1
7,2,0,9,mixedType,1
14,2,0,16,mixedType,2
6,4,0,10,mixedType,1
7,1,0,8,mixedType,1
2,8,0,10,mixedType,1
6,3,0,9,mixedType,1
11,1,0,12,mixedType,1
5,6,0,11,mixedType,1
7,2,0,9,mixedType,1
5,2,0,7,mixedType,0
8,1,0,9,mixedType,1
12,4,0,16,mixedType,2
6,6,0,12,mixedType,1
13,3,0,16,mixedType,2
14,2,0,16,mixedType,2
3,9,0,12,mixedType,1
5,3,0,8,mixedType,1
8,2,0,10,mixedType,1
1,8,0,9,mixedType,1
9,3,0,12,mixedType,1
3,8,0,11,mixedType,1
5,2,0,7,mixedType,0
6,3,0,9,mixedType,1
5,5,0,10,mixedType,1
7,3,0,10,mixedType,1
11,4,0,15,mixedType,2
7,3,0,10,mixedType,1
7,2,0,9,mixedType,1
6,2,0,8,mixedType,1
8,2,0,10,mixedType,1
6,1,0,7,mixedType,0
12,3,1,16,mixedType,2
7,3,0,10,mixedType,1
5,3,0,8,mixedType,1
6,3,0,9,mixedType,1
6,4,0,10,mixedType,1
3,7,0,10,mixedType,1
4,6,0,10,mixedType,1
7,3,0,10,mixedType,1
7,3,0,10,mixedType,1
4,8,3,15,mixedType,2
5,3,0,8,mixedType,1
4,6,0,10,mixedType,1
9,1,0,10,mixedType,1
7,1,0,8,mixedType,1
4,8,0,12,mixedType,1
4,2,0,6,mixedType,0
2,8,0,10,mixedType,1
6,2,0,8,mixedType,1
6,3,0,9,mixedType,1
7,2,0,9,mixedType,1
8,4,0,12,mixedType,1
7,2,0,9,mixedType,1
7,1,0,8,mixedType,1
7,3,0,10,mixedType,1
7,1,0,8,mixedType,1
15,1,0,16,mixedType,2
9,6,0,15,mixedType,2
5,2,0,7,mixedType,0
1,7,0,8,mixedType,1
6,2,0,8,mixedType,1
6,3,0,9,mixedType,1
9,2,0,11,mixedType,1
12,3,0,15,mixedType,2
9,1,0,10,mixedType,1
5,3,0,8,mixedType,1
6,1,0,7,mixedType,0
5,2,0,7,mixedType,0
3,5,0,8,mixedType,1
3,3,0,6,mixedType,0
5,1,0,6,mixedType,0
8,2,0,10,mixedType,1
15,1,0,16,mixedType,2
5,1,0,6,mixedType,0
7,2,0,9,mixedType,1
7,4,0,11,mixedType,1
5,2,0,7,mixedType,0
1,9,0,10,mixedType,1
5,3,0,8,mixedType,1
8,2,0,10,mixedType,1
6,1,0,7,mixedType,0
12,3,0,15,mixedType,2
5,3,0,8,mixedType,1
6,4,0,10,mixedType,1
11,2,0,13,mixedType,1
5,3,0,8,mixedType,1
8,5,0,13,mixedType,1
8,2,0,10,mixedType,1
5,3,0,8,mixedType,1
6,1,0,7,mixedType,0
11,3,0,14,mixedType,2
6,1,0,7,mixedType,0
3,6,0,9,mixedType,1
8,1,0,9,mixedType,1
9,3,0,12,mixedType,1
6,2,0,8,mixedType,1
3,7,0,10,mixedType,1
4,2,0,6,mixedType,0
6,7,0,13,mixedType,1
1,8,0,9,mixedType,1
4,2,0,6,mixedType,0
6,2,0,8,mixedType,1
6,3,0,9,mixedType,1
7,1,0,8,mixedType,1
5,6,0,11,mixedType,1
5,3,0,8,mixedType,1
3,5,0,8,mixedType,1
11,5,0,16,mixedType,2
6,5,0,11,mixedType,1
6,3,0,9,mixedType,1
8,4,0,12,mixedType,1
2,7,0,9,mixedType,1
6,3,0,9,mixedType,1
5,3,0,8,mixedType,1
5,4,0,9,mixedType,1
7,2,0,9,mixedType,1
3,8,0,11,mixedType,1
5,3,0,8,mixedType,1
4,2,0,6,mixedType,0
4,4,0,8,mixedType,1
2,6,0,8,mixedType,1
9,2,0,11,mixedType,1
6,4,0,10,mixedType,1
9,1,0,10,mixedType,1
7,1,0,8,mixedType,1
5,1,0,6,mixedType,0
7,3,0,10,mixedType,1
8,2,0,10,mixedType,1
14,2,0,16,mixedType,2
7,3,0,10,mixedType,1
5,1,0,6,mixedType,0
5,4,0,9,mixedType,1
5,1,0,6,mixedType,0
6,3,0,9,mixedType,1
8,1,0,9,mixedType,1
10,1,0,11,mixedType,1
7,3,0,10,mixedType,1
0,4,2,6,mixedType,0
9,3,0,12,mixedType,1
5,3,0,8,mixedType,1
7,2,0,9,mixedType,1
4,6,0,10,mixedType,1
1,8,0,9,mixedType,1
10,1,0,11,mixedType,1
8,1,0,9,mixedType,1
2,6,0,8,mixedType,1
5,9,0,14,mixedType,2
9,3,0,12,mixedType,1
9,1,0,10,mixedType,1
6,3,0,9,mixedType,1
6,4,0,10,mixedType,1
5,3,0,8,mixedType,1
1,5,0,6,mixedType,0
2,8,0,10,mixedType,1
8,4,0,12,mixedType,1
5,2,0,7,mixedType,0
6,4,0,10,mixedType,1
7,3,0,10,mixedType,1
6,0,1,7,mixedType,0
7,1,0,8,mixedType,1
3,7,0,10,mixedType,1
17,1,1,19,mixedType,2
7,3,0,10,mixedType,1
9,4,0,13,mixedType,1
6,4,0,10,mixedType,1
5,2,0,7,mixedType,0
5,1,0,6,mixedType,0
6,4,0,10,mixedType,1
2,6,0,8,mixedType,1
6,4,0,10,mixedType,1
8,1,0,9,mixedType,1
1,8,0,9,mixedType,1
8,3,0,11,mixedType,1
9,2,0,11,mixedType,1
5,2,0,7,mixedType,0
3,3,0,6,mixedType,0
13,3,0,16,mixedType,2
7,3,0,10,mixedType,1
3,3,0,6,mixedType,0
6,3,0,9,mixedType,1
5,3,0,8,mixedType,1
6,3,0,9,mixedType,1
2,6,0,8,mixedType,1
6,3,0,9,mixedType,1
7,3,0,10,mixedType,1
14,2,0,16,mixedType,2
4,4,0,8,mixedType,1
8,2,0,10,mixedType,1
4,4,0,8,mixedType,1
1,10,0,11,mixedType,1
4,4,0,8,mixedType,1
7,3,0,10,mixedType,1
6,4,0,10,mixedType,1
1,8,0,9,mixedType,1
6,4,0,10,mixedType,1
6,1,0,7,mixedType,0
6,4,0,10,mixedType,1
8,2,0,10,mixedType,1
5,3,0,8,mixedType,1
2,6,0,8,mixedType,1
3,7,0,10,mixedType,1
7,3,0,10,mixedType,1
5,8,0,13,mixedType,1
9,1,0,10,mixedType,1
14,2,0,16,mixedType,2
6,3,0,9,mixedType,1
7,1,0,8,mixedType,1
6,2,0,8,mixedType,1
7,2,0,9,mixedType,1
5,3,0,8,mixedType,1
15,1,0,16,mixedType,2
5,6,0,11,mixedType,1
15,1,0,16,mixedType,2
2,6,0,8,mixedType,1
7,3,0,10,mixedType,1
7,3,0,10,mixedType,1
6,3,0,9,mixedType,1
7,4,0,11,mixedType,1
2,8,0,10,mixedType,1
6,2,0,8,mixedType,1
9,2,0,11,mixedType,1
5,1,0,6,mixedType,0
6,4,0,10,mixedType,1
5,3,0,8,mixedType,1
9,1,0,10,mixedType,1
12,3,0,15,mixedType,2
6,3,0,9,mixedType,1
5,4,0,9,mixedType,1
5,3,0,8,mixedType,1
11,3,0,14,mixedType,2
4,9,0,13,mixedType,1
7,2,0,9,mixedType,1
7,2,0,9,mixedType,1
7,3,0,10,mixedType,1
1,8,0,9,mixedType,1
8,1,0,9,mixedType,1
7,3,0,10,mixedType,1
2,10,0,12,mixedType,1
11,3,0,14,mixedType,2
11,3,0,14,mixedType,2
3,6,0,9,mixedType,1
6,4,0,10,mixedType,1
6,4,0,10,mixedType,1
5,3,0,8,mixedType,1
6,6,0,12,mixedType,1
7,3,0,10,mixedType,1
8,2,0,10,mixedType,1
6,6,0,12,mixedType,1
8,4,0,12,mixedType,1
6,4,0,10,mixedType,1
5,2,0,7,mixedType,0
5,3,0,8,mixedType,1
6,4,0,10,mixedType,1
5,2,0,7,mixedType,0
4,6,0,10,mixedType,1
8,1,0,9,mixedType,1
5,4,0,9,mixedType,1
5,4,0,9,mixedType,1
12,4,0,16,mixedType,2
7,2,0,9,mixedType,1
6,2,0,8,mixedType,1
8,4,0,12,mixedType,1
4,7,0,11,mixedType,1
6,11,0,17,mixedType,2
5,1,0,6,mixedType,0
5,3,0,8,mixedType,1
6,3,0,9,mixedType,1
7,3,0,10,mixedType,1
5,1,0,6,mixedType,0
9,2,0,11,mixedType,1
14,2,0,16,mixedType,2
1,8,0,9,mixedType,1
15,1,0,16,mixedType,2
6,2,0,8,mixedType,1
9,3,0,12,mixedType,1
4,2,0,6,mixedType,0
6,4,0,10,mixedType,1
6,2,0,8,mixedType,1
12,3,0,15,mixedType,2
5,3,0,8,mixedType,1
6,4,0,10,mixedType,1
6,2,0,8,mixedType,1
5,5,0,10,mixedType,1
11,3,0,14,mixedType,2
8,1,0,9,mixedType,1
8,3,0,11,mixedType,1
5,1,0,6,mixedType,0
2,11,0,13,mixedType,1
5,2,0,7,mixedType,0
5,2,0,7,mixedType,0
8,7,0,15,mixedType,2
6,1,0,7,mixedType,0
6,2,0,8,mixedType,1
2,6,0,8,mixedType,1
1,8,0,9,mixedType,1
3,10,0,13,mixedType,1
4,2,0,6,mixedType,0
5,3,0,8,mixedType,1
9,1,0,10,mixedType,1
3,5,0,8,mixedType,1
5,3,0,8,mixedType,1
6,3,0,9,mixedType,1
5,3,0,8,mixedType,1
5,7,0,12,mixedType,1
7,3,0,10,mixedType,1
7,3,0,10,mixedType,1
2,3,0,5,mixedType,0
9,1,0,10,mixedType,1
3,9,0,12,mixedType,1
6,4,0,10,mixedType,1
10,2,0,12,mixedType,1
4,2,0,6,mixedType,0
7,1,0,8,mixedType,1
4,5,0,9,mixedType,1
4,4,0,8,mixedType,1
14,2,0,16,mixedType,2
6,3,0,9,mixedType,1
11,3,0,14,mixedType,2
5,3,0,8,mixedType,1
7,2,0,9,mixedType,1
5,4,0,9,mixedType,1
1,8,0,9,mixedType,1
5,2,0,7,mixedType,0
9,2,0,11,mixedType,1
6,1,0,7,mixedType,0
1,10,0,11,mixedType,1
5,3,0,8,mixedType,1
7,4,0,11,mixedType,1
4,5,0,9,mixedType,1
9,2,0,11,mixedType,1
1,10,0,11,mixedType,1
8,1,0,9,mixedType,1
12,3,0,15,mixedType,2
7,3,0,10,mixedType,1
5,5,0,10,mixedType,1
6,2,0,8,mixedType,1
10,1,0,11,mixedType,1
8,3,0,11,mixedType,1
6,4,0,10,mixedType,1
5,4,0,9,mixedType,1
13,3,0,16,mixedType,2
6,4,0,10,mixedType,1
8,4,0,12,mixedType,1
4,4,0,8,mixedType,1
4,4,0,8,mixedType,1
8,2,0,10,mixedType,1
14,2,0,16,mixedType,2
11,2,0,13,mixedType,1
4,4,0,8,mixedType,1
4,6,0,10,mixedType,1
3,6,0,9,mixedType,1
8,2,0,10,mixedType,1
6,3,0,9,mixedType,1
6,3,0,9,mixedType,1
5,4,0,9,mixedType,1
6,3,0,9,mixedType,1
22,1,0,23,mixedType,2
9,1,0,10,mixedType,1
5,3,0,8,mixedType,1
6,4,0,10,mixedType,1
6,1,0,7,mixedType,0
2,6,0,8,mixedType,1
1,10,0,11,mixedType,1
13,3,0,16,mixedType,2
6,4,0,10,mixedType,1
4,6,0,10,mixedType,1
7,4,0,11,mixedType,1
7,2,0,9,mixedType,1
5,2,0,7,mixedType,0
5,2,0,7,mixedType,0
7,4,0,11,mixedType,1
6,4,0,10,mixedType,1
3,7,0,10,mixedType,1
5,3,0,8,mixedType,1
11,1,0,12,mixedType,1
12,4,1,17,mixedType,2
7,4,0,11,mixedType,1
6,2,0,8,mixedType,1
4,4,0,8,mixedType,1
11,2,0,13,mixedType,1
8,1,0,9,mixedType,1
4,2,0,6,mixedType,0
8,1,0,9,mixedType,1
6,4,0,10,mixedType,1
6,1,0,7,mixedType,0
11,1,0,12,mixedType,1
9,1,0,10,mixedType,1
5,5,0,10,mixedType,1
5,3,0,8,mixedType,1
8,2,0,10,mixedType,1
12,4,0,16,mixedType,2
5,3,0,8,mixedType,1
7,3,0,10,mixedType,1
7,1,0,8,mixedType,1
10,1,0,11,mixedType,1
6,2,0,8,mixedType,1
9,2,0,11,mixedType,1
9,3,0,12,mixedType,1
6,3,0,9,mixedType,1
7,3,0,10,mixedType,1
1,8,0,9,mixedType,1
8,1,0,9,mixedType,1
5,2,0,7,mixedType,0
9,3,0,12,mixedType,1
9,1,0,10,mixedType,1
14,2,0,16,mixedType,2
8,1,0,9,mixedType,1
5,3,0,8,mixedType,1
8,3,0,11,mixedType,1
7,1,0,8,mixedType,1
8,4,0,12,mixedType,1
5,5,0,10,mixedType,1
7,2,0,9,mixedType,1
14,2,0,16,mixedType,2
12,4,0,16,mixedType,2
8,1,0,9,mixedType,1
5,3,0,8,mixedType,1
9,1,0,10,mixedType,1
5,2,0,7,mixedType,0
5,4,0,9,mixedType,1
4,5,0,9,mixedType,1
2,12,0,14,mixedType,2
4,2,0,6,mixedType,0
14,2,0,16,mixedType,2
9,3,0,12,mixedType,1
13,1,2,16,mixedType,2
6,4,0,10,mixedType,1
2,4,0,6,mixedType,0
7,2,0,9,mixedType,1
5,2,0,7,mixedType,0
7,6,0,13,mixedType,1
6,3,0,9,mixedType,1
4,8,0,12,mixedType,1
6,9,1,16,mixedType,2
5,3,0,8,mixedType,1
6,1,0,7,mixedType,0
9,2,0,11,mixedType,1
6,3,0,9,mixedType,1
6,3,0,9,mixedType,1
2,6,0,8,mixedType,1
6,3,0,9,mixedType,1
6,2,0,8,mixedType,1
6,3,0,9,mixedType,1
4,2,0,6,mixedType,0
1,11,0,12,mixedType,1
3,7,0,10,mixedType,1
8,1,0,9,mixedType,1
9,1,0,10,mixedType,1
11,2,3,16,mixedType,2
7,1,0,8,mixedType,1
8,1,0,9,mixedType,1
5,3,0,8,mixedType,1
7,1,0,8,mixedType,1
11,1,0,12,mixedType,1
1,8,0,9,mixedType,1
9,3,0,12,mixedType,1
9,1,0,10,mixedType,1
7,2,0,9,mixedType,1
13,3,0,16,mixedType,2
7,1,0,8,mixedType,1
9,2,0,11,mixedType,1
6,3,0,9,mixedType,1
9,2,0,11,mixedType,1
1,8,0,9,mixedType,1
5,2,0,7,mixedType,0
17,2,0,19,mixedType,2
7,3,0,10,mixedType,1
8,1,0,9,mixedType,1
6,2,0,8,mixedType,1
4,2,0,6,mixedType,0
6,3,0,9,mixedType,1
7,5,0,12,mixedType,1
4,2,0,6,mixedType,0
7,1,0,8,mixedType,1
5,6,0,11,mixedType,1
3,5,0,8,mixedType,1
4,5,0,9,mixedType,1
8,1,0,9,mixedType,1
4,4,0,8,mixedType,1
8,3,0,11,mixedType,1
13,3,0,16,mixedType,2
9,2,0,11,mixedType,1
2,6,0,8,mixedType,1
4,4,0,8,mixedType,1
2,6,0,8,mixedType,1
7,3,0,10,mixedType,1
4,4,0,8,mixedType,1
1,8,0,9,mixedType,1
14,2,0,16,mixedType,2
7,3,0,10,mixedType,1
7,2,0,9,mixedType,1
5,4,0,9,mixedType,1
6,3,0,9,mixedType,1
5,3,0,8,mixedType,1
6,2,0,8,mixedType,1
5,1,0,6,mixedType,0
5,0,2,7,mixedType,0
5,4,0,9,mixedType,1
7,1,0,8,mixedType,1
7,2,0,9,mixedType,1
7,3,0,10,mixedType,1
9,1,0,10,mixedType,1
4,5,0,9,mixedType,1
8,4,0,12,mixedType,1
2,6,0,8,mixedType,1
10,1,0,11,mixedType,1
5,1,0,6,mixedType,0
1,8,0,9,mixedType,1
9,1,0,10,mixedType,1
5,5,0,10,mixedType,1
5,3,0,8,mixedType,1
7,2,0,9,mixedType,1
5,2,0,7,mixedType,0
8,2,0,10,mixedType,1
4,5,0,9,mixedType,1
7,3,0,10,mixedType,1
2,9,0,11,mixedType,1
4,6,0,10,mixedType,1
5,1,0,6,mixedType,0
14,2,0,16,mixedType,2
8,2,0,10,mixedType,1
5,6,0,11,mixedType,1
5,4,0,9,mixedType,1
9,1,0,10,mixedType,1
7,3,0,10,mixedType,1
6,2,0,8,mixedType,1
4,5,0,9,mixedType,1
10,1,0,11,mixedType,1
6,1,0,7,mixedType,0
5,6,0,11,mixedType,1
6,1,0,7,mixedType,0
7,2,0,9,mixedType,1
8,1,0,9,mixedType,1
6,1,0,7,mixedType,0
10,3,0,13,mixedType,1
7,2,0,9,mixedType,1
5,8,0,13,mixedType,1
12,3,0,15,mixedType,2
3,4,0,7,mixedType,0
5,4,0,9,mixedType,1
4,2,0,6,mixedType,0
4,2,0,6,mixedType,0
12,4,0,16,mixedType,2
7,2,0,9,mixedType,1
5,2,0,7,mixedType,0
4,6,0,10,mixedType,1
8,2,0,10,mixedType,1
5,2,0,7,mixedType,0
4,4,0,8,mixedType,1
6,3,0,9,mixedType,1
6,2,0,8,mixedType,1
4,9,0,13,mixedType,1
4,2,0,6,mixedType,0
9,1,0,10,mixedType,1
6,4,0,10,mixedType,1
6,3,0,9,mixedType,1
13,3,0,16,mixedType,2
3,6,0,9,mixedType,1
13,3,0,16,mixedType,2
5,3,0,8,mixedType,1
7,3,0,10,mixedType,1
6,1,0,7,mixedType,0
4,4,0,8,mixedType,1
3,6,0,9,mixedType,1
14,2,0,16,mixedType,2
6,3,0,9,mixedType,1
5,5,0,10,mixedType,1
15,1,0,16,mixedType,2
7,3,0,10,mixedType,1
4,2,0,6,mixedType,0
12,3,0,15,mixedType,2
9,3,0,12,mixedType,1
7,2,0,9,mixedType,1
3,3,0,6,mixedType,0
8,2,0,10,mixedType,1
2,6,0,8,mixedType,1
1,9,0,10,mixedType,1
8,1,0,9,mixedType,1
7,3,0,10,mixedType,1
11,2,0,13,mixedType,1
2,6,0,8,mixedType,1
4,2,0,6,mixedType,0
3,3,0,6,mixedType,0
7,1,0,8,mixedType,1
7,3,0,10,mixedType,1
6,4,0,10,mixedType,1
4,2,0,6,mixedType,0
9,1,0,10,mixedType,1
4,2,0,6,mixedType,0
12,4,0,16,mixedType,2
3,3,0,6,mixedType,0
1,9,0,10,mixedType,1
5,4,0,9,mixedType,1
3,6,0,9,mixedType,1
8,2,0,10,mixedType,1
5,2,0,7,mixedType,0
14,2,0,16,mixedType,2
1,8,0,9,mixedType,1
10,3,0,13,mixedType,1
6,3,0,9,mixedType,1
5,1,0,6,mixedType,0
15,1,0,16,mixedType,2
7,1,0,8,mixedType,1
3,5,0,8,mixedType,1
2,6,0,8,mixedType,1
8,1,0,9,mixedType,1
4,5,0,9,mixedType,1
9,2,0,11,mixedType,1
5,3,0,8,mixedType,1
1,8,0,9,mixedType,1
7,6,0,13,mixedType,1
7,3,0,10,mixedType,1
5,3,0,8,mixedType,1
7,3,0,10,mixedType,1
7,3,0,10,mixedType,1
8,2,0,10,mixedType,1
2,6,0,8,mixedType,1
6,3,0,9,mixedType,1
6,3,0,9,mixedType,1
6,2,0,8,mixedType,1
7,1,0,8,mixedType,1
6,4,0,10,mixedType,1
2,4,0,6,mixedType,0
3,5,0,8,mixedType,1
10,3,0,13,mixedType,1
5,3,0,8,mixedType,1
8,1,0,9,mixedType,1
7,2,0,9,mixedType,1
5,4,0,9,mixedType,1
5,3,0,8,mixedType,1
8,1,0,9,mixedType,1
5,3,0,8,mixedType,1
9,1,0,10,mixedType,1
8,1,0,9,mixedType,1
6,4,0,10,mixedType,1
8,2,0,10,mixedType,1
6,3,0,9,mixedType,1
7,3,0,10,mixedType,1
7,1,0,8,mixedType,1
12,1,1,14,mixedType,2
1,9,0,10,mixedType,1
15,1,0,16,mixedType,2
11,2,0,13,mixedType,1
9,1,0,10,mixedType,1
8,3,0,11,mixedType,1
9,2,0,11,mixedType,1
8,2,0,10,mixedType,1
11,1,0,12,mixedType,1
4,2,0,6,mixedType,0
4,4,0,8,mixedType,1
4,5,0,9,mixedType,1
1,7,0,8,mixedType,1
7,5,3,15,mixedType,2
7,3,0,10,mixedType,1
5,3,0,8,mixedType,1
9,1,0,10,mixedType,1
1,8,0,9,mixedType,1
5,5,0,10,mixedType,1
9,1,0,10,mixedType,1
1,8,0,9,mixedType,1
4,4,0,8,mixedType,1
7,2,0,9,mixedType,1
8,1,0,9,mixedType,1
5,4,0,9,mixedType,1
5,3,0,8,mixedType,1
5,2,0,7,mixedType,0
4,2,0,6,mixedType,0
8,2,0,10,mixedType,1
15,1,0,16,mixedType,2
6,3,0,9,mixedType,1
6,4,0,10,mixedType,1
9,1,0,10,mixedType,1
1,8,0,9,mixedType,1
5,3,0,8,mixedType,1
6,6,0,12,mixedType,1
11,3,1,15,mixedType,2
4,0,0,4,sameType,0
8,2,0,10,mixedType,1
6,4,0,10,mixedType,1
13,3,0,16,mixedType,2
10,1,0,11,mixedType,1
2,10,0,12,mixedType,1
5,3,0,8,mixedType,1
7,3,0,10,mixedType,1
6,3,0,9,mixedType,1
1,8,0,9,mixedType,1
6,3,0,9,mixedType,1
11,3,0,14,mixedType,2
9,3,0,12,mixedType,1
6,2,0,8,mixedType,1
8,1,0,9,mixedType,1
6,3,0,9,mixedType,1
5,1,0,6,mixedType,0
6,3,0,9,mixedType,1
7,1,0,8,mixedType,1
8,3,0,11,mixedType,1
12,4,0,16,mixedType,2
3,6,0,9,mixedType,1
7,2,0,9,mixedType,1
14,2,0,16,mixedType,2
11,5,0,16,mixedType,2
2,6,0,8,mixedType,1
5,4,0,9,mixedType,1
6,1,0,7,mixedType,0
8,2,0,10,mixedType,1
6,2,0,8,mixedType,1
6,3,0,9,mixedType,1
8,2,0,10,mixedType,1
8,4,0,12,mixedType,1
5,3,0,8,mixedType,1
8,4,0,12,mixedType,1
7,2,0,9,mixedType,1
3,6,0,9,mixedType,1
3,5,0,8,mixedType,1
6,4,0,10,mixedType,1
3,9,0,12,mixedType,1
14,2,0,16,mixedType,2
7,4,0,11,mixedType,1
4,2,0,6,mixedType,0
6,1,0,7,mixedType,0
5,2,0,7,mixedType,0
9,2,0,11,mixedType,1
2,6,0,8,mixedType,1
5,2,0,7,mixedType,0
2,6,0,8,mixedType,1
3,8,0,11,mixedType,1
7,3,0,10,mixedType,1
6,1,0,7,mixedType,0
6,3,0,9,mixedType,1
9,3,0,12,mixedType,1
2,4,0,6,mixedType,0
7,2,0,9,mixedType,1
4,6,0,10,mixedType,1
9,3,0,12,mixedType,1
8,2,0,10,mixedType,1
5,6,0,11,mixedType,1
7,2,0,9,mixedType,1
10,2,0,12,mixedType,1
15,1,0,16,mixedType,2
4,2,0,6,mixedType,0
3,3,0,6,mixedType,0
4,4,0,8,mixedType,1
5,1,0,6,mixedType,0
2,7,0,9,mixedType,1
4,4,0,8,mixedType,1
4,5,0,9,mixedType,1
13,3,0,16,mixedType,2
7,3,0,10,mixedType,1
6,3,0,9,mixedType,1
5,1,0,6,mixedType,0
10,2,0,12,mixedType,1
5,2,0,7,mixedType,0
9,2,0,11,mixedType,1
9,3,0,12,mixedType,1
2,6,0,8,mixedType,1
15,1,0,16,mixedType,2
7,3,0,10,mixedType,1
6,4,0,10,mixedType,1
9,3,0,12,mixedType,1
6,3,0,9,mixedType,1
3,6,0,9,mixedType,1
8,1,0,9,mixedType,1
9,1,0,10,mixedType,1
8,2,0,10,mixedType,1
10,2,0,12,mixedType,1
1,7,0,8,mixedType,1
5,3,0,8,mixedType,1
4,4,0,8,mixedType,1
14,2,0,16,mixedType,2
6,1,0,7,mixedType,0
5,7,0,12,mixedType,1
5,1,0,6,mixedType,0
4,2,0,6,mixedType,0
6,3,0,9,mixedType,1
12,4,0,16,mixedType,2
6,3,0,9,mixedType,1
7,3,0,10,mixedType,1
9,2,0,11,mixedType,1
5,4,0,9,mixedType,1
8,1,0,9,mixedType,1
12,2,1,15,mixedType,2
13,3,0,16,mixedType,2
4,5,0,9,mixedType,1
9,2,0,11,mixedType,1
8,1,0,9,mixedType,1
9,3,0,12,mixedType,1
6,4,0,10,mixedType,1
4,5,0,9,mixedType,1
7,2,0,9,mixedType,1
5,4,0,9,mixedType,1
3,5,0,8,mixedType,1
5,3,0,8,mixedType,1
9,3,0,12,mixedType,1
6,4,0,10,mixedType,1
6,3,0,9,mixedType,1
1,7,0,8,mixedType,1
11,4,0,15,mixedType,2
3,6,0,9,mixedType,1
8,3,0,11,mixedType,1
15,1,0,16,mixedType,2
6,1,0,7,mixedType,0
6,6,0,12,mixedType,1
3,8,0,11,mixedType,1
6,3,0,9,mixedType,1
7,3,0,10,mixedType,1
2,6,0,8,mixedType,1
6,2,0,8,mixedType,1
6,3,0,9,mixedType,1
5,3,0,8,mixedType,1
8,4,0,12,mixedType,1
5,3,0,8,mixedType,1
5,3,0,8,mixedType,1
7,6,0,13,mixedType,1
15,1,0,16,mixedType,2
4,4,0,8,mixedType,1
7,3,0,10,mixedType,1
14,2,0,16,mixedType,2
6,1,0,7,mixedType,0
4,5,0,9,mixedType,1
7,2,0,9,mixedType,1
7,1,0,8,mixedType,1
6,3,0,9,mixedType,1
6,4,0,10,mixedType,1
16,4,0,20,mixedType,2
2,8,0,10,mixedType,1
9,1,0,10,mixedType,1
9,1,0,10,mixedType,1
5,5,0,10,mixedType,1
7,1,0,8,mixedType,1
0,6,2,8,mixedType,1
10,2,0,12,mixedType,1
4,4,0,8,mixedType,1
11,5,0,16,mixedType,2
10,3,0,13,mixedType,1
1,9,0,10,mixedType,1
5,4,0,9,mixedType,1
7,3,0,10,mixedType,1
8,1,0,9,mixedType,1
4,5,0,9,mixedType,1
14,2,0,16,mixedType,2
3,6,0,9,mixedType,1
13,3,0,16,mixedType,2
8,1,0,9,mixedType,1
1,9,0,10,mixedType,1
13,3,0,16,mixedType,2
6,3,0,9,mixedType,1
11,3,0,14,mixedType,2
2,6,0,8,mixedType,1
6,3,0,9,mixedType,1
7,3,0,10,mixedType,1
8,4,0,12,mixedType,1
6,4,0,10,mixedType,1
6,2,0,8,mixedType,1
6,1,0,7,mixedType,0
8,4,0,12,mixedType,1
5,0,1,6,mixedType,0
3,6,0,9,mixedType,1
4,4,0,8,mixedType,1
8,2,0,10,mixedType,1
7,2,0,9,mixedType,1
13,3,0,16,mixedType,2
4,2,0,6,mixedType,0
4,2,0,6,mixedType,0
6,4,0,10,mixedType,1
1,8,0,9,mixedType,1
12,4,0,16,mixedType,2
8,4,0,12,mixedType,1
6,3,0,9,mixedType,1
11,3,0,14,mixedType,2
4,2,0,6,mixedType,0
4,4,0,8,mixedType,1
7,4,0,11,mixedType,1
4,2,0,6,mixedType,0
4,6,0,10,mixedType,1
6,3,0,9,mixedType,1
14,2,0,16,mixedType,2
4,2,0,6,mixedType,0
5,3,0,8,mixedType,1
8,2,0,10,mixedType,1
5,3,0,8,mixedType,1
4,4,0,8,mixedType,1
6,3,0,9,mixedType,1
5,1,0,6,mixedType,0
12,4,0,16,mixedType,2
5,3,0,8,mixedType,1
8,2,0,10,mixedType,1
7,1,0,8,mixedType,1
14,4,0,18,mixedType,2
9,1,0,10,mixedType,1
8,1,0,9,mixedType,1
8,1,0,9,mixedType,1
7,4,0,11,mixedType,1
15,1,0,16,mixedType,2
10,1,0,11,mixedType,1
5,4,0,9,mixedType,1
6,4,0,10,mixedType,1
6,3,0,9,mixedType,1
10,3,0,13,mixedType,1
4,4,0,8,mixedType,1
2,6,0,8,mixedType,1
5,5,0,10,mixedType,1
2,6,0,8,mixedType,1
11,5,0,16,mixedType,2
10,6,0,16,mixedType,2
15,1,0,16,mixedType,2
6,3,0,9,mixedType,1
4,4,0,8,mixedType,1
5,4,0,9,mixedType,1
7,3,0,10,mixedType,1
5,3,0,8,mixedType,1
8,2,0,10,mixedType,1
1,7,0,8,mixedType,1
6,2,2,10,mixedType,1
10,3,0,13,mixedType,1
6,1,0,7,mixedType,0
7,4,0,11,mixedType,1
7,2,0,9,mixedType,1
8,2,0,10,mixedType,1
4,2,0,6,mixedType,0
7,3,0,10,mixedType,1
12,3,0,15,mixedType,2
5,2,0,7,mixedType,0
6,2,0,8,mixedType,1
2,8,0,10,mixedType,1
7,1,0,8,mixedType,1
5,8,1,14,mixedType,2
4,8,0,12,mixedType,1
5,1,0,6,mixedType,0
4,2,0,6,mixedType,0
12,4,0,16,mixedType,2
14,2,0,16,mixedType,2
7,3,0,10,mixedType,1
6,3,0,9,mixedType,1
11,2,0,13,mixedType,1
5,4,0,9,mixedType,1
10,3,0,13,mixedType,1
1,0,0,1,sameType,0
4,5,0,9,mixedType,1
8,2,0,10,mixedType,1
4,4,0,8,mixedType,1
6,3,0,9,mixedType,1
0,7,1,8,mixedType,1
7,3,0,10,mixedType,1
10,2,0,12,mixedType,1
6,3,0,9,mixedType,1
3,6,0,9,mixedType,1
4,2,0,6,mixedType,0
7,4,0,11,mixedType,1
9,3,0,12,mixedType,1
1,8,0,9,mixedType,1
5,2,0,7,mixedType,0
5,1,0,6,mixedType,0
14,2,0,16,mixedType,2
8,4,0,12,mixedType,1
7,2,0,9,mixedType,1
6,3,0,9,mixedType,1
6,3,0,9,mixedType,1
8,2,0,10,mixedType,1
13,3,0,16,mixedType,2
5,2,0,7,mixedType,0
6,4,0,10,mixedType,1
6,1,0,7,mixedType,0
4,6,0,10,mixedType,1
7,2,0,9,mixedType,1
8,1,0,9,mixedType,1
3,7,0,10,mixedType,1
8,2,0,10,mixedType,1
10,1,0,11,mixedType,1
7,3,0,10,mixedType,1
4,6,0,10,mixedType,1
6,3,0,9,mixedType,1
5,3,0,8,mixedType,1
7,2,0,9,mixedType,1
3,7,0,10,mixedType,1
14,2,0,16,mixedType,2
6,2,0,8,mixedType,1
5,3,0,8,mixedType,1
3,10,0,13,mixedType,1
6,5,0,11,mixedType,1
7,3,0,10,mixedType,1
14,2,0,16,mixedType,2
6,3,0,9,mixedType,1
6,4,0,10,mixedType,1
6,6,0,12,mixedType,1
7,1,0,8,mixedType,1
6,3,0,9,mixedType,1
3,6,0,9,mixedType,1
6,1,0,7,mixedType,0
14,2,0,16,mixedType,2
13,3,0,16,mixedType,2
6,3,0,9,mixedType,1
8,1,0,9,mixedType,1
9,1,0,10,mixedType,1
14,2,0,16,mixedType,2
5,3,0,8,mixedType,1
7,3,0,10,mixedType,1
5,1,0,6,mixedType,0
6,1,0,7,mixedType,0
8,2,0,10,mixedType,1
8,2,0,10,mixedType,1
3,5,0,8,mixedType,1
4,4,0,8,mixedType,1
6,3,0,9,mixedType,1
8,2,0,10,mixedType,1
12,3,0,15,mixedType,2
1,12,0,13,mixedType,1
13,3,0,16,mixedType,2
6,1,0,7,mixedType,0
6,3,0,9,mixedType,1
7,3,0,10,mixedType,1
6,7,0,13,mixedType,1
6,3,0,9,mixedType,1
7,2,0,9,mixedType,1
8,2,0,10,mixedType,1
5,2,0,7,mixedType,0
5,2,0,7,mixedType,0
7,1,0,8,mixedType,1
6,4,0,10,mixedType,1
5,2,0,7,mixedType,0
8,1,0,9,mixedType,1
7,5,0,12,mixedType,1
8,1,0,9,mixedType,1
8,4,0,12,mixedType,1
9,3,0,12,mixedType,1
5,1,0,6,mixedType,0
6,3,0,9,mixedType,1
13,3,0,16,mixedType,2
3,6,0,9,mixedType,1
8,3,0,11,mixedType,1
8,4,0,12,mixedType,1
4,4,0,8,mixedType,1
4,4,0,8,mixedType,1
9,1,0,10,mixedType,1
6,3,0,9,mixedType,1
11,1,0,12,mixedType,1
7,3,0,10,mixedType,1
13,3,0,16,mixedType,2
10,6,0,16,mixedType,2
4,4,0,8,mixedType,1
7,1,0,8,mixedType,1
6,3,0,9,mixedType,1
6,4,0,10,mixedType,1
28,6,0,34,mixedType,2
7,2,0,9,mixedType,1
7,3,0,10,mixedType,1
3,7,0,10,mixedType,1
9,4,0,13,mixedType,1
3,6,0,9,mixedType,1
7,1,0,8,mixedType,1
15,1,0,16,mixedType,2
7,2,0,9,mixedType,1
13,3,0,16,mixedType,2
5,2,0,7,mixedType,0
7,3,0,10,mixedType,1
6,2,0,8,mixedType,1
6,2,0,8,mixedType,1
2,8,0,10,mixedType,1
5,2,0,7,mixedType,0
8,4,0,12,mixedType,1
1,7,0,8,mixedType,1
7,1,0,8,mixedType,1
6,1,0,7,mixedType,0
6,4,0,10,mixedType,1
13,3,0,16,mixedType,2
4,4,0,8,mixedType,1
8,3,0,11,mixedType,1
7,3,0,10,mixedType,1
5,4,0,9,mixedType,1
5,4,0,9,mixedType,1
7,4,0,11,mixedType,1
6,1,0,7,mixedType,0
4,6,0,10,mixedType,1
6,4,0,10,mixedType,1
4,2,0,6,mixedType,0
6,3,0,9,mixedType,1
6,4,0,10,mixedType,1
3,7,0,10,mixedType,1
12,4,0,16,mixedType,2
3,7,0,10,mixedType,1
3,6,0,9,mixedType,1
5,4,0,9,mixedType,1
3,6,0,9,mixedType,1
7,3,0,10,mixedType,1
6,3,0,9,mixedType,1
8,2,0,10,mixedType,1
7,2,0,9,mixedType,1
11,5,0,16,mixedType,2
6,2,0,8,mixedType,1
2,6,0,8,mixedType,1
1,7,0,8,mixedType,1
2,8,0,10,mixedType,1
5,4,0,9,mixedType,1
7,3,0,10,mixedType,1
9,6,0,15,mixedType,2
4,4,0,8,mixedType,1
14,2,0,16,mixedType,2
5,2,0,7,mixedType,0
5,2,0,7,mixedType,0
3,6,0,9,mixedType,1
11,3,0,14,mixedType,2
5,3,0,8,mixedType,1
9,2,0,11,mixedType,1
6,4,0,10,mixedType,1
8,4,0,12,mixedType,1
17,2,0,19,mixedType,2
11,5,0,16,mixedType,2
6,5,0,11,mixedType,1
1,9,0,10,mixedType,1
5,5,0,10,mixedType,1
6,4,0,10,mixedType,1
8,1,0,9,mixedType,1
13,3,0,16,mixedType,2
14,2,0,16,mixedType,2
3,3,0,6,mixedType,0
8,1,0,9,mixedType,1
7,2,0,9,mixedType,1
8,3,0,11,mixedType,1
8,2,0,10,mixedType,1
8,1,0,9,mixedType,1
13,3,0,16,mixedType,2
9,1,0,10,mixedType,1
7,4,0,11,mixedType,1
5,1,0,6,mixedType,0
5,4,0,9,mixedType,1
7,1,0,8,mixedType,1
6,3,0,9,mixedType,1
7,1,0,8,mixedType,1
9,2,0,11,mixedType,1
12,4,0,16,mixedType,2
4,4,0,8,mixedType,1
4,6,0,10,mixedType,1
6,3,0,9,mixedType,1
6,3,0,9,mixedType,1
7,4,0,11,mixedType,1
7,2,0,9,mixedType,1
7,3,0,10,mixedType,1
6,3,0,9,mixedType,1
7,4,0,11,mixedType,1
10,1,0,11,mixedType,1
12,4,0,16,mixedType,2
7,1,0,8,mixedType,1
11,2,0,13,mixedType,1
6,2,0,8,mixedType,1
5,2,0,7,mixedType,0
3,8,0,11,mixedType,1
6,3,0,9,mixedType,1
6,3,0,9,mixedType,1
8,2,0,10,mixedType,1
5,2,0,7,mixedType,0
5,3,0,8,mixedType,1
6,4,0,10,mixedType,1
3,5,0,8,mixedType,1
6,2,0,8,mixedType,1
7,3,0,10,mixedType,1
4,4,0,8,mixedType,1
7,1,0,8,mixedType,1
3,6,0,9,mixedType,1
4,7,0,11,mixedType,1
1,8,0,9,mixedType,1
7,3,0,10,mixedType,1
11,3,0,14,mixedType,2
7,1,0,8,mixedType,1
14,2,0,16,mixedType,2
15,1,0,16,mixedType,2
9,2,0,11,mixedType,1
6,3,0,9,mixedType,1
5,4,0,9,mixedType,1
8,1,0,9,mixedType,1
8,0,1,9,mixedType,1
6,4,0,10,mixedType,1
5,2,0,7,mixedType,0
5,1,0,6,mixedType,0
9,1,0,10,mixedType,1
6,1,0,7,mixedType,0
8,4,0,12,mixedType,1
6,3,0,9,mixedType,1
7,5,0,12,mixedType,1
2,4,0,6,mixedType,0
8,3,0,11,mixedType,1
7,3,0,10,mixedType,1
7,1,0,8,mixedType,1
4,6,0,10,mixedType,1
6,3,0,9,mixedType,1
15,1,0,16,mixedType,2
5,8,0,13,mixedType,1
2,4,0,6,mixedType,0
13,3,0,16,mixedType,2
6,2,0,8,mixedType,1
8,1,0,9,mixedType,1
4,2,0,6,mixedType,0
7,3,0,10,mixedType,1
4,4,0,8,mixedType,1
4,4,0,8,mixedType,1
6,1,0,7,mixedType,0
5,1,0,6,mixedType,0
5,2,0,7,mixedType,0
5,3,0,8,mixedType,1
8,1,0,9,mixedType,1
8,1,0,9,mixedType,1
10,3,0,13,mixedType,1
6,3,0,9,mixedType,1
4,2,0,6,mixedType,0
8,3,0,11,mixedType,1
9,2,0,11,mixedType,1
6,2,0,8,mixedType,1
7,3,0,10,mixedType,1
15,1,0,16,mixedType,2
7,2,0,9,mixedType,1
3,6,0,9,mixedType,1
6,4,0,10,mixedType,1
8,2,0,10,mixedType,1
8,1,0,9,mixedType,1
8,4,0,12,mixedType,1
7,3,0,10,mixedType,1
2,6,0,8,mixedType,1
7,2,0,9,mixedType,1
5,3,0,8,mixedType,1
12,2,2,16,mixedType,2
13,3,0,16,mixedType,2
14,2,0,16,mixedType,2
8,2,0,10,mixedType,1
6,4,0,10,mixedType,1
6,1,0,7,mixedType,0
6,4,0,10,mixedType,1
7,3,0,10,mixedType,1
7,3,0,10,mixedType,1
12,1,0,13,mixedType,1
7,3,0,10,mixedType,1
7,3,0,10,mixedType,1
2,8,0,10,mixedType,1
7,3,0,10,mixedType,1
5,3,0,8,mixedType,1
7,2,0,9,mixedType,1
8,3,0,11,mixedType,1
15,1,0,16,mixedType,2
6,4,0,10,mixedType,1
7,3,0,10,mixedType,1
5,6,0,11,mixedType,1
4,2,0,6,mixedType,0
5,1,0,6,mixedType,0
5,4,0,9,mixedType,1
7,1,0,8,mixedType,1
6,1,0,7,mixedType,0
6,3,0,9,mixedType,1
2,9,0,11,mixedType,1
2,10,0,12,mixedType,1
6,2,0,8,mixedType,1
6,1,0,7,mixedType,0
6,3,0,9,mixedType,1
14,2,0,16,mixedType,2
8,1,0,9,mixedType,1
9,2,0,11,mixedType,1
5,3,0,8,mixedType,1
6,3,0,9,mixedType,1
12,4,0,16,mixedType,2
6,4,0,10,mixedType,1
4,7,0,11,mixedType,1
6,2,0,8,mixedType,1
1,8,0,9,mixedType,1
14,2,0,16,mixedType,2
6,7,0,13,mixedType,1
2,8,0,10,mixedType,1
8,1,0,9,mixedType,1
6,3,0,9,mixedType,1
4,2,0,6,mixedType,0
6,2,0,8,mixedType,1
7,3,0,10,mixedType,1
6,1,0,7,mixedType,0
5,2,0,7,mixedType,0
5,6,0,11,mixedType,1
14,2,0,16,mixedType,2
7,3,0,10,mixedType,1
6,3,0,9,mixedType,1
15,1,0,16,mixedType,2
4,4,0,8,mixedType,1
5,5,0,10,mixedType,1
8,2,0,10,mixedType,1
8,1,0,9,mixedType,1
6,5,0,11,mixedType,1
7,2,0,9,mixedType,1
6,1,0,7,mixedType,0
9,2,0,11,mixedType,1
2,8,0,10,mixedType,1
5,3,0,8,mixedType,1
13,3,0,16,mixedType,2
8,3,0,11,mixedType,1
6,1,0,7,mixedType,0
7,3,0,10,mixedType,1
7,1,0,8,mixedType,1
6,3,0,9,mixedType,1
5,1,0,6,mixedType,0
6,3,0,9,mixedType,1
6,3,0,9,mixedType,1
6,2,0,8,mixedType,1
8,4,0,12,mixedType,1
5,3,0,8,mixedType,1
8,1,0,9,mixedType,1
3,5,0,8,mixedType,1
6,6,0,12,mixedType,1
3,3,0,6,mixedType,0
5,3,0,8,mixedType,1
7,2,0,9,mixedType,1
5,2,0,7,mixedType,0
13,3,0,16,mixedType,2
6,2,0,8,mixedType,1
7,2,0,9,mixedType,1
13,3,0,16,mixedType,2
6,2,0,8,mixedType,1
5,1,0,6,mixedType,0
7,3,0,10,mixedType,1
8,3,0,11,mixedType,1
3,6,0,9,mixedType,1
4,2,0,6,mixedType,0
9,2,0,11,mixedType,1
5,5,0,10,mixedType,1
5,2,0,7,mixedType,0
7,3,0,10,mixedType,1
15,1,0,16,mixedType,2
7,2,0,9,mixedType,1
6,3,0,9,mixedType,1
3,6,0,9,mixedType,1
15,1,0,16,mixedType,2
5,5,0,10,mixedType,1
5,4,0,9,mixedType,1
3,3,0,6,mixedType,0
7,3,0,10,mixedType,1
3,8,0,11,mixedType,1
5,4,0,9,mixedType,1
7,3,0,10,mixedType,1
8,2,0,10,mixedType,1
5,5,0,10,mixedType,1
5,1,0,6,mixedType,0
11,3,0,14,mixedType,2
4,6,0,10,mixedType,1
7,4,0,11,mixedType,1
8,2,0,10,mixedType,1
11,2,0,13,mixedType,1
9,1,0,10,mixedType,1
6,3,0,9,mixedType,1
6,6,0,12,mixedType,1
14,2,0,16,mixedType,2
5,2,0,7,mixedType,0
5,4,0,9,mixedType,1
4,2,0,6,mixedType,0
8,1,0,9,mixedType,1
7,2,0,9,mixedType,1
8,2,0,10,mixedType,1
6,3,0,9,mixedType,1
15,1,0,16,mixedType,2
1,8,0,9,mixedType,1
15,1,0,16,mixedType,2
8,1,0,9,mixedType,1
4,8,0,12,mixedType,1
3,7,0,10,mixedType,1
8,2,0,10,mixedType,1
7,2,0,9,mixedType,1
4,5,0,9,mixedType,1
4,4,0,8,mixedType,1
2,8,0,10,mixedType,1
13,3,0,16,mixedType,2
5,3,0,8,mixedType,1
1,9,0,10,mixedType,1
1,7,0,8,mixedType,1
13,3,0,16,mixedType,2
6,6,0,12,mixedType,1
7,2,0,9,mixedType,1
8,2,0,10,mixedType,1
5,4,0,9,mixedType,1
9,3,0,12,mixedType,1
5,3,0,8,mixedType,1
9,2,0,11,mixedType,1
9,1,0,10,mixedType,1
6,3,0,9,mixedType,1
6,3,0,9,mixedType,1
6,2,0,8,mixedType,1
6,6,0,12,mixedType,1
11,3,0,14,mixedType,2
6,3,0,9,mixedType,1
3,6,0,9,mixedType,1
9,3,0,12,mixedType,1
6,3,0,9,mixedType,1
7,5,0,12,mixedType,1
7,3,0,10,mixedType,1
3,5,0,8,mixedType,1
2,7,0,9,mixedType,1
7,5,0,12,mixedType,1
6,2,0,8,mixedType,1
6,4,0,10,mixedType,1
8,1,0,9,mixedType,1
4,2,0,6,mixedType,0
1,7,0,8,mixedType,1
10,1,0,11,mixedType,1
7,2,0,9,mixedType,1
6,1,0,7,mixedType,0
7,2,0,9,mixedType,1
6,3,0,9,mixedType,1
4,6,0,10,mixedType,1
2,8,0,10,mixedType,1
7,3,0,10,mixedType,1
14,2,0,16,mixedType,2
7,2,0,9,mixedType,1
9,4,0,13,mixedType,1
9,3,0,12,mixedType,1
6,2,0,8,mixedType,1
14,2,0,16,mixedType,2
7,2,0,9,mixedType,1
7,2,0,9,mixedType,1
2,4,0,6,mixedType,0
8,1,0,9,mixedType,1
8,2,0,10,mixedType,1
3,7,0,10,mixedType,1
5,3,0,8,mixedType,1
11,4,0,15,mixedType,2
5,4,0,9,mixedType,1
5,3,0,8,mixedType,1
5,4,0,9,mixedType,1
7,4,0,11,mixedType,1
6,3,0,9,mixedType,1
8,3,0,11,mixedType,1
5,4,0,9,mixedType,1
14,2,0,16,mixedType,2
6,3,0,9,mixedType,1
6,3,0,9,mixedType,1
8,2,0,10,mixedType,1
8,4,0,12,mixedType,1
2,6,0,8,mixedType,1
7,4,0,11,mixedType,1
6,3,0,9,mixedType,1
13,3,0,16,mixedType,2
5,4,0,9,mixedType,1
3,8,0,11,mixedType,1
5,3,0,8,mixedType,1
6,4,0,10,mixedType,1
7,4,0,11,mixedType,1
7,3,0,10,mixedType,1
9,1,0,10,mixedType,1
6,2,0,8,mixedType,1
7,2,0,9,mixedType,1
6,4,0,10,mixedType,1
3,7,0,10,mixedType,1
13,3,0,16,mixedType,2
3,5,0,8,mixedType,1
1,7,0,8,mixedType,1
6,4,0,10,mixedType,1
7,1,0,8,mixedType,1
7,3,0,10,mixedType,1
6,3,0,9,mixedType,1
11,3,0,14,mixedType,2
6,5,0,11,mixedType,1
6,2,0,8,mixedType,1
5,2,0,7,mixedType,0
15,1,0,16,mixedType,2
5,4,0,9,mixedType,1
8,4,0,12,mixedType,1
12,3,0,15,mixedType,2
8,1,0,9,mixedType,1
3,3,0,6,mixedType,0
8,3,0,11,mixedType,1
7,1,0,8,mixedType,1
5,4,0,9,mixedType,1
3,6,0,9,mixedType,1
4,5,0,9,mixedType,1
5,4,0,9,mixedType,1
5,2,0,7,mixedType,0
1,12,0,13,mixedType,1
8,2,0,10,mixedType,1
5,1,0,6,mixedType,0
11,4,0,15,mixedType,2
1,11,0,12,mixedType,1
6,7,0,13,mixedType,1
5,4,0,9,mixedType,1
8,1,0,9,mixedType,1
6,4,0,10,mixedType,1
7,3,0,10,mixedType,1
12,4,0,16,mixedType,2
13,3,0,16,mixedType,2
11,4,0,15,mixedType,2
3,3,0,6,mixedType,0
13,3,0,16,mixedType,2
14,2,0,16,mixedType,2
4,2,0,6,mixedType,0
14,2,0,16,mixedType,2
7,2,0,9,mixedType,1
9,4,0,13,mixedType,1
5,2,0,7,mixedType,0
8,5,0,13,mixedType,1
5,3,0,8,mixedType,1
7,3,0,10,mixedType,1
14,2,0,16,mixedType,2
14,2,0,16,mixedType,2
12,4,0,16,mixedType,2
6,4,0,10,mixedType,1
13,3,0,16,mixedType,2
5,5,0,10,mixedType,1
6,3,0,9,mixedType,1
7,4,0,11,mixedType,1
6,1,0,7,mixedType,0
6,4,0,10,mixedType,1
8,2,0,10,mixedType,1
8,2,0,10,mixedType,1
7,2,0,9,mixedType,1
7,6,0,13,mixedType,1
8,5,1,14,mixedType,2
11,1,0,12,mixedType,1
6,3,0,9,mixedType,1
8,2,0,10,mixedType,1
14,2,0,16,mixedType,2
6,3,0,9,mixedType,1
7,3,0,10,mixedType,1
7,2,0,9,mixedType,1
9,1,0,10,mixedType,1
2,7,0,9,mixedType,1
6,4,0,10,mixedType,1
6,3,0,9,mixedType,1
7,1,0,8,mixedType,1
11,0,1,12,mixedType,1
7,3,0,10,mixedType,1
10,1,0,11,mixedType,1
15,1,0,16,mixedType,2
6,2,0,8,mixedType,1
7,6,0,13,mixedType,1
9,1,0,10,mixedType,1
5,0,2,7,mixedType,0
12,4,0,16,mixedType,2
8,3,0,11,mixedType,1
11,5,0,16,mixedType,2
7,3,0,10,mixedType,1
8,3,0,11,mixedType,1
4,4,0,8,mixedType,1
1,5,0,6,mixedType,0
11,1,0,12,mixedType,1
8,4,0,12,mixedType,1
6,3,0,9,mixedType,1
6,3,0,9,mixedType,1
6,3,0,9,mixedType,1
6,3,0,9,mixedType,1
12,4,0,16,mixedType,2
1,8,0,9,mixedType,1
5,4,0,9,mixedType,1
7,2,0,9,mixedType,1
9,2,0,11,mixedType,1
12,3,0,15,mixedType,2
6,1,0,7,mixedType,0
2,8,0,10,mixedType,1
6,1,0,7,mixedType,0
5,2,0,7,mixedType,0
6,3,0,9,mixedType,1
11,1,0,12,mixedType,1
4,4,0,8,mixedType,1
5,4,0,9,mixedType,1
8,1,0,9,mixedType,1
7,4,0,11,mixedType,1
4,4,0,8,mixedType,1
6,1,0,7,mixedType,0
5,4,0,9,mixedType,1
6,4,0,10,mixedType,1
14,2,0,16,mixedType,2
11,1,0,12,mixedType,1
5,3,0,8,mixedType,1
5,2,0,7,mixedType,0
6,1,0,7,mixedType,0
8,4,0,12,mixedType,1
13,3,0,16,mixedType,2
8,2,0,10,mixedType,1
13,3,0,16,mixedType,2
7,1,0,8,mixedType,1
8,2,0,10,mixedType,1
9,2,0,11,mixedType,1
18,1,1,20,mixedType,2
9,1,0,10,mixedType,1
8,2,0,10,mixedType,1
9,1,0,10,mixedType,1
7,3,0,10,mixedType,1
13,3,0,16,mixedType,2
6,1,0,7,mixedType,0
4,6,0,10,mixedType,1
1,9,0,10,mixedType,1
5,4,0,9,mixedType,1
14,2,0,16,mixedType,2
10,6,0,16,mixedType,2
9,1,0,10,mixedType,1
4,6,0,10,mixedType,1
8,3,0,11,mixedType,1
8,2,0,10,mixedType,1
7,1,0,8,mixedType,1
8,0,1,9,mixedType,1
7,3,0,10,mixedType,1
11,6,0,17,mixedType,2
14,2,0,16,mixedType,2
5,1,0,6,mixedType,0
6,5,0,11,mixedType,1
7,1,0,8,mixedType,1
6,2,0,8,mixedType,1
1,8,0,9,mixedType,1
4,8,0,12,mixedType,1
1,9,0,10,mixedType,1
4,4,0,8,mixedType,1
4,9,0,13,mixedType,1
5,9,1,15,mixedType,2
3,6,0,9,mixedType,1
6,2,0,8,mixedType,1
3,9,0,12,mixedType,1
9,3,0,12,mixedType,1
8,1,0,9,mixedType,1
1,11,0,12,mixedType,1
9,5,0,14,mixedType,2
8,2,0,10,mixedType,1
6,4,0,10,mixedType,1
15,1,0,16,mixedType,2
4,2,0,6,mixedType,0
5,4,0,9,mixedType,1
14,2,0,16,mixedType,2
14,2,0,16,mixedType,2
7,3,0,10,mixedType,1
2,4,0,6,mixedType,0
9,1,0,10,mixedType,1
13,3,0,16,mixedType,2
4,4,0,8,mixedType,1
14,2,0,16,mixedType,2
5,3,0,8,mixedType,1
12,4,0,16,mixedType,2
3,3,0,6,mixedType,0
7,3,0,10,mixedType,1
8,1,0,9,mixedType,1
9,4,0,13,mixedType,1
4,2,0,6,mixedType,0
7,2,0,9,mixedType,1
4,2,0,6,mixedType,0
7,5,0,12,mixedType,1
5,7,0,12,mixedType,1
8,2,0,10,mixedType,1
9,2,0,11,mixedType,1
7,3,0,10,mixedType,1
4,5,0,9,mixedType,1
7,3,0,10,mixedType,1
10,4,0,14,mixedType,2
5,3,0,8,mixedType,1
5,2,0,7,mixedType,0
13,3,0,16,mixedType,2
10,1,0,11,mixedType,1
7,3,0,10,mixedType,1
6,4,0,10,mixedType,1
8,1,0,9,mixedType,1
7,2,0,9,mixedType,1
8,2,0,10,mixedType,1
4,4,0,8,mixedType,1
10,1,0,11,mixedType,1
1,8,0,9,mixedType,1
8,2,0,10,mixedType,1
5,3,0,8,mixedType,1
7,4,0,11,mixedType,1
4,2,0,6,mixedType,0
4,4,0,8,mixedType,1
3,6,0,9,mixedType,1
6,1,0,7,mixedType,0
4,5,0,9,mixedType,1
14,2,0,16,mixedType,2
9,3,0,12,mixedType,1
4,2,0,6,mixedType,0
11,1,0,12,mixedType,1
8,1,0,9,mixedType,1
14,2,0,16,mixedType,2
7,3,0,10,mixedType,1
8,2,0,10,mixedType,1
10,2,0,12,mixedType,1
9,1,0,10,mixedType,1
6,3,0,9,mixedType,1
12,1,1,14,mixedType,2
7,3,0,10,mixedType,1
10,1,0,11,mixedType,1
7,2,0,9,mixedType,1
11,3,0,14,mixedType,2
6,2,0,8,mixedType,1
8,5,0,13,mixedType,1
8,1,0,9,mixedType,1
6,1,0,7,mixedType,0
7,2,0,9,mixedType,1
9,4,0,13,mixedType,1
3,8,0,11,mixedType,1
4,5,0,9,mixedType,1
8,2,0,10,mixedType,1
9,1,0,10,mixedType,1
6,6,0,12,mixedType,1
6,3,0,9,mixedType,1
11,0,2,13,mixedType,1
2,7,0,9,mixedType,1
6,2,0,8,mixedType,1
7,2,0,9,mixedType,1
7,4,0,11,mixedType,1
6,3,0,9,mixedType,1
3,8,0,11,mixedType,1
5,3,0,8,mixedType,1
10,1,0,11,mixedType,1
11,3,1,15,mixedType,2
5,2,0,7,mixedType,0
14,3,1,18,mixedType,2
6,3,0,9,mixedType,1
6,3,0,9,mixedType,1
15,1,0,16,mixedType,2
8,1,0,9,mixedType,1
5,1,0,6,mixedType,0
6,4,0,10,mixedType,1
10,1,0,11,mixedType,1
5,4,0,9,mixedType,1
4,5,0,9,mixedType,1
7,4,0,11,mixedType,1
11,1,0,12,mixedType,1
7,2,0,9,mixedType,1
6,4,0,10,mixedType,1
7,2,0,9,mixedType,1
8,1,0,9,mixedType,1
5,4,0,9,mixedType,1
1,9,0,10,mixedType,1
5,6,0,11,mixedType,1
6,3,0,9,mixedType,1
4,4,0,8,mixedType,1
6,3,0,9,mixedType,1
7,3,0,10,mixedType,1
5,3,0,8,mixedType,1
13,3,0,16,mixedType,2
8,2,0,10,mixedType,1
5,4,0,9,mixedType,1
1,7,0,8,mixedType,1
1,8,0,9,mixedType,1
7,1,0,8,mixedType,1
1,9,0,10,mixedType,1
6,2,0,8,mixedType,1
5,2,0,7,mixedType,0
10,1,0,11,mixedType,1
7,2,0,9,mixedType,1
5,2,0,7,mixedType,0
7,2,0,9,mixedType,1
6,2,0,8,mixedType,1
4,2,0,6,mixedType,0
6,3,0,9,mixedType,1
5,3,0,8,mixedType,1
8,1,0,9,mixedType,1
5,2,0,7,mixedType,0
9,1,0,10,mixedType,1
7,3,0,10,mixedType,1
8,1,0,9,mixedType,1
5,6,0,11,mixedType,1
1,8,0,9,mixedType,1
4,9,0,13,mixedType,1
15,1,0,16,mixedType,2
8,1,0,9,mixedType,1
14,2,0,16,mixedType,2
9,1,0,10,mixedType,1
14,2,0,16,mixedType,2
4,8,0,12,mixedType,1
7,1,0,8,mixedType,1
7,1,0,8,mixedType,1
4,2,0,6,mixedType,0
13,3,0,16,mixedType,2
9,1,0,10,mixedType,1
7,4,0,11,mixedType,1
6,4,0,10,mixedType,1
4,8,0,12,mixedType,1
7,4,0,11,mixedType,1
11,1,0,12,mixedType,1
4,4,0,8,mixedType,1
9,0,1,10,mixedType,1
8,3,0,11,mixedType,1
5,3,0,8,mixedType,1
5,5,0,10,mixedType,1
14,2,0,16,mixedType,2
7,0,1,8,mixedType,1
4,5,0,9,mixedType,1
10,5,0,15,mixedType,2
6,1,0,7,mixedType,0
2,7,0,9,mixedType,1
5,2,0,7,mixedType,0
6,3,0,9,mixedType,1
6,3,0,9,mixedType,1
6,2,0,8,mixedType,1
6,3,0,9,mixedType,1
1,7,0,8,mixedType,1
3,7,0,10,mixedType,1
8,2,0,10,mixedType,1
12,2,1,15,mixedType,2
9,4,0,13,mixedType,1
6,3,0,9,mixedType,1
4,5,0,9,mixedType,1
3,6,0,9,mixedType,1
15,1,0,16,mixedType,2
8,1,0,9,mixedType,1
5,1,0,6,mixedType,0
1,7,0,8,mixedType,1
9,3,0,12,mixedType,1
7,3,0,10,mixedType,1
8,1,0,9,mixedType,1
4,8,0,12,mixedType,1
6,3,0,9,mixedType,1
9,4,0,13,mixedType,1
7,3,0,10,mixedType,1
14,2,0,16,mixedType,2
15,1,0,16,mixedType,2
1,10,0,11,mixedType,1
4,4,0,8,mixedType,1
4,4,0,8,mixedType,1
7,2,0,9,mixedType,1
3,7,0,10,mixedType,1
2,7,0,9,mixedType,1
9,1,0,10,mixedType,1
7,2,0,9,mixedType,1
3,5,0,8,mixedType,1
7,2,0,9,mixedType,1
7,1,0,8,mixedType,1
3,6,0,9,mixedType,1
4,4,0,8,mixedType,1
3,5,0,8,mixedType,1
5,5,0,10,mixedType,1
8,2,0,10,mixedType,1
7,2,0,9,mixedType,1
11,3,0,14,mixedType,2
6,1,0,7,mixedType,0
6,8,0,14,mixedType,2
8,2,0,10,mixedType,1
10,3,0,13,mixedType,1
5,3,0,8,mixedType,1
6,1,0,7,mixedType,0
7,6,0,13,mixedType,1
15,1,0,16,mixedType,2
6,10,0,16,mixedType,2
6,2,0,8,mixedType,1
9,2,0,11,mixedType,1
4,2,0,6,mixedType,0
6,2,0,8,mixedType,1
6,3,0,9,mixedType,1
7,2,0,9,mixedType,1
4,6,0,10,mixedType,1
6,3,0,9,mixedType,1
5,3,0,8,mixedType,1
5,1,0,6,mixedType,0
4,2,0,6,mixedType,0
4,2,0,6,mixedType,0
2,8,0,10,mixedType,1
8,1,0,9,mixedType,1
15,1,0,16,mixedType,2
5,3,0,8,mixedType,1
4,4,0,8,mixedType,1
6,3,0,9,mixedType,1
7,3,0,10,mixedType,1
11,4,1,16,mixedType,2
6,3,0,9,mixedType,1
3,7,0,10,mixedType,1
13,3,0,16,mixedType,2
5,2,0,7,mixedType,0
15,1,0,16,mixedType,2
7,3,0,10,mixedType,1
2,8,0,10,mixedType,1
6,4,0,10,mixedType,1
6,3,0,9,mixedType,1
10,5,0,15,mixedType,2
8,2,0,10,mixedType,1
6,3,0,9,mixedType,1
8,1,0,9,mixedType,1
5,1,0,6,mixedType,0
6,3,0,9,mixedType,1
7,1,0,8,mixedType,1
7,3,0,10,mixedType,1
6,4,0,10,mixedType,1
7,3,0,10,mixedType,1
9,1,0,10,mixedType,1
13,3,0,16,mixedType,2
14,1,0,15,mixedType,2
12,3,0,15,mixedType,2
7,6,0,13,mixedType,1
6,3,0,9,mixedType,1
5,2,0,7,mixedType,0
5,2,0,7,mixedType,0
13,3,0,16,mixedType,2
4,2,0,6,mixedType,0
9,7,0,16,mixedType,2
7,1,0,8,mixedType,1
6,2,0,8,mixedType,1
7,3,0,10,mixedType,1
3,6,0,9,mixedType,1
7,2,0,9,mixedType,1
12,3,0,15,mixedType,2
7,1,0,8,mixedType,1
6,2,0,8,mixedType,1
5,3,0,8,mixedType,1
3,6,0,9,mixedType,1
6,1,0,7,mixedType,0
3,7,0,10,mixedType,1
4,6,0,10,mixedType,1
5,3,0,8,mixedType,1
4,5,0,9,mixedType,1
8,1,0,9,mixedType,1
9,2,0,11,mixedType,1
14,2,0,16,mixedType,2
13,3,0,16,mixedType,2
7,1,0,8,mixedType,1
4,2,0,6,mixedType,0
6,1,0,7,mixedType,0
8,2,0,10,mixedType,1
4,2,0,6,mixedType,0
9,2,0,11,mixedType,1
7,2,0,9,mixedType,1
7,1,0,8,mixedType,1
4,2,0,6,mixedType,0
6,1,0,7,mixedType,0
7,3,0,10,mixedType,1
5,1,0,6,mixedType,0
13,3,0,16,mixedType,2
8,1,0,9,mixedType,1
4,2,0,6,mixedType,0
7,2,0,9,mixedType,1
1,8,0,9,mixedType,1
12,3,0,15,mixedType,2
4,4,0,8,mixedType,1
13,2,0,15,mixedType,2
5,6,0,11,mixedType,1
7,1,0,8,mixedType,1
8,1,0,9,mixedType,1
7,3,0,10,mixedType,1
8,1,0,9,mixedType,1
4,2,0,6,mixedType,0
8,8,0,16,mixedType,2
5,2,0,7,mixedType,0
4,7,0,11,mixedType,1
5,4,0,9,mixedType,1
6,4,0,10,mixedType,1
12,4,0,16,mixedType,2
15,1,0,16,mixedType,2
8,1,0,9,mixedType,1
1,8,0,9,mixedType,1
6,1,0,7,mixedType,0
14,2,0,16,mixedType,2
15,1,0,16,mixedType,2
7,3,0,10,mixedType,1
7,3,0,10,mixedType,1
9,1,0,10,mixedType,1
5,4,0,9,mixedType,1
7,2,0,9,mixedType,1
9,1,0,10,mixedType,1
8,1,0,9,mixedType,1
8,3,0,11,mixedType,1
5,1,0,6,mixedType,0
1,9,0,10,mixedType,1
7,1,0,8,mixedType,1
5,2,0,7,mixedType,0
6,3,0,9,mixedType,1
7,3,0,10,mixedType,1
6,2,0,8,mixedType,1
7,2,0,9,mixedType,1
8,2,0,10,mixedType,1
4,4,0,8,mixedType,1
15,1,0,16,mixedType,2
7,2,0,9,mixedType,1
15,1,0,16,mixedType,2
6,1,0,7,mixedType,0
6,3,0,9,mixedType,1
7,3,0,10,mixedType,1
9,5,0,14,mixedType,2
7,1,0,8,mixedType,1
4,4,0,8,mixedType,1
5,3,0,8,mixedType,1
9,2,0,11,mixedType,1
10,1,0,11,mixedType,1
8,3,0,11,mixedType,1
6,3,0,9,mixedType,1
8,1,0,9,mixedType,1
3,5,0,8,mixedType,1
4,2,0,6,mixedType,0
7,2,0,9,mixedType,1
13,3,0,16,mixedType,2
9,1,0,10,mixedType,1
5,3,0,8,mixedType,1
6,2,0,8,mixedType,1
8,2,0,10,mixedType,1
3,6,0,9,mixedType,1
7,2,0,9,mixedType,1
5,5,0,10,mixedType,1
12,3,0,15,mixedType,2
8,2,0,10,mixedType,1
5,4,0,9,mixedType,1
9,1,0,10,mixedType,1
7,3,0,10,mixedType,1
5,1,0,6,mixedType,0
6,3,0,9,mixedType,1
2,8,0,10,mixedType,1
7,3,0,10,mixedType,1
6,2,0,8,mixedType,1
8,1,0,9,mixedType,1
6,3,0,9,mixedType,1
5,2,0,7,mixedType,0
5,2,0,7,mixedType,0
4,6,0,10,mixedType,1
7,3,0,10,mixedType,1
14,2,0,16,mixedType,2
11,3,0,14,mixedType,2
5,2,0,7,mixedType,0
4,2,0,6,mixedType,0
6,4,0,10,mixedType,1
9,0,1,10,mixedType,1
2,6,0,8,mixedType,1
5,4,0,9,mixedType,1
5,3,0,8,mixedType,1
8,1,0,9,mixedType,1
7,1,0,8,mixedType,1
4,6,0,10,mixedType,1
14,2,0,16,mixedType,2
9,1,0,10,mixedType,1
6,3,0,9,mixedType,1
3,8,0,11,mixedType,1
3,6,0,9,mixedType,1
15,2,0,17,mixedType,2
5,1,0,6,mixedType,0
4,6,0,10,mixedType,1
6,3,0,9,mixedType,1
9,1,0,10,mixedType,1
7,6,0,13,mixedType,1
7,2,0,9,mixedType,1
6,4,0,10,mixedType,1
1,10,0,11,mixedType,1
5,4,0,9,mixedType,1
7,2,0,9,mixedType,1
7,3,0,10,mixedType,1
8,4,0,12,mixedType,1
9,2,0,11,mixedType,1
8,1,0,9,mixedType,1
4,2,0,6,mixedType,0
3,8,0,11,mixedType,1
10,1,0,11,mixedType,1
8,1,0,9,mixedType,1
9,4,0,13,mixedType,1
5,3,0,8,mixedType,1
6,4,0,10,mixedType,1
11,3,0,14,mixedType,2
6,4,0,10,mixedType,1
7,2,0,9,mixedType,1
3,6,0,9,mixedType,1
7,4,0,11,mixedType,1
3,3,0,6,mixedType,0
9,1,0,10,mixedType,1
10,2,0,12,mixedType,1
10,1,0,11,mixedType,1
8,1,0,9,mixedType,1
6,2,0,8,mixedType,1
6,1,0,7,mixedType,0
7,3,0,10,mixedType,1
6,3,0,9,mixedType,1
3,6,0,9,mixedType,1
3,7,0,10,mixedType,1
7,3,0,10,mixedType,1
2,8,0,10,mixedType,1
7,2,0,9,mixedType,1
8,3,0,11,mixedType,1
6,2,0,8,mixedType,1
6,3,1,10,mixedType,1
5,1,0,6,mixedType,0
10,1,0,11,mixedType,1
2,4,0,6,mixedType,0
5,5,0,10,mixedType,1
5,2,0,7,mixedType,0
6,1,0,7,mixedType,0
14,2,0,16,mixedType,2
13,3,0,16,mixedType,2
4,2,0,6,mixedType,0
14,2,1,17,mixedType,2
8,6,0,14,mixedType,2
1,8,0,9,mixedType,1
7,3,0,10,mixedType,1
6,5,0,11,mixedType,1
5,2,0,7,mixedType,0
6,4,0,10,mixedType,1
8,2,0,10,mixedType,1
6,2,0,8,mixedType,1
7,6,0,13,mixedType,1
3,6,0,9,mixedType,1
4,4,0,8,mixedType,1
8,2,0,10,mixedType,1
11,3,0,14,mixedType,2
1,9,0,10,mixedType,1
5,3,0,8,mixedType,1
5,3,0,8,mixedType,1
5,3,0,8,mixedType,1
6,2,0,8,mixedType,1
3,3,0,6,mixedType,0
11,1,0,12,mixedType,1
9,2,0,11,mixedType,1
8,2,0,10,mixedType,1
4,7,0,11,mixedType,1
8,1,0,9,mixedType,1
5,3,0,8,mixedType,1
6,4,0,10,mixedType,1
2,6,0,8,mixedType,1
9,3,0,12,mixedType,1
2,4,0,6,mixedType,0
7,1,0,8,mixedType,1
6,3,0,9,mixedType,1
2,4,0,6,mixedType,0
3,7,0,10,mixedType,1
4,7,0,11,mixedType,1
5,4,0,9,mixedType,1
11,3,0,14,mixedType,2
5,2,0,7,mixedType,0
9,3,0,12,mixedType,1
6,3,0,9,mixedType,1
6,2,0,8,mixedType,1
1,8,0,9,mixedType,1
13,3,0,16,mixedType,2
8,2,0,10,mixedType,1
1,8,0,9,mixedType,1
4,4,0,8,mixedType,1
9,2,0,11,mixedType,1
6,1,0,7,mixedType,0
3,8,0,11,mixedType,1
5,4,0,9,mixedType,1
4,2,0,6,mixedType,0
6,3,0,9,mixedType,1
5,1,0,6,mixedType,0
8,3,0,11,mixedType,1
13,3,0,16,mixedType,2
6,1,0,7,mixedType,0
5,4,0,9,mixedType,1
15,0,1,16,mixedType,2
15,1,0,16,mixedType,2
4,4,0,8,mixedType,1
5,4,0,9,mixedType,1
5,2,0,7,mixedType,0
4,4,0,8,mixedType,1
2,7,0,9,mixedType,1
6,2,0,8,mixedType,1
6,3,0,9,mixedType,1
5,3,0,8,mixedType,1
14,2,0,16,mixedType,2
5,4,0,9,mixedType,1
6,2,0,8,mixedType,1
6,1,0,7,mixedType,0
15,1,0,16,mixedType,2
4,4,0,8,mixedType,1
7,1,0,8,mixedType,1
7,4,0,11,mixedType,1
10,1,0,11,mixedType,1
5,3,0,8,mixedType,1
2,8,0,10,mixedType,1
8,2,0,10,mixedType,1
4,4,0,8,mixedType,1
7,2,0,9,mixedType,1
8,3,0,11,mixedType,1
14,2,0,16,mixedType,2
4,6,0,10,mixedType,1
10,1,0,11,mixedType,1
6,4,0,10,mixedType,1
7,1,0,8,mixedType,1
5,3,0,8,mixedType,1
6,4,0,10,mixedType,1
7,1,0,8,mixedType,1
9,4,0,13,mixedType,1
9,1,0,10,mixedType,1
4,2,0,6,mixedType,0
8,2,0,10,mixedType,1
7,3,0,10,mixedType,1
15,1,0,16,mixedType,2
2,4,0,6,mixedType,0
6,3,0,9,mixedType,1
8,2,0,10,mixedType,1
16,3,2,21,mixedType,2
15,1,0,16,mixedType,2
6,4,0,10,mixedType,1
8,1,0,9,mixedType,1
5,3,0,8,mixedType,1
8,2,0,10,mixedType,1
6,5,0,11,mixedType,1
14,2,0,16,mixedType,2
11,2,0,13,mixedType,1
8,5,1,14,mixedType,2
7,3,0,10,mixedType,1
5,3,0,8,mixedType,1
10,2,0,12,mixedType,1
11,3,0,14,mixedType,2
5,2,0,7,mixedType,0
5,4,0,9,mixedType,1
8,2,0,10,mixedType,1
7,2,0,9,mixedType,1
1,7,0,8,mixedType,1
8,3,0,11,mixedType,1
13,3,0,16,mixedType,2
6,4,0,10,mixedType,1
4,6,0,10,mixedType,1
6,2,0,8,mixedType,1
2,6,0,8,mixedType,1
6,4,0,10,mixedType,1
4,4,0,8,mixedType,1
2,7,0,9,mixedType,1
6,1,0,7,mixedType,0
5,3,0,8,mixedType,1
5,4,0,9,mixedType,1
6,3,0,9,mixedType,1
7,1,0,8,mixedType,1
8,1,0,9,mixedType,1
7,2,0,9,mixedType,1
8,1,0,9,mixedType,1
8,4,0,12,mixedType,1
14,2,0,16,mixedType,2
5,4,0,9,mixedType,1
8,1,0,9,mixedType,1
6,3,0,9,mixedType,1
5,4,0,9,mixedType,1
7,2,0,9,mixedType,1
8,2,0,10,mixedType,1
8,3,0,11,mixedType,1
6,3,0,9,mixedType,1
8,1,0,9,mixedType,1
4,6,0,10,mixedType,1
2,8,0,10,mixedType,1
15,1,0,16,mixedType,2
5,5,0,10,mixedType,1
4,7,0,11,mixedType,1
7,2,0,9,mixedType,1
8,1,0,9,mixedType,1
9,2,0,11,mixedType,1
6,2,0,8,mixedType,1
6,3,0,9,mixedType,1
1,9,0,10,mixedType,1
7,3,0,10,mixedType,1
3,6,0,9,mixedType,1
13,3,0,16,mixedType,2
7,3,0,10,mixedType,1
7,2,0,9,mixedType,1
4,2,0,6,mixedType,0
6,2,0,8,mixedType,1
6,3,0,9,mixedType,1
7,3,0,10,mixedType,1
6,2,0,8,mixedType,1
4,4,0,8,mixedType,1
7,2,0,9,mixedType,1
5,1,0,6,mixedType,0
7,4,0,11,mixedType,1
6,3,0,9,mixedType,1
7,3,0,10,mixedType,1
3,3,0,6,mixedType,0
5,6,0,11,mixedType,1
4,4,2,10,mixedType,1
7,1,0,8,mixedType,1
14,2,0,16,mixedType,2
5,2,0,7,mixedType,0
8,1,0,9,mixedType,1
3,5,0,8,mixedType,1
7,3,0,10,mixedType,1
6,3,0,9,mixedType,1
8,2,0,10,mixedType,1
1,8,0,9,mixedType,1
6,3,0,9,mixedType,1
4,2,0,6,mixedType,0
8,2,0,10,mixedType,1
7,3,0,10,mixedType,1
5,3,0,8,mixedType,1
12,3,0,15,mixedType,2
11,2,0,13,mixedType,1
15,1,0,16,mixedType,2
6,3,0,9,mixedType,1
3,7,0,10,mixedType,1
6,3,0,9,mixedType,1
8,2,0,10,mixedType,1
5,4,0,9,mixedType,1
9,1,0,10,mixedType,1
12,3,0,15,mixedType,2
4,2,0,6,mixedType,0
7,2,0,9,mixedType,1
6,4,0,10,mixedType,1
11,2,0,13,mixedType,1
5,2,0,7,mixedType,0
3,6,0,9,mixedType,1
7,1,0,8,mixedType,1
3,3,0,6,mixedType,0
10,3,0,13,mixedType,1
5,2,0,7,mixedType,0
12,4,0,16,mixedType,2
18,3,0,21,mixedType,2
4,6,0,10,mixedType,1
8,1,0,9,mixedType,1
14,2,0,16,mixedType,2
5,4,0,9,mixedType,1
14,2,0,16,mixedType,2
8,5,0,13,mixedType,1
6,4,0,10,mixedType,1
7,3,0,10,mixedType,1
7,3,0,10,mixedType,1
7,2,0,9,mixedType,1
7,2,0,9,mixedType,1
13,3,0,16,mixedType,2
3,6,0,9,mixedType,1
7,4,0,11,mixedType,1
6,1,0,7,mixedType,0
1,8,0,9,mixedType,1
14,2,0,16,mixedType,2
6,3,0,9,mixedType,1
6,2,0,8,mixedType,1
5,5,0,10,mixedType,1
8,1,0,9,mixedType,1
8,5,0,13,mixedType,1
8,1,0,9,mixedType,1
6,4,0,10,mixedType,1
8,1,0,9,mixedType,1
4,2,0,6,mixedType,0
5,3,0,8,mixedType,1
6,2,0,8,mixedType,1
8,3,0,11,mixedType,1
6,3,0,9,mixedType,1
2,6,0,8,mixedType,1
1,8,0,9,mixedType,1
4,2,0,6,mixedType,0
4,2,0,6,mixedType,0
9,2,0,11,mixedType,1
7,2,0,9,mixedType,1
7,4,0,11,mixedType,1
8,1,0,9,mixedType,1
6,4,0,10,mixedType,1
6,3,0,9,mixedType,1
4,2,0,6,mixedType,0
5,1,0,6,mixedType,0
7,2,0,9,mixedType,1
7,3,0,10,mixedType,1
3,9,4,16,mixedType,2
9,3,0,12,mixedType,1
8,2,0,10,mixedType,1
9,1,0,10,mixedType,1
5,1,0,6,mixedType,0
8,1,0,9,mixedType,1
8,2,0,10,mixedType,1
8,3,0,11,mixedType,1
1,8,0,9,mixedType,1
12,3,0,15,mixedType,2
8,1,0,9,mixedType,1
5,5,0,10,mixedType,1
4,2,0,6,mixedType,0
5,2,0,7,mixedType,0
6,3,0,9,mixedType,1
4,2,0,6,mixedType,0
7,3,0,10,mixedType,1
13,3,0,16,mixedType,2
6,4,0,10,mixedType,1
5,3,0,8,mixedType,1
10,2,0,12,mixedType,1
2,11,0,13,mixedType,1
10,2,0,12,mixedType,1
7,3,0,10,mixedType,1
9,2,0,11,mixedType,1
4,4,0,8,mixedType,1
13,3,0,16,mixedType,2
7,4,0,11,mixedType,1
7,2,0,9,mixedType,1
7,2,0,9,mixedType,1
11,5,0,16,mixedType,2
4,4,0,8,mixedType,1
8,1,0,9,mixedType,1
5,2,0,7,mixedType,0
4,2,0,6,mixedType,0
8,2,0,10,mixedType,1
4,2,0,6,mixedType,0
15,1,0,16,mixedType,2
3,6,0,9,mixedType,1
2,10,0,12,mixedType,1
7,3,0,10,mixedType,1
6,3,0,9,mixedType,1
3,6,0,9,mixedType,1
7,1,0,8,mixedType,1
6,4,0,10,mixedType,1
5,3,0,8,mixedType,1
7,1,0,8,mixedType,1
4,2,0,6,mixedType,0
5,5,0,10,mixedType,1
11,2,3,16,mixedType,2
5,6,0,11,mixedType,1
4,4,0,8,mixedType,1
5,3,0,8,mixedType,1
8,4,0,12,mixedType,1
2,8,0,10,mixedType,1
11,3,0,14,mixedType,2
6,4,0,10,mixedType,1
6,4,0,10,mixedType,1
8,1,0,9,mixedType,1
4,5,0,9,mixedType,1
12,3,0,15,mixedType,2
3,6,0,9,mixedType,1
1,8,0,9,mixedType,1
8,2,0,10,mixedType,1
7,1,0,8,mixedType,1
4,2,0,6,mixedType,0
8,2,0,10,mixedType,1
5,3,0,8,mixedType,1
7,2,0,9,mixedType,1
7,1,0,8,mixedType,1
3,6,0,9,mixedType,1
1,8,0,9,mixedType,1
5,2,0,7,mixedType,0
8,2,0,10,mixedType,1
3,3,0,6,mixedType,0
3,3,0,6,mixedType,0
6,0,2,8,mixedType,1
5,3,0,8,mixedType,1
4,4,0,8,mixedType,1
6,3,0,9,mixedType,1
9,0,3,12,mixedType,1
5,4,0,9,mixedType,1
7,2,0,9,mixedType,1
5,4,0,9,mixedType,1
3,7,0,10,mixedType,1
6,2,0,8,mixedType,1
1,7,0,8,mixedType,1
7,4,0,11,mixedType,1
5,3,0,8,mixedType,1
9,1,0,10,mixedType,1
5,3,0,8,mixedType,1
6,1,0,7,mixedType,0
5,2,0,7,mixedType,0
8,2,0,10,mixedType,1
10,1,0,11,mixedType,1
15,1,0,16,mixedType,2
7,3,0,10,mixedType,1
15,1,0,16,mixedType,2
2,9,0,11,mixedType,1
5,3,0,8,mixedType,1
6,3,0,9,mixedType,1
4,6,0,10,mixedType,1
5,2,0,7,mixedType,0
8,2,0,10,mixedType,1
7,2,0,9,mixedType,1
6,3,0,9,mixedType,1
4,2,0,6,mixedType,0
6,2,0,8,mixedType,1
9,1,0,10,mixedType,1
8,2,0,10,mixedType,1
8,3,0,11,mixedType,1
3,6,0,9,mixedType,1
14,2,0,16,mixedType,2
5,6,0,11,mixedType,1
7,3,0,10,mixedType,1
6,3,0,9,mixedType,1
3,3,0,6,mixedType,0
4,2,0,6,mixedType,0
9,2,0,11,mixedType,1
5,3,0,8,mixedType,1
13,0,1,14,mixedType,2
6,2,0,8,mixedType,1
3,6,0,9,mixedType,1
6,3,0,9,mixedType,1
4,2,0,6,mixedType,0
4,2,0,6,mixedType,0
7,1,0,8,mixedType,1
7,2,0,9,mixedType,1
8,2,0,10,mixedType,1
5,1,0,6,mixedType,0
7,3,0,10,mixedType,1
7,3,0,10,mixedType,1
5,4,0,9,mixedType,1
9,1,0,10,mixedType,1
11,5,0,16,mixedType,2
5,2,0,7,mixedType,0
6,3,0,9,mixedType,1
6,1,0,7,mixedType,0
7,3,0,10,mixedType,1
9,5,1,15,mixedType,2
6,3,0,9,mixedType,1
7,2,0,9,mixedType,1
7,2,0,9,mixedType,1
3,4,0,7,mixedType,0
6,1,0,7,mixedType,0
7,2,0,9,mixedType,1
2,4,0,6,mixedType,0
8,2,0,10,mixedType,1
3,3,0,6,mixedType,0
4,2,0,6,mixedType,0
11,3,0,14,mixedType,2
6,3,0,9,mixedType,1
7,2,0,9,mixedType,1
9,1,0,10,mixedType,1
2,6,0,8,mixedType,1
8,1,0,9,mixedType,1
13,3,0,16,mixedType,2
4,4,0,8,mixedType,1
7,3,0,10,mixedType,1
6,3,0,9,mixedType,1
9,3,0,12,mixedType,1
5,4,0,9,mixedType,1
5,3,0,8,mixedType,1
5,8,0,13,mixedType,1
7,2,0,9,mixedType,1
6,3,0,9,mixedType,1
7,1,0,8,mixedType,1
7,1,0,8,mixedType,1
7,1,0,8,mixedType,1
4,2,0,6,mixedType,0
13,3,0,16,mixedType,2
3,9,0,12,mixedType,1
8,1,0,9,mixedType,1
11,1,0,12,mixedType,1
6,2,0,8,mixedType,1
6,4,0,10,mixedType,1
6,1,0,7,mixedType,0
8,2,0,10,mixedType,1
6,3,0,9,mixedType,1
4,4,0,8,mixedType,1
6,1,0,7,mixedType,0
7,2,0,9,mixedType,1
6,4,0,10,mixedType,1
13,3,0,16,mixedType,2
10,4,0,14,mixedType,2
4,7,0,11,mixedType,1
8,1,0,9,mixedType,1
9,1,0,10,mixedType,1
9,1,0,10,mixedType,1
7,3,0,10,mixedType,1
3,7,0,10,mixedType,1
3,6,0,9,mixedType,1
5,2,0,7,mixedType,0
5,3,0,8,mixedType,1
1,8,0,9,mixedType,1
5,3,0,8,mixedType,1
4,4,0,8,mixedType,1
6,1,0,7,mixedType,0
8,1,0,9,mixedType,1
5,1,0,6,mixedType,0
7,3,0,10,mixedType,1
4,2,0,6,mixedType,0
5,2,0,7,mixedType,0
5,4,0,9,mixedType,1
5,4,0,9,mixedType,1
1,8,0,9,mixedType,1
6,1,0,7,mixedType,0
7,3,0,10,mixedType,1
6,3,0,9,mixedType,1
5,2,0,7,mixedType,0
8,2,0,10,mixedType,1
7,1,0,8,mixedType,1
9,1,0,10,mixedType,1
9,2,0,11,mixedType,1
7,3,0,10,mixedType,1
4,6,0,10,mixedType,1
2,8,0,10,mixedType,1
6,1,0,7,mixedType,0
5,1,0,6,mixedType,0
7,1,0,8,mixedType,1
6,3,0,9,mixedType,1
7,2,0,9,mixedType,1
7,1,0,8,mixedType,1
7,1,0,8,mixedType,1
8,2,0,10,mixedType,1
1,10,0,11,mixedType,1
4,2,0,6,mixedType,0
4,2,0,6,mixedType,0
12,3,0,15,mixedType,2
8,1,0,9,mixedType,1
8,4,0,12,mixedType,1
4,4,0,8,mixedType,1
5,2,0,7,mixedType,0
8,2,0,10,mixedType,1
6,3,0,9,mixedType,1
8,1,0,9,mixedType,1
10,2,0,12,mixedType,1
6,3,0,9,mixedType,1
6,3,0,9,mixedType,1
1,8,0,9,mixedType,1
7,3,0,10,mixedType,1
8,3,0,11,mixedType,1
1,9,0,10,mixedType,1
7,3,0,10,mixedType,1
7,2,0,9,mixedType,1
6,1,0,7,mixedType,0
8,2,0,10,mixedType,1
6,4,0,10,mixedType,1
8,1,0,9,mixedType,1
7,3,0,10,mixedType,1
7,2,0,9,mixedType,1
7,1,0,8,mixedType,1
14,2,0,16,mixedType,2
7,2,0,9,mixedType,1
5,4,0,9,mixedType,1
10,3,1,14,mixedType,2
7,4,0,11,mixedType,1
5,5,0,10,mixedType,1
9,1,0,10,mixedType,1
6,6,0,12,mixedType,1
4,2,0,6,mixedType,0
7,2,0,9,mixedType,1
9,4,0,13,mixedType,1
15,1,0,16,mixedType,2
8,1,0,9,mixedType,1
9,1,0,10,mixedType,1
3,3,0,6,mixedType,0
4,2,0,6,mixedType,0
9,1,0,10,mixedType,1
8,4,0,12,mixedType,1
12,3,0,15,mixedType,2
4,2,0,6,mixedType,0
9,3,0,12,mixedType,1
6,6,0,12,mixedType,1
9,3,0,12,mixedType,1
9,4,0,13,mixedType,1
9,4,0,13,mixedType,1
5,3,0,8,mixedType,1
5,1,0,6,mixedType,0
15,5,0,20,mixedType,2
6,1,0,7,mixedType,0
8,1,0,9,mixedType,1
6,4,0,10,mixedType,1
4,2,0,6,mixedType,0
7,3,0,10,mixedType,1
1,8,0,9,mixedType,1
15,1,0,16,mixedType,2
8,2,0,10,mixedType,1
10,3,0,13,mixedType,1
10,4,0,14,mixedType,2
7,3,0,10,mixedType,1
15,1,0,16,mixedType,2
4,4,0,8,mixedType,1
6,3,0,9,mixedType,1
6,3,0,9,mixedType,1
2,4,0,6,mixedType,0
8,3,0,11,mixedType,1
15,1,0,16,mixedType,2
4,6,0,10,mixedType,1
9,1,0,10,mixedType,1
6,6,0,12,mixedType,1
8,2,0,10,mixedType,1
5,3,0,8,mixedType,1
6,4,0,10,mixedType,1
6,9,1,16,mixedType,2
6,2,0,8,mixedType,1
7,4,0,11,mixedType,1
1,7,0,8,mixedType,1
7,3,0,10,mixedType,1
3,6,0,9,mixedType,1
7,2,0,9,mixedType,1
6,3,0,9,mixedType,1
9,4,0,13,mixedType,1
6,1,0,7,mixedType,0
2,7,0,9,mixedType,1
6,3,0,9,mixedType,1
7,2,0,9,mixedType,1
4,4,0,8,mixedType,1
7,2,0,9,mixedType,1
7,6,0,13,mixedType,1
10,2,0,12,mixedType,1
8,4,0,12,mixedType,1
7,2,0,9,mixedType,1
8,3,0,11,mixedType,1
9,1,0,10,mixedType,1
11,5,0,16,mixedType,2
7,3,0,10,mixedType,1
1,8,0,9,mixedType,1
2,6,0,8,mixedType,1
5,1,0,6,mixedType,0
7,1,0,8,mixedType,1
5,2,0,7,mixedType,0
7,2,0,9,mixedType,1
6,3,0,9,mixedType,1
3,8,0,11,mixedType,1
8,2,0,10,mixedType,1
13,3,1,17,mixedType,2
5,3,0,8,mixedType,1
2,8,0,10,mixedType,1
3,5,0,8,mixedType,1
8,1,0,9,mixedType,1
5,3,0,8,mixedType,1
5,3,0,8,mixedType,1
7,4,0,11,mixedType,1
13,3,0,16,mixedType,2
1,10,0,11,mixedType,1
6,3,0,9,mixedType,1
3,8,0,11,mixedType,1
13,3,0,16,mixedType,2
6,4,0,10,mixedType,1
5,3,0,8,mixedType,1
5,2,0,7,mixedType,0
4,4,0,8,mixedType,1
5,5,0,10,mixedType,1
7,3,0,10,mixedType,1
8,1,0,9,mixedType,1
8,2,0,10,mixedType,1
1,9,0,10,mixedType,1
12,4,0,16,mixedType,2
10,2,0,12,mixedType,1
9,1,0,10,mixedType,1
1,7,0,8,mixedType,1
6,2,0,8,mixedType,1
6,3,0,9,mixedType,1
5,2,0,7,mixedType,0
5,3,0,8,mixedType,1
6,4,0,10,mixedType,1
3,5,0,8,mixedType,1
9,2,0,11,mixedType,1
9,4,0,13,mixedType,1
6,3,0,9,mixedType,1
7,4,0,11,mixedType,1
7,1,0,8,mixedType,1
8,4,0,12,mixedType,1
6,3,0,9,mixedType,1
10,3,0,13,mixedType,1
8,1,0,9,mixedType,1
12,3,0,15,mixedType,2
8,1,0,9,mixedType,1
7,1,0,8,mixedType,1
14,2,0,16,mixedType,2
13,3,0,16,mixedType,2
14,2,0,16,mixedType,2
11,5,0,16,mixedType,2
7,3,0,10,mixedType,1
7,1,0,8,mixedType,1
15,1,0,16,mixedType,2
6,2,0,8,mixedType,1
5,4,0,9,mixedType,1
12,3,0,15,mixedType,2
3,6,0,9,mixedType,1
6,3,0,9,mixedType,1
7,3,0,10,mixedType,1
6,1,0,7,mixedType,0
12,4,0,16,mixedType,2
6,3,0,9,mixedType,1
5,4,0,9,mixedType,1
7,4,0,11,mixedType,1
5,5,0,10,mixedType,1
1,8,0,9,mixedType,1
5,7,0,12,mixedType,1
15,1,0,16,mixedType,2
8,4,0,12,mixedType,1
13,3,0,16,mixedType,2
7,5,0,12,mixedType,1
2,7,0,9,mixedType,1
7,3,0,10,mixedType,1
5,4,0,9,mixedType,1
8,2,0,10,mixedType,1
2,6,0,8,mixedType,1
7,2,0,9,mixedType,1
7,1,0,8,mixedType,1
15,1,0,16,mixedType,2
4,5,0,9,mixedType,1
7,3,0,10,mixedType,1
14,5,2,21,mixedType,2
8,2,0,10,mixedType,1
7,3,0,10,mixedType,1
6,6,0,12,mixedType,1
3,6,0,9,mixedType,1
7,1,0,8,mixedType,1
6,5,0,11,mixedType,1
5,2,0,7,mixedType,0
3,6,0,9,mixedType,1
7,2,0,9,mixedType,1
4,2,0,6,mixedType,0
6,2,0,8,mixedType,1
5,3,0,8,mixedType,1
13,3,0,16,mixedType,2
5,2,0,7,mixedType,0
9,1,0,10,mixedType,1
11,3,0,14,mixedType,2
6,3,0,9,mixedType,1
13,3,0,16,mixedType,2
6,4,0,10,mixedType,1
6,6,0,12,mixedType,1
7,3,0,10,mixedType,1
5,2,0,7,mixedType,0
7,3,0,10,mixedType,1
6,2,0,8,mixedType,1
0,5,0,5,sameType,0
5,4,0,9,mixedType,1
3,7,0,10,mixedType,1
4,2,0,6,mixedType,0
5,1,0,6,mixedType,0
9,1,0,10,mixedType,1
6,1,0,7,mixedType,0
15,1,0,16,mixedType,2
9,1,0,10,mixedType,1
5,1,0,6,mixedType,0
11,1,0,12,mixedType,1
8,2,0,10,mixedType,1
7,2,0,9,mixedType,1
6,3,0,9,mixedType,1
5,2,0,7,mixedType,0
12,3,0,15,mixedType,2
4,2,0,6,mixedType,0
9,2,0,11,mixedType,1
6,4,0,10,mixedType,1
6,3,0,9,mixedType,1
6,3,0,9,mixedType,1
13,3,0,16,mixedType,2
5,2,0,7,mixedType,0
2,4,0,6,mixedType,0
7,1,0,8,mixedType,1
2,6,0,8,mixedType,1
6,6,0,12,mixedType,1
4,4,0,8,mixedType,1
6,2,0,8,mixedType,1
9,4,0,13,mixedType,1
6,1,0,7,mixedType,0
7,2,0,9,mixedType,1
7,2,0,9,mixedType,1
9,1,0,10,mixedType,1
6,2,0,8,mixedType,1
9,3,0,12,mixedType,1
8,1,0,9,mixedType,1
6,1,0,7,mixedType,0
11,2,0,13,mixedType,1
5,1,0,6,mixedType,0
8,2,0,10,mixedType,1
4,4,0,8,mixedType,1
6,3,0,9,mixedType,1
4,2,0,6,mixedType,0
1,9,0,10,mixedType,1
7,3,0,10,mixedType,1
7,2,0,9,mixedType,1
8,1,0,9,mixedType,1
6,2,0,8,mixedType,1
8,6,0,14,mixedType,2
6,1,0,7,mixedType,0
5,4,0,9,mixedType,1
9,1,0,10,mixedType,1
6,4,0,10,mixedType,1
6,3,0,9,mixedType,1
6,2,0,8,mixedType,1
9,2,0,11,mixedType,1
5,4,0,9,mixedType,1
14,2,0,16,mixedType,2
8,3,0,11,mixedType,1
10,3,0,13,mixedType,1
4,4,0,8,mixedType,1
0,6,2,8,mixedType,1
1,8,0,9,mixedType,1
4,4,0,8,mixedType,1
7,2,0,9,mixedType,1
6,3,0,9,mixedType,1
5,1,0,6,mixedType,0
15,1,0,16,mixedType,2
7,2,0,9,mixedType,1
9,1,0,10,mixedType,1
2,4,0,6,mixedType,0
9,3,0,12,mixedType,1
2,4,0,6,mixedType,0
4,2,0,6,mixedType,0
6,1,0,7,mixedType,0
4,6,0,10,mixedType,1
4,4,0,8,mixedType,1
7,1,0,8,mixedType,1
7,3,0,10,mixedType,1
7,3,0,10,mixedType,1
8,1,0,9,mixedType,1
9,2,0,11,mixedType,1
14,2,0,16,mixedType,2
8,2,0,10,mixedType,1
8,1,0,9,mixedType,1
14,2,0,16,mixedType,2
6,6,0,12,mixedType,1
6,4,0,10,mixedType,1
6,4,0,10,mixedType,1
2,4,0,6,mixedType,0
5,3,0,8,mixedType,1
11,2,0,13,mixedType,1
7,4,0,11,mixedType,1
2,4,0,6,mixedType,0
9,4,0,13,mixedType,1
13,3,0,16,mixedType,2
6,2,0,8,mixedType,1
9,2,0,11,mixedType,1
8,6,1,15,mixedType,2
7,0,0,7,sameType,0
4,6,0,10,mixedType,1
2,4,0,6,mixedType,0
12,1,0,13,mixedType,1
6,1,0,7,mixedType,0
13,3,0,16,mixedType,2
7,4,0,11,mixedType,1
5,4,0,9,mixedType,1
8,2,0,10,mixedType,1
4,4,0,8,mixedType,1
9,3,0,12,mixedType,1
1,9,0,10,mixedType,1
7,3,0,10,mixedType,1
9,3,0,12,mixedType,1
5,2,0,7,mixedType,0
15,1,0,16,mixedType,2
3,5,0,8,mixedType,1
15,1,0,16,mixedType,2
7,4,0,11,mixedType,1
6,3,0,9,mixedType,1
1,8,0,9,mixedType,1
3,9,0,12,mixedType,1
3,7,0,10,mixedType,1
7,3,0,10,mixedType,1
7,1,0,8,mixedType,1
2,8,0,10,mixedType,1
6,4,0,10,mixedType,1
5,2,0,7,mixedType,0
7,3,0,10,mixedType,1
6,1,0,7,mixedType,0
7,3,0,10,mixedType,1
9,1,0,10,mixedType,1
4,5,0,9,mixedType,1
10,1,0,11,mixedType,1
4,6,0,10,mixedType,1
8,2,0,10,mixedType,1
8,2,0,10,mixedType,1
7,3,0,10,mixedType,1
5,4,0,9,mixedType,1
2,8,0,10,mixedType,1
8,4,0,12,mixedType,1
9,2,0,11,mixedType,1
4,8,0,12,mixedType,1
5,2,0,7,mixedType,0
5,6,0,11,mixedType,1
12,4,0,16,mixedType,2
11,3,0,14,mixedType,2
13,3,0,16,mixedType,2
8,3,0,11,mixedType,1
5,5,0,10,mixedType,1
1,9,0,10,mixedType,1
2,6,0,8,mixedType,1
7,2,0,9,mixedType,1
5,2,0,7,mixedType,0
4,4,0,8,mixedType,1
1,8,0,9,mixedType,1
1,11,0,12,mixedType,1
12,1,0,13,mixedType,1
6,2,0,8,mixedType,1
5,6,0,11,mixedType,1
5,1,0,6,mixedType,0
7,3,0,10,mixedType,1
7,2,0,9,mixedType,1
8,1,0,9,mixedType,1
6,0,1,7,mixedType,0
7,2,0,9,mixedType,1
6,0,1,7,mixedType,0
3,3,0,6,mixedType,0
7,1,0,8,mixedType,1
1,8,0,9,mixedType,1
14,2,0,16,mixedType,2
9,1,0,10,mixedType,1
3,5,0,8,mixedType,1
5,4,0,9,mixedType,1
4,4,0,8,mixedType,1
6,4,0,10,mixedType,1
8,3,0,11,mixedType,1
6,3,0,9,mixedType,1
6,8,0,14,mixedType,2
7,3,0,10,mixedType,1
6,1,0,7,mixedType,0
10,6,0,16,mixedType,2
11,3,0,14,mixedType,2
7,2,0,9,mixedType,1
13,3,0,16,mixedType,2
5,4,0,9,mixedType,1
14,2,0,16,mixedType,2
7,4,0,11,mixedType,1
6,3,0,9,mixedType,1
6,3,0,9,mixedType,1
7,2,0,9,mixedType,1
9,3,0,12,mixedType,1
9,2,0,11,mixedType,1
4,2,0,6,mixedType,0
8,5,0,13,mixedType,1
10,3,0,13,mixedType,1
5,5,0,10,mixedType,1
6,2,0,8,mixedType,1
7,2,0,9,mixedType,1
2,4,0,6,mixedType,0
11,3,0,14,mixedType,2
7,1,0,8,mixedType,1
6,3,0,9,mixedType,1
10,2,0,12,mixedType,1
5,4,0,9,mixedType,1
5,3,0,8,mixedType,1
5,2,0,7,mixedType,0
14,2,0,16,mixedType,2
7,3,0,10,mixedType,1
8,2,0,10,mixedType,1
5,2,0,7,mixedType,0
7,4,0,11,mixedType,1
9,3,0,12,mixedType,1
6,3,0,9,mixedType,1
6,4,0,10,mixedType,1
7,2,0,9,mixedType,1
3,6,0,9,mixedType,1
7,2,0,9,mixedType,1
6,4,0,10,mixedType,1
4,2,0,6,mixedType,0
12,3,0,15,mixedType,2
8,2,0,10,mixedType,1
8,1,0,9,mixedType,1
5,3,0,8,mixedType,1
9,3,0,12,mixedType,1
11,5,0,16,mixedType,2
4,4,0,8,mixedType,1
9,2,0,11,mixedType,1
3,6,0,9,mixedType,1
8,2,0,10,mixedType,1
5,2,0,7,mixedType,0
8,1,0,9,mixedType,1
14,2,0,16,mixedType,2
14,2,0,16,mixedType,2
15,1,0,16,mixedType,2
6,3,0,9,mixedType,1
12,1,0,13,mixedType,1
7,3,0,10,mixedType,1
10,1,0,11,mixedType,1
7,1,0,8,mixedType,1
7,2,0,9,mixedType,1
4,4,0,8,mixedType,1
5,3,0,8,mixedType,1
8,3,0,11,mixedType,1
6,2,0,8,mixedType,1
5,4,0,9,mixedType,1
4,2,0,6,mixedType,0
6,0,0,6,sameType,0
9,3,0,12,mixedType,1
13,3,0,16,mixedType,2
5,2,0,7,mixedType,0
8,1,0,9,mixedType,1
6,3,0,9,mixedType,1
5,3,0,8,mixedType,1
6,2,0,8,mixedType,1
4,2,0,6,mixedType,0
4,4,0,8,mixedType,1
8,3,0,11,mixedType,1
5,3,0,8,mixedType,1
6,4,0,10,mixedType,1
5,3,0,8,mixedType,1
8,2,0,10,mixedType,1
12,4,0,16,mixedType,2
7,3,0,10,mixedType,1
14,2,0,16,mixedType,2
6,2,0,8,mixedType,1
2,8,0,10,mixedType,1
8,0,1,9,mixedType,1
6,4,0,10,mixedType,1
6,4,0,10,mixedType,1
4,4,0,8,mixedType,1
3,7,0,10,mixedType,1
8,3,0,11,mixedType,1
7,8,1,16,mixedType,2
5,2,0,7,mixedType,0
6,2,0,8,mixedType,1
6,4,0,10,mixedType,1
6,1,0,7,mixedType,0
5,4,0,9,mixedType,1
5,3,0,8,mixedType,1
3,6,0,9,mixedType,1
8,1,0,9,mixedType,1
4,2,0,6,mixedType,0
5,2,0,7,mixedType,0
3,7,0,10,mixedType,1
5,4,0,9,mixedType,1
5,2,0,7,mixedType,0
4,4,0,8,mixedType,1
4,4,0,8,mixedType,1
5,4,0,9,mixedType,1
4,4,0,8,mixedType,1
7,2,0,9,mixedType,1
6,3,0,9,mixedType,1
13,3,0,16,mixedType,2
4,6,0,10,mixedType,1
9,2,0,11,mixedType,1
9,3,0,12,mixedType,1
5,4,0,9,mixedType,1
2,7,0,9,mixedType,1
7,3,0,10,mixedType,1
3,3,0,6,mixedType,0
6,3,0,9,mixedType,1
3,6,0,9,mixedType,1
7,3,0,10,mixedType,1
15,1,0,16,mixedType,2
5,4,0,9,mixedType,1
6,1,0,7,mixedType,0
5,3,0,8,mixedType,1
9,3,0,12,mixedType,1
7,2,0,9,mixedType,1
10,1,0,11,mixedType,1
4,2,0,6,mixedType,0
7,3,0,10,mixedType,1
14,2,0,16,mixedType,2
6,4,0,10,mixedType,1
7,3,0,10,mixedType,1
7,3,0,10,mixedType,1
4,4,0,8,mixedType,1
1,8,0,9,mixedType,1
1,9,0,10,mixedType,1
7,1,0,8,mixedType,1
6,0,2,8,mixedType,1
13,3,0,16,mixedType,2
8,2,0,10,mixedType,1
9,3,0,12,mixedType,1
4,2,0,6,mixedType,0
4,4,0,8,mixedType,1
6,6,0,12,mixedType,1
5,2,0,7,mixedType,0
8,1,0,9,mixedType,1
4,8,0,12,mixedType,1
4,2,0,6,mixedType,0
6,1,0,7,mixedType,0
6,2,0,8,mixedType,1
9,1,0,10,mixedType,1
10,2,0,12,mixedType,1
6,4,0,10,mixedType,1
1,7,0,8,mixedType,1
4,4,0,8,mixedType,1
14,2,0,16,mixedType,2
9,4,0,13,mixedType,1
8,2,0,10,mixedType,1
7,6,0,13,mixedType,1
6,3,0,9,mixedType,1
7,2,0,9,mixedType,1
8,1,0,9,mixedType,1
14,2,0,16,mixedType,2
4,4,0,8,mixedType,1
7,0,1,8,mixedType,1
6,4,0,10,mixedType,1
8,2,0,10,mixedType,1
7,3,0,10,mixedType,1
13,3,0,16,mixedType,2
13,3,0,16,mixedType,2
6,5,0,11,mixedType,1
5,4,0,9,mixedType,1
6,3,0,9,mixedType,1
7,2,0,9,mixedType,1
8,5,3,16,mixedType,2
11,3,0,14,mixedType,2
6,2,0,8,mixedType,1
5,2,0,7,mixedType,0
5,2,0,7,mixedType,0
7,1,0,8,mixedType,1
7,3,0,10,mixedType,1
6,3,0,9,mixedType,1
2,7,0,9,mixedType,1
7,3,0,10,mixedType,1
5,3,0,8,mixedType,1
9,1,0,10,mixedType,1
8,2,0,10,mixedType,1
6,1,0,7,mixedType,0
14,2,0,16,mixedType,2
10,2,0,12,mixedType,1
11,3,0,14,mixedType,2
7,3,0,10,mixedType,1
7,6,0,13,mixedType,1
6,1,0,7,mixedType,0
15,1,0,16,mixedType,2
5,2,0,7,mixedType,0
9,1,0,10,mixedType,1
8,1,0,9,mixedType,1
11,1,0,12,mixedType,1
7,3,0,10,mixedType,1
2,6,0,8,mixedType,1
9,1,0,10,mixedType,1
12,4,0,16,mixedType,2
4,6,0,10,mixedType,1
7,2,0,9,mixedType,1
2,8,0,10,mixedType,1
1,9,0,10,mixedType,1
14,2,0,16,mixedType,2
6,4,0,10,mixedType,1
6,2,0,8,mixedType,1
11,1,0,12,mixedType,1
7,4,0,11,mixedType,1
9,3,0,12,mixedType,1
7,2,0,9,mixedType,1
12,4,0,16,mixedType,2
4,6,0,10,mixedType,1
7,3,0,10,mixedType,1
4,6,0,10,mixedType,1
8,2,0,10,mixedType,1
7,2,0,9,mixedType,1
14,2,0,16,mixedType,2
1,7,0,8,mixedType,1
4,5,0,9,mixedType,1
14,2,0,16,mixedType,2
7,1,0,8,mixedType,1
5,4,0,9,mixedType,1
7,1,0,8,mixedType,1
5,9,1,15,mixedType,2
6,2,0,8,mixedType,1
5,4,0,9,mixedType,1
2,8,0,10,mixedType,1
15,2,0,17,mixedType,2
7,3,0,10,mixedType,1
6,3,0,9,mixedType,1
6,3,0,9,mixedType,1
4,4,0,8,mixedType,1
5,4,0,9,mixedType,1
7,2,0,9,mixedType,1
8,3,0,11,mixedType,1
5,8,0,13,mixedType,1
6,4,0,10,mixedType,1
10,5,0,15,mixedType,2
5,1,0,6,mixedType,0
4,2,0,6,mixedType,0
7,3,0,10,mixedType,1
7,1,0,8,mixedType,1
6,4,0,10,mixedType,1
7,2,0,9,mixedType,1
7,1,0,8,mixedType,1
7,3,0,10,mixedType,1
7,1,0,8,mixedType,1
12,3,0,15,mixedType,2
3,5,0,8,mixedType,1
15,1,0,16,mixedType,2
6,2,0,8,mixedType,1
6,2,0,8,mixedType,1
8,2,0,10,mixedType,1
9,2,0,11,mixedType,1
15,1,0,16,mixedType,2
8,2,0,10,mixedType,1
6,3,0,9,mixedType,1
6,5,0,11,mixedType,1
5,2,0,7,mixedType,0
7,1,0,8,mixedType,1
5,2,0,7,mixedType,0
15,1,0,16,mixedType,2
8,1,0,9,mixedType,1
6,2,0,8,mixedType,1
11,4,0,15,mixedType,2
8,1,0,9,mixedType,1
9,3,0,12,mixedType,1
12,4,0,16,mixedType,2
4,0,3,7,mixedType,0
3,6,0,9,mixedType,1
12,4,0,16,mixedType,2
7,1,0,8,mixedType,1
3,10,0,13,mixedType,1
9,7,0,16,mixedType,2
1,8,0,9,mixedType,1
13,3,0,16,mixedType,2
6,4,0,10,mixedType,1
7,3,0,10,mixedType,1
1,7,0,8,mixedType,1
5,2,0,7,mixedType,0
7,2,0,9,mixedType,1
5,3,0,8,mixedType,1
7,3,0,10,mixedType,1
4,4,0,8,mixedType,1
3,6,0,9,mixedType,1
11,5,0,16,mixedType,2
2,8,0,10,mixedType,1
12,3,0,15,mixedType,2
14,2,0,16,mixedType,2
7,3,0,10,mixedType,1
5,2,0,7,mixedType,0
4,8,0,12,mixedType,1
2,7,0,9,mixedType,1
1,7,0,8,mixedType,1
6,1,0,7,mixedType,0
7,2,0,9,mixedType,1
6,4,0,10,mixedType,1
7,3,0,10,mixedType,1
8,2,0,10,mixedType,1
15,1,0,16,mixedType,2
9,1,0,10,mixedType,1
4,6,0,10,mixedType,1
4,7,0,11,mixedType,1
5,3,0,8,mixedType,1
9,0,1,10,mixedType,1
7,3,0,10,mixedType,1
7,3,0,10,mixedType,1
1,8,0,9,mixedType,1
12,3,0,15,mixedType,2
4,4,0,8,mixedType,1
9,1,0,10,mixedType,1
5,4,0,9,mixedType,1
7,6,0,13,mixedType,1
0,6,3,9,mixedType,1
6,2,0,8,mixedType,1
3,6,0,9,mixedType,1
6,4,0,10,mixedType,1
13,3,0,16,mixedType,2
8,5,0,13,mixedType,1
5,4,0,9,mixedType,1
15,1,0,16,mixedType,2
8,2,0,10,mixedType,1
12,3,0,15,mixedType,2
5,1,0,6,mixedType,0
6,3,0,9,mixedType,1
5,3,0,8,mixedType,1
9,2,0,11,mixedType,1
7,2,0,9,mixedType,1
6,3,0,9,mixedType,1
8,2,0,10,mixedType,1
4,4,0,8,mixedType,1
8,0,1,9,mixedType,1
9,2,0,11,mixedType,1
7,2,0,9,mixedType,1
15,1,0,16,mixedType,2
7,3,0,10,mixedType,1
6,3,0,9,mixedType,1
6,3,0,9,mixedType,1
6,3,0,9,mixedType,1
8,2,0,10,mixedType,1
7,2,0,9,mixedType,1
6,2,0,8,mixedType,1
1,12,0,13,mixedType,1
5,2,0,7,mixedType,0
7,8,0,15,mixedType,2
8,1,0,9,mixedType,1
9,3,0,12,mixedType,1
3,6,0,9,mixedType,1
7,3,0,10,mixedType,1
8,2,0,10,mixedType,1
5,1,0,6,mixedType,0
14,2,0,16,mixedType,2
7,1,0,8,mixedType,1
7,2,0,9,mixedType,1
8,2,0,10,mixedType,1
7,2,0,9,mixedType,1
7,2,0,9,mixedType,1
14,2,0,16,mixedType,2
4,2,0,6,mixedType,0
11,2,0,13,mixedType,1
7,3,0,10,mixedType,1
10,2,0,12,mixedType,1
5,6,0,11,mixedType,1
1,8,0,9,mixedType,1
6,2,0,8,mixedType,1
7,3,0,10,mixedType,1
7,2,0,9,mixedType,1
7,3,0,10,mixedType,1
6,2,0,8,mixedType,1
7,3,0,10,mixedType,1
15,1,0,16,mixedType,2
7,3,0,10,mixedType,1
12,3,0,15,mixedType,2
9,2,0,11,mixedType,1
5,1,0,6,mixedType,0
8,3,0,11,mixedType,1
5,2,0,7,mixedType,0
5,3,0,8,mixedType,1
6,3,0,9,mixedType,1
8,2,0,10,mixedType,1
5,1,0,6,mixedType,0
9,3,0,12,mixedType,1
6,3,0,9,mixedType,1
5,0,2,7,mixedType,0
6,4,0,10,mixedType,1
17,5,2,24,mixedType,2
7,2,0,9,mixedType,1
8,1,0,9,mixedType,1
6,4,0,10,mixedType,1
6,3,0,9,mixedType,1
5,4,0,9,mixedType,1
6,2,0,8,mixedType,1
6,4,0,10,mixedType,1
6,2,0,8,mixedType,1
12,3,0,15,mixedType,2
13,3,0,16,mixedType,2
2,6,0,8,mixedType,1
6,3,0,9,mixedType,1
5,2,0,7,mixedType,0
4,2,0,6,mixedType,0
9,1,0,10,mixedType,1
7,3,0,10,mixedType,1
14,2,0,16,mixedType,2
3,8,0,11,mixedType,1
6,1,0,7,mixedType,0
14,2,0,16,mixedType,2
7,2,0,9,mixedType,1
5,2,0,7,mixedType,0
6,4,0,10,mixedType,1
7,3,0,10,mixedType,1
14,2,0,16,mixedType,2
7,3,0,10,mixedType,1
6,1,0,7,mixedType,0
6,4,0,10,mixedType,1
10,5,1,16,mixedType,2
0,9,1,10,mixedType,1
2,7,0,9,mixedType,1
13,4,0,17,mixedType,2
6,1,0,7,mixedType,0
9,1,0,10,mixedType,1
3,6,0,9,mixedType,1
14,2,0,16,mixedType,2
9,3,0,12,mixedType,1
8,1,0,9,mixedType,1
7,2,0,9,mixedType,1
4,4,0,8,mixedType,1
6,5,0,11,mixedType,1
8,2,0,10,mixedType,1
5,7,3,15,mixedType,2
7,3,0,10,mixedType,1
6,3,0,9,mixedType,1
6,4,0,10,mixedType,1
6,2,0,8,mixedType,1
6,3,0,9,mixedType,1
7,1,0,8,mixedType,1
2,8,0,10,mixedType,1
7,2,0,9,mixedType,1
13,3,0,16,mixedType,2
11,3,0,14,mixedType,2
22,1,1,24,mixedType,2
14,2,0,16,mixedType,2
9,3,0,12,mixedType,1
6,1,0,7,mixedType,0
6,4,0,10,mixedType,1
12,3,1,16,mixedType,2
5,2,0,7,mixedType,0
5,5,0,10,mixedType,1
9,2,0,11,mixedType,1
8,2,0,10,mixedType,1
2,6,0,8,mixedType,1
6,3,0,9,mixedType,1
6,4,0,10,mixedType,1
6,1,0,7,mixedType,0
15,1,0,16,mixedType,2
15,1,0,16,mixedType,2
3,5,0,8,mixedType,1
7,3,0,10,mixedType,1
7,1,0,8,mixedType,1
2,6,0,8,mixedType,1
7,3,0,10,mixedType,1
6,3,0,9,mixedType,1
7,3,0,10,mixedType,1
7,3,0,10,mixedType,1
11,2,0,13,mixedType,1
6,3,0,9,mixedType,1
8,3,0,11,mixedType,1
9,3,0,12,mixedType,1
11,3,0,14,mixedType,2
4,4,0,8,mixedType,1
6,2,0,8,mixedType,1
9,1,0,10,mixedType,1
4,4,0,8,mixedType,1
14,2,0,16,mixedType,2
7,3,0,10,mixedType,1
8,3,0,11,mixedType,1
8,3,0,11,mixedType,1
6,2,0,8,mixedType,1
4,6,0,10,mixedType,1
4,4,0,8,mixedType,1
8,4,0,12,mixedType,1
5,3,0,8,mixedType,1
7,3,0,10,mixedType,1
5,4,0,9,mixedType,1
2,4,0,6,mixedType,0
6,4,0,10,mixedType,1
8,3,0,11,mixedType,1
12,4,0,16,mixedType,2
7,6,0,13,mixedType,1
6,3,0,9,mixedType,1
6,3,0,9,mixedType,1
2,8,0,10,mixedType,1
7,3,0,10,mixedType,1
3,6,0,9,mixedType,1
6,4,0,10,mixedType,1
4,8,0,12,mixedType,1
15,1,0,16,mixedType,2
13,3,0,16,mixedType,2
5,4,0,9,mixedType,1
6,3,0,9,mixedType,1
5,1,0,6,mixedType,0
7,3,0,10,mixedType,1
15,1,0,16,mixedType,2
6,1,0,7,mixedType,0
7,2,0,9,mixedType,1
8,2,0,10,mixedType,1
5,3,0,8,mixedType,1
6,4,0,10,mixedType,1
6,3,0,9,mixedType,1
8,2,0,10,mixedType,1
1,8,0,9,mixedType,1
7,2,0,9,mixedType,1
8,1,0,9,mixedType,1
7,1,0,8,mixedType,1
10,2,0,12,mixedType,1
8,1,0,9,mixedType,1
4,4,0,8,mixedType,1
10,4,0,14,mixedType,2
3,7,0,10,mixedType,1
7,2,0,9,mixedType,1
2,6,0,8,mixedType,1
5,3,0,8,mixedType,1
5,2,0,7,mixedType,0
2,8,0,10,mixedType,1
1,10,0,11,mixedType,1
9,2,0,11,mixedType,1
8,0,1,9,mixedType,1
5,3,0,8,mixedType,1
8,2,0,10,mixedType,1
4,5,0,9,mixedType,1
14,2,0,16,mixedType,2
12,4,0,16,mixedType,2
4,2,0,6,mixedType,0
8,2,0,10,mixedType,1
8,2,0,10,mixedType,1
0,10,1,11,mixedType,1
6,3,0,9,mixedType,1
8,4,0,12,mixedType,1
2,7,0,9,mixedType,1
11,5,0,16,mixedType,2
9,1,0,10,mixedType,1
8,1,0,9,mixedType,1
5,3,0,8,mixedType,1
6,2,0,8,mixedType,1
4,6,0,10,mixedType,1
7,3,0,10,mixedType,1
5,4,0,9,mixedType,1
6,3,0,9,mixedType,1
5,3,0,8,mixedType,1
5,4,0,9,mixedType,1
5,1,0,6,mixedType,0
6,1,0,7,mixedType,0
6,3,0,9,mixedType,1
12,4,0,16,mixedType,2
11,0,1,12,mixedType,1
5,3,0,8,mixedType,1
5,4,0,9,mixedType,1
5,4,0,9,mixedType,1
5,2,0,7,mixedType,0
5,4,0,9,mixedType,1
3,6,0,9,mixedType,1
9,2,0,11,mixedType,1
7,1,0,8,mixedType,1
5,4,0,9,mixedType,1
5,2,0,7,mixedType,0
5,5,0,10,mixedType,1
8,1,0,9,mixedType,1
7,2,0,9,mixedType,1
1,8,0,9,mixedType,1
4,4,0,8,mixedType,1
7,1,0,8,mixedType,1
8,1,0,9,mixedType,1
12,3,0,15,mixedType,2
9,1,0,10,mixedType,1
3,6,0,9,mixedType,1
5,3,0,8,mixedType,1
8,2,0,10,mixedType,1
8,1,0,9,mixedType,1
8,2,0,10,mixedType,1
2,6,0,8,mixedType,1
7,3,0,10,mixedType,1
15,1,0,16,mixedType,2
4,6,0,10,mixedType,1
11,3,0,14,mixedType,2
7,3,0,10,mixedType,1
12,4,0,16,mixedType,2
6,3,0,9,mixedType,1
5,3,0,8,mixedType,1
4,4,0,8,mixedType,1
9,4,0,13,mixedType,1
8,2,0,10,mixedType,1
8,3,0,11,mixedType,1
16,1,1,18,mixedType,2
5,3,0,8,mixedType,1
1,8,0,9,mixedType,1
7,2,0,9,mixedType,1
5,4,0,9,mixedType,1
11,5,0,16,mixedType,2
1,9,0,10,mixedType,1
7,1,0,8,mixedType,1
7,1,0,8,mixedType,1
8,3,0,11,mixedType,1
4,2,0,6,mixedType,0
7,3,0,10,mixedType,1
8,3,0,11,mixedType,1
6,4,0,10,mixedType,1
6,2,0,8,mixedType,1
6,3,0,9,mixedType,1
5,4,0,9,mixedType,1
2,6,0,8,mixedType,1
6,3,0,9,mixedType,1
5,4,0,9,mixedType,1
6,3,0,9,mixedType,1
6,3,0,9,mixedType,1
4,6,0,10,mixedType,1
5,6,0,11,mixedType,1
6,4,0,10,mixedType,1
7,3,0,10,mixedType,1
6,1,0,7,mixedType,0
7,1,0,8,mixedType,1
6,3,0,9,mixedType,1
13,3,0,16,mixedType,2
11,2,0,13,mixedType,1
3,6,0,9,mixedType,1
14,1,0,15,mixedType,2
1,10,0,11,mixedType,1
6,6,0,12,mixedType,1
0,6,2,8,mixedType,1
3,6,0,9,mixedType,1
1,9,0,10,mixedType,1
7,2,0,9,mixedType,1
6,1,0,7,mixedType,0
5,1,0,6,mixedType,0
3,6,0,9,mixedType,1
14,2,0,16,mixedType,2
4,4,0,8,mixedType,1
7,3,0,10,mixedType,1
4,2,0,6,mixedType,0
7,4,0,11,mixedType,1
9,8,0,17,mixedType,2
7,2,0,9,mixedType,1
9,4,0,13,mixedType,1
7,3,0,10,mixedType,1
10,2,0,12,mixedType,1
12,3,0,15,mixedType,2
14,2,0,16,mixedType,2
7,2,0,9,mixedType,1
10,2,0,12,mixedType,1
6,1,0,7,mixedType,0
10,0,1,11,mixedType,1
9,3,0,12,mixedType,1
6,2,0,8,mixedType,1
8,3,0,11,mixedType,1
6,3,0,9,mixedType,1
11,3,0,14,mixedType,2
5,6,0,11,mixedType,1
7,2,0,9,mixedType,1
6,3,0,9,mixedType,1
6,1,0,7,mixedType,0
10,2,0,12,mixedType,1
14,1,0,15,mixedType,2
3,7,0,10,mixedType,1
2,8,0,10,mixedType,1
5,4,0,9,mixedType,1
7,3,0,10,mixedType,1
6,4,0,10,mixedType,1
5,3,0,8,mixedType,1
14,2,0,16,mixedType,2
3,6,0,9,mixedType,1
10,2,0,12,mixedType,1
6,2,0,8,mixedType,1
5,1,0,6,mixedType,0
7,3,0,10,mixedType,1
5,4,0,9,mixedType,1
5,3,0,8,mixedType,1
6,2,0,8,mixedType,1
10,3,0,13,mixedType,1
4,6,0,10,mixedType,1
7,2,0,9,mixedType,1
4,4,0,8,mixedType,1
11,1,0,12,mixedType,1
8,2,0,10,mixedType,1
5,1,0,6,mixedType,0
4,2,0,6,mixedType,0
6,4,0,10,mixedType,1
7,2,0,9,mixedType,1
5,1,0,6,mixedType,0
5,1,0,6,mixedType,0
4,4,0,8,mixedType,1
6,1,0,7,mixedType,0
6,0,0,6,sameType,0
8,1,0,9,mixedType,1
7,5,0,12,mixedType,1
5,2,0,7,mixedType,0
6,6,0,12,mixedType,1
4,4,0,8,mixedType,1
15,1,0,16,mixedType,2
7,3,0,10,mixedType,1
4,2,0,6,mixedType,0
6,3,0,9,mixedType,1
5,3,0,8,mixedType,1
6,3,0,9,mixedType,1
7,3,0,10,mixedType,1
7,1,0,8,mixedType,1
7,1,0,8,mixedType,1
7,2,0,9,mixedType,1
5,1,0,6,mixedType,0
14,2,0,16,mixedType,2
10,6,1,17,mixedType,2
6,1,0,7,mixedType,0
3,7,0,10,mixedType,1
11,5,0,16,mixedType,2
4,8,0,12,mixedType,1
4,4,0,8,mixedType,1
5,2,0,7,mixedType,0
5,4,0,9,mixedType,1
5,1,0,6,mixedType,0
7,1,0,8,mixedType,1
5,4,0,9,mixedType,1
7,3,0,10,mixedType,1
4,2,0,6,mixedType,0
8,1,0,9,mixedType,1
6,3,0,9,mixedType,1
5,3,0,8,mixedType,1
7,3,0,10,mixedType,1
1,11,0,12,mixedType,1
7,1,0,8,mixedType,1
4,6,0,10,mixedType,1
10,1,0,11,mixedType,1
6,2,0,8,mixedType,1
6,2,0,8,mixedType,1
5,1,0,6,mixedType,0
14,2,0,16,mixedType,2
7,2,0,9,mixedType,1
4,2,0,6,mixedType,0
6,3,0,9,mixedType,1
5,3,0,8,mixedType,1
5,1,0,6,mixedType,0
8,2,0,10,mixedType,1
8,1,0,9,mixedType,1
12,4,0,16,mixedType,2
8,2,0,10,mixedType,1
7,4,0,11,mixedType,1
9,3,0,12,mixedType,1
4,2,0,6,mixedType,0
8,4,0,12,mixedType,1
9,2,0,11,mixedType,1
6,3,0,9,mixedType,1
7,3,0,10,mixedType,1
7,2,0,9,mixedType,1
1,8,0,9,mixedType,1
13,3,0,16,mixedType,2
8,1,0,9,mixedType,1
7,4,0,11,mixedType,1
7,3,0,10,mixedType,1
6,4,0,10,mixedType,1
4,2,0,6,mixedType,0
5,2,0,7,mixedType,0
10,2,0,12,mixedType,1
5,4,0,9,mixedType,1
8,1,0,9,mixedType,1
5,4,0,9,mixedType,1
6,3,0,9,mixedType,1
6,3,0,9,mixedType,1
3,3,0,6,mixedType,0
8,1,0,9,mixedType,1
6,4,0,10,mixedType,1
7,1,0,8,mixedType,1
8,2,0,10,mixedType,1
7,3,0,10,mixedType,1
6,3,0,9,mixedType,1
8,2,0,10,mixedType,1
10,1,0,11,mixedType,1
6,1,0,7,mixedType,0
15,1,0,16,mixedType,2
12,3,0,15,mixedType,2
6,2,0,8,mixedType,1
7,2,0,9,mixedType,1
7,2,0,9,mixedType,1
6,4,0,10,mixedType,1
8,3,0,11,mixedType,1
7,2,0,9,mixedType,1
5,4,0,9,mixedType,1
6,3,0,9,mixedType,1
9,4,0,13,mixedType,1
5,2,0,7,mixedType,0
7,2,0,9,mixedType,1
6,6,0,12,mixedType,1
7,3,0,10,mixedType,1
6,6,0,12,mixedType,1
7,4,0,11,mixedType,1
8,3,0,11,mixedType,1
7,3,0,10,mixedType,1
7,3,0,10,mixedType,1
6,2,0,8,mixedType,1
10,1,0,11,mixedType,1
8,4,0,12,mixedType,1
3,7,0,10,mixedType,1
5,5,0,10,mixedType,1
6,1,0,7,mixedType,0
6,2,0,8,mixedType,1
3,5,0,8,mixedType,1
5,4,0,9,mixedType,1
3,6,0,9,mixedType,1
8,4,0,12,mixedType,1
4,2,0,6,mixedType,0
6,3,0,9,mixedType,1
9,3,0,12,mixedType,1
6,2,0,8,mixedType,1
6,4,0,10,mixedType,1
5,2,0,7,mixedType,0
5,2,0,7,mixedType,0
7,1,0,8,mixedType,1
7,2,0,9,mixedType,1
6,2,0,8,mixedType,1
6,3,0,9,mixedType,1
2,8,0,10,mixedType,1
7,2,0,9,mixedType,1
11,3,0,14,mixedType,2
6,2,0,8,mixedType,1
8,2,0,10,mixedType,1
5,2,0,7,mixedType,0
2,10,0,12,mixedType,1
6,1,0,7,mixedType,0
3,8,0,11,mixedType,1
8,1,0,9,mixedType,1
8,6,0,14,mixedType,2
3,7,0,10,mixedType,1
6,3,0,9,mixedType,1
8,1,0,9,mixedType,1
8,2,0,10,mixedType,1
12,3,0,15,mixedType,2
10,2,0,12,mixedType,1
5,2,0,7,mixedType,0
4,6,0,10,mixedType,1
7,3,0,10,mixedType,1
10,1,0,11,mixedType,1
5,2,0,7,mixedType,0
7,3,0,10,mixedType,1
3,6,0,9,mixedType,1
10,5,5,20,mixedType,2
7,1,0,8,mixedType,1
5,3,0,8,mixedType,1
5,3,0,8,mixedType,1
7,1,0,8,mixedType,1
5,3,0,8,mixedType,1
2,11,0,13,mixedType,1
10,2,0,12,mixedType,1
5,3,0,8,mixedType,1
5,4,0,9,mixedType,1
6,3,0,9,mixedType,1
1,9,0,10,mixedType,1
6,4,0,10,mixedType,1
8,1,0,9,mixedType,1
5,4,0,9,mixedType,1
4,4,0,8,mixedType,1
4,4,0,8,mixedType,1
7,2,0,9,mixedType,1
6,3,0,9,mixedType,1
3,5,0,8,mixedType,1
7,1,0,8,mixedType,1
6,4,0,10,mixedType,1
7,6,0,13,mixedType,1
5,4,0,9,mixedType,1
12,4,0,16,mixedType,2
4,2,0,6,mixedType,0
5,2,0,7,mixedType,0
4,5,0,9,mixedType,1
5,1,0,6,mixedType,0
8,4,0,12,mixedType,1
4,4,0,8,mixedType,1
14,2,0,16,mixedType,2
7,5,0,12,mixedType,1
3,8,0,11,mixedType,1
7,2,0,9,mixedType,1
14,2,0,16,mixedType,2
2,4,0,6,mixedType,0
3,8,0,11,mixedType,1
6,3,0,9,mixedType,1
6,2,0,8,mixedType,1
7,3,0,10,mixedType,1
7,3,0,10,mixedType,1
6,2,0,8,mixedType,1
5,5,0,10,mixedType,1
7,5,0,12,mixedType,1
15,1,0,16,mixedType,2
3,6,0,9,mixedType,1
6,1,0,7,mixedType,0
9,4,0,13,mixedType,1
8,1,0,9,mixedType,1
8,2,0,10,mixedType,1
7,3,0,10,mixedType,1
5,1,0,6,mixedType,0
5,5,0,10,mixedType,1
8,1,0,9,mixedType,1
6,3,0,9,mixedType,1
7,3,0,10,mixedType,1
6,1,0,7,mixedType,0
5,2,0,7,mixedType,0
3,6,0,9,mixedType,1
7,2,0,9,mixedType,1
7,3,0,10,mixedType,1
5,4,0,9,mixedType,1
13,3,0,16,mixedType,2
6,1,0,7,mixedType,0
7,3,0,10,mixedType,1
14,2,0,16,mixedType,2
6,3,0,9,mixedType,1
8,1,0,9,mixedType,1
6,2,0,8,mixedType,1
3,5,0,8,mixedType,1
6,2,0,8,mixedType,1
6,2,0,8,mixedType,1
7,3,0,10,mixedType,1
7,3,0,10,mixedType,1
6,2,0,8,mixedType,1
4,6,0,10,mixedType,1
4,4,0,8,mixedType,1
6,0,1,7,mixedType,0
3,8,0,11,mixedType,1
2,8,0,10,mixedType,1
9,1,0,10,mixedType,1
5,2,0,7,mixedType,0
3,5,0,8,mixedType,1
8,2,0,10,mixedType,1
9,3,0,12,mixedType,1
8,3,0,11,mixedType,1
7,2,0,9,mixedType,1
7,3,0,10,mixedType,1
4,6,0,10,mixedType,1
6,2,0,8,mixedType,1
15,1,0,16,mixedType,2
9,1,0,10,mixedType,1
6,2,0,8,mixedType,1
7,3,0,10,mixedType,1
7,1,0,8,mixedType,1
3,6,0,9,mixedType,1
5,2,0,7,mixedType,0
15,1,0,16,mixedType,2
11,3,0,14,mixedType,2
5,2,0,7,mixedType,0
8,4,0,12,mixedType,1
7,3,0,10,mixedType,1
8,2,0,10,mixedType,1
14,2,0,16,mixedType,2
2,4,0,6,mixedType,0
9,1,0,10,mixedType,1
7,3,0,10,mixedType,1
11,1,0,12,mixedType,1
6,2,0,8,mixedType,1
5,1,0,6,mixedType,0
9,3,0,12,mixedType,1
11,3,0,14,mixedType,2
6,2,0,8,mixedType,1
6,1,0,7,mixedType,0
6,0,1,7,mixedType,0
6,3,0,9,mixedType,1
3,8,3,14,mixedType,2
10,1,0,11,mixedType,1
3,6,0,9,mixedType,1
5,4,0,9,mixedType,1
5,2,0,7,mixedType,0
2,8,0,10,mixedType,1
7,2,0,9,mixedType,1
8,1,0,9,mixedType,1
12,4,0,16,mixedType,2
3,5,0,8,mixedType,1
6,1,0,7,mixedType,0
14,2,0,16,mixedType,2
13,3,0,16,mixedType,2
13,3,0,16,mixedType,2
15,1,0,16,mixedType,2
6,4,0,10,mixedType,1
7,3,0,10,mixedType,1
8,2,0,10,mixedType,1
5,3,0,8,mixedType,1
7,4,0,11,mixedType,1
5,3,0,8,mixedType,1
2,4,0,6,mixedType,0
7,6,0,13,mixedType,1
5,6,0,11,mixedType,1
12,3,0,15,mixedType,2
5,3,0,8,mixedType,1
6,3,0,9,mixedType,1
6,3,0,9,mixedType,1
6,4,0,10,mixedType,1
7,3,0,10,mixedType,1
6,1,0,7,mixedType,0
8,2,0,10,mixedType,1
6,3,0,9,mixedType,1
9,2,0,11,mixedType,1
16,1,1,18,mixedType,2
5,2,0,7,mixedType,0
7,3,0,10,mixedType,1
14,2,0,16,mixedType,2
7,2,0,9,mixedType,1
7,3,0,10,mixedType,1
6,4,0,10,mixedType,1
5,2,0,7,mixedType,0
9,2,0,11,mixedType,1
6,3,0,9,mixedType,1
6,3,0,9,mixedType,1
7,4,0,11,mixedType,1
4,4,0,8,mixedType,1
12,3,0,15,mixedType,2
8,1,0,9,mixedType,1
9,1,0,10,mixedType,1
2,8,0,10,mixedType,1
4,4,0,8,mixedType,1
4,2,0,6,mixedType,0
4,2,0,6,mixedType,0
7,2,0,9,mixedType,1
10,1,0,11,mixedType,1
7,4,0,11,mixedType,1
8,2,0,10,mixedType,1
3,6,0,9,mixedType,1
10,3,0,13,mixedType,1
6,4,0,10,mixedType,1
6,2,0,8,mixedType,1
13,3,0,16,mixedType,2
2,7,0,9,mixedType,1
10,2,0,12,mixedType,1
6,3,0,9,mixedType,1
9,2,0,11,mixedType,1
13,3,0,16,mixedType,2
8,1,0,9,mixedType,1
9,1,0,10,mixedType,1
9,2,0,11,mixedType,1
13,3,0,16,mixedType,2
7,3,0,10,mixedType,1
8,1,0,9,mixedType,1
8,1,0,9,mixedType,1
1,9,0,10,mixedType,1
8,1,0,9,mixedType,1
4,4,0,8,mixedType,1
5,4,0,9,mixedType,1
5,4,0,9,mixedType,1
8,2,0,10,mixedType,1
6,3,0,9,mixedType,1
6,1,0,7,mixedType,0
6,3,0,9,mixedType,1
4,2,0,6,mixedType,0
6,4,0,10,mixedType,1
9,2,0,11,mixedType,1
7,3,0,10,mixedType,1
7,4,0,11,mixedType,1
4,5,0,9,mixedType,1
6,3,0,9,mixedType,1
2,7,0,9,mixedType,1
8,1,0,9,mixedType,1
6,4,0,10,mixedType,1
1,10,0,11,mixedType,1
5,2,0,7,mixedType,0
9,1,0,10,mixedType,1
1,10,0,11,mixedType,1
13,3,0,16,mixedType,2
7,3,0,10,mixedType,1
11,3,0,14,mixedType,2
4,8,0,12,mixedType,1
15,1,0,16,mixedType,2
7,2,0,9,mixedType,1
3,6,0,9,mixedType,1
1,10,0,11,mixedType,1
7,4,0,11,mixedType,1
7,3,0,10,mixedType,1
1,7,0,8,mixedType,1
5,5,0,10,mixedType,1
7,2,0,9,mixedType,1
12,3,0,15,mixedType,2
6,2,0,8,mixedType,1
9,2,0,11,mixedType,1
7,3,0,10,mixedType,1
6,5,0,11,mixedType,1
2,6,0,8,mixedType,1
1,8,0,9,mixedType,1
8,1,0,9,mixedType,1
1,5,0,6,mixedType,0
7,3,0,10,mixedType,1
3,6,0,9,mixedType,1
5,3,0,8,mixedType,1
8,5,0,13,mixedType,1
2,6,0,8,mixedType,1
5,3,0,8,mixedType,1
6,3,0,9,mixedType,1
6,1,0,7,mixedType,0
7,2,0,9,mixedType,1
6,2,0,8,mixedType,1
5,4,0,9,mixedType,1
14,2,0,16,mixedType,2
14,2,0,16,mixedType,2
7,2,0,9,mixedType,1
6,3,0,9,mixedType,1
9,2,0,11,mixedType,1
3,6,0,9,mixedType,1
7,2,0,9,mixedType,1
7,1,0,8,mixedType,1
6,4,0,10,mixedType,1
8,2,0,10,mixedType,1
6,4,0,10,mixedType,1
2,6,0,8,mixedType,1
8,3,0,11,mixedType,1
5,2,0,7,mixedType,0
15,1,0,16,mixedType,2
2,6,0,8,mixedType,1
8,2,0,10,mixedType,1
7,2,0,9,mixedType,1
7,1,0,8,mixedType,1
7,2,0,9,mixedType,1
5,3,0,8,mixedType,1
2,6,0,8,mixedType,1
10,2,2,14,mixedType,2
6,3,0,9,mixedType,1
8,2,0,10,mixedType,1
8,2,0,10,mixedType,1
5,1,0,6,mixedType,0
5,4,0,9,mixedType,1
8,2,0,10,mixedType,1
7,1,0,8,mixedType,1
7,3,0,10,mixedType,1
6,3,0,9,mixedType,1
7,4,0,11,mixedType,1
7,1,0,8,mixedType,1
13,3,0,16,mixedType,2
7,2,0,9,mixedType,1
9,3,0,12,mixedType,1
8,2,0,10,mixedType,1
6,4,0,10,mixedType,1
6,3,0,9,mixedType,1
6,4,0,10,mixedType,1
11,1,0,12,mixedType,1
6,2,0,8,mixedType,1
9,1,0,10,mixedType,1
7,3,0,10,mixedType,1
15,1,0,16,mixedType,2
5,2,0,7,mixedType,0
7,1,0,8,mixedType,1
1,7,0,8,mixedType,1
5,1,0,6,mixedType,0
4,6,0,10,mixedType,1
10,4,0,14,mixedType,2
13,1,1,15,mixedType,2
7,2,0,9,mixedType,1
14,2,0,16,mixedType,2
0,10,1,11,mixedType,1
9,1,0,10,mixedType,1
5,2,0,7,mixedType,0
2,4,0,6,mixedType,0
6,4,0,10,mixedType,1
5,3,0,8,mixedType,1
7,2,0,9,mixedType,1
6,3,0,9,mixedType,1
5,6,0,11,mixedType,1
6,3,0,9,mixedType,1
3,3,0,6,mixedType,0
7,1,0,8,mixedType,1
6,2,0,8,mixedType,1
7,3,0,10,mixedType,1
10,6,0,16,mixedType,2
4,5,0,9,mixedType,1
14,2,0,16,mixedType,2
6,2,0,8,mixedType,1
6,2,0,8,mixedType,1
4,2,0,6,mixedType,0
3,7,0,10,mixedType,1
5,4,0,9,mixedType,1
10,2,0,12,mixedType,1
8,7,0,15,mixedType,2
3,4,0,7,mixedType,0
4,4,0,8,mixedType,1
7,1,0,8,mixedType,1
4,4,1,9,mixedType,1
7,2,0,9,mixedType,1
7,3,0,10,mixedType,1
2,8,0,10,mixedType,1
6,3,0,9,mixedType,1
6,2,0,8,mixedType,1
8,1,0,9,mixedType,1
7,2,0,9,mixedType,1
15,1,0,16,mixedType,2
4,8,0,12,mixedType,1
7,4,0,11,mixedType,1
7,4,0,11,mixedType,1
13,3,0,16,mixedType,2
8,1,0,9,mixedType,1
6,4,0,10,mixedType,1
11,3,0,14,mixedType,2
6,3,0,9,mixedType,1
6,6,0,12,mixedType,1
4,4,0,8,mixedType,1
6,3,0,9,mixedType,1
8,2,0,10,mixedType,1
4,5,0,9,mixedType,1
4,4,0,8,mixedType,1
8,1,0,9,mixedType,1
6,4,0,10,mixedType,1
5,3,0,8,mixedType,1
7,1,0,8,mixedType,1
9,2,0,11,mixedType,1
5,2,0,7,mixedType,0
12,3,0,15,mixedType,2
9,2,0,11,mixedType,1
14,3,0,17,mixedType,2
6,2,0,8,mixedType,1
11,1,0,12,mixedType,1
7,3,0,10,mixedType,1
7,3,0,10,mixedType,1
7,2,0,9,mixedType,1
11,5,0,16,mixedType,2
6,2,0,8,mixedType,1
5,1,0,6,mixedType,0
6,2,0,8,mixedType,1
7,2,0,9,mixedType,1
7,1,0,8,mixedType,1
6,3,0,9,mixedType,1
5,3,0,8,mixedType,1
5,1,0,6,mixedType,0
5,4,0,9,mixedType,1
8,5,0,13,mixedType,1
7,2,0,9,mixedType,1
7,2,0,9,mixedType,1
5,4,0,9,mixedType,1
7,6,0,13,mixedType,1
3,5,0,8,mixedType,1
7,3,0,10,mixedType,1
5,5,0,10,mixedType,1
8,1,0,9,mixedType,1
6,3,0,9,mixedType,1
2,8,0,10,mixedType,1
3,7,0,10,mixedType,1
6,1,0,7,mixedType,0
6,4,0,10,mixedType,1
4,8,0,12,mixedType,1
7,3,0,10,mixedType,1
13,3,0,16,mixedType,2
4,4,0,8,mixedType,1
7,4,0,11,mixedType,1
7,3,0,10,mixedType,1
7,3,0,10,mixedType,1
3,6,0,9,mixedType,1
3,5,0,8,mixedType,1
10,1,0,11,mixedType,1
5,2,0,7,mixedType,0
5,3,0,8,mixedType,1
3,6,0,9,mixedType,1
5,4,0,9,mixedType,1
14,2,0,16,mixedType,2
7,1,0,8,mixedType,1
14,2,0,16,mixedType,2
6,4,0,10,mixedType,1
8,2,0,10,mixedType,1
5,3,0,8,mixedType,1
7,1,0,8,mixedType,1
4,2,0,6,mixedType,0
9,2,0,11,mixedType,1
4,5,0,9,mixedType,1
6,6,0,12,mixedType,1
5,4,0,9,mixedType,1
4,0,2,6,mixedType,0
6,1,0,7,mixedType,0
9,2,0,11,mixedType,1
5,2,0,7,mixedType,0
2,6,0,8,mixedType,1
6,3,0,9,mixedType,1
4,6,0,10,mixedType,1
4,2,0,6,mixedType,0
1,9,0,10,mixedType,1
6,4,0,10,mixedType,1
6,3,0,9,mixedType,1
7,1,0,8,mixedType,1
14,2,0,16,mixedType,2
5,1,0,6,mixedType,0
14,2,0,16,mixedType,2
5,3,0,8,mixedType,1
6,2,0,8,mixedType,1
6,4,0,10,mixedType,1
6,1,0,7,mixedType,0
6,1,0,7,mixedType,0
6,1,0,7,mixedType,0
9,0,2,11,mixedType,1
6,3,0,9,mixedType,1
6,4,0,10,mixedType,1
6,3,0,9,mixedType,1
11,3,0,14,mixedType,2
15,1,0,16,mixedType,2
6,2,0,8,mixedType,1
13,2,1,16,mixedType,2
6,1,0,7,mixedType,0
15,1,0,16,mixedType,2
4,4,0,8,mixedType,1
3,5,0,8,mixedType,1
7,3,0,10,mixedType,1
5,3,0,8,mixedType,1
5,4,0,9,mixedType,1
8,2,0,10,mixedType,1
5,5,0,10,mixedType,1
6,4,0,10,mixedType,1
6,1,0,7,mixedType,0
6,3,0,9,mixedType,1
5,2,0,7,mixedType,0
8,2,0,10,mixedType,1
7,2,0,9,mixedType,1
9,3,0,12,mixedType,1
6,3,0,9,mixedType,1
9,3,0,12,mixedType,1
9,4,0,13,mixedType,1
7,1,0,8,mixedType,1
4,4,0,8,mixedType,1
5,2,0,7,mixedType,0
13,3,0,16,mixedType,2
8,2,0,10,mixedType,1
13,3,0,16,mixedType,2
4,6,0,10,mixedType,1
8,2,0,10,mixedType,1
9,2,0,11,mixedType,1
2,6,0,8,mixedType,1
8,1,0,9,mixedType,1
7,2,0,9,mixedType,1
9,1,0,10,mixedType,1
2,8,0,10,mixedType,1
5,4,0,9,mixedType,1
6,5,0,11,mixedType,1
5,4,0,9,mixedType,1
9,2,0,11,mixedType,1
7,3,0,10,mixedType,1
5,2,0,7,mixedType,0
7,3,0,10,mixedType,1
6,3,0,9,mixedType,1
6,3,0,9,mixedType,1
6,6,0,12,mixedType,1
2,7,0,9,mixedType,1
12,4,0,16,mixedType,2
4,4,0,8,mixedType,1
6,3,0,9,mixedType,1
6,4,0,10,mixedType,1
8,4,0,12,mixedType,1
5,4,0,9,mixedType,1
8,2,0,10,mixedType,1
7,2,0,9,mixedType,1
6,4,0,10,mixedType,1
14,2,0,16,mixedType,2
7,2,0,9,mixedType,1
7,5,0,12,mixedType,1
7,2,0,9,mixedType,1
2,7,0,9,mixedType,1
9,3,0,12,mixedType,1
5,3,0,8,mixedType,1
8,2,0,10,mixedType,1
4,12,0,16,mixedType,2
6,2,0,8,mixedType,1
12,3,0,15,mixedType,2
1,8,0,9,mixedType,1
8,4,2,14,mixedType,2
8,3,0,11,mixedType,1
7,3,0,10,mixedType,1
3,7,0,10,mixedType,1
6,2,0,8,mixedType,1
9,3,3,15,mixedType,2
7,1,0,8,mixedType,1
6,2,0,8,mixedType,1
7,2,0,9,mixedType,1
2,8,0,10,mixedType,1
5,4,0,9,mixedType,1
3,8,0,11,mixedType,1
7,4,0,11,mixedType,1
6,2,0,8,mixedType,1
13,3,0,16,mixedType,2
7,3,0,10,mixedType,1
15,1,0,16,mixedType,2
1,7,0,8,mixedType,1
4,4,0,8,mixedType,1
7,4,0,11,mixedType,1
7,3,0,10,mixedType,1
14,2,0,16,mixedType,2
11,3,0,14,mixedType,2
6,1,0,7,mixedType,0
4,4,0,8,mixedType,1
13,3,0,16,mixedType,2
8,1,0,9,mixedType,1
8,1,0,9,mixedType,1
5,3,0,8,mixedType,1
7,1,0,8,mixedType,1
5,3,0,8,mixedType,1
8,3,0,11,mixedType,1
7,2,0,9,mixedType,1
7,2,0,9,mixedType,1
1,11,0,12,mixedType,1
7,3,0,10,mixedType,1
5,8,0,13,mixedType,1
7,2,0,9,mixedType,1
13,3,0,16,mixedType,2
8,1,0,9,mixedType,1
7,3,0,10,mixedType,1
6,7,0,13,mixedType,1
7,3,0,10,mixedType,1
4,2,0,6,mixedType,0
3,6,0,9,mixedType,1
9,1,0,10,mixedType,1
7,2,0,9,mixedType,1
7,3,0,10,mixedType,1
13,3,0,16,mixedType,2
6,4,0,10,mixedType,1
6,4,0,10,mixedType,1
7,1,0,8,mixedType,1
0,7,2,9,mixedType,1
12,3,0,15,mixedType,2
8,2,0,10,mixedType,1
14,2,0,16,mixedType,2
8,1,0,9,mixedType,1
8,1,0,9,mixedType,1
9,2,0,11,mixedType,1
8,3,0,11,mixedType,1
7,2,0,9,mixedType,1
6,4,0,10,mixedType,1
7,3,0,10,mixedType,1
12,0,1,13,mixedType,1
13,3,0,16,mixedType,2
14,2,0,16,mixedType,2
9,2,0,11,mixedType,1
7,1,0,8,mixedType,1
7,2,0,9,mixedType,1
8,4,0,12,mixedType,1
6,1,0,7,mixedType,0
7,3,0,10,mixedType,1
5,1,0,6,mixedType,0
6,2,0,8,mixedType,1
6,3,0,9,mixedType,1
3,6,0,9,mixedType,1
10,6,0,16,mixedType,2
7,1,0,8,mixedType,1
7,3,0,10,mixedType,1
6,3,0,9,mixedType,1
6,1,0,7,mixedType,0
6,1,0,7,mixedType,0
6,1,0,7,mixedType,0
6,4,0,10,mixedType,1
7,2,0,9,mixedType,1
6,2,0,8,mixedType,1
7,1,0,8,mixedType,1
12,4,0,16,mixedType,2
6,3,0,9,mixedType,1
8,2,0,10,mixedType,1
14,2,0,16,mixedType,2
6,3,0,9,mixedType,1
14,3,0,17,mixedType,2
6,3,0,9,mixedType,1
3,7,0,10,mixedType,1
7,3,0,10,mixedType,1
15,1,1,17,mixedType,2
8,1,0,9,mixedType,1
9,1,0,10,mixedType,1
10,3,0,13,mixedType,1
11,1,0,12,mixedType,1
7,2,0,9,mixedType,1
7,2,0,9,mixedType,1
5,2,0,7,mixedType,0
6,2,0,8,mixedType,1
4,5,0,9,mixedType,1
5,6,0,11,mixedType,1
8,4,0,12,mixedType,1
10,2,0,12,mixedType,1
7,6,0,13,mixedType,1
1,9,0,10,mixedType,1
6,4,0,10,mixedType,1
6,3,0,9,mixedType,1
3,7,0,10,mixedType,1
5,3,0,8,mixedType,1
3,6,0,9,mixedType,1
8,3,0,11,mixedType,1
4,2,0,6,mixedType,0
7,3,0,10,mixedType,1
5,3,0,8,mixedType,1
5,4,0,9,mixedType,1
6,3,0,9,mixedType,1
6,4,0,10,mixedType,1
4,2,0,6,mixedType,0
6,1,0,7,mixedType,0
5,4,0,9,mixedType,1
6,3,0,9,mixedType,1
4,4,0,8,mixedType,1
5,4,0,9,mixedType,1
7,3,0,10,mixedType,1
5,4,0,9,mixedType,1
6,2,0,8,mixedType,1
14,2,0,16,mixedType,2
13,2,0,15,mixedType,2
8,1,0,9,mixedType,1
6,2,0,8,mixedType,1
7,4,0,11,mixedType,1
6,3,0,9,mixedType,1
6,6,0,12,mixedType,1
5,4,0,9,mixedType,1
6,1,0,7,mixedType,0
11,3,0,14,mixedType,2
13,3,0,16,mixedType,2
2,6,0,8,mixedType,1
11,5,0,16,mixedType,2
15,1,0,16,mixedType,2
4,2,0,6,mixedType,0
3,3,0,6,mixedType,0
7,6,0,13,mixedType,1
4,6,0,10,mixedType,1
6,3,0,9,mixedType,1
8,1,0,9,mixedType,1
4,4,0,8,mixedType,1
11,1,0,12,mixedType,1
8,2,0,10,mixedType,1
6,2,0,8,mixedType,1
6,3,0,9,mixedType,1
5,3,0,8,mixedType,1
6,2,0,8,mixedType,1
6,1,0,7,mixedType,0
6,1,0,7,mixedType,0
15,1,0,16,mixedType,2
4,2,0,6,mixedType,0
3,7,0,10,mixedType,1
5,2,0,7,mixedType,0
1,8,0,9,mixedType,1
4,2,0,6,mixedType,0
2,8,0,10,mixedType,1
8,4,0,12,mixedType,1
7,3,0,10,mixedType,1
8,2,0,10,mixedType,1
6,3,0,9,mixedType,1
7,3,0,10,mixedType,1
6,3,0,9,mixedType,1
3,6,0,9,mixedType,1
5,1,0,6,mixedType,0
2,0,8,10,mixedType,0
5,4,0,9,mixedType,1
8,3,0,11,mixedType,1
6,1,0,7,mixedType,0
9,1,0,10,mixedType,1
6,3,0,9,mixedType,1
6,3,0,9,mixedType,1
8,3,0,11,mixedType,1
7,6,0,13,mixedType,1
7,3,0,10,mixedType,1
6,3,0,9,mixedType,1
12,3,0,15,mixedType,2
2,8,0,10,mixedType,1
14,2,0,16,mixedType,2
3,5,0,8,mixedType,1
6,3,0,9,mixedType,1
5,6,0,11,mixedType,1
6,1,0,7,mixedType,0
5,5,0,10,mixedType,1
3,6,0,9,mixedType,1
12,3,0,15,mixedType,2
3,6,0,9,mixedType,1
10,3,0,13,mixedType,1
9,1,0,10,mixedType,1
8,3,0,11,mixedType,1
7,2,0,9,mixedType,1
5,2,0,7,mixedType,0
4,9,0,13,mixedType,1
6,2,0,8,mixedType,1
4,4,0,8,mixedType,1
5,6,0,11,mixedType,1
5,2,0,7,mixedType,0
4,2,0,6,mixedType,0
5,4,0,9,mixedType,1
15,1,0,16,mixedType,2
7,3,0,10,mixedType,1
5,2,0,7,mixedType,0
6,1,0,7,mixedType,0
7,2,0,9,mixedType,1
12,4,0,16,mixedType,2
4,5,0,9,mixedType,1
7,3,0,10,mixedType,1
7,2,0,9,mixedType,1
6,2,0,8,mixedType,1
6,1,0,7,mixedType,0
9,2,0,11,mixedType,1
1,9,0,10,mixedType,1
6,3,0,9,mixedType,1
8,2,0,10,mixedType,1
13,3,0,16,mixedType,2
5,4,0,9,mixedType,1
7,2,0,9,mixedType,1
7,2,0,9,mixedType,1
9,1,0,10,mixedType,1
9,4,0,13,mixedType,1
7,2,0,9,mixedType,1
4,4,0,8,mixedType,1
5,6,0,11,mixedType,1
6,1,0,7,mixedType,0
5,4,0,9,mixedType,1
8,2,0,10,mixedType,1
6,3,0,9,mixedType,1
7,1,0,8,mixedType,1
3,6,0,9,mixedType,1
15,1,0,16,mixedType,2
2,12,0,14,mixedType,2
5,3,0,8,mixedType,1
2,11,0,13,mixedType,1
6,4,0,10,mixedType,1
8,1,0,9,mixedType,1
8,3,0,11,mixedType,1
10,1,0,11,mixedType,1
10,2,0,12,mixedType,1
6,4,0,10,mixedType,1
7,3,0,10,mixedType,1
7,2,0,9,mixedType,1
5,3,0,8,mixedType,1
4,4,0,8,mixedType,1
7,2,0,9,mixedType,1
11,5,0,16,mixedType,2
5,2,0,7,mixedType,0
3,7,0,10,mixedType,1
5,2,0,7,mixedType,0
6,2,0,8,mixedType,1
14,2,0,16,mixedType,2
4,0,4,8,mixedType,1
8,2,0,10,mixedType,1
11,0,1,12,mixedType,1
7,3,0,10,mixedType,1
7,1,0,8,mixedType,1
7,2,0,9,mixedType,1
7,2,0,9,mixedType,1
6,2,0,8,mixedType,1
7,2,0,9,mixedType,1
7,3,0,10,mixedType,1
4,2,0,6,mixedType,0
4,6,0,10,mixedType,1
7,2,0,9,mixedType,1
6,3,0,9,mixedType,1
3,3,0,6,mixedType,0
8,4,0,12,mixedType,1
5,3,0,8,mixedType,1
6,2,0,8,mixedType,1
13,3,0,16,mixedType,2
5,5,0,10,mixedType,1
7,3,0,10,mixedType,1
2,4,0,6,mixedType,0
5,3,0,8,mixedType,1
9,1,0,10,mixedType,1
5,2,0,7,mixedType,0
8,2,0,10,mixedType,1
4,4,0,8,mixedType,1
6,4,0,10,mixedType,1
7,2,0,9,mixedType,1
6,3,0,9,mixedType,1
8,2,0,10,mixedType,1
6,1,0,7,mixedType,0
8,3,0,11,mixedType,1
12,3,0,15,mixedType,2
9,2,0,11,mixedType,1
11,3,0,14,mixedType,2
6,3,0,9,mixedType,1
13,3,0,16,mixedType,2
2,6,0,8,mixedType,1
4,2,0,6,mixedType,0
5,3,0,8,mixedType,1
6,2,0,8,mixedType,1
5,2,0,7,mixedType,0
7,2,0,9,mixedType,1
7,3,0,10,mixedType,1
3,7,0,10,mixedType,1
6,2,0,8,mixedType,1
6,4,0,10,mixedType,1
8,1,0,9,mixedType,1
6,6,0,12,mixedType,1
11,4,0,15,mixedType,2
14,2,0,16,mixedType,2
6,4,0,10,mixedType,1
8,2,0,10,mixedType,1
6,3,0,9,mixedType,1
14,2,0,16,mixedType,2
7,3,0,10,mixedType,1
8,1,0,9,mixedType,1
15,1,0,16,mixedType,2
5,2,0,7,mixedType,0
6,1,0,7,mixedType,0
8,2,0,10,mixedType,1
8,2,0,10,mixedType,1
8,3,0,11,mixedType,1
8,4,0,12,mixedType,1
7,3,0,10,mixedType,1
7,2,0,9,mixedType,1
1,8,0,9,mixedType,1
5,1,0,6,mixedType,0
5,3,0,8,mixedType,1
14,2,0,16,mixedType,2
7,6,0,13,mixedType,1
5,2,0,7,mixedType,0
8,2,0,10,mixedType,1
8,1,0,9,mixedType,1
7,3,0,10,mixedType,1
3,5,0,8,mixedType,1
8,2,0,10,mixedType,1
5,1,0,6,mixedType,0
6,2,0,8,mixedType,1
6,2,0,8,mixedType,1
6,5,0,11,mixedType,1
8,1,0,9,mixedType,1
3,6,0,9,mixedType,1
15,1,0,16,mixedType,2
9,3,0,12,mixedType,1
7,3,0,10,mixedType,1
7,3,0,10,mixedType,1
2,6,0,8,mixedType,1
11,5,0,16,mixedType,2
7,3,0,10,mixedType,1
6,3,0,9,mixedType,1
2,6,0,8,mixedType,1
9,1,0,10,mixedType,1
2,7,0,9,mixedType,1
6,3,0,9,mixedType,1
14,2,0,16,mixedType,2
5,2,0,7,mixedType,0
12,1,0,13,mixedType,1
4,2,0,6,mixedType,0
4,2,0,6,mixedType,0
7,3,0,10,mixedType,1
8,4,0,12,mixedType,1
1,8,0,9,mixedType,1
4,2,0,6,mixedType,0
7,2,0,9,mixedType,1
6,3,0,9,mixedType,1
7,3,0,10,mixedType,1
8,0,1,9,mixedType,1
10,1,0,11,mixedType,1
5,4,0,9,mixedType,1
5,3,0,8,mixedType,1
5,3,0,8,mixedType,1
8,1,0,9,mixedType,1
4,6,0,10,mixedType,1
5,2,0,7,mixedType,0
6,3,0,9,mixedType,1
13,3,0,16,mixedType,2
3,6,0,9,mixedType,1
9,1,0,10,mixedType,1
5,4,0,9,mixedType,1
5,3,0,8,mixedType,1
7,1,0,8,mixedType,1
9,2,0,11,mixedType,1
8,2,0,10,mixedType,1
6,3,0,9,mixedType,1
7,3,0,10,mixedType,1
9,2,0,11,mixedType,1
8,2,0,10,mixedType,1
9,4,0,13,mixedType,1
6,3,0,9,mixedType,1
12,4,0,16,mixedType,2
8,3,0,11,mixedType,1
8,1,0,9,mixedType,1
7,4,0,11,mixedType,1
8,1,0,9,mixedType,1
5,4,0,9,mixedType,1
6,2,0,8,mixedType,1
7,2,0,9,mixedType,1
9,1,0,10,mixedType,1
15,1,0,16,mixedType,2
6,3,0,9,mixedType,1
3,6,0,9,mixedType,1
7,3,0,10,mixedType,1
4,5,0,9,mixedType,1
7,3,0,10,mixedType,1
11,5,0,16,mixedType,2
9,0,1,10,mixedType,1
14,2,0,16,mixedType,2
9,1,0,10,mixedType,1
3,6,0,9,mixedType,1
9,1,0,10,mixedType,1
7,3,0,10,mixedType,1
7,8,1,16,mixedType,2
6,4,0,10,mixedType,1
6,3,0,9,mixedType,1
7,2,0,9,mixedType,1
5,3,0,8,mixedType,1
1,8,0,9,mixedType,1
14,2,0,16,mixedType,2
11,3,0,14,mixedType,2
9,3,0,12,mixedType,1
5,1,0,6,mixedType,0
11,1,0,12,mixedType,1
4,2,0,6,mixedType,0
7,3,0,10,mixedType,1
1,8,0,9,mixedType,1
5,4,0,9,mixedType,1
15,1,0,16,mixedType,2
4,2,0,6,mixedType,0
8,3,0,11,mixedType,1
8,2,0,10,mixedType,1
6,4,0,10,mixedType,1
4,2,0,6,mixedType,0
5,3,0,8,mixedType,1
14,2,0,16,mixedType,2
8,1,0,9,mixedType,1
4,4,0,8,mixedType,1
14,2,0,16,mixedType,2
1,9,0,10,mixedType,1
1,8,0,9,mixedType,1
9,2,0,11,mixedType,1
6,3,0,9,mixedType,1
5,4,0,9,mixedType,1
9,4,0,13,mixedType,1
9,3,0,12,mixedType,1
6,3,0,9,mixedType,1
8,2,0,10,mixedType,1
6,1,0,7,mixedType,0
13,3,0,16,mixedType,2
7,6,0,13,mixedType,1
6,3,0,9,mixedType,1
5,8,0,13,mixedType,1
9,1,0,10,mixedType,1
8,1,0,9,mixedType,1
9,4,0,13,mixedType,1
7,1,0,8,mixedType,1
3,4,0,7,mixedType,0
8,2,0,10,mixedType,1
2,8,0,10,mixedType,1
2,6,0,8,mixedType,1
7,2,0,9,mixedType,1
9,1,0,10,mixedType,1
5,2,0,7,mixedType,0
8,1,0,9,mixedType,1
6,4,0,10,mixedType,1
11,2,0,13,mixedType,1
2,8,0,10,mixedType,1
5,2,0,7,mixedType,0
6,2,0,8,mixedType,1
6,1,0,7,mixedType,0
4,6,0,10,mixedType,1
7,2,0,9,mixedType,1
4,8,0,12,mixedType,1
7,2,0,9,mixedType,1
7,3,0,10,mixedType,1
7,3,0,10,mixedType,1
8,1,0,9,mixedType,1
5,4,0,9,mixedType,1
6,3,0,9,mixedType,1
5,4,0,9,mixedType,1
2,4,0,6,mixedType,0
7,4,0,11,mixedType,1
7,1,0,8,mixedType,1
4,2,0,6,mixedType,0
9,1,0,10,mixedType,1
4,4,0,8,mixedType,1
5,2,0,7,mixedType,0
7,2,0,9,mixedType,1
4,4,0,8,mixedType,1
4,4,0,8,mixedType,1
5,2,0,7,mixedType,0
4,6,0,10,mixedType,1
5,3,0,8,mixedType,1
12,3,0,15,mixedType,2
8,1,0,9,mixedType,1
9,2,0,11,mixedType,1
5,4,0,9,mixedType,1
2,6,0,8,mixedType,1
7,1,0,8,mixedType,1
8,4,0,12,mixedType,1
6,3,0,9,mixedType,1
6,2,0,8,mixedType,1
7,2,0,9,mixedType,1
5,2,0,7,mixedType,0
8,6,1,15,mixedType,2
5,3,0,8,mixedType,1
6,4,0,10,mixedType,1
15,1,0,16,mixedType,2
4,6,0,10,mixedType,1
11,5,0,16,mixedType,2
7,2,0,9,mixedType,1
5,7,0,12,mixedType,1
4,8,0,12,mixedType,1
3,6,0,9,mixedType,1
6,2,0,8,mixedType,1
4,2,0,6,mixedType,0
8,2,0,10,mixedType,1
8,2,0,10,mixedType,1
2,10,0,12,mixedType,1
5,3,0,8,mixedType,1
6,1,0,7,mixedType,0
7,8,0,15,mixedType,2
1,9,0,10,mixedType,1
6,2,0,8,mixedType,1
8,1,0,9,mixedType,1
12,0,1,13,mixedType,1
3,4,0,7,mixedType,0
4,6,0,10,mixedType,1
5,4,0,9,mixedType,1
8,3,0,11,mixedType,1
2,4,0,6,mixedType,0
3,5,0,8,mixedType,1
15,1,0,16,mixedType,2
8,1,0,9,mixedType,1
5,3,0,8,mixedType,1
3,5,0,8,mixedType,1
14,2,0,16,mixedType,2
8,6,0,14,mixedType,2
5,3,0,8,mixedType,1
7,3,0,10,mixedType,1
1,9,0,10,mixedType,1
5,2,0,7,mixedType,0
7,3,0,10,mixedType,1
7,3,0,10,mixedType,1
6,4,0,10,mixedType,1
5,2,0,7,mixedType,0
7,3,0,10,mixedType,1
12,3,0,15,mixedType,2
6,1,0,7,mixedType,0
6,3,0,9,mixedType,1
4,2,0,6,mixedType,0
5,3,0,8,mixedType,1
2,10,0,12,mixedType,1
14,2,0,16,mixedType,2
4,6,0,10,mixedType,1
10,4,0,14,mixedType,2
7,3,0,10,mixedType,1
4,2,0,6,mixedType,0
6,6,0,12,mixedType,1
9,1,0,10,mixedType,1
7,2,0,9,mixedType,1
7,3,0,10,mixedType,1
12,4,0,16,mixedType,2
8,2,0,10,mixedType,1
7,6,0,13,mixedType,1
5,3,0,8,mixedType,1
2,6,0,8,mixedType,1
5,1,0,6,mixedType,0
4,6,0,10,mixedType,1
7,3,0,10,mixedType,1
3,6,0,9,mixedType,1
9,3,0,12,mixedType,1
6,3,0,9,mixedType,1
7,1,0,8,mixedType,1
7,3,0,10,mixedType,1
9,1,0,10,mixedType,1
5,1,0,6,mixedType,0
6,1,0,7,mixedType,0
5,3,0,8,mixedType,1
7,2,0,9,mixedType,1
3,6,0,9,mixedType,1
6,4,0,10,mixedType,1
5,2,0,7,mixedType,0
5,3,0,8,mixedType,1
7,3,0,10,mixedType,1
12,4,0,16,mixedType,2
14,2,0,16,mixedType,2
6,2,0,8,mixedType,1
7,3,0,10,mixedType,1
14,2,0,16,mixedType,2
6,2,0,8,mixedType,1
9,4,0,13,mixedType,1
6,5,0,11,mixedType,1
6,1,0,7,mixedType,0
7,1,0,8,mixedType,1
2,4,0,6,mixedType,0
7,4,0,11,mixedType,1
13,3,0,16,mixedType,2
5,2,0,7,mixedType,0
8,4,0,12,mixedType,1
6,2,0,8,mixedType,1
6,4,0,10,mixedType,1
13,2,1,16,mixedType,2
7,3,0,10,mixedType,1
5,2,0,7,mixedType,0
7,3,0,10,mixedType,1
7,1,0,8,mixedType,1
14,2,0,16,mixedType,2
7,4,0,11,mixedType,1
7,2,0,9,mixedType,1
5,4,0,9,mixedType,1
8,1,0,9,mixedType,1
3,5,0,8,mixedType,1
13,3,0,16,mixedType,2
6,1,0,7,mixedType,0
5,2,0,7,mixedType,0
7,3,0,10,mixedType,1
7,1,0,8,mixedType,1
9,4,0,13,mixedType,1
6,1,0,7,mixedType,0
8,3,0,11,mixedType,1
8,2,0,10,mixedType,1
5,4,0,9,mixedType,1
14,2,0,16,mixedType,2
8,1,0,9,mixedType,1
6,3,0,9,mixedType,1
4,5,0,9,mixedType,1
4,6,0,10,mixedType,1
6,4,0,10,mixedType,1
8,2,0,10,mixedType,1
5,8,0,13,mixedType,1
7,3,0,10,mixedType,1
7,4,0,11,mixedType,1
2,7,0,9,mixedType,1
6,2,0,8,mixedType,1
4,4,0,8,mixedType,1
11,5,0,16,mixedType,2
8,1,0,9,mixedType,1
12,3,0,15,mixedType,2
5,4,0,9,mixedType,1
7,1,0,8,mixedType,1
6,1,0,7,mixedType,0
13,3,0,16,mixedType,2
6,1,0,7,mixedType,0
3,5,0,8,mixedType,1
14,2,0,16,mixedType,2
6,3,0,9,mixedType,1
4,7,0,11,mixedType,1
6,3,0,9,mixedType,1
6,3,0,9,mixedType,1
4,4,0,8,mixedType,1
7,3,0,10,mixedType,1
1,7,0,8,mixedType,1
14,2,0,16,mixedType,2
15,1,0,16,mixedType,2
6,3,0,9,mixedType,1
5,3,0,8,mixedType,1
7,1,0,8,mixedType,1
7,3,0,10,mixedType,1
5,4,0,9,mixedType,1
7,3,0,10,mixedType,1
4,2,0,6,mixedType,0
8,1,0,9,mixedType,1
6,4,0,10,mixedType,1
6,1,0,7,mixedType,0
5,3,0,8,mixedType,1
6,9,0,15,mixedType,2
7,2,0,9,mixedType,1
5,4,0,9,mixedType,1
6,3,0,9,mixedType,1
8,1,0,9,mixedType,1
13,3,0,16,mixedType,2
4,8,0,12,mixedType,1
5,4,0,9,mixedType,1
3,6,0,9,mixedType,1
5,2,0,7,mixedType,0
1,7,0,8,mixedType,1
9,1,0,10,mixedType,1
12,1,0,13,mixedType,1
4,5,0,9,mixedType,1
8,2,0,10,mixedType,1
13,6,0,19,mixedType,2
1,5,0,6,mixedType,0
6,1,0,7,mixedType,0
4,2,0,6,mixedType,0
6,1,0,7,mixedType,0
6,8,0,14,mixedType,2
5,3,0,8,mixedType,1
5,2,0,7,mixedType,0
5,1,0,6,mixedType,0
4,2,0,6,mixedType,0
4,4,0,8,mixedType,1
8,2,0,10,mixedType,1
6,3,0,9,mixedType,1
5,2,0,7,mixedType,0
7,2,0,9,mixedType,1
5,3,0,8,mixedType,1
14,2,0,16,mixedType,2
6,3,0,9,mixedType,1
5,1,0,6,mixedType,0
8,4,0,12,mixedType,1
4,2,0,6,mixedType,0
8,2,0,10,mixedType,1
6,1,0,7,mixedType,0
14,2,0,16,mixedType,2
9,2,0,11,mixedType,1
1,8,0,9,mixedType,1
11,3,0,14,mixedType,2
7,0,2,9,mixedType,1
9,0,1,10,mixedType,1
14,2,0,16,mixedType,2
7,5,0,12,mixedType,1
6,1,0,7,mixedType,0
8,1,0,9,mixedType,1
14,2,0,16,mixedType,2
8,0,1,9,mixedType,1
2,4,0,6,mixedType,0
7,3,0,10,mixedType,1
8,1,0,9,mixedType,1
1,9,0,10,mixedType,1
13,3,0,16,mixedType,2
7,3,0,10,mixedType,1
8,2,0,10,mixedType,1
12,0,1,13,mixedType,1
5,2,0,7,mixedType,0
7,3,0,10,mixedType,1
6,2,0,8,mixedType,1
6,1,0,7,mixedType,0
0,9,1,10,mixedType,1
6,1,0,7,mixedType,0
14,2,0,16,mixedType,2
7,1,0,8,mixedType,1
7,1,0,8,mixedType,1
4,4,0,8,mixedType,1
6,4,0,10,mixedType,1
8,5,0,13,mixedType,1
6,3,0,9,mixedType,1
12,4,0,16,mixedType,2
9,2,0,11,mixedType,1
8,2,0,10,mixedType,1
5,4,0,9,mixedType,1
8,2,0,10,mixedType,1
7,4,0,11,mixedType,1
6,0,1,7,mixedType,0
13,3,0,16,mixedType,2
5,1,0,6,mixedType,0
7,1,0,8,mixedType,1
4,2,0,6,mixedType,0
5,2,0,7,mixedType,0
3,6,0,9,mixedType,1
7,2,0,9,mixedType,1
7,3,0,10,mixedType,1
6,2,0,8,mixedType,1
7,1,0,8,mixedType,1
4,2,0,6,mixedType,0
8,8,2,18,mixedType,2
7,2,0,9,mixedType,1
8,1,0,9,mixedType,1
4,4,0,8,mixedType,1
6,3,0,9,mixedType,1
6,1,0,7,mixedType,0
3,3,0,6,mixedType,0
9,3,0,12,mixedType,1
5,3,0,8,mixedType,1
6,3,0,9,mixedType,1
1,11,0,12,mixedType,1
6,4,0,10,mixedType,1
9,3,0,12,mixedType,1
5,4,0,9,mixedType,1
5,4,0,9,mixedType,1
14,2,0,16,mixedType,2
2,6,0,8,mixedType,1
5,2,0,7,mixedType,0
15,1,0,16,mixedType,2
3,5,0,8,mixedType,1
6,4,0,10,mixedType,1
2,8,0,10,mixedType,1
8,1,0,9,mixedType,1
8,2,0,10,mixedType,1
5,8,0,13,mixedType,1
3,5,0,8,mixedType,1
6,3,0,9,mixedType,1
8,0,1,9,mixedType,1
9,1,0,10,mixedType,1
5,4,0,9,mixedType,1
6,0,1,7,mixedType,0
8,1,0,9,mixedType,1
8,2,0,10,mixedType,1
6,8,1,15,mixedType,2
1,12,0,13,mixedType,1
6,4,0,10,mixedType,1
4,4,0,8,mixedType,1
9,3,0,12,mixedType,1
8,1,0,9,mixedType,1
7,2,0,9,mixedType,1
8,3,0,11,mixedType,1
6,2,0,8,mixedType,1
8,2,0,10,mixedType,1
8,1,0,9,mixedType,1
6,1,0,7,mixedType,0
7,3,0,10,mixedType,1
5,3,0,8,mixedType,1
8,1,0,9,mixedType,1
8,1,0,9,mixedType,1
2,8,0,10,mixedType,1
6,3,0,9,mixedType,1
4,6,0,10,mixedType,1
2,6,0,8,mixedType,1
1,8,0,9,mixedType,1
6,3,0,9,mixedType,1
5,2,0,7,mixedType,0
8,1,0,9,mixedType,1
8,1,0,9,mixedType,1
7,3,0,10,mixedType,1
5,4,0,9,mixedType,1
7,1,0,8,mixedType,1
7,2,0,9,mixedType,1
8,4,0,12,mixedType,1
4,6,0,10,mixedType,1
5,6,0,11,mixedType,1
7,3,0,10,mixedType,1
7,3,0,10,mixedType,1
6,4,0,10,mixedType,1
5,3,0,8,mixedType,1
4,2,0,6,mixedType,0
10,3,0,13,mixedType,1
7,3,0,10,mixedType,1
5,3,0,8,mixedType,1
6,3,0,9,mixedType,1
2,8,0,10,mixedType,1
13,3,0,16,mixedType,2
6,3,0,9,mixedType,1
5,4,0,9,mixedType,1
1,8,0,9,mixedType,1
6,3,0,9,mixedType,1
7,4,0,11,mixedType,1
6,1,0,7,mixedType,0
5,3,0,8,mixedType,1
5,4,0,9,mixedType,1
5,2,0,7,mixedType,0
5,1,0,6,mixedType,0
6,2,0,8,mixedType,1
11,4,1,16,mixedType,2
6,2,0,8,mixedType,1
4,8,0,12,mixedType,1
5,2,0,7,mixedType,0
11,2,0,13,mixedType,1
6,2,0,8,mixedType,1
8,1,0,9,mixedType,1
6,3,0,9,mixedType,1
6,1,0,7,mixedType,0
5,2,0,7,mixedType,0
5,1,0,6,mixedType,0
5,2,0,7,mixedType,0
13,3,0,16,mixedType,2
7,1,0,8,mixedType,1
11,1,0,12,mixedType,1
8,1,0,9,mixedType,1
8,1,0,9,mixedType,1
12,1,0,13,mixedType,1
5,4,0,9,mixedType,1
8,1,0,9,mixedType,1
6,3,0,9,mixedType,1
4,2,0,6,mixedType,0
4,4,0,8,mixedType,1
7,3,0,10,mixedType,1
8,4,0,12,mixedType,1
4,2,0,6,mixedType,0
15,1,0,16,mixedType,2
2,6,0,8,mixedType,1
4,4,0,8,mixedType,1
8,5,0,13,mixedType,1
6,4,0,10,mixedType,1
6,1,0,7,mixedType,0
9,2,0,11,mixedType,1
8,2,0,10,mixedType,1
7,3,0,10,mixedType,1
5,3,0,8,mixedType,1
7,4,0,11,mixedType,1
7,3,0,10,mixedType,1
11,5,0,16,mixedType,2
7,3,0,10,mixedType,1
6,2,0,8,mixedType,1
4,2,0,6,mixedType,0
15,1,0,16,mixedType,2
7,2,0,9,mixedType,1
5,1,0,6,mixedType,0
9,1,0,10,mixedType,1
6,4,0,10,mixedType,1
9,2,0,11,mixedType,1
11,1,0,12,mixedType,1
13,3,0,16,mixedType,2
6,4,0,10,mixedType,1
7,4,0,11,mixedType,1
3,8,0,11,mixedType,1
7,3,0,10,mixedType,1
5,2,0,7,mixedType,0
10,2,0,12,mixedType,1
8,1,0,9,mixedType,1
15,1,0,16,mixedType,2
6,1,0,7,mixedType,0
4,5,0,9,mixedType,1
7,3,0,10,mixedType,1
4,5,0,9,mixedType,1
7,3,0,10,mixedType,1
6,4,0,10,mixedType,1
10,2,0,12,mixedType,1
4,2,0,6,mixedType,0
7,4,0,11,mixedType,1
7,2,0,9,mixedType,1
15,1,0,16,mixedType,2
3,3,0,6,mixedType,0
5,4,0,9,mixedType,1
5,9,0,14,mixedType,2
12,4,0,16,mixedType,2
1,8,0,9,mixedType,1
6,2,0,8,mixedType,1
8,1,0,9,mixedType,1
5,2,0,7,mixedType,0
6,6,0,12,mixedType,1
2,8,0,10,mixedType,1
4,2,0,6,mixedType,0
8,4,0,12,mixedType,1
6,1,0,7,mixedType,0
6,3,0,9,mixedType,1
5,3,0,8,mixedType,1
14,2,0,16,mixedType,2
7,3,0,10,mixedType,1
7,1,0,8,mixedType,1
8,2,0,10,mixedType,1
6,3,0,9,mixedType,1
11,2,0,13,mixedType,1
6,3,0,9,mixedType,1
7,3,0,10,mixedType,1
7,3,0,10,mixedType,1
5,4,0,9,mixedType,1
6,3,0,9,mixedType,1
6,2,0,8,mixedType,1
7,3,0,10,mixedType,1
3,5,0,8,mixedType,1
8,2,0,10,mixedType,1
7,2,0,9,mixedType,1
2,4,0,6,mixedType,0
7,4,0,11,mixedType,1
8,4,0,12,mixedType,1
6,3,0,9,mixedType,1
6,1,0,7,mixedType,0
7,2,0,9,mixedType,1
5,2,0,7,mixedType,0
12,4,0,16,mixedType,2
8,2,0,10,mixedType,1
6,3,0,9,mixedType,1
6,1,0,7,mixedType,0
15,1,0,16,mixedType,2
6,1,0,7,mixedType,0
5,2,0,7,mixedType,0
8,2,0,10,mixedType,1
10,2,0,12,mixedType,1
9,1,0,10,mixedType,1
7,2,0,9,mixedType,1
6,3,0,9,mixedType,1
5,3,0,8,mixedType,1
5,2,0,7,mixedType,0
1,8,0,9,mixedType,1
7,3,0,10,mixedType,1
6,1,0,7,mixedType,0
12,4,0,16,mixedType,2
6,1,0,7,mixedType,0
2,6,0,8,mixedType,1
6,3,0,9,mixedType,1
7,6,0,13,mixedType,1
4,2,0,6,mixedType,0
7,2,0,9,mixedType,1
7,2,0,9,mixedType,1
7,3,0,10,mixedType,1
12,3,0,15,mixedType,2
5,1,0,6,mixedType,0
4,4,0,8,mixedType,1
6,2,0,8,mixedType,1
8,2,0,10,mixedType,1
6,2,0,8,mixedType,1
8,2,0,10,mixedType,1
8,1,0,9,mixedType,1
5,1,0,6,mixedType,0
6,2,0,8,mixedType,1
8,1,0,9,mixedType,1
7,2,0,9,mixedType,1
5,2,0,7,mixedType,0
6,2,0,8,mixedType,1
7,3,0,10,mixedType,1
6,3,0,9,mixedType,1
4,2,0,6,mixedType,0
9,1,0,10,mixedType,1
10,1,0,11,mixedType,1
8,1,0,9,mixedType,1
7,2,0,9,mixedType,1
6,2,0,8,mixedType,1
7,3,0,10,mixedType,1
5,6,0,11,mixedType,1
3,7,0,10,mixedType,1
6,4,0,10,mixedType,1
5,4,0,9,mixedType,1
6,3,0,9,mixedType,1
5,1,0,6,mixedType,0
7,3,0,10,mixedType,1
3,6,0,9,mixedType,1
6,6,0,12,mixedType,1
1,8,0,9,mixedType,1
9,1,0,10,mixedType,1
10,2,0,12,mixedType,1
7,6,0,13,mixedType,1
7,4,0,11,mixedType,1
8,3,0,11,mixedType,1
7,4,0,11,mixedType,1
9,1,0,10,mixedType,1
1,8,0,9,mixedType,1
2,8,0,10,mixedType,1
5,2,0,7,mixedType,0
4,4,0,8,mixedType,1
7,1,0,8,mixedType,1
6,2,0,8,mixedType,1
13,3,0,16,mixedType,2
11,5,0,16,mixedType,2
7,3,0,10,mixedType,1
7,1,0,8,mixedType,1
6,3,0,9,mixedType,1
5,3,0,8,mixedType,1
3,8,0,11,mixedType,1
6,2,0,8,mixedType,1
5,2,0,7,mixedType,0
6,2,0,8,mixedType,1
4,8,0,12,mixedType,1
10,1,0,11,mixedType,1
8,4,0,12,mixedType,1
5,1,0,6,mixedType,0
12,3,0,15,mixedType,2
14,2,0,16,mixedType,2
5,3,0,8,mixedType,1
8,2,0,10,mixedType,1
4,6,0,10,mixedType,1
8,1,0,9,mixedType,1
5,5,0,10,mixedType,1
7,4,4,15,mixedType,2
5,4,0,9,mixedType,1
8,2,0,10,mixedType,1
9,4,0,13,mixedType,1
5,1,0,6,mixedType,0
0,6,3,9,mixedType,1
8,2,0,10,mixedType,1
6,2,0,8,mixedType,1
4,2,0,6,mixedType,0
4,6,0,10,mixedType,1
9,2,0,11,mixedType,1
9,2,0,11,mixedType,1
15,1,0,16,mixedType,2
6,2,0,8,mixedType,1
7,3,0,10,mixedType,1
4,7,0,11,mixedType,1
10,2,0,12,mixedType,1
6,1,0,7,mixedType,0
7,3,0,10,mixedType,1
5,2,0,7,mixedType,0
9,3,0,12,mixedType,1
3,5,0,8,mixedType,1
9,2,0,11,mixedType,1
6,6,0,12,mixedType,1
4,4,0,8,mixedType,1
5,3,0,8,mixedType,1
7,1,0,8,mixedType,1
6,3,0,9,mixedType,1
8,2,0,10,mixedType,1
6,3,0,9,mixedType,1
5,1,0,6,mixedType,0
3,6,0,9,mixedType,1
4,4,0,8,mixedType,1
7,2,0,9,mixedType,1
2,8,0,10,mixedType,1
4,6,0,10,mixedType,1
11,3,0,14,mixedType,2
10,1,0,11,mixedType,1
10,8,0,18,mixedType,2
5,2,0,7,mixedType,0
8,4,0,12,mixedType,1
4,6,0,10,mixedType,1
8,3,0,11,mixedType,1
6,1,0,7,mixedType,0
3,5,0,8,mixedType,1
7,2,0,9,mixedType,1
5,4,0,9,mixedType,1
7,4,0,11,mixedType,1
6,2,0,8,mixedType,1
8,6,0,14,mixedType,2
8,2,0,10,mixedType,1
12,4,0,16,mixedType,2
7,3,0,10,mixedType,1
3,6,0,9,mixedType,1
5,1,0,6,mixedType,0
1,8,0,9,mixedType,1
7,0,1,8,mixedType,1
6,4,0,10,mixedType,1
7,4,0,11,mixedType,1
8,4,0,12,mixedType,1
6,6,0,12,mixedType,1
7,1,0,8,mixedType,1
5,2,0,7,mixedType,0
10,3,0,13,mixedType,1
7,3,0,10,mixedType,1
5,2,0,7,mixedType,0
6,1,0,7,mixedType,0
6,4,0,10,mixedType,1
7,2,0,9,mixedType,1
14,1,0,15,mixedType,2
4,2,0,6,mixedType,0
6,6,0,12,mixedType,1
6,2,0,8,mixedType,1
6,2,0,8,mixedType,1
7,1,0,8,mixedType,1
7,2,0,9,mixedType,1
7,2,0,9,mixedType,1
6,3,0,9,mixedType,1
7,2,0,9,mixedType,1
5,3,0,8,mixedType,1
11,4,0,15,mixedType,2
5,3,0,8,mixedType,1
8,1,0,9,mixedType,1
1,7,0,8,mixedType,1
6,3,0,9,mixedType,1
4,6,0,10,mixedType,1
6,3,0,9,mixedType,1
5,5,0,10,mixedType,1
2,6,0,8,mixedType,1
11,3,0,14,mixedType,2
6,4,0,10,mixedType,1
6,0,2,8,mixedType,0
9,2,0,11,mixedType,1
6,2,0,8,mixedType,1
5,3,0,8,mixedType,1
1,8,0,9,mixedType,1
6,1,0,7,mixedType,0
5,3,0,8,mixedType,1
4,4,0,8,mixedType,1
5,1,0,6,mixedType,0
8,1,0,9,mixedType,1
5,2,0,7,mixedType,0
8,3,0,11,mixedType,1
7,2,0,9,mixedType,1
6,1,0,7,mixedType,0
4,2,0,6,mixedType,0
2,6,0,8,mixedType,1
1,9,0,10,mixedType,1
4,4,0,8,mixedType,1
4,2,0,6,mixedType,0
6,4,0,10,mixedType,1
7,2,0,9,mixedType,1
7,2,0,9,mixedType,1
9,2,0,11,mixedType,1
12,3,0,15,mixedType,2
4,4,0,8,mixedType,1
4,7,0,11,mixedType,1
6,1,0,7,mixedType,0
1,8,0,9,mixedType,1
6,6,0,12,mixedType,1
7,2,0,9,mixedType,1
6,4,0,10,mixedType,1
5,3,0,8,mixedType,1
5,2,0,7,mixedType,0
5,6,0,11,mixedType,1
4,6,0,10,mixedType,1
12,3,0,15,mixedType,2
6,1,0,7,mixedType,0
5,2,0,7,mixedType,0
7,3,0,10,mixedType,1
7,1,0,8,mixedType,1
13,3,0,16,mixedType,2
9,3,0,12,mixedType,1
1,7,0,8,mixedType,1
8,3,0,11,mixedType,1
9,1,0,10,mixedType,1
6,3,0,9,mixedType,1
7,1,0,8,mixedType,1
6,1,0,7,mixedType,0
6,2,0,8,mixedType,1
5,4,0,9,mixedType,1
24,6,0,30,mixedType,2
7,3,0,10,mixedType,1
2,9,0,11,mixedType,1
5,4,0,9,mixedType,1
4,4,0,8,mixedType,1
5,1,0,6,mixedType,0
15,1,0,16,mixedType,2
14,2,0,16,mixedType,2
5,1,0,6,mixedType,0
9,1,0,10,mixedType,1
5,3,0,8,mixedType,1
5,3,0,8,mixedType,1
4,2,0,6,mixedType,0
5,3,0,8,mixedType,1
4,4,0,8,mixedType,1
8,1,0,9,mixedType,1
5,3,0,8,mixedType,1
10,0,1,11,mixedType,1
6,3,0,9,mixedType,1
4,4,0,8,mixedType,1
6,3,0,9,mixedType,1
10,2,0,12,mixedType,1
6,4,0,10,mixedType,1
1,9,0,10,mixedType,1
8,2,0,10,mixedType,1
2,10,0,12,mixedType,1
6,4,0,10,mixedType,1
5,2,0,7,mixedType,0
8,3,0,11,mixedType,1
14,2,0,16,mixedType,2
6,3,0,9,mixedType,1
13,3,0,16,mixedType,2
15,1,0,16,mixedType,2
6,4,0,10,mixedType,1
4,4,0,8,mixedType,1
5,2,0,7,mixedType,0
4,2,0,6,mixedType,0
5,3,0,8,mixedType,1
8,2,0,10,mixedType,1
4,4,0,8,mixedType,1
5,1,0,6,mixedType,0
9,1,0,10,mixedType,1
8,3,0,11,mixedType,1
5,4,0,9,mixedType,1
7,2,0,9,mixedType,1
14,2,0,16,mixedType,2
5,4,0,9,mixedType,1
8,1,0,9,mixedType,1
8,3,0,11,mixedType,1
6,1,0,7,mixedType,0
5,3,0,8,mixedType,1
6,3,0,9,mixedType,1
7,3,0,10,mixedType,1
6,1,0,7,mixedType,0
8,3,0,11,mixedType,1
5,2,0,7,mixedType,0
8,1,0,9,mixedType,1
6,1,0,7,mixedType,0
7,2,0,9,mixedType,1
7,2,0,9,mixedType,1
15,1,0,16,mixedType,2
6,3,0,9,mixedType,1
9,3,0,12,mixedType,1
4,2,0,6,mixedType,0
5,4,0,9,mixedType,1
5,6,0,11,mixedType,1
2,4,0,6,mixedType,0
5,3,0,8,mixedType,1
6,3,0,9,mixedType,1
1,8,0,9,mixedType,1
5,1,0,6,mixedType,0
6,2,0,8,mixedType,1
7,3,0,10,mixedType,1
7,3,0,10,mixedType,1
4,4,0,8,mixedType,1
4,2,0,6,mixedType,0
5,2,0,7,mixedType,0
6,3,0,9,mixedType,1
6,1,0,7,mixedType,0
5,4,0,9,mixedType,1
8,1,0,9,mixedType,1
1,7,0,8,mixedType,1
6,2,0,8,mixedType,1
15,1,0,16,mixedType,2
5,3,0,8,mixedType,1
6,2,0,8,mixedType,1
6,1,0,7,mixedType,0
2,8,0,10,mixedType,1
14,2,0,16,mixedType,2
5,4,0,9,mixedType,1
10,2,0,12,mixedType,1
8,2,0,10,mixedType,1
4,2,0,6,mixedType,0
6,6,0,12,mixedType,1
13,3,0,16,mixedType,2
6,4,0,10,mixedType,1
2,7,0,9,mixedType,1
6,4,0,10,mixedType,1
7,3,0,10,mixedType,1
8,3,0,11,mixedType,1
7,3,0,10,mixedType,1
5,3,0,8,mixedType,1
1,8,0,9,mixedType,1
5,4,0,9,mixedType,1
5,1,0,6,mixedType,0
2,6,0,8,mixedType,1
8,4,0,12,mixedType,1
7,2,0,9,mixedType,1
8,1,0,9,mixedType,1
5,4,0,9,mixedType,1
7,2,0,9,mixedType,1
7,2,0,9,mixedType,1
6,3,0,9,mixedType,1
6,4,0,10,mixedType,1
3,6,0,9,mixedType,1
7,3,0,10,mixedType,1
4,6,0,10,mixedType,1
3,7,0,10,mixedType,1
5,8,0,13,mixedType,1
9,4,1,14,mixedType,2
6,1,0,7,mixedType,0
7,4,0,11,mixedType,1
11,2,0,13,mixedType,1
8,2,0,10,mixedType,1
8,2,0,10,mixedType,1
8,2,0,10,mixedType,1
7,4,0,11,mixedType,1
6,3,0,9,mixedType,1
6,6,0,12,mixedType,1
11,1,1,13,mixedType,1
12,1,0,13,mixedType,1
7,3,0,10,mixedType,1
7,8,2,17,mixedType,2
4,8,0,12,mixedType,1
4,6,0,10,mixedType,1
3,6,0,9,mixedType,1
6,3,0,9,mixedType,1
11,1,0,12,mixedType,1
4,6,0,10,mixedType,1
7,3,0,10,mixedType,1
3,8,0,11,mixedType,1
3,6,0,9,mixedType,1
7,3,0,10,mixedType,1
9,2,0,11,mixedType,1
7,2,0,9,mixedType,1
8,1,0,9,mixedType,1
6,1,0,7,mixedType,0
5,4,0,9,mixedType,1
6,3,0,9,mixedType,1
3,6,0,9,mixedType,1
7,2,0,9,mixedType,1
1,11,0,12,mixedType,1
4,2,0,6,mixedType,0
6,1,0,7,mixedType,0
3,6,0,9,mixedType,1
6,2,0,8,mixedType,1
6,2,0,8,mixedType,1
4,4,0,8,mixedType,1
5,3,0,8,mixedType,1
1,9,0,10,mixedType,1
6,2,0,8,mixedType,1
5,3,0,8,mixedType,1
6,4,0,10,mixedType,1
7,3,0,10,mixedType,1
8,3,0,11,mixedType,1
8,3,0,11,mixedType,1
13,3,0,16,mixedType,2
4,2,0,6,mixedType,0
6,3,0,9,mixedType,1
4,2,0,6,mixedType,0
14,2,0,16,mixedType,2
6,4,0,10,mixedType,1
8,3,0,11,mixedType,1
12,4,0,16,mixedType,2
6,1,0,7,mixedType,0
9,1,0,10,mixedType,1
7,4,0,11,mixedType,1
5,2,0,7,mixedType,0
8,4,0,12,mixedType,1
9,2,0,11,mixedType,1
4,9,1,14,mixedType,2
10,4,0,14,mixedType,2
4,2,0,6,mixedType,0
8,1,0,9,mixedType,1
7,1,0,8,mixedType,1
2,7,0,9,mixedType,1
6,6,0,12,mixedType,1
1,7,0,8,mixedType,1
7,1,0,8,mixedType,1
5,1,0,6,mixedType,0
7,3,0,10,mixedType,1
6,8,0,14,mixedType,2
6,2,0,8,mixedType,1
8,2,0,10,mixedType,1
14,2,0,16,mixedType,2
7,2,0,9,mixedType,1
6,3,0,9,mixedType,1
8,1,0,9,mixedType,1
12,3,0,15,mixedType,2
13,3,0,16,mixedType,2
7,4,0,11,mixedType,1
6,6,3,15,mixedType,2
8,2,0,10,mixedType,1
6,3,0,9,mixedType,1
10,1,0,11,mixedType,1
7,3,0,10,mixedType,1
9,2,0,11,mixedType,1
13,3,0,16,mixedType,2
5,3,0,8,mixedType,1
5,1,0,6,mixedType,0
4,9,0,13,mixedType,1
4,2,0,6,mixedType,0
1,7,0,8,mixedType,1
5,3,0,8,mixedType,1
3,6,0,9,mixedType,1
6,4,0,10,mixedType,1
3,8,0,11,mixedType,1
7,3,0,10,mixedType,1
14,2,0,16,mixedType,2
6,1,0,7,mixedType,0
5,1,0,6,mixedType,0
6,3,0,9,mixedType,1
3,6,0,9,mixedType,1
8,2,0,10,mixedType,1
6,3,0,9,mixedType,1
8,2,0,10,mixedType,1
9,1,0,10,mixedType,1
4,7,0,11,mixedType,1
5,2,0,7,mixedType,0
6,3,0,9,mixedType,1
6,3,0,9,mixedType,1
8,1,0,9,mixedType,1
19,9,0,28,mixedType,2
6,3,0,9,mixedType,1
15,1,0,16,mixedType,2
1,7,0,8,mixedType,1
7,3,0,10,mixedType,1
5,1,0,6,mixedType,0
5,4,0,9,mixedType,1
4,2,0,6,mixedType,0
5,3,0,8,mixedType,1
14,2,0,16,mixedType,2
5,3,0,8,mixedType,1
5,2,0,7,mixedType,0
7,1,0,8,mixedType,1
6,7,0,13,mixedType,1
7,3,0,10,mixedType,1
7,4,0,11,mixedType,1
7,3,0,10,mixedType,1
13,1,1,15,mixedType,2
14,2,0,16,mixedType,2
9,5,0,14,mixedType,2
4,4,0,8,mixedType,1
5,3,0,8,mixedType,1
14,2,0,16,mixedType,2
6,3,0,9,mixedType,1
2,8,0,10,mixedType,1
5,2,0,7,mixedType,0
5,3,0,8,mixedType,1
7,4,0,11,mixedType,1
9,1,0,10,mixedType,1
8,1,0,9,mixedType,1
8,1,0,9,mixedType,1
5,4,0,9,mixedType,1
8,1,0,9,mixedType,1
8,2,0,10,mixedType,1
8,1,0,9,mixedType,1
5,1,0,6,mixedType,0
5,3,0,8,mixedType,1
4,4,0,8,mixedType,1
8,1,0,9,mixedType,1
5,1,0,6,mixedType,0
2,7,0,9,mixedType,1
6,3,0,9,mixedType,1
7,3,0,10,mixedType,1
8,4,0,12,mixedType,1
6,3,0,9,mixedType,1
7,2,0,9,mixedType,1
8,2,0,10,mixedType,1
2,6,0,8,mixedType,1
4,8,0,12,mixedType,1
6,3,0,9,mixedType,1
5,4,0,9,mixedType,1
3,6,0,9,mixedType,1
1,7,0,8,mixedType,1
6,3,0,9,mixedType,1
11,0,1,12,mixedType,1
7,4,0,11,mixedType,1
8,1,0,9,mixedType,1
8,1,0,9,mixedType,1
8,2,0,10,mixedType,1
12,3,0,15,mixedType,2
6,4,0,10,mixedType,1
7,1,0,8,mixedType,1
10,1,0,11,mixedType,1
11,5,0,16,mixedType,2
9,2,0,11,mixedType,1
1,10,0,11,mixedType,1
6,4,0,10,mixedType,1
5,6,0,11,mixedType,1
13,3,1,17,mixedType,2
6,1,0,7,mixedType,0
4,4,0,8,mixedType,1
5,4,0,9,mixedType,1
7,2,0,9,mixedType,1
4,6,0,10,mixedType,1
6,3,0,9,mixedType,1
5,3,0,8,mixedType,1
15,1,0,16,mixedType,2
5,2,0,7,mixedType,0
8,2,0,10,mixedType,1
7,3,0,10,mixedType,1
6,1,0,7,mixedType,0
14,2,0,16,mixedType,2
6,4,0,10,mixedType,1
2,8,0,10,mixedType,1
5,4,0,9,mixedType,1
5,2,0,7,mixedType,0
12,4,0,16,mixedType,2
4,2,0,6,mixedType,0
4,6,0,10,mixedType,1
6,3,0,9,mixedType,1
5,3,0,8,mixedType,1
3,6,0,9,mixedType,1
6,3,0,9,mixedType,1
11,2,0,13,mixedType,1
4,6,0,10,mixedType,1
6,4,0,10,mixedType,1
9,2,0,11,mixedType,1
5,2,0,7,mixedType,0
3,6,0,9,mixedType,1
6,2,0,8,mixedType,1
1,7,0,8,mixedType,1
0,9,1,10,mixedType,1
5,8,0,13,mixedType,1
5,1,0,6,mixedType,0
5,5,0,10,mixedType,1
1,8,0,9,mixedType,1
6,3,0,9,mixedType,1
7,3,0,10,mixedType,1
10,3,0,13,mixedType,1
5,4,0,9,mixedType,1
7,2,0,9,mixedType,1
10,4,0,14,mixedType,2
14,2,0,16,mixedType,2
4,5,0,9,mixedType,1
13,3,0,16,mixedType,2
4,6,0,10,mixedType,1
14,2,0,16,mixedType,2
5,2,0,7,mixedType,0
7,2,0,9,mixedType,1
5,2,0,7,mixedType,0
7,2,0,9,mixedType,1
5,1,0,6,mixedType,0
5,2,0,7,mixedType,0
6,4,0,10,mixedType,1
4,4,0,8,mixedType,1
10,0,1,11,mixedType,1
8,3,0,11,mixedType,1
3,6,0,9,mixedType,1
7,3,0,10,mixedType,1
3,6,0,9,mixedType,1
14,2,0,16,mixedType,2
4,4,0,8,mixedType,1
3,7,0,10,mixedType,1
6,4,0,10,mixedType,1
8,1,0,9,mixedType,1
7,3,0,10,mixedType,1
7,3,0,10,mixedType,1
13,3,0,16,mixedType,2
5,3,0,8,mixedType,1
8,2,0,10,mixedType,1
8,1,0,9,mixedType,1
6,2,0,8,mixedType,1
6,1,0,7,mixedType,0
4,6,0,10,mixedType,1
8,2,0,10,mixedType,1
12,4,0,16,mixedType,2
14,2,0,16,mixedType,2
7,3,0,10,mixedType,1
15,1,0,16,mixedType,2
4,2,0,6,mixedType,0
10,3,0,13,mixedType,1
2,4,0,6,mixedType,0
5,3,0,8,mixedType,1
8,2,0,10,mixedType,1
6,4,0,10,mixedType,1
6,4,0,10,mixedType,1
15,1,0,16,mixedType,2
6,0,1,7,mixedType,0
3,6,0,9,mixedType,1
10,1,0,11,mixedType,1
6,3,0,9,mixedType,1
6,4,0,10,mixedType,1
11,1,0,12,mixedType,1
8,2,0,10,mixedType,1
6,1,0,7,mixedType,0
10,1,0,11,mixedType,1
2,7,0,9,mixedType,1
6,4,0,10,mixedType,1
0,10,1,11,mixedType,1
7,2,0,9,mixedType,1
4,5,0,9,mixedType,1
5,6,0,11,mixedType,1
6,3,0,9,mixedType,1
4,6,0,10,mixedType,1
5,2,0,7,mixedType,0
6,4,0,10,mixedType,1
9,1,0,10,mixedType,1
7,4,0,11,mixedType,1
5,3,0,8,mixedType,1
7,3,0,10,mixedType,1
4,6,0,10,mixedType,1
4,2,0,6,mixedType,0
6,3,0,9,mixedType,1
6,3,0,9,mixedType,1
6,4,0,10,mixedType,1
14,4,0,18,mixedType,2
2,8,0,10,mixedType,1
6,2,0,8,mixedType,1
14,2,0,16,mixedType,2
7,2,0,9,mixedType,1
7,2,0,9,mixedType,1
5,2,0,7,mixedType,0
6,2,0,8,mixedType,1
5,5,0,10,mixedType,1
4,2,0,6,mixedType,0
9,1,0,10,mixedType,1
8,2,0,10,mixedType,1
6,4,0,10,mixedType,1
7,2,0,9,mixedType,1
5,2,0,7,mixedType,0
5,4,0,9,mixedType,1
15,1,0,16,mixedType,2
14,2,0,16,mixedType,2
4,6,0,10,mixedType,1
4,4,0,8,mixedType,1
8,2,0,10,mixedType,1
5,5,0,10,mixedType,1
7,3,0,10,mixedType,1
7,1,0,8,mixedType,1
6,1,0,7,mixedType,0
4,2,0,6,mixedType,0
6,1,0,7,mixedType,0
6,4,0,10,mixedType,1
6,1,0,7,mixedType,0
1,8,0,9,mixedType,1
6,6,0,12,mixedType,1
11,3,1,15,mixedType,2
7,2,0,9,mixedType,1
2,6,0,8,mixedType,1
15,7,0,22,mixedType,2
15,1,0,16,mixedType,2
5,1,0,6,mixedType,0
5,2,0,7,mixedType,0
7,1,1,9,mixedType,1
6,3,0,9,mixedType,1
5,1,0,6,mixedType,0
7,2,0,9,mixedType,1
8,1,0,9,mixedType,1
7,2,0,9,mixedType,1
8,1,0,9,mixedType,1
5,3,0,8,mixedType,1
7,3,0,10,mixedType,1
9,1,0,10,mixedType,1
5,3,0,8,mixedType,1
8,2,0,10,mixedType,1
8,1,0,9,mixedType,1
2,8,0,10,mixedType,1
6,3,0,9,mixedType,1
5,2,0,7,mixedType,0
8,1,0,9,mixedType,1
8,3,0,11,mixedType,1
6,1,0,7,mixedType,0
8,2,0,10,mixedType,1
5,2,0,7,mixedType,0
4,6,0,10,mixedType,1
6,3,0,9,mixedType,1
7,2,0,9,mixedType,1
1,8,0,9,mixedType,1
8,2,0,10,mixedType,1
8,2,0,10,mixedType,1
8,1,0,9,mixedType,1
8,2,0,10,mixedType,1
2,6,0,8,mixedType,1
14,2,0,16,mixedType,2
9,6,0,15,mixedType,2
5,6,0,11,mixedType,1
6,4,0,10,mixedType,1
11,2,0,13,mixedType,1
3,6,0,9,mixedType,1
8,3,0,11,mixedType,1
4,6,0,10,mixedType,1
6,2,0,8,mixedType,1
1,8,0,9,mixedType,1
8,2,0,10,mixedType,1
14,2,0,16,mixedType,2
5,3,0,8,mixedType,1
9,0,1,10,mixedType,1
6,3,0,9,mixedType,1
12,4,0,16,mixedType,2
4,4,0,8,mixedType,1
9,7,0,16,mixedType,2
6,2,0,8,mixedType,1
13,3,0,16,mixedType,2
6,2,0,8,mixedType,1
8,6,0,14,mixedType,2
4,4,0,8,mixedType,1
3,6,0,9,mixedType,1
6,3,0,9,mixedType,1
1,7,0,8,mixedType,1
13,3,0,16,mixedType,2
4,6,0,10,mixedType,1
5,2,0,7,mixedType,0
13,3,0,16,mixedType,2
7,3,0,10,mixedType,1
6,1,0,7,mixedType,0
7,2,0,9,mixedType,1
1,8,0,9,mixedType,1
5,3,0,8,mixedType,1
12,3,0,15,mixedType,2
14,2,0,16,mixedType,2
4,5,0,9,mixedType,1
7,3,0,10,mixedType,1
8,3,0,11,mixedType,1
3,6,0,9,mixedType,1
5,1,0,6,mixedType,0
9,2,0,11,mixedType,1
3,7,0,10,mixedType,1
7,3,0,10,mixedType,1
5,3,0,8,mixedType,1
6,6,0,12,mixedType,1
6,2,0,8,mixedType,1
7,3,0,10,mixedType,1
5,3,0,8,mixedType,1
7,2,0,9,mixedType,1
4,8,0,12,mixedType,1
3,6,0,9,mixedType,1
12,3,0,15,mixedType,2
6,2,0,8,mixedType,1
8,2,0,10,mixedType,1
12,3,0,15,mixedType,2
15,1,0,16,mixedType,2
1,8,0,9,mixedType,1
12,4,0,16,mixedType,2
6,3,0,9,mixedType,1
15,1,0,16,mixedType,2
2,6,0,8,mixedType,1
4,2,0,6,mixedType,0
1,6,0,7,mixedType,0
7,2,0,9,mixedType,1
4,4,0,8,mixedType,1
6,2,0,8,mixedType,1
7,4,0,11,mixedType,1
6,3,0,9,mixedType,1
9,1,0,10,mixedType,1
6,3,0,9,mixedType,1
5,3,0,8,mixedType,1
8,2,0,10,mixedType,1
12,4,0,16,mixedType,2
13,3,0,16,mixedType,2
4,4,0,8,mixedType,1
12,3,0,15,mixedType,2
6,3,0,9,mixedType,1
10,4,0,14,mixedType,2
6,2,0,8,mixedType,1
19,5,5,29,mixedType,2
15,1,0,16,mixedType,2
15,1,0,16,mixedType,2
10,2,0,12,mixedType,1
8,2,0,10,mixedType,1
14,2,0,16,mixedType,2
4,5,0,9,mixedType,1
6,1,0,7,mixedType,0
7,3,0,10,mixedType,1
4,4,0,8,mixedType,1
6,1,0,7,mixedType,0
9,6,0,15,mixedType,2
10,2,0,12,mixedType,1
9,3,0,12,mixedType,1
6,4,0,10,mixedType,1
3,5,0,8,mixedType,1
15,1,0,16,mixedType,2
15,1,1,17,mixedType,2
4,6,0,10,mixedType,1
5,4,0,9,mixedType,1
6,4,0,10,mixedType,1
11,3,0,14,mixedType,2
8,2,0,10,mixedType,1
7,2,0,9,mixedType,1
6,1,0,7,mixedType,0
10,1,0,11,mixedType,1
7,2,0,9,mixedType,1
1,12,0,13,mixedType,1
5,3,0,8,mixedType,1
8,1,0,9,mixedType,1
8,1,0,9,mixedType,1
2,8,0,10,mixedType,1
4,4,0,8,mixedType,1
7,3,0,10,mixedType,1
5,3,0,8,mixedType,1
5,3,0,8,mixedType,1
9,1,0,10,mixedType,1
6,1,0,7,mixedType,0
7,3,0,10,mixedType,1
8,6,3,17,mixedType,2
4,4,0,8,mixedType,1
8,1,0,9,mixedType,1
5,4,0,9,mixedType,1
5,3,0,8,mixedType,1
6,3,0,9,mixedType,1
5,2,0,7,mixedType,0
13,3,0,16,mixedType,2
6,3,0,9,mixedType,1
5,1,0,6,mixedType,0
7,2,0,9,mixedType,1
10,3,0,13,mixedType,1
7,2,0,9,mixedType,1
4,4,0,8,mixedType,1
5,2,0,7,mixedType,0
7,2,0,9,mixedType,1
13,3,0,16,mixedType,2
9,6,0,15,mixedType,2
8,2,0,10,mixedType,1
14,2,0,16,mixedType,2
5,4,0,9,mixedType,1
1,8,0,9,mixedType,1
7,3,0,10,mixedType,1
6,4,0,10,mixedType,1
5,4,0,9,mixedType,1
3,7,0,10,mixedType,1
7,3,0,10,mixedType,1
6,2,0,8,mixedType,1
6,3,0,9,mixedType,1
6,1,0,7,mixedType,0
6,6,0,12,mixedType,1
4,6,0,10,mixedType,1
6,5,0,11,mixedType,1
6,1,0,7,mixedType,0
7,2,0,9,mixedType,1
4,4,0,8,mixedType,1
8,4,0,12,mixedType,1
8,3,0,11,mixedType,1
8,2,0,10,mixedType,1
6,3,0,9,mixedType,1
5,1,0,6,mixedType,0
5,5,0,10,mixedType,1
7,3,0,10,mixedType,1
7,3,0,10,mixedType,1
7,2,0,9,mixedType,1
7,2,0,9,mixedType,1
5,4,0,9,mixedType,1
9,2,0,11,mixedType,1
2,6,0,8,mixedType,1
5,2,0,7,mixedType,0
6,2,0,8,mixedType,1
8,1,0,9,mixedType,1
6,3,0,9,mixedType,1
8,1,0,9,mixedType,1
6,3,0,9,mixedType,1
6,4,0,10,mixedType,1
6,1,0,7,mixedType,0
9,1,0,10,mixedType,1
3,10,0,13,mixedType,1
5,4,0,9,mixedType,1
5,3,0,8,mixedType,1
6,3,0,9,mixedType,1
3,3,0,6,mixedType,0
5,2,0,7,mixedType,0
2,7,0,9,mixedType,1
2,6,0,8,mixedType,1
14,2,0,16,mixedType,2
4,9,0,13,mixedType,1
7,2,0,9,mixedType,1
15,1,0,16,mixedType,2
5,3,0,8,mixedType,1
8,1,0,9,mixedType,1
8,3,0,11,mixedType,1
7,3,0,10,mixedType,1
6,3,0,9,mixedType,1
15,1,0,16,mixedType,2
7,2,0,9,mixedType,1
6,4,0,10,mixedType,1
4,2,0,6,mixedType,0
13,3,0,16,mixedType,2
4,4,0,8,mixedType,1
9,4,0,13,mixedType,1
8,3,0,11,mixedType,1
2,7,0,9,mixedType,1
7,4,0,11,mixedType,1
5,6,0,11,mixedType,1
6,3,0,9,mixedType,1
4,4,0,8,mixedType,1
8,3,0,11,mixedType,1
4,6,0,10,mixedType,1
2,8,0,10,mixedType,1
6,3,0,9,mixedType,1
9,1,0,10,mixedType,1
5,8,0,13,mixedType,1
7,0,1,8,mixedType,1
6,2,0,8,mixedType,1
7,0,2,9,mixedType,1
5,2,0,7,mixedType,0
6,1,0,7,mixedType,0
5,2,0,7,mixedType,0
4,4,0,8,mixedType,1
12,3,0,15,mixedType,2
12,3,0,15,mixedType,2
4,4,0,8,mixedType,1
4,8,0,12,mixedType,1
1,10,0,11,mixedType,1
8,1,0,9,mixedType,1
8,1,0,9,mixedType,1
7,1,0,8,mixedType,1
14,2,0,16,mixedType,2
8,2,0,10,mixedType,1
5,4,0,9,mixedType,1
1,7,0,8,mixedType,1
8,2,0,10,mixedType,1
7,2,0,9,mixedType,1
11,1,0,12,mixedType,1
6,3,0,9,mixedType,1
8,1,0,9,mixedType,1
5,3,0,8,mixedType,1
10,1,0,11,mixedType,1
6,2,0,8,mixedType,1
6,3,0,9,mixedType,1
3,6,0,9,mixedType,1
7,2,0,9,mixedType,1
12,4,0,16,mixedType,2
8,2,0,10,mixedType,1
9,1,0,10,mixedType,1
3,5,0,8,mixedType,1
7,2,0,9,mixedType,1
6,6,0,12,mixedType,1
8,1,0,9,mixedType,1
6,3,0,9,mixedType,1
15,1,0,16,mixedType,2
7,2,0,9,mixedType,1
6,3,0,9,mixedType,1
8,2,0,10,mixedType,1
16,1,1,18,mixedType,2
13,3,0,16,mixedType,2
7,2,0,9,mixedType,1
6,1,0,7,mixedType,0
5,4,0,9,mixedType,1
7,3,0,10,mixedType,1
6,3,0,9,mixedType,1
4,4,0,8,mixedType,1
5,8,0,13,mixedType,1
6,2,0,8,mixedType,1
8,1,0,9,mixedType,1
7,1,0,8,mixedType,1
9,4,0,13,mixedType,1
8,1,0,9,mixedType,1
5,6,0,11,mixedType,1
5,3,0,8,mixedType,1
6,4,0,10,mixedType,1
9,2,0,11,mixedType,1
10,2,0,12,mixedType,1
8,4,0,12,mixedType,1
3,3,0,6,mixedType,0
6,2,0,8,mixedType,1
5,0,1,6,mixedType,0
5,3,0,8,mixedType,1
7,2,0,9,mixedType,1
8,2,0,10,mixedType,1
4,7,0,11,mixedType,1
5,4,0,9,mixedType,1
13,3,0,16,mixedType,2
7,2,0,9,mixedType,1
6,2,0,8,mixedType,1
2,6,0,8,mixedType,1
5,5,0,10,mixedType,1
6,3,0,9,mixedType,1
6,4,0,10,mixedType,1
13,3,0,16,mixedType,2
6,3,0,9,mixedType,1
14,2,0,16,mixedType,2
9,4,0,13,mixedType,1
9,3,0,12,mixedType,1
5,4,0,9,mixedType,1
6,3,0,9,mixedType,1
5,4,0,9,mixedType,1
8,2,0,10,mixedType,1
9,1,0,10,mixedType,1
7,5,0,12,mixedType,1
5,4,0,9,mixedType,1
6,3,0,9,mixedType,1
6,2,0,8,mixedType,1
6,2,0,8,mixedType,1
7,2,0,9,mixedType,1
7,3,0,10,mixedType,1
5,2,0,7,mixedType,0
13,3,0,16,mixedType,2
8,2,0,10,mixedType,1
7,4,0,11,mixedType,1
12,4,0,16,mixedType,2
5,1,0,6,mixedType,0
5,3,0,8,mixedType,1
2,8,0,10,mixedType,1
5,4,0,9,mixedType,1
4,2,0,6,mixedType,0
6,4,0,10,mixedType,1
1,9,0,10,mixedType,1
3,7,0,10,mixedType,1
13,3,0,16,mixedType,2
7,2,0,9,mixedType,1
13,2,0,15,mixedType,2
7,3,0,10,mixedType,1
7,3,0,10,mixedType,1
7,7,1,15,mixedType,2
8,2,0,10,mixedType,1
5,3,0,8,mixedType,1
5,3,0,8,mixedType,1
7,3,0,10,mixedType,1
14,2,0,16,mixedType,2
3,6,0,9,mixedType,1
7,1,0,8,mixedType,1
6,1,0,7,mixedType,0
7,3,0,10,mixedType,1
8,3,0,11,mixedType,1
1,8,0,9,mixedType,1
4,5,0,9,mixedType,1
5,3,0,8,mixedType,1
25,4,0,29,mixedType,2
4,2,0,6,mixedType,0
6,4,0,10,mixedType,1
5,4,0,9,mixedType,1
6,2,0,8,mixedType,1
6,1,0,7,mixedType,0
5,1,0,6,mixedType,0
8,1,0,9,mixedType,1
6,3,0,9,mixedType,1
7,3,0,10,mixedType,1
7,1,0,8,mixedType,1
2,8,0,10,mixedType,1
8,1,0,9,mixedType,1
8,2,0,10,mixedType,1
7,2,0,9,mixedType,1
9,1,0,10,mixedType,1
1,9,0,10,mixedType,1
6,3,0,9,mixedType,1
6,1,0,7,mixedType,0
11,1,0,12,mixedType,1
6,4,0,10,mixedType,1
11,3,0,14,mixedType,2
7,1,0,8,mixedType,1
5,3,0,8,mixedType,1
4,2,0,6,mixedType,0
6,4,0,10,mixedType,1
7,2,0,9,mixedType,1
5,2,0,7,mixedType,0
15,1,0,16,mixedType,2
8,1,0,9,mixedType,1
4,2,0,6,mixedType,0
7,3,0,10,mixedType,1
6,4,0,10,mixedType,1
2,6,0,8,mixedType,1
4,2,0,6,mixedType,0
12,4,0,16,mixedType,2
12,1,0,13,mixedType,1
9,1,0,10,mixedType,1
4,6,0,10,mixedType,1
6,2,0,8,mixedType,1
14,2,0,16,mixedType,2
1,1,1,3,mixedType,0
4,2,0,6,mixedType,0
4,6,0,10,mixedType,1
10,3,0,13,mixedType,1
3,6,0,9,mixedType,1
6,2,0,8,mixedType,1
7,3,0,10,mixedType,1
8,1,0,9,mixedType,1
8,3,0,11,mixedType,1
4,4,0,8,mixedType,1
13,3,0,16,mixedType,2
7,1,0,8,mixedType,1
4,4,0,8,mixedType,1
8,5,0,13,mixedType,1
7,2,0,9,mixedType,1
5,4,0,9,mixedType,1
6,4,0,10,mixedType,1
2,6,0,8,mixedType,1
5,4,0,9,mixedType,1
6,3,0,9,mixedType,1
6,2,0,8,mixedType,1
1,9,0,10,mixedType,1
6,1,0,7,mixedType,0
10,2,0,12,mixedType,1
2,8,0,10,mixedType,1
5,8,0,13,mixedType,1
6,4,0,10,mixedType,1
4,4,0,8,mixedType,1
15,1,0,16,mixedType,2
10,4,0,14,mixedType,2
6,1,0,7,mixedType,0
4,4,0,8,mixedType,1
8,1,0,9,mixedType,1
7,3,0,10,mixedType,1
6,2,0,8,mixedType,1
4,2,0,6,mixedType,0
5,9,1,15,mixedType,2
6,4,0,10,mixedType,1
7,3,0,10,mixedType,1
8,2,0,10,mixedType,1
5,7,0,12,mixedType,1
7,3,0,10,mixedType,1
2,8,0,10,mixedType,1
8,2,0,10,mixedType,1
4,7,0,11,mixedType,1
4,4,0,8,mixedType,1
5,3,0,8,mixedType,1
10,2,0,12,mixedType,1
6,1,0,7,mixedType,0
6,1,0,7,mixedType,0
7,0,1,8,mixedType,1
9,4,0,13,mixedType,1
13,3,0,16,mixedType,2
2,6,0,8,mixedType,1
6,1,0,7,mixedType,0
1,8,0,9,mixedType,1
5,3,0,8,mixedType,1
5,4,0,9,mixedType,1
4,6,0,10,mixedType,1
2,7,0,9,mixedType,1
5,2,0,7,mixedType,0
6,4,0,10,mixedType,1
6,3,0,9,mixedType,1
5,1,0,6,mixedType,0
8,4,0,12,mixedType,1
7,2,0,9,mixedType,1
4,4,0,8,mixedType,1
10,3,0,13,mixedType,1
7,2,0,9,mixedType,1
8,4,0,12,mixedType,1
8,1,0,9,mixedType,1
6,1,0,7,mixedType,0
6,0,1,7,mixedType,0
8,1,0,9,mixedType,1
6,1,0,7,mixedType,0
9,4,0,13,mixedType,1
7,3,0,10,mixedType,1
9,1,0,10,mixedType,1
5,3,0,8,mixedType,1
11,3,0,14,mixedType,2
14,2,0,16,mixedType,2
6,3,0,9,mixedType,1
6,2,0,8,mixedType,1
2,4,0,6,mixedType,0
5,4,0,9,mixedType,1
7,3,0,10,mixedType,1
5,4,0,9,mixedType,1
4,4,0,8,mixedType,1
5,1,0,6,mixedType,0
7,1,0,8,mixedType,1
6,2,0,8,mixedType,1
7,1,0,8,mixedType,1
7,2,0,9,mixedType,1
6,2,0,8,mixedType,1
7,2,0,9,mixedType,1
5,2,0,7,mixedType,0
6,2,0,8,mixedType,1
12,4,0,16,mixedType,2
1,9,0,10,mixedType,1
7,3,0,10,mixedType,1
12,3,0,15,mixedType,2
11,4,0,15,mixedType,2
3,6,0,9,mixedType,1
1,7,0,8,mixedType,1
5,4,0,9,mixedType,1
13,2,2,17,mixedType,2
6,2,0,8,mixedType,1
2,6,0,8,mixedType,1
12,4,0,16,mixedType,2
5,3,0,8,mixedType,1
8,3,0,11,mixedType,1
9,4,0,13,mixedType,1
9,4,0,13,mixedType,1
5,4,0,9,mixedType,1
9,4,0,13,mixedType,1
8,1,0,9,mixedType,1
4,2,0,6,mixedType,0
6,2,0,8,mixedType,1
9,1,0,10,mixedType,1
11,5,0,16,mixedType,2
5,4,0,9,mixedType,1
5,1,0,6,mixedType,0
9,4,0,13,mixedType,1
7,3,0,10,mixedType,1
6,1,0,7,mixedType,0
5,4,0,9,mixedType,1
8,2,0,10,mixedType,1
2,6,0,8,mixedType,1
7,3,0,10,mixedType,1
9,3,0,12,mixedType,1
7,2,0,9,mixedType,1
7,3,0,10,mixedType,1
11,2,0,13,mixedType,1
5,3,0,8,mixedType,1
5,3,0,8,mixedType,1
6,3,0,9,mixedType,1
7,2,0,9,mixedType,1
5,5,0,10,mixedType,1
7,2,0,9,mixedType,1
13,3,0,16,mixedType,2
4,2,0,6,mixedType,0
6,3,0,9,mixedType,1
12,4,0,16,mixedType,2
2,10,0,12,mixedType,1
8,1,0,9,mixedType,1
6,1,0,7,mixedType,0
4,4,0,8,mixedType,1
8,2,0,10,mixedType,1
8,1,0,9,mixedType,1
2,7,0,9,mixedType,1
4,2,0,6,mixedType,0
12,3,0,15,mixedType,2
6,5,0,11,mixedType,1
12,4,0,16,mixedType,2
2,10,0,12,mixedType,1
2,4,0,6,mixedType,0
11,3,0,14,mixedType,2
8,2,0,10,mixedType,1
5,2,0,7,mixedType,0
9,2,0,11,mixedType,1
6,2,0,8,mixedType,1
15,1,0,16,mixedType,2
7,2,0,9,mixedType,1
2,7,0,9,mixedType,1
6,3,0,9,mixedType,1
6,1,0,7,mixedType,0
5,4,0,9,mixedType,1
10,0,3,13,mixedType,1
12,4,0,16,mixedType,2
7,3,0,10,mixedType,1
6,3,0,9,mixedType,1
7,3,0,10,mixedType,1
5,2,0,7,mixedType,0
14,2,0,16,mixedType,2
1,7,0,8,mixedType,1
8,2,0,10,mixedType,1
8,1,0,9,mixedType,1
8,2,0,10,mixedType,1
4,6,0,10,mixedType,1
6,6,0,12,mixedType,1
10,4,0,14,mixedType,2
12,4,0,16,mixedType,2
4,2,0,6,mixedType,0
12,4,0,16,mixedType,2
5,3,0,8,mixedType,1
6,1,0,7,mixedType,0
11,1,0,12,mixedType,1
6,2,0,8,mixedType,1
5,2,0,7,mixedType,0
14,2,0,16,mixedType,2
6,3,0,9,mixedType,1
9,1,0,10,mixedType,1
8,1,0,9,mixedType,1
9,1,0,10,mixedType,1
6,3,0,9,mixedType,1
2,8,0,10,mixedType,1
8,1,0,9,mixedType,1
5,2,0,7,mixedType,0
1,10,0,11,mixedType,1
2,9,0,11,mixedType,1
9,1,0,10,mixedType,1
3,3,0,6,mixedType,0
10,6,1,17,mixedType,2
5,6,0,11,mixedType,1
6,3,0,9,mixedType,1
7,4,0,11,mixedType,1
7,3,0,10,mixedType,1
6,3,0,9,mixedType,1
7,3,0,10,mixedType,1
2,8,0,10,mixedType,1
8,3,0,11,mixedType,1
9,0,1,10,mixedType,1
4,2,0,6,mixedType,0
5,3,0,8,mixedType,1
1,8,0,9,mixedType,1
6,3,0,9,mixedType,1
10,6,0,16,mixedType,2
6,1,0,7,mixedType,0
6,4,0,10,mixedType,1
8,4,0,12,mixedType,1
8,3,0,11,mixedType,1
5,2,0,7,mixedType,0
6,3,0,9,mixedType,1
14,2,0,16,mixedType,2
5,1,0,6,mixedType,0
7,1,0,8,mixedType,1
9,2,0,11,mixedType,1
7,3,0,10,mixedType,1
7,1,0,8,mixedType,1
6,2,0,8,mixedType,1
11,1,0,12,mixedType,1
9,1,0,10,mixedType,1
12,3,0,15,mixedType,2
6,1,0,7,mixedType,0
5,1,0,6,mixedType,0
13,3,0,16,mixedType,2
12,3,0,15,mixedType,2
7,2,0,9,mixedType,1
9,1,0,10,mixedType,1
5,2,0,7,mixedType,0
7,1,0,8,mixedType,1
7,1,0,8,mixedType,1
8,1,0,9,mixedType,1
8,3,0,11,mixedType,1
6,3,0,9,mixedType,1
6,3,0,9,mixedType,1
9,1,0,10,mixedType,1
8,1,0,9,mixedType,1
4,6,0,10,mixedType,1
6,1,0,7,mixedType,0
7,2,0,9,mixedType,1
6,4,0,10,mixedType,1
6,6,0,12,mixedType,1
9,2,0,11,mixedType,1
3,5,0,8,mixedType,1
8,2,0,10,mixedType,1
4,4,0,8,mixedType,1
10,3,0,13,mixedType,1
4,2,0,6,mixedType,0
6,4,0,10,mixedType,1
6,2,0,8,mixedType,1
8,4,0,12,mixedType,1
9,2,0,11,mixedType,1
5,2,0,7,mixedType,0
9,3,0,12,mixedType,1
9,3,0,12,mixedType,1
3,5,0,8,mixedType,1
6,1,0,7,mixedType,0
5,2,0,7,mixedType,0
5,4,0,9,mixedType,1
7,1,0,8,mixedType,1
8,5,1,14,mixedType,2
8,3,0,11,mixedType,1
8,6,0,14,mixedType,2
5,5,0,10,mixedType,1
2,8,0,10,mixedType,1
9,2,0,11,mixedType,1
9,4,0,13,mixedType,1
7,2,0,9,mixedType,1
6,3,0,9,mixedType,1
5,6,0,11,mixedType,1
6,3,0,9,mixedType,1
8,2,0,10,mixedType,1
12,3,0,15,mixedType,2
8,1,0,9,mixedType,1
3,6,0,9,mixedType,1
5,4,0,9,mixedType,1
4,4,0,8,mixedType,1
3,7,0,10,mixedType,1
8,4,0,12,mixedType,1
8,1,0,9,mixedType,1
8,3,0,11,mixedType,1
12,4,0,16,mixedType,2
14,2,0,16,mixedType,2
11,5,0,16,mixedType,2
11,4,0,15,mixedType,2
15,1,0,16,mixedType,2
6,1,0,7,mixedType,0
9,1,0,10,mixedType,1
12,4,0,16,mixedType,2
6,3,0,9,mixedType,1
6,4,0,10,mixedType,1
8,1,0,9,mixedType,1
6,1,0,7,mixedType,0
3,5,0,8,mixedType,1
8,2,0,10,mixedType,1
4,4,0,8,mixedType,1
4,4,0,8,mixedType,1
5,3,0,8,mixedType,1
3,8,0,11,mixedType,1
13,3,0,16,mixedType,2
6,2,0,8,mixedType,1
6,1,0,7,mixedType,0
7,1,0,8,mixedType,1
7,3,0,10,mixedType,1
3,6,0,9,mixedType,1
9,1,0,10,mixedType,1
1,9,0,10,mixedType,1
7,3,0,10,mixedType,1
14,2,0,16,mixedType,2
5,2,0,7,mixedType,0
7,1,0,8,mixedType,1
14,2,0,16,mixedType,2
11,3,0,14,mixedType,2
2,8,0,10,mixedType,1
2,6,0,8,mixedType,1
5,2,0,7,mixedType,0
4,4,0,8,mixedType,1
8,2,0,10,mixedType,1
9,1,0,10,mixedType,1
13,3,0,16,mixedType,2
9,1,0,10,mixedType,1
6,3,0,9,mixedType,1
8,2,0,10,mixedType,1
6,4,0,10,mixedType,1
9,2,0,11,mixedType,1
8,1,0,9,mixedType,1
5,3,0,8,mixedType,1
7,1,0,8,mixedType,1
15,1,0,16,mixedType,2
9,1,0,10,mixedType,1
2,6,0,8,mixedType,1
4,2,0,6,mixedType,0
1,9,0,10,mixedType,1
4,6,0,10,mixedType,1
7,5,0,12,mixedType,1
7,1,0,8,mixedType,1
11,2,0,13,mixedType,1
6,3,0,9,mixedType,1
6,3,0,9,mixedType,1
6,4,0,10,mixedType,1
6,4,0,10,mixedType,1
9,3,0,12,mixedType,1
7,2,0,9,mixedType,1
7,3,0,10,mixedType,1
9,4,0,13,mixedType,1
6,4,0,10,mixedType,1
5,10,0,15,mixedType,2
11,3,0,14,mixedType,2
6,1,0,7,mixedType,0
7,1,0,8,mixedType,1
5,4,0,9,mixedType,1
8,1,0,9,mixedType,1
6,6,0,12,mixedType,1
10,2,0,12,mixedType,1
6,3,0,9,mixedType,1
5,2,0,7,mixedType,0
5,4,0,9,mixedType,1
3,6,0,9,mixedType,1
7,3,0,10,mixedType,1
6,3,0,9,mixedType,1
6,3,0,9,mixedType,1
8,3,0,11,mixedType,1
1,9,0,10,mixedType,1
9,3,0,12,mixedType,1
8,3,0,11,mixedType,1
9,1,0,10,mixedType,1
7,4,0,11,mixedType,1
2,8,0,10,mixedType,1
14,2,0,16,mixedType,2
7,3,0,10,mixedType,1
7,3,0,10,mixedType,1
11,1,0,12,mixedType,1
7,2,0,9,mixedType,1
5,4,0,9,mixedType,1
8,1,0,9,mixedType,1
6,2,0,8,mixedType,1
7,3,0,10,mixedType,1
9,0,1,10,mixedType,1
4,2,0,6,mixedType,0
8,2,0,10,mixedType,1
6,3,0,9,mixedType,1
7,1,0,8,mixedType,1
8,2,0,10,mixedType,1
5,2,0,7,mixedType,0
8,3,0,11,mixedType,1
6,3,0,9,mixedType,1
7,1,0,8,mixedType,1
6,3,0,9,mixedType,1
5,4,0,9,mixedType,1
6,2,0,8,mixedType,1
6,3,0,9,mixedType,1
9,1,0,10,mixedType,1
6,2,0,8,mixedType,1
6,3,0,9,mixedType,1
4,4,0,8,mixedType,1
8,4,0,12,mixedType,1
4,4,0,8,mixedType,1
10,2,0,12,mixedType,1
14,2,0,16,mixedType,2
6,4,0,10,mixedType,1
8,3,0,11,mixedType,1
4,7,0,11,mixedType,1
5,7,0,12,mixedType,1
7,3,0,10,mixedType,1
6,3,0,9,mixedType,1
6,4,0,10,mixedType,1
3,6,0,9,mixedType,1
8,1,0,9,mixedType,1
7,3,0,10,mixedType,1
6,4,0,10,mixedType,1
2,4,0,6,mixedType,0
4,4,0,8,mixedType,1
2,8,0,10,mixedType,1
2,10,0,12,mixedType,1
2,6,0,8,mixedType,1
8,2,0,10,mixedType,1
6,1,0,7,mixedType,0
7,3,0,10,mixedType,1
5,3,0,8,mixedType,1
8,1,0,9,mixedType,1
14,2,0,16,mixedType,2
6,4,0,10,mixedType,1
6,2,0,8,mixedType,1
7,3,0,10,mixedType,1
12,3,0,15,mixedType,2
9,3,0,12,mixedType,1
2,6,0,8,mixedType,1
8,1,0,9,mixedType,1
9,1,0,10,mixedType,1
5,1,0,6,mixedType,0
6,2,0,8,mixedType,1
7,3,0,10,mixedType,1
9,3,0,12,mixedType,1
5,2,0,7,mixedType,0
7,3,0,10,mixedType,1
3,6,0,9,mixedType,1
2,4,0,6,mixedType,0
6,2,0,8,mixedType,1
3,5,0,8,mixedType,1
2,6,0,8,mixedType,1
2,8,0,10,mixedType,1
9,3,0,12,mixedType,1
6,3,0,9,mixedType,1
7,1,0,8,mixedType,1
5,3,0,8,mixedType,1
6,3,0,9,mixedType,1
5,4,0,9,mixedType,1
8,2,0,10,mixedType,1
7,3,0,10,mixedType,1
6,0,1,7,mixedType,0
8,2,0,10,mixedType,1
8,3,0,11,mixedType,1
11,3,0,14,mixedType,2
7,2,0,9,mixedType,1
7,2,0,9,mixedType,1
7,2,0,9,mixedType,1
6,1,0,7,mixedType,0
5,2,0,7,mixedType,0
9,2,0,11,mixedType,1
6,1,0,7,mixedType,0
6,4,0,10,mixedType,1
8,2,0,10,mixedType,1
8,2,0,10,mixedType,1
19,3,2,24,mixedType,2
8,2,0,10,mixedType,1
6,4,0,10,mixedType,1
5,1,0,6,mixedType,0
6,1,0,7,mixedType,0
7,3,0,10,mixedType,1
6,3,0,9,mixedType,1
6,1,0,7,mixedType,0
11,3,0,14,mixedType,2
4,2,0,6,mixedType,0
9,3,0,12,mixedType,1
4,4,0,8,mixedType,1
4,4,0,8,mixedType,1
2,9,0,11,mixedType,1
8,1,0,9,mixedType,1
9,3,0,12,mixedType,1
6,1,0,7,mixedType,0
8,3,0,11,mixedType,1
5,4,0,9,mixedType,1
7,1,0,8,mixedType,1
6,2,0,8,mixedType,1
7,2,0,9,mixedType,1
8,3,0,11,mixedType,1
11,1,0,12,mixedType,1
7,3,0,10,mixedType,1
8,1,0,9,mixedType,1
10,3,0,13,mixedType,1
4,6,0,10,mixedType,1
7,3,0,10,mixedType,1
7,2,0,9,mixedType,1
4,2,0,6,mixedType,0
7,2,0,9,mixedType,1
4,4,0,8,mixedType,1
6,2,0,8,mixedType,1
5,4,0,9,mixedType,1
6,3,0,9,mixedType,1
8,3,0,11,mixedType,1
8,2,0,10,mixedType,1
7,5,0,12,mixedType,1
6,3,0,9,mixedType,1
2,8,0,10,mixedType,1
5,4,0,9,mixedType,1
5,2,0,7,mixedType,0
11,1,0,12,mixedType,1
8,1,0,9,mixedType,1
2,8,0,10,mixedType,1
8,2,0,10,mixedType,1
5,5,0,10,mixedType,1
8,2,0,10,mixedType,1
9,1,0,10,mixedType,1
4,4,0,8,mixedType,1
7,3,0,10,mixedType,1
8,3,0,11,mixedType,1
3,6,0,9,mixedType,1
7,3,0,10,mixedType,1
12,4,0,16,mixedType,2
6,4,4,14,mixedType,2
5,4,0,9,mixedType,1
6,3,0,9,mixedType,1
5,6,0,11,mixedType,1
5,2,0,7,mixedType,0
6,4,0,10,mixedType,1
5,3,0,8,mixedType,1
6,3,0,9,mixedType,1
6,3,0,9,mixedType,1
5,1,0,6,mixedType,0
6,2,0,8,mixedType,1
5,4,0,9,mixedType,1
5,1,0,6,mixedType,0
14,2,0,16,mixedType,2
11,3,0,14,mixedType,2
7,3,0,10,mixedType,1
1,9,0,10,mixedType,1
14,2,0,16,mixedType,2
5,2,0,7,mixedType,0
6,3,0,9,mixedType,1
5,3,0,8,mixedType,1
8,2,0,10,mixedType,1
15,1,0,16,mixedType,2
7,3,0,10,mixedType,1
10,3,0,13,mixedType,1
10,3,0,13,mixedType,1
11,4,0,15,mixedType,2
9,2,0,11,mixedType,1
8,5,0,13,mixedType,1
8,2,0,10,mixedType,1
9,3,0,12,mixedType,1
5,6,0,11,mixedType,1
6,3,0,9,mixedType,1
13,3,0,16,mixedType,2
9,4,0,13,mixedType,1
6,2,0,8,mixedType,1
9,2,0,11,mixedType,1
14,2,0,16,mixedType,2
6,7,0,13,mixedType,1
6,1,0,7,mixedType,0
6,4,0,10,mixedType,1
8,1,0,9,mixedType,1
2,7,0,9,mixedType,1
7,2,0,9,mixedType,1
2,6,0,8,mixedType,1
6,3,0,9,mixedType,1
7,2,0,9,mixedType,1
7,3,0,10,mixedType,1
6,3,0,9,mixedType,1
4,4,0,8,mixedType,1
10,6,0,16,mixedType,2
14,2,0,16,mixedType,2
5,3,0,8,mixedType,1
15,1,0,16,mixedType,2
9,3,0,12,mixedType,1
1,8,0,9,mixedType,1
9,2,0,11,mixedType,1
13,3,0,16,mixedType,2
4,2,0,6,mixedType,0
7,4,0,11,mixedType,1
7,1,0,8,mixedType,1
13,3,0,16,mixedType,2
6,3,0,9,mixedType,1
8,2,0,10,mixedType,1
9,1,0,10,mixedType,1
6,1,0,7,mixedType,0
5,2,0,7,mixedType,0
14,2,0,16,mixedType,2
6,2,0,8,mixedType,1
7,4,0,11,mixedType,1
7,2,0,9,mixedType,1
3,6,0,9,mixedType,1
12,3,0,15,mixedType,2
5,3,0,8,mixedType,1
12,1,0,13,mixedType,1
9,1,0,10,mixedType,1
6,1,0,7,mixedType,0
12,3,0,15,mixedType,2
6,5,0,11,mixedType,1
8,1,0,9,mixedType,1
7,3,0,10,mixedType,1
5,1,0,6,mixedType,0
5,4,0,9,mixedType,1
7,1,0,8,mixedType,1
7,3,0,10,mixedType,1
7,2,0,9,mixedType,1
4,2,0,6,mixedType,0
8,3,0,11,mixedType,1
4,4,0,8,mixedType,1
9,3,0,12,mixedType,1
7,1,0,8,mixedType,1
10,0,1,11,mixedType,1
11,4,0,15,mixedType,2
7,2,0,9,mixedType,1
12,3,0,15,mixedType,2
3,6,0,9,mixedType,1
4,4,0,8,mixedType,1
2,7,0,9,mixedType,1
6,1,0,7,mixedType,0
6,1,0,7,mixedType,0
5,1,0,6,mixedType,0
6,4,0,10,mixedType,1
5,1,0,6,mixedType,0
3,7,0,10,mixedType,1
5,1,0,6,mixedType,0
1,12,0,13,mixedType,1
8,2,0,10,mixedType,1
6,5,0,11,mixedType,1
5,6,0,11,mixedType,1
7,4,0,11,mixedType,1
8,1,0,9,mixedType,1
6,4,0,10,mixedType,1
4,8,0,12,mixedType,1
13,2,0,15,mixedType,2
5,3,0,8,mixedType,1
15,3,1,19,mixedType,2
5,2,0,7,mixedType,0
13,3,0,16,mixedType,2
12,3,0,15,mixedType,2
5,2,0,7,mixedType,0
10,2,0,12,mixedType,1
8,1,0,9,mixedType,1
7,2,0,9,mixedType,1
9,1,0,10,mixedType,1
1,11,0,12,mixedType,1
6,2,0,8,mixedType,1
12,4,0,16,mixedType,2
6,3,0,9,mixedType,1
8,3,0,11,mixedType,1
5,0,2,7,mixedType,0
7,1,0,8,mixedType,1
2,8,0,10,mixedType,1
12,3,0,15,mixedType,2
7,3,0,10,mixedType,1
6,6,0,12,mixedType,1
7,2,0,9,mixedType,1
13,3,0,16,mixedType,2
4,4,0,8,mixedType,1
6,2,0,8,mixedType,1
5,3,0,8,mixedType,1
14,2,0,16,mixedType,2
3,9,0,12,mixedType,1
5,4,0,9,mixedType,1
7,1,0,8,mixedType,1
15,1,0,16,mixedType,2
12,4,0,16,mixedType,2
13,3,0,16,mixedType,2
1,9,0,10,mixedType,1
5,3,0,8,mixedType,1
9,3,0,12,mixedType,1
3,10,0,13,mixedType,1
9,2,0,11,mixedType,1
6,4,0,10,mixedType,1
7,2,0,9,mixedType,1
9,2,0,11,mixedType,1
7,1,0,8,mixedType,1
1,8,0,9,mixedType,1
7,2,0,9,mixedType,1
4,6,0,10,mixedType,1
4,6,0,10,mixedType,1
7,3,0,10,mixedType,1
4,4,0,8,mixedType,1
7,3,0,10,mixedType,1
4,4,0,8,mixedType,1
6,3,0,9,mixedType,1
7,3,0,10,mixedType,1
7,3,0,10,mixedType,1
10,1,0,11,mixedType,1
2,8,0,10,mixedType,1
6,3,0,9,mixedType,1
6,3,0,9,mixedType,1
5,1,0,6,mixedType,0
7,3,0,10,mixedType,1
13,3,0,16,mixedType,2
8,4,0,12,mixedType,1
10,2,0,12,mixedType,1
5,6,0,11,mixedType,1
8,1,0,9,mixedType,1
4,4,0,8,mixedType,1
10,1,0,11,mixedType,1
6,2,0,8,mixedType,1
6,3,0,9,mixedType,1
7,2,0,9,mixedType,1
5,1,0,6,mixedType,0
6,2,0,8,mixedType,1
7,3,0,10,mixedType,1
6,2,0,8,mixedType,1
6,6,0,12,mixedType,1
3,6,0,9,mixedType,1
6,2,0,8,mixedType,1
5,2,0,7,mixedType,0
8,3,0,11,mixedType,1
6,2,0,8,mixedType,1
13,3,0,16,mixedType,2
2,4,0,6,mixedType,0
3,7,0,10,mixedType,1
9,1,0,10,mixedType,1
7,1,0,8,mixedType,1
4,4,0,8,mixedType,1
6,1,0,7,mixedType,0
7,2,0,9,mixedType,1
5,3,0,8,mixedType,1
9,1,0,10,mixedType,1
8,2,0,10,mixedType,1
6,4,0,10,mixedType,1
7,2,0,9,mixedType,1
8,2,0,10,mixedType,1
1,8,0,9,mixedType,1
13,3,0,16,mixedType,2
1,8,0,9,mixedType,1
1,8,0,9,mixedType,1
9,1,0,10,mixedType,1
1,9,0,10,mixedType,1
6,3,0,9,mixedType,1
8,4,0,12,mixedType,1
1,11,0,12,mixedType,1
4,2,0,6,mixedType,0
4,4,0,8,mixedType,1
11,2,0,13,mixedType,1
5,4,0,9,mixedType,1
8,2,0,10,mixedType,1
4,6,0,10,mixedType,1
7,3,0,10,mixedType,1
3,5,0,8,mixedType,1
5,2,0,7,mixedType,0
7,2,0,9,mixedType,1
8,2,0,10,mixedType,1
3,5,0,8,mixedType,1
8,1,0,9,mixedType,1
8,4,0,12,mixedType,1
11,3,0,14,mixedType,2
3,6,0,9,mixedType,1
7,3,0,10,mixedType,1
4,6,0,10,mixedType,1
3,7,0,10,mixedType,1
8,2,0,10,mixedType,1
5,4,0,9,mixedType,1
8,3,0,11,mixedType,1
7,3,0,10,mixedType,1
6,4,0,10,mixedType,1
9,4,3,16,mixedType,2
15,1,0,16,mixedType,2
10,3,0,13,mixedType,1
6,1,0,7,mixedType,0
7,3,0,10,mixedType,1
4,4,0,8,mixedType,1
7,1,0,8,mixedType,1
8,2,0,10,mixedType,1
8,2,0,10,mixedType,1
7,2,0,9,mixedType,1
7,2,0,9,mixedType,1
4,4,0,8,mixedType,1
3,5,0,8,mixedType,1
7,1,0,8,mixedType,1
8,1,0,9,mixedType,1
5,1,0,6,mixedType,0
5,2,0,7,mixedType,0
3,6,0,9,mixedType,1
15,1,0,16,mixedType,2
4,4,0,8,mixedType,1
6,1,0,7,mixedType,0
3,5,0,8,mixedType,1
5,2,0,7,mixedType,0
6,7,0,13,mixedType,1
8,2,0,10,mixedType,1
5,3,0,8,mixedType,1
6,3,0,9,mixedType,1
11,2,0,13,mixedType,1
1,9,0,10,mixedType,1
6,3,0,9,mixedType,1
11,3,0,14,mixedType,2
5,2,0,7,mixedType,0
7,1,0,8,mixedType,1
5,4,0,9,mixedType,1
5,3,0,8,mixedType,1
6,1,0,7,mixedType,0
13,4,0,17,mixedType,2
4,2,0,6,mixedType,0
2,6,0,8,mixedType,1
4,4,0,8,mixedType,1
6,3,0,9,mixedType,1
2,8,0,10,mixedType,1
5,4,0,9,mixedType,1
6,3,0,9,mixedType,1
3,6,0,9,mixedType,1
15,1,0,16,mixedType,2
10,6,0,16,mixedType,2
6,4,0,10,mixedType,1
13,3,0,16,mixedType,2
1,8,0,9,mixedType,1
3,7,0,10,mixedType,1
6,2,0,8,mixedType,1
6,3,0,9,mixedType,1
4,2,0,6,mixedType,0
6,8,0,14,mixedType,2
7,3,0,10,mixedType,1
6,2,0,8,mixedType,1
9,4,0,13,mixedType,1
6,2,0,8,mixedType,1
4,4,0,8,mixedType,1
6,2,0,8,mixedType,1
13,3,0,16,mixedType,2
3,6,0,9,mixedType,1
4,4,0,8,mixedType,1
10,1,0,11,mixedType,1
7,2,0,9,mixedType,1
7,3,0,10,mixedType,1
8,4,0,12,mixedType,1
13,3,0,16,mixedType,2
6,1,0,7,mixedType,0
8,1,0,9,mixedType,1
8,1,0,9,mixedType,1
4,2,0,6,mixedType,0
6,6,0,12,mixedType,1
7,2,0,9,mixedType,1
4,10,2,16,mixedType,2
6,3,0,9,mixedType,1
2,7,0,9,mixedType,1
9,2,0,11,mixedType,1
5,4,0,9,mixedType,1
4,4,0,8,mixedType,1
3,6,0,9,mixedType,1
7,2,0,9,mixedType,1
8,1,0,9,mixedType,1
14,2,0,16,mixedType,2
10,1,0,11,mixedType,1
14,2,0,16,mixedType,2
7,2,0,9,mixedType,1
6,1,0,7,mixedType,0
9,3,0,12,mixedType,1
5,1,0,6,mixedType,0
7,2,0,9,mixedType,1
5,3,0,8,mixedType,1
6,1,0,7,mixedType,0
8,2,0,10,mixedType,1
7,2,0,9,mixedType,1
6,1,0,7,mixedType,0
1,9,0,10,mixedType,1
1,9,0,10,mixedType,1
6,2,0,8,mixedType,1
6,1,0,7,mixedType,0
5,2,0,7,mixedType,0
14,2,0,16,mixedType,2
2,8,0,10,mixedType,1
14,2,0,16,mixedType,2
9,1,0,10,mixedType,1
9,1,0,10,mixedType,1
8,3,0,11,mixedType,1
5,3,0,8,mixedType,1
7,2,0,9,mixedType,1
6,4,0,10,mixedType,1
7,3,0,10,mixedType,1
2,12,0,14,mixedType,2
2,8,0,10,mixedType,1
9,2,0,11,mixedType,1
4,2,0,6,mixedType,0
3,5,0,8,mixedType,1
5,4,0,9,mixedType,1
9,2,0,11,mixedType,1
12,4,0,16,mixedType,2
10,7,0,17,mixedType,2
8,3,0,11,mixedType,1
2,8,0,10,mixedType,1
3,6,0,9,mixedType,1
7,2,0,9,mixedType,1
9,3,0,12,mixedType,1
4,2,0,6,mixedType,0
1,8,0,9,mixedType,1
14,2,0,16,mixedType,2
5,3,0,8,mixedType,1
6,3,0,9,mixedType,1
8,2,0,10,mixedType,1
1,8,0,9,mixedType,1
8,2,0,10,mixedType,1
1,8,0,9,mixedType,1
5,2,0,7,mixedType,0
1,8,0,9,mixedType,1
9,1,0,10,mixedType,1
6,4,0,10,mixedType,1
7,1,0,8,mixedType,1
14,2,0,16,mixedType,2
8,1,0,9,mixedType,1
8,2,0,10,mixedType,1
8,1,0,9,mixedType,1
4,7,0,11,mixedType,1
5,6,0,11,mixedType,1
3,7,0,10,mixedType,1
4,4,0,8,mixedType,1
1,9,0,10,mixedType,1
2,7,0,9,mixedType,1
7,4,0,11,mixedType,1
8,1,0,9,mixedType,1
7,3,0,10,mixedType,1
5,2,0,7,mixedType,0
7,3,0,10,mixedType,1
15,1,0,16,mixedType,2
4,6,0,10,mixedType,1
15,1,0,16,mixedType,2
15,1,0,16,mixedType,2
0,10,0,10,sameType,1
9,3,0,12,mixedType,1
6,2,0,8,mixedType,1
5,3,0,8,mixedType,1
6,2,0,8,mixedType,1
6,3,0,9,mixedType,1
2,6,0,8,mixedType,1
9,2,0,11,mixedType,1
12,3,0,15,mixedType,2
4,2,0,6,mixedType,0
4,2,0,6,mixedType,0
7,2,0,9,mixedType,1
9,4,0,13,mixedType,1
4,5,0,9,mixedType,1
5,2,0,7,mixedType,0
6,3,1,10,mixedType,1
13,3,0,16,mixedType,2
5,2,0,7,mixedType,0
9,4,0,13,mixedType,1
4,4,0,8,mixedType,1
12,4,0,16,mixedType,2
10,2,0,12,mixedType,1
6,2,0,8,mixedType,1
6,2,0,8,mixedType,1
2,8,0,10,mixedType,1
8,3,0,11,mixedType,1
3,6,0,9,mixedType,1
8,1,0,9,mixedType,1
6,3,0,9,mixedType,1
6,2,0,8,mixedType,1
4,6,0,10,mixedType,1
5,3,0,8,mixedType,1
5,4,0,9,mixedType,1
11,3,0,14,mixedType,2
12,3,0,15,mixedType,2
8,1,0,9,mixedType,1
5,2,0,7,mixedType,0
5,3,0,8,mixedType,1
11,3,0,14,mixedType,2
14,2,0,16,mixedType,2
5,6,0,11,mixedType,1
8,4,0,12,mixedType,1
8,1,0,9,mixedType,1
6,1,0,7,mixedType,0
5,5,4,14,mixedType,1
5,8,0,13,mixedType,1
8,1,0,9,mixedType,1
6,2,0,8,mixedType,1
7,2,0,9,mixedType,1
5,3,0,8,mixedType,1
8,1,0,9,mixedType,1
6,6,0,12,mixedType,1
5,8,1,14,mixedType,2
8,3,0,11,mixedType,1
5,5,0,10,mixedType,1
12,3,0,15,mixedType,2
7,1,0,8,mixedType,1
5,2,0,7,mixedType,0
5,3,0,8,mixedType,1
6,2,0,8,mixedType,1
7,3,0,10,mixedType,1
11,1,0,12,mixedType,1
12,3,1,16,mixedType,2
6,3,0,9,mixedType,1
3,8,0,11,mixedType,1
13,3,0,16,mixedType,2
9,3,0,12,mixedType,1
5,5,0,10,mixedType,1
7,3,0,10,mixedType,1
9,1,0,10,mixedType,1
14,2,0,16,mixedType,2
6,4,0,10,mixedType,1
6,1,0,7,mixedType,0
9,1,0,10,mixedType,1
7,3,0,10,mixedType,1
8,3,0,11,mixedType,1
7,3,0,10,mixedType,1
12,1,0,13,mixedType,1
8,1,0,9,mixedType,1
1,10,0,11,mixedType,1
5,2,0,7,mixedType,0
7,2,0,9,mixedType,1
12,3,0,15,mixedType,2
5,2,0,7,mixedType,0
7,3,0,10,mixedType,1
12,4,0,16,mixedType,2
8,1,0,9,mixedType,1
8,2,0,10,mixedType,1
6,1,0,7,mixedType,0
1,8,0,9,mixedType,1
6,1,0,7,mixedType,0
5,9,2,16,mixedType,2
3,7,0,10,mixedType,1
9,2,0,11,mixedType,1
7,4,0,11,mixedType,1
4,4,0,8,mixedType,1
8,2,0,10,mixedType,1
4,2,0,6,mixedType,0
6,4,0,10,mixedType,1
8,3,0,11,mixedType,1
3,3,0,6,mixedType,0
5,3,0,8,mixedType,1
3,6,0,9,mixedType,1
13,3,0,16,mixedType,2
12,4,0,16,mixedType,2
6,3,0,9,mixedType,1
8,1,0,9,mixedType,1
14,2,0,16,mixedType,2
10,1,0,11,mixedType,1
7,2,0,9,mixedType,1
8,1,0,9,mixedType,1
7,2,0,9,mixedType,1
6,4,0,10,mixedType,1
4,5,0,9,mixedType,1
6,2,0,8,mixedType,1
9,1,0,10,mixedType,1
5,4,0,9,mixedType,1
7,4,0,11,mixedType,1
13,3,0,16,mixedType,2
5,3,0,8,mixedType,1
6,4,0,10,mixedType,1
8,1,0,9,mixedType,1
7,2,0,9,mixedType,1
7,3,0,10,mixedType,1
13,3,0,16,mixedType,2
6,3,0,9,mixedType,1
8,1,0,9,mixedType,1
7,3,0,10,mixedType,1
5,4,0,9,mixedType,1
6,3,0,9,mixedType,1
8,2,0,10,mixedType,1
7,3,0,10,mixedType,1
11,3,0,14,mixedType,2
6,2,0,8,mixedType,1
5,3,0,8,mixedType,1
7,3,0,10,mixedType,1
7,4,0,11,mixedType,1
2,7,0,9,mixedType,1
5,5,0,10,mixedType,1
5,6,0,11,mixedType,1
2,8,0,10,mixedType,1
11,0,2,13,mixedType,1
8,5,0,13,mixedType,1
6,3,0,9,mixedType,1
14,2,0,16,mixedType,2
13,3,0,16,mixedType,2
9,3,0,12,mixedType,1
5,4,0,9,mixedType,1
8,1,0,9,mixedType,1
6,2,0,8,mixedType,1
6,3,0,9,mixedType,1
3,6,0,9,mixedType,1
14,2,0,16,mixedType,2
6,1,0,7,mixedType,0
6,3,0,9,mixedType,1
8,1,0,9,mixedType,1
13,3,0,16,mixedType,2
7,3,0,10,mixedType,1
6,1,0,7,mixedType,0
9,4,0,13,mixedType,1
3,3,0,6,mixedType,0
9,3,0,12,mixedType,1
6,4,0,10,mixedType,1
5,6,0,11,mixedType,1
5,8,0,13,mixedType,1
7,3,0,10,mixedType,1
1,8,0,9,mixedType,1
7,3,0,10,mixedType,1
8,2,0,10,mixedType,1
5,4,0,9,mixedType,1
4,6,0,10,mixedType,1
7,3,0,10,mixedType,1
9,2,0,11,mixedType,1
7,3,0,10,mixedType,1
4,4,0,8,mixedType,1
7,1,0,8,mixedType,1
5,3,0,8,mixedType,1
5,4,0,9,mixedType,1
1,9,0,10,mixedType,1
6,3,0,9,mixedType,1
7,3,0,10,mixedType,1
9,1,0,10,mixedType,1
13,3,0,16,mixedType,2
7,3,0,10,mixedType,1
4,2,0,6,mixedType,0
14,2,0,16,mixedType,2
15,1,0,16,mixedType,2
9,2,0,11,mixedType,1
3,5,0,8,mixedType,1
3,3,0,6,mixedType,0
4,4,0,8,mixedType,1
5,3,0,8,mixedType,1
6,2,0,8,mixedType,1
5,4,0,9,mixedType,1
9,1,0,10,mixedType,1
5,8,0,13,mixedType,1
5,1,0,6,mixedType,0
9,1,0,10,mixedType,1
6,7,0,13,mixedType,1
2,6,0,8,mixedType,1
13,3,0,16,mixedType,2
2,6,0,8,mixedType,1
3,7,0,10,mixedType,1
4,4,0,8,mixedType,1
4,6,0,10,mixedType,1
10,3,1,14,mixedType,2
6,2,0,8,mixedType,1
5,4,0,9,mixedType,1
8,1,0,9,mixedType,1
1,9,0,10,mixedType,1
8,2,0,10,mixedType,1
9,3,0,12,mixedType,1
7,3,0,10,mixedType,1
1,7,0,8,mixedType,1
6,4,0,10,mixedType,1
5,3,0,8,mixedType,1
12,4,0,16,mixedType,2
5,4,0,9,mixedType,1
4,2,0,6,mixedType,0
9,3,0,12,mixedType,1
13,3,0,16,mixedType,2
14,2,0,16,mixedType,2
9,1,0,10,mixedType,1
4,2,0,6,mixedType,0
7,1,0,8,mixedType,1
7,3,0,10,mixedType,1
10,1,0,11,mixedType,1
6,4,0,10,mixedType,1
9,3,0,12,mixedType,1
4,6,0,10,mixedType,1
5,4,0,9,mixedType,1
14,2,0,16,mixedType,2
7,3,0,10,mixedType,1
5,2,0,7,mixedType,0
2,6,0,8,mixedType,1
5,3,0,8,mixedType,1
5,3,0,8,mixedType,1
5,4,0,9,mixedType,1
2,6,0,8,mixedType,1
10,2,0,12,mixedType,1
5,5,0,10,mixedType,1
14,2,0,16,mixedType,2
5,2,0,7,mixedType,0
6,1,0,7,mixedType,0
6,4,0,10,mixedType,1
4,5,0,9,mixedType,1
10,2,0,12,mixedType,1
15,1,0,16,mixedType,2
5,5,0,10,mixedType,1
9,1,0,10,mixedType,1
5,3,0,8,mixedType,1
7,3,0,10,mixedType,1
8,2,0,10,mixedType,1
7,2,0,9,mixedType,1
6,4,0,10,mixedType,1
15,1,0,16,mixedType,2
7,3,0,10,mixedType,1
8,1,0,9,mixedType,1
4,4,0,8,mixedType,1
7,1,0,8,mixedType,1
10,2,0,12,mixedType,1
8,2,0,10,mixedType,1
5,1,0,6,mixedType,0
6,2,0,8,mixedType,1
13,3,0,16,mixedType,2
5,3,0,8,mixedType,1
3,6,0,9,mixedType,1
8,1,0,9,mixedType,1
9,1,0,10,mixedType,1
9,2,0,11,mixedType,1
6,3,0,9,mixedType,1
7,1,0,8,mixedType,1
5,4,0,9,mixedType,1
7,2,0,9,mixedType,1
8,1,0,9,mixedType,1
5,1,0,6,mixedType,0
8,3,0,11,mixedType,1
5,4,0,9,mixedType,1
8,1,0,9,mixedType,1
7,1,0,8,mixedType,1
13,3,0,16,mixedType,2
5,1,0,6,mixedType,0
1,8,0,9,mixedType,1
4,6,0,10,mixedType,1
7,4,0,11,mixedType,1
1,10,0,11,mixedType,1
6,3,0,9,mixedType,1
4,4,0,8,mixedType,1
5,4,0,9,mixedType,1
6,3,0,9,mixedType,1
8,3,0,11,mixedType,1
7,4,0,11,mixedType,1
14,2,0,16,mixedType,2
6,1,0,7,mixedType,0
7,3,0,10,mixedType,1
4,6,0,10,mixedType,1
4,6,0,10,mixedType,1
8,2,0,10,mixedType,1
8,4,0,12,mixedType,1
5,2,0,7,mixedType,0
1,7,0,8,mixedType,1
6,2,0,8,mixedType,1
3,6,0,9,mixedType,1
5,4,0,9,mixedType,1
9,2,0,11,mixedType,1
4,6,0,10,mixedType,1
2,6,0,8,mixedType,1
6,2,0,8,mixedType,1
7,2,0,9,mixedType,1
6,3,0,9,mixedType,1
6,2,0,8,mixedType,1
8,4,0,12,mixedType,1
5,3,0,8,mixedType,1
2,4,0,6,mixedType,0
7,2,0,9,mixedType,1
8,3,0,11,mixedType,1
2,6,0,8,mixedType,1
6,2,0,8,mixedType,1
10,1,0,11,mixedType,1
6,2,0,8,mixedType,1
7,2,0,9,mixedType,1
11,0,1,12,mixedType,1
6,1,0,7,mixedType,0
8,2,0,10,mixedType,1
8,5,0,13,mixedType,1
8,5,0,13,mixedType,1
8,2,0,10,mixedType,1
3,7,0,10,mixedType,1
8,2,0,10,mixedType,1
9,1,0,10,mixedType,1
5,2,0,7,mixedType,0
6,3,0,9,mixedType,1
13,3,0,16,mixedType,2
4,4,0,8,mixedType,1
7,3,0,10,mixedType,1
7,3,0,10,mixedType,1
13,3,0,16,mixedType,2
4,4,0,8,mixedType,1
9,2,0,11,mixedType,1
14,2,0,16,mixedType,2
15,1,0,16,mixedType,2
3,6,0,9,mixedType,1
4,2,0,6,mixedType,0
3,8,0,11,mixedType,1
9,4,0,13,mixedType,1
15,1,0,16,mixedType,2
5,2,0,7,mixedType,0
5,8,0,13,mixedType,1
6,1,0,7,mixedType,0
4,2,0,6,mixedType,0
15,1,0,16,mixedType,2
8,1,0,9,mixedType,1
12,3,0,15,mixedType,2
5,3,0,8,mixedType,1
6,3,0,9,mixedType,1
8,1,0,9,mixedType,1
6,1,0,7,mixedType,0
8,2,0,10,mixedType,1
5,1,0,6,mixedType,0
6,4,0,10,mixedType,1
10,1,0,11,mixedType,1
5,1,0,6,mixedType,0
4,4,0,8,mixedType,1
6,1,0,7,mixedType,0
4,2,0,6,mixedType,0
8,1,0,9,mixedType,1
4,4,0,8,mixedType,1
10,1,0,11,mixedType,1
8,4,0,12,mixedType,1
5,3,0,8,mixedType,1
7,1,0,8,mixedType,1
6,2,0,8,mixedType,1
7,3,0,10,mixedType,1
8,2,0,10,mixedType,1
10,1,0,11,mixedType,1
7,3,0,10,mixedType,1
7,3,0,10,mixedType,1
7,1,0,8,mixedType,1
7,1,0,8,mixedType,1
7,6,0,13,mixedType,1
6,1,0,7,mixedType,0
9,4,0,13,mixedType,1
6,1,0,7,mixedType,0
5,4,0,9,mixedType,1
7,2,0,9,mixedType,1
7,1,0,8,mixedType,1
6,3,0,9,mixedType,1
9,3,0,12,mixedType,1
6,3,0,9,mixedType,1
1,7,0,8,mixedType,1
1,8,0,9,mixedType,1
6,3,0,9,mixedType,1
12,4,0,16,mixedType,2
1,10,0,11,mixedType,1
7,4,0,11,mixedType,1
4,6,0,10,mixedType,1
12,4,0,16,mixedType,2
5,2,0,7,mixedType,0
7,3,0,10,mixedType,1
9,2,0,11,mixedType,1
8,1,0,9,mixedType,1
5,3,0,8,mixedType,1
1,10,0,11,mixedType,1
12,3,0,15,mixedType,2
4,4,0,8,mixedType,1
8,3,0,11,mixedType,1
6,3,0,9,mixedType,1
12,4,0,16,mixedType,2
7,2,0,9,mixedType,1
6,3,0,9,mixedType,1
8,2,0,10,mixedType,1
5,2,0,7,mixedType,0
15,1,0,16,mixedType,2
8,3,0,11,mixedType,1
1,10,0,11,mixedType,1
4,8,0,12,mixedType,1
7,3,0,10,mixedType,1
6,3,0,9,mixedType,1
8,1,0,9,mixedType,1
4,2,0,6,mixedType,0
6,4,0,10,mixedType,1
9,4,0,13,mixedType,1
7,2,0,9,mixedType,1
8,2,0,10,mixedType,1
5,4,0,9,mixedType,1
7,5,0,12,mixedType,1
9,4,0,13,mixedType,1
4,4,0,8,mixedType,1
9,2,0,11,mixedType,1
8,1,0,9,mixedType,1
7,2,0,9,mixedType,1
1,9,0,10,mixedType,1
8,3,0,11,mixedType,1
14,2,0,16,mixedType,2
7,2,0,9,mixedType,1
14,2,0,16,mixedType,2
2,8,0,10,mixedType,1
8,2,0,10,mixedType,1
6,3,0,9,mixedType,1
12,3,0,15,mixedType,2
7,1,0,8,mixedType,1
5,5,0,10,mixedType,1
4,4,0,8,mixedType,1
8,4,0,12,mixedType,1
5,1,0,6,mixedType,0
6,4,0,10,mixedType,1
8,2,0,10,mixedType,1
8,1,0,9,mixedType,1
5,8,0,13,mixedType,1
7,2,0,9,mixedType,1
7,2,0,9,mixedType,1
11,4,0,15,mixedType,2
7,6,0,13,mixedType,1
4,2,0,6,mixedType,0
7,2,0,9,mixedType,1
6,1,0,7,mixedType,0
12,1,0,13,mixedType,1
9,1,0,10,mixedType,1
6,1,0,7,mixedType,0
5,2,0,7,mixedType,0
4,5,0,9,mixedType,1
4,4,0,8,mixedType,1
5,4,0,9,mixedType,1
7,3,0,10,mixedType,1
3,3,0,6,mixedType,0
1,11,0,12,mixedType,1
8,2,0,10,mixedType,1
4,4,0,8,mixedType,1
6,2,0,8,mixedType,1
4,4,0,8,mixedType,1
7,3,0,10,mixedType,1
4,4,0,8,mixedType,1
6,2,0,8,mixedType,1
8,2,0,10,mixedType,1
12,4,0,16,mixedType,2
4,4,0,8,mixedType,1
5,3,0,8,mixedType,1
5,3,0,8,mixedType,1
8,1,0,9,mixedType,1
11,1,0,12,mixedType,1
1,8,0,9,mixedType,1
6,2,0,8,mixedType,1
1,8,0,9,mixedType,1
6,4,0,10,mixedType,1
4,4,0,8,mixedType,1
13,3,0,16,mixedType,2
12,4,0,16,mixedType,2
15,1,0,16,mixedType,2
14,2,0,16,mixedType,2
2,7,0,9,mixedType,1
7,3,0,10,mixedType,1
8,2,0,10,mixedType,1
6,3,0,9,mixedType,1
7,3,0,10,mixedType,1
5,3,0,8,mixedType,1
5,1,0,6,mixedType,0
7,2,0,9,mixedType,1
6,2,0,8,mixedType,1
8,2,0,10,mixedType,1
4,2,0,6,mixedType,0
7,2,0,9,mixedType,1
7,2,0,9,mixedType,1
7,3,0,10,mixedType,1
6,4,0,10,mixedType,1
2,6,0,8,mixedType,1
3,7,0,10,mixedType,1
6,1,0,7,mixedType,0
7,2,0,9,mixedType,1
8,2,0,10,mixedType,1
8,2,0,10,mixedType,1
6,1,0,7,mixedType,0
8,1,0,9,mixedType,1
5,4,0,9,mixedType,1
4,9,0,13,mixedType,1
6,1,0,7,mixedType,0
6,4,0,10,mixedType,1
5,2,0,7,mixedType,0
3,5,0,8,mixedType,1
7,3,0,10,mixedType,1
4,8,0,12,mixedType,1
7,1,0,8,mixedType,1
11,5,0,16,mixedType,2
2,4,0,6,mixedType,0
8,1,0,9,mixedType,1
4,6,0,10,mixedType,1
3,10,1,14,mixedType,2
6,1,0,7,mixedType,0
1,9,0,10,mixedType,1
6,3,0,9,mixedType,1
6,1,0,7,mixedType,0
6,3,0,9,mixedType,1
8,4,0,12,mixedType,1
10,2,0,12,mixedType,1
6,3,0,9,mixedType,1
9,1,0,10,mixedType,1
5,2,0,7,mixedType,0
7,2,0,9,mixedType,1
5,3,0,8,mixedType,1
6,1,0,7,mixedType,0
5,3,0,8,mixedType,1
8,2,0,10,mixedType,1
7,2,0,9,mixedType,1
7,2,0,9,mixedType,1
5,4,0,9,mixedType,1
7,3,0,10,mixedType,1
6,3,0,9,mixedType,1
8,2,0,10,mixedType,1
13,3,0,16,mixedType,2
6,2,0,8,mixedType,1
5,2,0,7,mixedType,0
6,4,0,10,mixedType,1
10,2,0,12,mixedType,1
5,4,0,9,mixedType,1
6,1,0,7,mixedType,0
6,3,0,9,mixedType,1
6,4,0,10,mixedType,1
7,3,0,10,mixedType,1
14,2,0,16,mixedType,2
10,5,1,16,mixedType,2
9,4,0,13,mixedType,1
9,2,0,11,mixedType,1
7,3,0,10,mixedType,1
9,0,1,10,mixedType,1
7,2,0,9,mixedType,1
7,7,0,14,mixedType,2
6,3,0,9,mixedType,1
14,2,0,16,mixedType,2
8,3,0,11,mixedType,1
4,4,0,8,mixedType,1
13,3,0,16,mixedType,2
6,2,0,8,mixedType,1
13,3,0,16,mixedType,2
2,7,0,9,mixedType,1
9,2,0,11,mixedType,1
8,2,0,10,mixedType,1
11,0,2,13,mixedType,1
8,2,0,10,mixedType,1
7,3,0,10,mixedType,1
5,3,0,8,mixedType,1
6,1,0,7,mixedType,0
6,1,0,7,mixedType,0
12,4,0,16,mixedType,2
15,1,0,16,mixedType,2
6,3,0,9,mixedType,1
4,2,0,6,mixedType,0
3,10,0,13,mixedType,1
6,6,0,12,mixedType,1
14,2,0,16,mixedType,2
2,10,0,12,mixedType,1
5,2,0,7,mixedType,0
5,3,0,8,mixedType,1
7,3,0,10,mixedType,1
4,4,0,8,mixedType,1
6,3,0,9,mixedType,1
3,5,0,8,mixedType,1
5,2,0,7,mixedType,0
6,1,0,7,mixedType,0
5,2,0,7,mixedType,0
5,3,0,8,mixedType,1
14,2,0,16,mixedType,2
7,3,0,10,mixedType,1
4,4,0,8,mixedType,1
7,1,0,8,mixedType,1
12,3,0,15,mixedType,2
7,1,0,8,mixedType,1
14,2,0,16,mixedType,2
2,7,0,9,mixedType,1
4,4,0,8,mixedType,1
5,2,0,7,mixedType,0
5,1,0,6,mixedType,0
6,3,0,9,mixedType,1
1,7,0,8,mixedType,1
4,2,0,6,mixedType,0
6,1,0,7,mixedType,0
4,4,0,8,mixedType,1
6,3,0,9,mixedType,1
5,2,0,7,mixedType,0
6,4,0,10,mixedType,1
5,4,0,9,mixedType,1
7,3,0,10,mixedType,1
6,2,0,8,mixedType,1
3,3,0,6,mixedType,0
7,2,0,9,mixedType,1
7,1,0,8,mixedType,1
6,4,0,10,mixedType,1
4,4,0,8,mixedType,1
1,10,0,11,mixedType,1
6,4,0,10,mixedType,1
8,2,0,10,mixedType,1
3,5,0,8,mixedType,1
6,3,0,9,mixedType,1
3,5,0,8,mixedType,1
11,3,0,14,mixedType,2
4,5,0,9,mixedType,1
3,5,0,8,mixedType,1
7,5,0,12,mixedType,1
11,5,0,16,mixedType,2
6,1,0,7,mixedType,0
8,3,0,11,mixedType,1
11,3,0,14,mixedType,2
1,8,0,9,mixedType,1
8,1,0,9,mixedType,1
2,8,0,10,mixedType,1
7,1,0,8,mixedType,1
5,4,0,9,mixedType,1
4,2,0,6,mixedType,0
11,2,2,15,mixedType,2
8,1,0,9,mixedType,1
7,2,0,9,mixedType,1
5,2,0,7,mixedType,0
11,1,2,14,mixedType,2
6,4,0,10,mixedType,1
15,1,0,16,mixedType,2
16,4,0,20,mixedType,2
15,1,0,16,mixedType,2
7,3,0,10,mixedType,1
6,3,0,9,mixedType,1
14,3,0,17,mixedType,2
7,2,0,9,mixedType,1
9,2,0,11,mixedType,1
6,3,0,9,mixedType,1
7,3,0,10,mixedType,1
6,1,0,7,mixedType,0
4,8,0,12,mixedType,1
4,8,0,12,mixedType,1
6,2,0,8,mixedType,1
6,2,0,8,mixedType,1
2,7,0,9,mixedType,1
9,1,0,10,mixedType,1
12,4,0,16,mixedType,2
8,1,0,9,mixedType,1
5,3,0,8,mixedType,1
6,1,0,7,mixedType,0
8,3,0,11,mixedType,1
14,2,0,16,mixedType,2
7,2,0,9,mixedType,1
6,2,0,8,mixedType,1
8,2,0,10,mixedType,1
6,1,0,7,mixedType,0
6,3,0,9,mixedType,1
8,2,0,10,mixedType,1
15,1,0,16,mixedType,2
7,3,0,10,mixedType,1
8,3,0,11,mixedType,1
8,2,0,10,mixedType,1
8,1,0,9,mixedType,1
6,8,2,16,mixedType,2
7,3,0,10,mixedType,1
9,4,1,14,mixedType,2
4,2,0,6,mixedType,0
7,3,0,10,mixedType,1
15,1,0,16,mixedType,2
8,3,0,11,mixedType,1
5,4,0,9,mixedType,1
4,2,0,6,mixedType,0
5,1,0,6,mixedType,0
5,4,0,9,mixedType,1
5,3,0,8,mixedType,1
18,1,1,20,mixedType,2
6,4,0,10,mixedType,1
6,3,0,9,mixedType,1
10,4,0,14,mixedType,2
14,2,0,16,mixedType,2
7,3,0,10,mixedType,1
8,2,0,10,mixedType,1
6,3,0,9,mixedType,1
5,2,0,7,mixedType,0
14,2,0,16,mixedType,2
6,1,0,7,mixedType,0
8,1,0,9,mixedType,1
4,2,0,6,mixedType,0
6,3,0,9,mixedType,1
4,4,0,8,mixedType,1
5,4,0,9,mixedType,1
5,2,0,7,mixedType,0
2,8,0,10,mixedType,1
5,3,0,8,mixedType,1
4,2,0,6,mixedType,0
3,5,0,8,mixedType,1
5,3,0,8,mixedType,1
5,4,6,15,mixedType,2
3,6,0,9,mixedType,1
6,1,0,7,mixedType,0
6,3,0,9,mixedType,1
6,4,0,10,mixedType,1
15,1,0,16,mixedType,2
7,1,0,8,mixedType,1
5,1,0,6,mixedType,0
6,2,0,8,mixedType,1
8,1,0,9,mixedType,1
5,3,0,8,mixedType,1
6,2,0,8,mixedType,1
6,4,0,10,mixedType,1
8,2,0,10,mixedType,1
5,4,0,9,mixedType,1
13,3,0,16,mixedType,2
8,1,0,9,mixedType,1
2,6,0,8,mixedType,1
6,2,0,8,mixedType,1
6,1,0,7,mixedType,0
6,3,0,9,mixedType,1
10,2,0,12,mixedType,1
8,3,0,11,mixedType,1
6,2,0,8,mixedType,1
7,4,0,11,mixedType,1
8,2,0,10,mixedType,1
2,8,0,10,mixedType,1
11,5,0,16,mixedType,2
7,3,0,10,mixedType,1
6,4,0,10,mixedType,1
8,2,0,10,mixedType,1
6,3,0,9,mixedType,1
6,3,0,9,mixedType,1
4,4,0,8,mixedType,1
3,7,0,10,mixedType,1
7,6,0,13,mixedType,1
4,6,0,10,mixedType,1
9,2,0,11,mixedType,1
5,6,0,11,mixedType,1
5,2,0,7,mixedType,0
5,4,0,9,mixedType,1
13,3,0,16,mixedType,2
4,2,0,6,mixedType,0
11,3,0,14,mixedType,2
1,9,0,10,mixedType,1
10,2,0,12,mixedType,1
6,3,0,9,mixedType,1
6,4,0,10,mixedType,1
4,2,0,6,mixedType,0
6,3,0,9,mixedType,1
11,3,0,14,mixedType,2
10,2,0,12,mixedType,1
12,3,0,15,mixedType,2
8,3,0,11,mixedType,1
7,1,0,8,mixedType,1
12,6,4,22,mixedType,2
5,6,0,11,mixedType,1
7,3,0,10,mixedType,1
8,1,0,9,mixedType,1
5,0,1,6,mixedType,0
4,6,0,10,mixedType,1
6,3,0,9,mixedType,1
7,4,0,11,mixedType,1
7,3,0,10,mixedType,1
8,2,0,10,mixedType,1
8,2,0,10,mixedType,1
3,6,0,9,mixedType,1
6,4,0,10,mixedType,1
13,3,0,16,mixedType,2
7,3,0,10,mixedType,1
3,7,0,10,mixedType,1
8,2,0,10,mixedType,1
7,1,0,8,mixedType,1
1,7,0,8,mixedType,1
8,1,0,9,mixedType,1
8,2,0,10,mixedType,1
8,2,0,10,mixedType,1
8,3,0,11,mixedType,1
6,6,0,12,mixedType,1
14,2,0,16,mixedType,2
13,3,0,16,mixedType,2
7,3,0,10,mixedType,1
6,3,0,9,mixedType,1
8,2,0,10,mixedType,1
12,3,0,15,mixedType,2
8,4,0,12,mixedType,1
12,1,0,13,mixedType,1
5,5,0,10,mixedType,1
6,3,0,9,mixedType,1
4,4,0,8,mixedType,1
5,2,0,7,mixedType,0
8,2,0,10,mixedType,1
6,3,0,9,mixedType,1
10,3,0,13,mixedType,1
7,3,0,10,mixedType,1
7,2,0,9,mixedType,1
9,1,0,10,mixedType,1
9,2,0,11,mixedType,1
9,2,0,11,mixedType,1
7,2,0,9,mixedType,1
10,2,0,12,mixedType,1
6,1,0,7,mixedType,0
7,3,0,10,mixedType,1
5,1,0,6,mixedType,0
15,1,0,16,mixedType,2
3,3,0,6,mixedType,0
12,3,0,15,mixedType,2
11,2,0,13,mixedType,1
5,2,0,7,mixedType,0
6,4,0,10,mixedType,1
12,4,0,16,mixedType,2
12,4,0,16,mixedType,2
7,1,0,8,mixedType,1
15,1,0,16,mixedType,2
6,2,0,8,mixedType,1
1,7,0,8,mixedType,1
5,2,0,7,mixedType,0
5,4,0,9,mixedType,1
2,7,0,9,mixedType,1
5,6,0,11,mixedType,1
14,2,0,16,mixedType,2
4,2,0,6,mixedType,0
4,2,0,6,mixedType,0
6,4,0,10,mixedType,1
3,6,0,9,mixedType,1
8,2,0,10,mixedType,1
6,2,0,8,mixedType,1
8,1,0,9,mixedType,1
6,4,0,10,mixedType,1
5,3,0,8,mixedType,1
8,1,0,9,mixedType,1
6,3,0,9,mixedType,1
5,2,0,7,mixedType,0
9,0,1,10,mixedType,1
12,3,0,15,mixedType,2
7,3,0,10,mixedType,1
5,2,0,7,mixedType,0
4,2,0,6,mixedType,0
7,2,0,9,mixedType,1
1,7,0,8,mixedType,1
5,4,0,9,mixedType,1
9,3,0,12,mixedType,1
7,3,0,10,mixedType,1
5,3,0,8,mixedType,1
7,3,0,10,mixedType,1
5,4,0,9,mixedType,1
5,2,0,7,mixedType,0
8,2,0,10,mixedType,1
9,1,0,10,mixedType,1
3,5,0,8,mixedType,1
3,6,0,9,mixedType,1
6,1,0,7,mixedType,0
7,2,0,9,mixedType,1
9,1,0,10,mixedType,1
4,4,0,8,mixedType,1
10,2,0,12,mixedType,1
12,4,0,16,mixedType,2
6,3,0,9,mixedType,1
6,1,0,7,mixedType,0
13,3,0,16,mixedType,2
4,2,0,6,mixedType,0
9,2,0,11,mixedType,1
0,6,2,8,mixedType,1
9,7,0,16,mixedType,2
8,4,0,12,mixedType,1
7,2,0,9,mixedType,1
5,4,0,9,mixedType,1
6,3,0,9,mixedType,1
3,6,0,9,mixedType,1
7,1,0,8,mixedType,1
11,5,0,16,mixedType,2
7,4,0,11,mixedType,1
10,2,0,12,mixedType,1
15,1,0,16,mixedType,2
8,2,0,10,mixedType,1
5,5,0,10,mixedType,1
5,2,0,7,mixedType,0
11,2,1,14,mixedType,2
5,2,0,7,mixedType,0
6,3,0,9,mixedType,1
9,2,0,11,mixedType,1
8,2,0,10,mixedType,1
6,1,0,7,mixedType,0
14,2,0,16,mixedType,2
8,1,0,9,mixedType,1
5,2,0,7,mixedType,0
6,1,0,7,mixedType,0
9,3,0,12,mixedType,1
9,1,0,10,mixedType,1
14,2,0,16,mixedType,2
5,3,0,8,mixedType,1
7,3,0,10,mixedType,1
6,3,0,9,mixedType,1
8,1,0,9,mixedType,1
7,2,0,9,mixedType,1
8,3,0,11,mixedType,1
4,2,0,6,mixedType,0
2,9,0,11,mixedType,1
6,3,0,9,mixedType,1
7,3,0,10,mixedType,1
6,3,0,9,mixedType,1
14,2,0,16,mixedType,2
9,2,0,11,mixedType,1
12,4,0,16,mixedType,2
6,1,0,7,mixedType,0
8,2,0,10,mixedType,1
10,6,0,16,mixedType,2
2,4,0,6,mixedType,0
4,4,0,8,mixedType,1
7,3,0,10,mixedType,1
7,2,0,9,mixedType,1
10,0,1,11,mixedType,1
7,2,0,9,mixedType,1
9,2,0,11,mixedType,1
3,5,0,8,mixedType,1
5,2,0,7,mixedType,0
9,3,0,12,mixedType,1
4,2,0,6,mixedType,0
6,8,0,14,mixedType,2
2,9,0,11,mixedType,1
6,4,0,10,mixedType,1
10,2,0,12,mixedType,1
11,3,0,14,mixedType,2
9,1,0,10,mixedType,1
15,1,0,16,mixedType,2
7,1,0,8,mixedType,1
9,2,0,11,mixedType,1
6,1,0,7,mixedType,0
8,1,0,9,mixedType,1
3,5,0,8,mixedType,1
12,4,0,16,mixedType,2
5,1,0,6,mixedType,0
6,1,0,7,mixedType,0
8,2,0,10,mixedType,1
6,1,0,7,mixedType,0
2,4,0,6,mixedType,0
5,3,0,8,mixedType,1
2,9,0,11,mixedType,1
11,3,0,14,mixedType,2
2,4,0,6,mixedType,0
8,4,0,12,mixedType,1
2,6,0,8,mixedType,1
4,4,0,8,mixedType,1
9,2,0,11,mixedType,1
6,3,0,9,mixedType,1
7,1,0,8,mixedType,1
8,3,0,11,mixedType,1
3,3,0,6,mixedType,0
6,2,0,8,mixedType,1
5,2,0,7,mixedType,0
7,3,0,10,mixedType,1
7,2,0,9,mixedType,1
5,6,0,11,mixedType,1
6,1,0,7,mixedType,0
8,2,0,10,mixedType,1
5,5,0,10,mixedType,1
7,3,0,10,mixedType,1
6,4,0,10,mixedType,1
9,2,0,11,mixedType,1
5,3,0,8,mixedType,1
7,2,0,9,mixedType,1
6,4,0,10,mixedType,1
6,6,0,12,mixedType,1
7,3,0,10,mixedType,1
5,4,0,9,mixedType,1
5,2,0,7,mixedType,0
2,8,0,10,mixedType,1
8,1,0,9,mixedType,1
5,7,0,12,mixedType,1
9,1,0,10,mixedType,1
14,2,0,16,mixedType,2
14,2,0,16,mixedType,2
8,1,0,9,mixedType,1
8,1,0,9,mixedType,1
8,2,0,10,mixedType,1
12,4,0,16,mixedType,2
5,3,0,8,mixedType,1
5,1,0,6,mixedType,0
2,6,0,8,mixedType,1
10,1,0,11,mixedType,1
5,4,0,9,mixedType,1
5,3,0,8,mixedType,1
1,8,0,9,mixedType,1
5,4,0,9,mixedType,1
8,1,0,9,mixedType,1
6,3,0,9,mixedType,1
5,2,0,7,mixedType,0
7,3,0,10,mixedType,1
5,1,0,6,mixedType,0
7,2,0,9,mixedType,1
3,6,0,9,mixedType,1
12,4,0,16,mixedType,2
5,4,0,9,mixedType,1
14,2,0,16,mixedType,2
6,3,0,9,mixedType,1
5,1,0,6,mixedType,0
8,3,0,11,mixedType,1
5,3,0,8,mixedType,1
7,4,0,11,mixedType,1
13,3,0,16,mixedType,2
7,4,0,11,mixedType,1
3,6,0,9,mixedType,1
8,1,0,9,mixedType,1
4,7,0,11,mixedType,1
3,6,0,9,mixedType,1
6,3,0,9,mixedType,1
5,4,0,9,mixedType,1
8,1,0,9,mixedType,1
8,0,2,10,mixedType,1
7,3,0,10,mixedType,1
4,2,0,6,mixedType,0
4,2,0,6,mixedType,0
4,4,0,8,mixedType,1
7,2,0,9,mixedType,1
7,2,0,9,mixedType,1
6,1,0,7,mixedType,0
6,3,0,9,mixedType,1
15,1,0,16,mixedType,2
7,3,0,10,mixedType,1
7,2,0,9,mixedType,1
7,1,0,8,mixedType,1
4,4,0,8,mixedType,1
5,2,0,7,mixedType,0
1,7,0,8,mixedType,1
6,1,0,7,mixedType,0
5,2,0,7,mixedType,0
13,3,0,16,mixedType,2
3,6,0,9,mixedType,1
8,4,0,12,mixedType,1
7,2,0,9,mixedType,1
3,6,0,9,mixedType,1
15,4,0,19,mixedType,2
6,4,0,10,mixedType,1
5,3,0,8,mixedType,1
6,1,0,7,mixedType,0
7,2,0,9,mixedType,1
14,2,0,16,mixedType,2
5,4,0,9,mixedType,1
7,0,1,8,mixedType,1
5,5,0,10,mixedType,1
7,3,0,10,mixedType,1
7,3,0,10,mixedType,1
3,6,0,9,mixedType,1
9,2,0,11,mixedType,1
7,3,0,10,mixedType,1
8,2,0,10,mixedType,1
6,3,0,9,mixedType,1
9,1,0,10,mixedType,1
5,4,0,9,mixedType,1
5,7,0,12,mixedType,1
5,8,0,13,mixedType,1
4,4,0,8,mixedType,1
14,2,0,16,mixedType,2
3,6,0,9,mixedType,1
9,2,0,11,mixedType,1
1,8,0,9,mixedType,1
6,2,0,8,mixedType,1
7,3,0,10,mixedType,1
7,4,0,11,mixedType,1
7,2,0,9,mixedType,1
8,2,0,10,mixedType,1
6,3,0,9,mixedType,1
6,2,0,8,mixedType,1
5,5,0,10,mixedType,1
7,2,0,9,mixedType,1
9,4,0,13,mixedType,1
8,2,0,10,mixedType,1
8,3,0,11,mixedType,1
6,3,0,9,mixedType,1
6,3,0,9,mixedType,1
6,4,0,10,mixedType,1
13,3,0,16,mixedType,2
7,3,0,10,mixedType,1
5,4,0,9,mixedType,1
7,3,0,10,mixedType,1
7,1,0,8,mixedType,1
5,3,0,8,mixedType,1
7,1,0,8,mixedType,1
15,1,0,16,mixedType,2
3,5,0,8,mixedType,1
13,3,0,16,mixedType,2
5,2,0,7,mixedType,0
14,2,0,16,mixedType,2
11,3,0,14,mixedType,2
7,3,0,10,mixedType,1
6,3,0,9,mixedType,1
7,3,0,10,mixedType,1
12,4,0,16,mixedType,2
6,3,0,9,mixedType,1
5,3,0,8,mixedType,1
6,2,0,8,mixedType,1
5,3,0,8,mixedType,1
7,3,0,10,mixedType,1
9,2,0,11,mixedType,1
5,3,0,8,mixedType,1
6,4,0,10,mixedType,1
8,1,0,9,mixedType,1
6,3,0,9,mixedType,1
2,11,0,13,mixedType,1
6,3,0,9,mixedType,1
13,1,1,15,mixedType,2
7,3,0,10,mixedType,1
4,2,0,6,mixedType,0
5,4,0,9,mixedType,1
7,2,0,9,mixedType,1
13,3,0,16,mixedType,2
6,3,0,9,mixedType,1
6,2,0,8,mixedType,1
7,3,0,10,mixedType,1
6,2,0,8,mixedType,1
6,5,0,11,mixedType,1
6,2,0,8,mixedType,1
6,3,0,9,mixedType,1
10,2,0,12,mixedType,1
14,2,0,16,mixedType,2
6,1,0,7,mixedType,0
10,0,1,11,mixedType,1
3,3,0,6,mixedType,0
5,3,0,8,mixedType,1
4,2,0,6,mixedType,0
5,4,0,9,mixedType,1
4,4,0,8,mixedType,1
5,4,0,9,mixedType,1
9,4,0,13,mixedType,1
1,8,0,9,mixedType,1
9,4,0,13,mixedType,1
11,3,0,14,mixedType,2
8,1,0,9,mixedType,1
13,3,0,16,mixedType,2
5,3,0,8,mixedType,1
7,3,0,10,mixedType,1
4,6,0,10,mixedType,1
4,4,0,8,mixedType,1
2,9,0,11,mixedType,1
9,2,0,11,mixedType,1
8,3,0,11,mixedType,1
8,4,0,12,mixedType,1
5,2,0,7,mixedType,0
1,7,0,8,mixedType,1
15,1,0,16,mixedType,2
7,3,0,10,mixedType,1
14,2,0,16,mixedType,2
3,6,0,9,mixedType,1
3,6,0,9,mixedType,1
5,4,0,9,mixedType,1
4,4,0,8,mixedType,1
4,2,0,6,mixedType,0
6,1,0,7,mixedType,0
5,3,0,8,mixedType,1
3,6,0,9,mixedType,1
5,6,0,11,mixedType,1
6,2,0,8,mixedType,1
4,6,0,10,mixedType,1
14,2,0,16,mixedType,2
1,9,0,10,mixedType,1
5,2,0,7,mixedType,0
7,3,0,10,mixedType,1
5,3,0,8,mixedType,1
7,3,0,10,mixedType,1
6,4,0,10,mixedType,1
1,8,0,9,mixedType,1
4,9,0,13,mixedType,1
7,2,0,9,mixedType,1
7,5,0,12,mixedType,1
7,3,0,10,mixedType,1
9,1,0,10,mixedType,1
8,2,0,10,mixedType,1
4,4,0,8,mixedType,1
5,4,0,9,mixedType,1
8,1,0,9,mixedType,1
13,3,0,16,mixedType,2
9,1,0,10,mixedType,1
5,3,0,8,mixedType,1
5,4,0,9,mixedType,1
4,2,0,6,mixedType,0
7,2,0,9,mixedType,1
5,1,0,6,mixedType,0
8,2,0,10,mixedType,1
6,2,0,8,mixedType,1
5,5,0,10,mixedType,1
10,2,0,12,mixedType,1
9,1,0,10,mixedType,1
7,4,0,11,mixedType,1
11,3,0,14,mixedType,2
6,4,0,10,mixedType,1
10,1,0,11,mixedType,1
7,3,0,10,mixedType,1
4,2,0,6,mixedType,0
9,1,0,10,mixedType,1
6,6,0,12,mixedType,1
8,3,0,11,mixedType,1
4,5,0,9,mixedType,1
3,5,0,8,mixedType,1
10,1,0,11,mixedType,1
7,3,0,10,mixedType,1
6,3,0,9,mixedType,1
6,3,0,9,mixedType,1
3,5,0,8,mixedType,1
3,3,0,6,mixedType,0
6,3,0,9,mixedType,1
8,1,0,9,mixedType,1
4,6,0,10,mixedType,1
11,3,0,14,mixedType,2
5,8,1,14,mixedType,2
9,1,0,10,mixedType,1
3,6,0,9,mixedType,1
5,4,0,9,mixedType,1
6,4,0,10,mixedType,1
4,5,0,9,mixedType,1
8,1,0,9,mixedType,1
5,2,0,7,mixedType,0
8,1,0,9,mixedType,1
5,4,0,9,mixedType,1
7,4,0,11,mixedType,1
8,1,0,9,mixedType,1
6,3,0,9,mixedType,1
5,4,0,9,mixedType,1
3,6,0,9,mixedType,1
9,2,0,11,mixedType,1
0,11,2,13,mixedType,1
6,2,0,8,mixedType,1
12,3,0,15,mixedType,2
9,1,0,10,mixedType,1
13,3,0,16,mixedType,2
2,6,0,8,mixedType,1
7,6,0,13,mixedType,1
10,1,0,11,mixedType,1
5,4,0,9,mixedType,1
6,3,0,9,mixedType,1
7,3,0,10,mixedType,1
7,3,0,10,mixedType,1
8,2,0,10,mixedType,1
7,2,0,9,mixedType,1
6,1,0,7,mixedType,0
5,3,0,8,mixedType,1
2,7,0,9,mixedType,1
4,6,0,10,mixedType,1
7,2,0,9,mixedType,1
8,2,0,10,mixedType,1
5,4,0,9,mixedType,1
5,3,0,8,mixedType,1
4,6,0,10,mixedType,1
8,2,0,10,mixedType,1
6,3,0,9,mixedType,1
13,3,0,16,mixedType,2
8,1,0,9,mixedType,1
12,3,0,15,mixedType,2
13,3,0,16,mixedType,2
4,2,0,6,mixedType,0
2,9,0,11,mixedType,1
3,9,0,12,mixedType,1
15,1,0,16,mixedType,2
6,3,0,9,mixedType,1
13,3,0,16,mixedType,2
7,3,0,10,mixedType,1
5,3,0,8,mixedType,1
14,2,0,16,mixedType,2
6,3,0,9,mixedType,1
1,8,0,9,mixedType,1
2,6,0,8,mixedType,1
5,4,0,9,mixedType,1
5,4,0,9,mixedType,1
3,6,0,9,mixedType,1
8,3,0,11,mixedType,1
7,2,0,9,mixedType,1
8,3,0,11,mixedType,1
7,2,0,9,mixedType,1
15,1,0,16,mixedType,2
4,8,0,12,mixedType,1
5,2,0,7,mixedType,0
7,3,0,10,mixedType,1
6,3,0,9,mixedType,1
6,3,0,9,mixedType,1
9,1,0,10,mixedType,1
6,3,0,9,mixedType,1
15,1,0,16,mixedType,2
1,8,0,9,mixedType,1
6,4,0,10,mixedType,1
6,11,0,17,mixedType,2
15,1,0,16,mixedType,2
10,6,0,16,mixedType,2
13,2,0,15,mixedType,2
14,2,0,16,mixedType,2
4,4,0,8,mixedType,1
3,7,0,10,mixedType,1
9,2,0,11,mixedType,1
5,4,0,9,mixedType,1
10,4,0,14,mixedType,2
8,2,0,10,mixedType,1
3,1,1,5,mixedType,0
5,5,0,10,mixedType,1
8,1,0,9,mixedType,1
9,3,0,12,mixedType,1
7,3,0,10,mixedType,1
15,1,0,16,mixedType,2
5,2,0,7,mixedType,0
5,2,0,7,mixedType,0
4,2,0,6,mixedType,0
12,4,0,16,mixedType,2
5,2,0,7,mixedType,0
2,8,0,10,mixedType,1
8,2,0,10,mixedType,1
3,6,0,9,mixedType,1
9,4,0,13,mixedType,1
7,2,0,9,mixedType,1
5,2,0,7,mixedType,0
5,3,0,8,mixedType,1
5,4,0,9,mixedType,1
4,6,0,10,mixedType,1
8,4,0,12,mixedType,1
6,1,0,7,mixedType,0
8,2,0,10,mixedType,1
2,10,0,12,mixedType,1
10,3,0,13,mixedType,1
13,3,0,16,mixedType,2
7,2,0,9,mixedType,1
10,5,0,15,mixedType,2
7,3,0,10,mixedType,1
9,4,0,13,mixedType,1
6,2,0,8,mixedType,1
3,9,0,12,mixedType,1
11,2,0,13,mixedType,1
9,2,0,11,mixedType,1
6,6,0,12,mixedType,1
8,4,0,12,mixedType,1
5,4,0,9,mixedType,1
6,1,0,7,mixedType,0
4,4,0,8,mixedType,1
6,4,0,10,mixedType,1
14,2,0,16,mixedType,2
14,2,0,16,mixedType,2
6,1,0,7,mixedType,0
13,3,0,16,mixedType,2
4,6,0,10,mixedType,1
6,1,0,7,mixedType,0
6,4,0,10,mixedType,1
4,4,0,8,mixedType,1
6,4,0,10,mixedType,1
6,3,0,9,mixedType,1
6,3,0,9,mixedType,1
13,3,0,16,mixedType,2
9,1,0,10,mixedType,1
8,4,0,12,mixedType,1
8,1,0,9,mixedType,1
11,5,0,16,mixedType,2
5,3,0,8,mixedType,1
3,7,0,10,mixedType,1
11,1,0,12,mixedType,1
7,2,0,9,mixedType,1
8,4,0,12,mixedType,1
11,3,0,14,mixedType,2
6,3,0,9,mixedType,1
6,3,0,9,mixedType,1
11,3,0,14,mixedType,2
2,6,0,8,mixedType,1
1,8,0,9,mixedType,1
3,6,0,9,mixedType,1
26,4,0,30,mixedType,2
12,4,0,16,mixedType,2
7,3,0,10,mixedType,1
9,1,0,10,mixedType,1
17,0,1,18,mixedType,2
8,2,0,10,mixedType,1
5,6,0,11,mixedType,1
14,1,1,16,mixedType,2
4,6,0,10,mixedType,1
9,1,0,10,mixedType,1
4,4,0,8,mixedType,1
6,7,0,13,mixedType,1
11,5,0,16,mixedType,2
6,3,0,9,mixedType,1
8,2,0,10,mixedType,1
6,3,0,9,mixedType,1
11,5,0,16,mixedType,2
12,4,0,16,mixedType,2
3,6,0,9,mixedType,1
5,3,0,8,mixedType,1
4,2,0,6,mixedType,0
5,3,0,8,mixedType,1
9,4,1,14,mixedType,2
7,1,0,8,mixedType,1
6,3,0,9,mixedType,1
7,2,0,9,mixedType,1
3,6,0,9,mixedType,1
5,4,0,9,mixedType,1
6,1,0,7,mixedType,0
6,2,0,8,mixedType,1
5,3,0,8,mixedType,1
4,2,0,6,mixedType,0
6,4,0,10,mixedType,1
8,1,0,9,mixedType,1
8,2,0,10,mixedType,1
4,4,0,8,mixedType,1
7,4,0,11,mixedType,1
7,1,0,8,mixedType,1
6,3,0,9,mixedType,1
12,4,0,16,mixedType,2
15,1,0,16,mixedType,2
6,1,0,7,mixedType,0
2,6,0,8,mixedType,1
5,4,0,9,mixedType,1
7,3,0,10,mixedType,1
7,3,0,10,mixedType,1
5,2,0,7,mixedType,0
7,1,0,8,mixedType,1
15,1,0,16,mixedType,2
10,2,0,12,mixedType,1
1,9,0,10,mixedType,1
15,1,0,16,mixedType,2
5,4,0,9,mixedType,1
7,3,0,10,mixedType,1
7,4,0,11,mixedType,1
7,3,0,10,mixedType,1
8,2,0,10,mixedType,1
4,4,0,8,mixedType,1
5,3,0,8,mixedType,1
7,2,0,9,mixedType,1
14,2,0,16,mixedType,2
6,4,0,10,mixedType,1
6,6,0,12,mixedType,1
12,4,0,16,mixedType,2
7,3,0,10,mixedType,1
6,4,0,10,mixedType,1
7,2,0,9,mixedType,1
5,5,0,10,mixedType,1
0,6,0,6,sameType,0
8,1,0,9,mixedType,1
7,2,0,9,mixedType,1
5,1,0,6,mixedType,0
6,10,0,16,mixedType,2
5,5,0,10,mixedType,1
3,7,0,10,mixedType,1
4,4,0,8,mixedType,1
12,3,0,15,mixedType,2
8,2,0,10,mixedType,1
6,4,0,10,mixedType,1
9,1,0,10,mixedType,1
7,3,0,10,mixedType,1
14,2,0,16,mixedType,2
5,4,0,9,mixedType,1
8,1,0,9,mixedType,1
7,2,0,9,mixedType,1
12,1,1,14,mixedType,2
2,8,0,10,mixedType,1
7,3,0,10,mixedType,1
6,2,0,8,mixedType,1
4,2,0,6,mixedType,0
8,2,0,10,mixedType,1
8,5,0,13,mixedType,1
5,1,0,6,mixedType,0
6,3,0,9,mixedType,1
6,3,0,9,mixedType,1
7,3,0,10,mixedType,1
5,4,0,9,mixedType,1
4,4,0,8,mixedType,1
7,3,0,10,mixedType,1
9,1,0,10,mixedType,1
7,2,0,9,mixedType,1
8,1,0,9,mixedType,1
1,8,0,9,mixedType,1
5,4,0,9,mixedType,1
8,2,0,10,mixedType,1
6,4,0,10,mixedType,1
2,7,0,9,mixedType,1
3,6,0,9,mixedType,1
4,2,0,6,mixedType,0
5,3,0,8,mixedType,1
6,0,1,7,mixedType,0
8,2,0,10,mixedType,1
6,3,0,9,mixedType,1
6,4,0,10,mixedType,1
5,4,0,9,mixedType,1
8,1,0,9,mixedType,1
8,2,0,10,mixedType,1
11,3,0,14,mixedType,2
7,1,0,8,mixedType,1
9,3,0,12,mixedType,1
5,2,0,7,mixedType,0
5,1,0,6,mixedType,0
15,1,0,16,mixedType,2
11,3,0,14,mixedType,2
4,9,0,13,mixedType,1
13,3,0,16,mixedType,2
5,2,0,7,mixedType,0
12,3,0,15,mixedType,2
6,3,0,9,mixedType,1
5,4,0,9,mixedType,1
12,3,0,15,mixedType,2
14,2,0,16,mixedType,2
2,7,0,9,mixedType,1
8,2,0,10,mixedType,1
5,4,0,9,mixedType,1
9,1,0,10,mixedType,1
8,1,0,9,mixedType,1
8,3,0,11,mixedType,1
5,1,0,6,mixedType,0
14,1,1,16,mixedType,2
6,1,0,7,mixedType,0
5,3,0,8,mixedType,1
1,8,0,9,mixedType,1
6,3,0,9,mixedType,1
5,5,0,10,mixedType,1
8,4,0,12,mixedType,1
5,4,0,9,mixedType,1
5,6,0,11,mixedType,1
9,1,0,10,mixedType,1
6,3,0,9,mixedType,1
5,3,0,8,mixedType,1
13,3,0,16,mixedType,2
7,3,0,10,mixedType,1
5,1,0,6,mixedType,0
4,2,0,6,mixedType,0
7,1,0,8,mixedType,1
7,2,0,9,mixedType,1
6,2,0,8,mixedType,1
4,2,0,6,mixedType,0
7,2,0,9,mixedType,1
10,3,0,13,mixedType,1
6,1,0,7,mixedType,0
8,2,0,10,mixedType,1
6,3,0,9,mixedType,1
4,4,0,8,mixedType,1
7,2,0,9,mixedType,1
4,6,0,10,mixedType,1
2,6,0,8,mixedType,1
2,6,0,8,mixedType,1
5,4,0,9,mixedType,1
2,6,0,8,mixedType,1
7,3,0,10,mixedType,1
6,4,0,10,mixedType,1
7,3,0,10,mixedType,1
5,6,0,11,mixedType,1
5,2,0,7,mixedType,0
15,1,0,16,mixedType,2
5,2,0,7,mixedType,0
4,2,0,6,mixedType,0
5,4,0,9,mixedType,1
8,3,0,11,mixedType,1
6,4,0,10,mixedType,1
7,3,0,10,mixedType,1
15,1,0,16,mixedType,2
4,8,0,12,mixedType,1
6,4,0,10,mixedType,1
4,2,0,6,mixedType,0
6,5,0,11,mixedType,1
6,4,0,10,mixedType,1
5,2,0,7,mixedType,0
10,2,0,12,mixedType,1
5,4,0,9,mixedType,1
19,1,0,20,mixedType,2
7,3,0,10,mixedType,1
7,2,0,9,mixedType,1
6,1,0,7,mixedType,0
10,3,0,13,mixedType,1
7,3,0,10,mixedType,1
7,3,0,10,mixedType,1
9,4,0,13,mixedType,1
7,3,0,10,mixedType,1
6,1,0,7,mixedType,0
13,3,0,16,mixedType,2
7,3,0,10,mixedType,1
12,3,0,15,mixedType,2
8,1,0,9,mixedType,1
5,6,0,11,mixedType,1
1,11,0,12,mixedType,1
9,3,0,12,mixedType,1
6,4,0,10,mixedType,1
11,5,0,16,mixedType,2
8,2,0,10,mixedType,1
8,2,0,10,mixedType,1
8,1,0,9,mixedType,1
8,1,0,9,mixedType,1
5,4,0,9,mixedType,1
6,1,0,7,mixedType,0
9,1,0,10,mixedType,1
14,2,0,16,mixedType,2
5,3,0,8,mixedType,1
7,4,0,11,mixedType,1
7,3,0,10,mixedType,1
7,2,0,9,mixedType,1
7,3,0,10,mixedType,1
14,2,0,16,mixedType,2
3,6,0,9,mixedType,1
5,3,0,8,mixedType,1
4,2,0,6,mixedType,0
7,2,0,9,mixedType,1
6,4,0,10,mixedType,1
3,8,0,11,mixedType,1
6,2,0,8,mixedType,1
11,1,0,12,mixedType,1
8,4,0,12,mixedType,1
13,2,0,15,mixedType,2
13,3,0,16,mixedType,2
15,1,0,16,mixedType,2
5,3,0,8,mixedType,1
3,3,0,6,mixedType,0
5,3,0,8,mixedType,1
15,1,0,16,mixedType,2
5,3,0,8,mixedType,1
2,6,0,8,mixedType,1
8,1,0,9,mixedType,1
5,3,0,8,mixedType,1
8,8,0,16,mixedType,2
6,1,0,7,mixedType,0
7,3,0,10,mixedType,1
8,2,0,10,mixedType,1
4,4,0,8,mixedType,1
6,3,0,9,mixedType,1
2,7,0,9,mixedType,1
7,2,0,9,mixedType,1
5,2,0,7,mixedType,0
5,3,0,8,mixedType,1
6,3,0,9,mixedType,1
5,3,0,8,mixedType,1
7,2,0,9,mixedType,1
7,1,0,8,mixedType,1
13,3,0,16,mixedType,2
9,1,0,10,mixedType,1
7,2,0,9,mixedType,1
2,7,0,9,mixedType,1
10,6,0,16,mixedType,2
7,3,0,10,mixedType,1
7,3,0,10,mixedType,1
7,1,0,8,mixedType,1
8,1,0,9,mixedType,1
2,8,0,10,mixedType,1
3,6,0,9,mixedType,1
5,9,0,14,mixedType,2
11,5,0,16,mixedType,2
8,2,0,10,mixedType,1
9,1,0,10,mixedType,1
8,3,0,11,mixedType,1
5,2,0,7,mixedType,0
6,2,0,8,mixedType,1
10,4,1,15,mixedType,2
8,1,0,9,mixedType,1
12,3,0,15,mixedType,2
5,6,0,11,mixedType,1
6,1,0,7,mixedType,0
7,3,0,10,mixedType,1
6,8,0,14,mixedType,2
9,4,0,13,mixedType,1
5,3,0,8,mixedType,1
9,4,0,13,mixedType,1
15,1,0,16,mixedType,2
5,4,0,9,mixedType,1
13,2,1,16,mixedType,2
14,2,0,16,mixedType,2
9,2,0,11,mixedType,1
4,2,0,6,mixedType,0
8,2,0,10,mixedType,1
4,2,0,6,mixedType,0
4,2,0,6,mixedType,0
7,2,0,9,mixedType,1
7,3,0,10,mixedType,1
7,2,0,9,mixedType,1
7,2,0,9,mixedType,1
3,7,0,10,mixedType,1
1,8,0,9,mixedType,1
4,6,0,10,mixedType,1
2,7,0,9,mixedType,1
8,2,0,10,mixedType,1
8,3,0,11,mixedType,1
6,2,0,8,mixedType,1
8,1,0,9,mixedType,1
8,3,0,11,mixedType,1
6,4,0,10,mixedType,1
6,3,0,9,mixedType,1
6,3,0,9,mixedType,1
15,1,0,16,mixedType,2
7,1,0,8,mixedType,1
4,2,0,6,mixedType,0
5,2,0,7,mixedType,0
11,3,0,14,mixedType,2
8,4,0,12,mixedType,1
15,1,0,16,mixedType,2
12,1,0,13,mixedType,1
6,4,0,10,mixedType,1
10,3,0,13,mixedType,1
5,3,0,8,mixedType,1
11,2,0,13,mixedType,1
4,2,0,6,mixedType,0
3,7,0,10,mixedType,1
1,7,0,8,mixedType,1
7,2,0,9,mixedType,1
13,3,0,16,mixedType,2
4,4,0,8,mixedType,1
5,2,0,7,mixedType,0
2,4,0,6,mixedType,0
8,4,0,12,mixedType,1
6,3,0,9,mixedType,1
4,4,0,8,mixedType,1
8,3,0,11,mixedType,1
4,4,0,8,mixedType,1
5,2,0,7,mixedType,0
12,1,1,14,mixedType,2
9,1,0,10,mixedType,1
5,2,0,7,mixedType,0
7,4,0,11,mixedType,1
3,5,0,8,mixedType,1
5,1,0,6,mixedType,0
4,6,0,10,mixedType,1
3,6,0,9,mixedType,1
4,4,0,8,mixedType,1
13,3,0,16,mixedType,2
5,3,0,8,mixedType,1
2,6,0,8,mixedType,1
6,1,0,7,mixedType,0
12,4,0,16,mixedType,2
4,2,0,6,mixedType,0
9,1,0,10,mixedType,1
6,1,0,7,mixedType,0
4,2,0,6,mixedType,0
8,1,0,9,mixedType,1
5,3,0,8,mixedType,1
5,3,0,8,mixedType,1
7,4,0,11,mixedType,1
3,3,0,6,mixedType,0
5,2,0,7,mixedType,0
6,3,0,9,mixedType,1
6,2,0,8,mixedType,1
6,4,0,10,mixedType,1
12,4,0,16,mixedType,2
6,3,0,9,mixedType,1
15,1,0,16,mixedType,2
6,2,0,8,mixedType,1
5,1,0,6,mixedType,0
13,3,0,16,mixedType,2
3,3,0,6,mixedType,0
6,2,0,8,mixedType,1
6,3,0,9,mixedType,1
7,1,0,8,mixedType,1
1,9,0,10,mixedType,1
11,3,0,14,mixedType,2
14,2,0,16,mixedType,2
4,2,0,6,mixedType,0
6,3,0,9,mixedType,1
7,2,0,9,mixedType,1
7,3,0,10,mixedType,1
6,3,0,9,mixedType,1
11,1,0,12,mixedType,1
6,3,0,9,mixedType,1
6,3,0,9,mixedType,1
8,2,0,10,mixedType,1
7,3,0,10,mixedType,1
6,2,0,8,mixedType,1
6,3,0,9,mixedType,1
9,3,0,12,mixedType,1
8,1,0,9,mixedType,1
1,8,0,9,mixedType,1
7,2,0,9,mixedType,1
15,1,0,16,mixedType,2
5,3,0,8,mixedType,1
6,2,0,8,mixedType,1
15,1,0,16,mixedType,2
6,4,0,10,mixedType,1
7,2,0,9,mixedType,1
1,9,0,10,mixedType,1
7,3,0,10,mixedType,1
16,1,1,18,mixedType,2
5,2,0,7,mixedType,0
8,2,0,10,mixedType,1
15,1,0,16,mixedType,2
5,4,0,9,mixedType,1
7,6,0,13,mixedType,1
2,6,0,8,mixedType,1
1,8,0,9,mixedType,1
10,6,0,16,mixedType,2
8,1,0,9,mixedType,1
1,9,0,10,mixedType,1
6,3,0,9,mixedType,1
10,1,0,11,mixedType,1
6,4,0,10,mixedType,1
14,2,0,16,mixedType,2
2,8,0,10,mixedType,1
8,1,0,9,mixedType,1
4,4,0,8,mixedType,1
11,5,0,16,mixedType,2
3,5,0,8,mixedType,1
4,4,0,8,mixedType,1
6,2,0,8,mixedType,1
7,4,0,11,mixedType,1
9,1,0,10,mixedType,1
6,3,0,9,mixedType,1
7,3,0,10,mixedType,1
9,3,0,12,mixedType,1
4,4,0,8,mixedType,1
9,1,0,10,mixedType,1
6,4,0,10,mixedType,1
14,2,0,16,mixedType,2
4,5,0,9,mixedType,1
5,3,0,8,mixedType,1
7,1,0,8,mixedType,1
7,3,0,10,mixedType,1
2,8,0,10,mixedType,1
4,4,0,8,mixedType,1
6,4,0,10,mixedType,1
6,4,0,10,mixedType,1
8,2,0,10,mixedType,1
5,3,0,8,mixedType,1
3,9,0,12,mixedType,1
5,3,0,8,mixedType,1
6,4,0,10,mixedType,1
13,3,0,16,mixedType,2
7,1,0,8,mixedType,1
9,1,0,10,mixedType,1
2,4,0,6,mixedType,0
1,9,0,10,mixedType,1
2,6,0,8,mixedType,1
11,2,0,13,mixedType,1
5,8,0,13,mixedType,1
10,2,0,12,mixedType,1
5,2,0,7,mixedType,0
8,6,1,15,mixedType,2
9,1,4,14,mixedType,2
8,2,0,10,mixedType,1
6,3,0,9,mixedType,1
14,2,0,16,mixedType,2
2,8,0,10,mixedType,1
7,3,0,10,mixedType,1
7,3,0,10,mixedType,1
3,6,0,9,mixedType,1
1,8,0,9,mixedType,1
4,4,0,8,mixedType,1
2,4,0,6,mixedType,0
8,2,0,10,mixedType,1
15,1,0,16,mixedType,2
7,3,0,10,mixedType,1
5,4,0,9,mixedType,1
7,3,0,10,mixedType,1
6,4,0,10,mixedType,1
6,2,0,8,mixedType,1
5,4,0,9,mixedType,1
7,2,0,9,mixedType,1
5,3,0,8,mixedType,1
15,1,0,16,mixedType,2
1,7,0,8,mixedType,1
8,3,0,11,mixedType,1
5,4,0,9,mixedType,1
3,9,0,12,mixedType,1
1,5,0,6,mixedType,0
9,1,0,10,mixedType,1
7,4,0,11,mixedType,1
5,2,0,7,mixedType,0
4,4,0,8,mixedType,1
6,4,0,10,mixedType,1
6,3,0,9,mixedType,1
9,4,0,13,mixedType,1
7,2,0,9,mixedType,1
4,2,0,6,mixedType,0
9,4,0,13,mixedType,1
7,3,0,10,mixedType,1
5,4,0,9,mixedType,1
6,2,0,8,mixedType,1
8,2,0,10,mixedType,1
8,1,0,9,mixedType,1
6,2,0,8,mixedType,1
7,3,0,10,mixedType,1
5,4,0,9,mixedType,1
8,1,0,9,mixedType,1
4,6,0,10,mixedType,1
9,1,0,10,mixedType,1
10,3,0,13,mixedType,1
8,2,0,10,mixedType,1
7,3,0,10,mixedType,1
8,1,0,9,mixedType,1
5,2,0,7,mixedType,0
7,1,0,8,mixedType,1
8,2,0,10,mixedType,1
11,5,0,16,mixedType,2
14,2,0,16,mixedType,2
1,10,0,11,mixedType,1
3,3,0,6,mixedType,0
9,1,0,10,mixedType,1
11,3,0,14,mixedType,2
9,1,0,10,mixedType,1
3,5,0,8,mixedType,1
6,4,0,10,mixedType,1
5,1,0,6,mixedType,0
6,2,0,8,mixedType,1
4,4,0,8,mixedType,1
15,1,0,16,mixedType,2
9,4,0,13,mixedType,1
6,1,0,7,mixedType,0
1,8,0,9,mixedType,1
9,1,0,10,mixedType,1
14,2,0,16,mixedType,2
8,1,0,9,mixedType,1
6,4,0,10,mixedType,1
7,2,0,9,mixedType,1
8,3,0,11,mixedType,1
8,4,0,12,mixedType,1
11,3,0,14,mixedType,2
6,1,0,7,mixedType,0
3,3,0,6,mixedType,0
9,1,0,10,mixedType,1
15,1,0,16,mixedType,2
1,10,0,11,mixedType,1
6,3,0,9,mixedType,1
5,1,0,6,mixedType,0
5,4,0,9,mixedType,1
5,2,0,7,mixedType,0
3,7,0,10,mixedType,1
7,1,0,8,mixedType,1
14,2,0,16,mixedType,2
6,4,0,10,mixedType,1
6,1,0,7,mixedType,0
7,6,0,13,mixedType,1
5,8,0,13,mixedType,1
13,3,0,16,mixedType,2
5,3,0,8,mixedType,1
12,4,0,16,mixedType,2
9,3,0,12,mixedType,1
1,9,0,10,mixedType,1
6,2,0,8,mixedType,1
8,1,0,9,mixedType,1
4,4,0,8,mixedType,1
5,2,0,7,mixedType,0
4,6,0,10,mixedType,1
8,1,0,9,mixedType,1
6,4,0,10,mixedType,1
4,4,0,8,mixedType,1
9,1,0,10,mixedType,1
9,2,0,11,mixedType,1
12,4,0,16,mixedType,2
8,1,0,9,mixedType,1
9,1,0,10,mixedType,1
5,4,0,9,mixedType,1
8,2,0,10,mixedType,1
3,3,0,6,mixedType,0
4,6,0,10,mixedType,1
15,1,1,17,mixedType,2
8,2,0,10,mixedType,1
7,3,0,10,mixedType,1
5,5,0,10,mixedType,1
8,1,0,9,mixedType,1
7,3,0,10,mixedType,1
13,3,0,16,mixedType,2
4,2,0,6,mixedType,0
5,3,0,8,mixedType,1
14,2,0,16,mixedType,2
7,3,0,10,mixedType,1
20,1,1,22,mixedType,2
5,2,0,7,mixedType,0
8,2,0,10,mixedType,1
14,2,0,16,mixedType,2
4,5,0,9,mixedType,1
5,4,0,9,mixedType,1
6,4,0,10,mixedType,1
12,3,0,15,mixedType,2
4,4,0,8,mixedType,1
5,4,0,9,mixedType,1
6,4,0,10,mixedType,1
12,3,4,19,mixedType,2
5,6,0,11,mixedType,1
15,1,0,16,mixedType,2
14,2,0,16,mixedType,2
8,3,0,11,mixedType,1
8,2,0,10,mixedType,1
6,2,0,8,mixedType,1
2,8,0,10,mixedType,1
11,5,0,16,mixedType,2
5,1,0,6,mixedType,0
10,3,0,13,mixedType,1
0,0,6,6,sameType,0
4,4,0,8,mixedType,1
11,4,0,15,mixedType,2
8,2,0,10,mixedType,1
6,1,0,7,mixedType,0
7,3,0,10,mixedType,1
1,8,0,9,mixedType,1
2,7,0,9,mixedType,1
4,4,0,8,mixedType,1
6,2,0,8,mixedType,1
4,2,0,6,mixedType,0
7,3,0,10,mixedType,1
3,7,0,10,mixedType,1
1,8,0,9,mixedType,1
8,1,0,9,mixedType,1
8,2,0,10,mixedType,1
6,2,0,8,mixedType,1
5,3,0,8,mixedType,1
6,3,0,9,mixedType,1
11,3,0,14,mixedType,2
4,2,0,6,mixedType,0
11,3,0,14,mixedType,2
13,3,0,16,mixedType,2
2,6,0,8,mixedType,1
4,2,0,6,mixedType,0
12,4,0,16,mixedType,2
5,1,0,6,mixedType,0
8,2,0,10,mixedType,1
11,2,0,13,mixedType,1
6,1,0,7,mixedType,0
15,1,0,16,mixedType,2
6,3,0,9,mixedType,1
5,2,0,7,mixedType,0
8,3,0,11,mixedType,1
10,2,0,12,mixedType,1
15,1,0,16,mixedType,2
8,0,1,9,mixedType,1
3,6,0,9,mixedType,1
5,8,0,13,mixedType,1
4,4,0,8,mixedType,1
6,2,0,8,mixedType,1
11,2,0,13,mixedType,1
5,4,0,9,mixedType,1
7,3,0,10,mixedType,1
9,1,0,10,mixedType,1
7,1,0,8,mixedType,1
6,2,0,8,mixedType,1
9,3,0,12,mixedType,1
7,3,0,10,mixedType,1
15,1,0,16,mixedType,2
8,2,0,10,mixedType,1
5,3,0,8,mixedType,1
15,1,0,16,mixedType,2
8,2,0,10,mixedType,1
9,3,0,12,mixedType,1
6,2,0,8,mixedType,1
9,2,0,11,mixedType,1
9,1,0,10,mixedType,1
7,1,0,8,mixedType,1
5,2,0,7,mixedType,0
13,3,0,16,mixedType,2
15,1,0,16,mixedType,2
3,3,0,6,mixedType,0
15,1,0,16,mixedType,2
7,3,0,10,mixedType,1
6,2,0,8,mixedType,1
9,3,0,12,mixedType,1
5,8,0,13,mixedType,1
5,3,0,8,mixedType,1
6,1,0,7,mixedType,0
10,3,0,13,mixedType,1
2,6,0,8,mixedType,1
7,2,0,9,mixedType,1
6,6,0,12,mixedType,1
5,4,0,9,mixedType,1
13,3,0,16,mixedType,2
2,6,0,8,mixedType,1
8,2,0,10,mixedType,1
14,2,0,16,mixedType,2
7,3,0,10,mixedType,1
7,3,0,10,mixedType,1
6,2,0,8,mixedType,1
1,8,0,9,mixedType,1
14,2,0,16,mixedType,2
8,1,0,9,mixedType,1
7,3,0,10,mixedType,1
7,1,0,8,mixedType,1
6,2,0,8,mixedType,1
9,1,0,10,mixedType,1
6,4,0,10,mixedType,1
14,2,0,16,mixedType,2
9,3,0,12,mixedType,1
5,3,0,8,mixedType,1
6,3,0,9,mixedType,1
7,3,0,10,mixedType,1
6,3,0,9,mixedType,1
8,2,0,10,mixedType,1
8,1,0,9,mixedType,1
6,3,0,9,mixedType,1
7,2,0,9,mixedType,1
8,2,0,10,mixedType,1
7,3,0,10,mixedType,1
5,6,0,11,mixedType,1
6,1,0,7,mixedType,0
7,2,0,9,mixedType,1
5,4,0,9,mixedType,1
5,3,0,8,mixedType,1
9,4,0,13,mixedType,1
2,8,0,10,mixedType,1
6,3,0,9,mixedType,1
6,3,0,9,mixedType,1
2,6,0,8,mixedType,1
8,2,0,10,mixedType,1
5,3,0,8,mixedType,1
7,2,0,9,mixedType,1
9,1,0,10,mixedType,1
10,2,0,12,mixedType,1
4,4,0,8,mixedType,1
13,3,0,16,mixedType,2
4,5,0,9,mixedType,1
6,3,0,9,mixedType,1
5,3,0,8,mixedType,1
7,2,0,9,mixedType,1
13,3,0,16,mixedType,2
3,6,0,9,mixedType,1
7,3,0,10,mixedType,1
9,4,1,14,mixedType,2
8,1,0,9,mixedType,1
6,3,0,9,mixedType,1
15,1,0,16,mixedType,2
11,3,0,14,mixedType,2
6,2,0,8,mixedType,1
6,3,0,9,mixedType,1
12,1,0,13,mixedType,1
6,2,0,8,mixedType,1
6,2,0,8,mixedType,1
11,5,0,16,mixedType,2
10,1,0,11,mixedType,1
8,2,0,10,mixedType,1
5,4,0,9,mixedType,1
5,4,0,9,mixedType,1
8,3,0,11,mixedType,1
2,8,0,10,mixedType,1
9,3,0,12,mixedType,1
5,5,0,10,mixedType,1
7,3,0,10,mixedType,1
8,1,0,9,mixedType,1
12,3,0,15,mixedType,2
6,4,0,10,mixedType,1
5,3,0,8,mixedType,1
6,4,0,10,mixedType,1
7,2,0,9,mixedType,1
8,1,0,9,mixedType,1
9,2,0,11,mixedType,1
3,6,0,9,mixedType,1
6,1,0,7,mixedType,0
9,2,0,11,mixedType,1
8,1,0,9,mixedType,1
7,3,0,10,mixedType,1
5,4,0,9,mixedType,1
8,5,0,13,mixedType,1
5,4,0,9,mixedType,1
12,3,0,15,mixedType,2
7,3,0,10,mixedType,1
7,2,0,9,mixedType,1
13,1,1,15,mixedType,2
6,1,0,7,mixedType,0
4,2,0,6,mixedType,0
8,2,0,10,mixedType,1
8,1,0,9,mixedType,1
10,4,0,14,mixedType,2
7,1,0,8,mixedType,1
6,3,0,9,mixedType,1
5,1,0,6,mixedType,0
8,4,0,12,mixedType,1
12,4,0,16,mixedType,2
4,4,0,8,mixedType,1
3,7,0,10,mixedType,1
5,4,0,9,mixedType,1
7,3,0,10,mixedType,1
9,2,0,11,mixedType,1
7,3,0,10,mixedType,1
7,1,0,8,mixedType,1
12,3,0,15,mixedType,2
4,4,0,8,mixedType,1
10,1,0,11,mixedType,1
5,1,0,6,mixedType,0
5,3,0,8,mixedType,1
5,3,0,8,mixedType,1
5,2,0,7,mixedType,0
6,1,0,7,mixedType,0
8,2,0,10,mixedType,1
7,4,0,11,mixedType,1
8,1,0,9,mixedType,1
11,1,0,12,mixedType,1
8,2,0,10,mixedType,1
6,3,0,9,mixedType,1
9,1,0,10,mixedType,1
6,4,0,10,mixedType,1
9,4,0,13,mixedType,1
8,2,0,10,mixedType,1
14,2,0,16,mixedType,2
6,4,0,10,mixedType,1
6,4,0,10,mixedType,1
7,3,0,10,mixedType,1
1,11,0,12,mixedType,1
6,3,0,9,mixedType,1
10,3,0,13,mixedType,1
11,5,0,16,mixedType,2
6,6,0,12,mixedType,1
8,2,0,10,mixedType,1
6,4,0,10,mixedType,1
6,4,0,10,mixedType,1
7,1,0,8,mixedType,1
6,1,0,7,mixedType,0
6,6,0,12,mixedType,1
9,3,0,12,mixedType,1
6,2,0,8,mixedType,1
5,2,0,7,mixedType,0
1,7,0,8,mixedType,1
7,2,0,9,mixedType,1
9,3,0,12,mixedType,1
7,1,0,8,mixedType,1
3,5,0,8,mixedType,1
7,4,0,11,mixedType,1
14,2,0,16,mixedType,2
5,8,0,13,mixedType,1
13,3,0,16,mixedType,2
4,6,0,10,mixedType,1
7,3,0,10,mixedType,1
8,1,0,9,mixedType,1
13,3,0,16,mixedType,2
4,4,0,8,mixedType,1
6,1,0,7,mixedType,0
10,2,0,12,mixedType,1
5,4,0,9,mixedType,1
12,1,0,13,mixedType,1
8,1,0,9,mixedType,1
5,2,0,7,mixedType,0
9,2,0,11,mixedType,1
7,4,0,11,mixedType,1
4,2,0,6,mixedType,0
12,4,0,16,mixedType,2
6,3,0,9,mixedType,1
5,3,0,8,mixedType,1
14,1,1,16,mixedType,2
7,3,0,10,mixedType,1
7,3,0,10,mixedType,1
7,1,0,8,mixedType,1
6,2,0,8,mixedType,1
9,3,0,12,mixedType,1
5,2,0,7,mixedType,0
8,4,0,12,mixedType,1
15,1,0,16,mixedType,2
7,3,0,10,mixedType,1
5,4,0,9,mixedType,1
8,2,0,10,mixedType,1
7,3,0,10,mixedType,1
7,1,0,8,mixedType,1
6,1,0,7,mixedType,0
2,10,0,12,mixedType,1
2,6,0,8,mixedType,1
7,2,0,9,mixedType,1
3,3,0,6,mixedType,0
6,3,0,9,mixedType,1
8,2,0,10,mixedType,1
3,6,0,9,mixedType,1
4,2,0,6,mixedType,0
8,2,0,10,mixedType,1
5,5,0,10,mixedType,1
11,1,0,12,mixedType,1
3,7,0,10,mixedType,1
9,2,0,11,mixedType,1
7,3,0,10,mixedType,1
14,2,0,16,mixedType,2
4,4,0,8,mixedType,1
8,2,0,10,mixedType,1
6,3,0,9,mixedType,1
4,4,0,8,mixedType,1
12,3,0,15,mixedType,2
4,4,0,8,mixedType,1
7,2,0,9,mixedType,1
5,3,0,8,mixedType,1
6,3,0,9,mixedType,1
4,4,0,8,mixedType,1
4,6,0,10,mixedType,1
4,4,0,8,mixedType,1
8,2,0,10,mixedType,1
7,2,0,9,mixedType,1
5,6,0,11,mixedType,1
7,3,0,10,mixedType,1
2,6,0,8,mixedType,1
7,3,0,10,mixedType,1
7,2,0,9,mixedType,1
11,5,0,16,mixedType,2
5,2,0,7,mixedType,0
1,9,0,10,mixedType,1
12,3,0,15,mixedType,2
6,1,0,7,mixedType,0
7,1,0,8,mixedType,1
5,3,0,8,mixedType,1
8,4,0,12,mixedType,1
3,6,0,9,mixedType,1
6,4,0,10,mixedType,1
6,4,0,10,mixedType,1
5,4,0,9,mixedType,1
11,3,0,14,mixedType,2
14,2,0,16,mixedType,2
4,2,0,6,mixedType,0
3,3,0,6,mixedType,0
4,5,0,9,mixedType,1
13,3,0,16,mixedType,2
6,5,0,11,mixedType,1
8,1,0,9,mixedType,1
5,3,0,8,mixedType,1
6,3,0,9,mixedType,1
9,4,0,13,mixedType,1
6,3,0,9,mixedType,1
6,4,0,10,mixedType,1
8,2,0,10,mixedType,1
1,8,0,9,mixedType,1
5,6,0,11,mixedType,1
2,4,0,6,mixedType,0
5,4,0,9,mixedType,1
5,4,0,9,mixedType,1
14,1,0,15,mixedType,2
6,4,0,10,mixedType,1
14,2,0,16,mixedType,2
5,3,0,8,mixedType,1
5,2,0,7,mixedType,0
15,1,0,16,mixedType,2
3,6,0,9,mixedType,1
9,4,0,13,mixedType,1
7,4,0,11,mixedType,1
5,2,0,7,mixedType,0
2,6,0,8,mixedType,1
10,2,0,12,mixedType,1
6,1,0,7,mixedType,0
6,3,0,9,mixedType,1
13,3,0,16,mixedType,2
6,6,0,12,mixedType,1
5,3,0,8,mixedType,1
4,4,0,8,mixedType,1
8,2,0,10,mixedType,1
5,2,0,7,mixedType,0
9,4,0,13,mixedType,1
8,6,0,14,mixedType,2
6,3,0,9,mixedType,1
3,10,0,13,mixedType,1
11,1,0,12,mixedType,1
9,2,0,11,mixedType,1
4,6,0,10,mixedType,1
6,3,0,9,mixedType,1
5,1,0,6,mixedType,0
12,4,0,16,mixedType,2
7,3,0,10,mixedType,1
7,1,0,8,mixedType,1
11,3,0,14,mixedType,2
2,6,0,8,mixedType,1
5,4,0,9,mixedType,1
5,3,0,8,mixedType,1
12,3,0,15,mixedType,2
6,4,0,10,mixedType,1
3,3,0,6,mixedType,0
4,4,0,8,mixedType,1
11,2,0,13,mixedType,1
6,2,0,8,mixedType,1
9,3,0,12,mixedType,1
7,2,0,9,mixedType,1
4,5,0,9,mixedType,1
11,3,0,14,mixedType,2
5,3,0,8,mixedType,1
4,7,0,11,mixedType,1
3,10,0,13,mixedType,1
7,2,0,9,mixedType,1
8,2,0,10,mixedType,1
7,2,0,9,mixedType,1
9,2,0,11,mixedType,1
4,6,0,10,mixedType,1
7,3,0,10,mixedType,1
5,4,0,9,mixedType,1
4,4,0,8,mixedType,1
8,3,0,11,mixedType,1
13,3,0,16,mixedType,2
8,2,0,10,mixedType,1
15,1,0,16,mixedType,2
8,4,0,12,mixedType,1
9,3,0,12,mixedType,1
7,3,0,10,mixedType,1
5,3,0,8,mixedType,1
6,4,0,10,mixedType,1
4,6,0,10,mixedType,1
5,3,0,8,mixedType,1
8,2,0,10,mixedType,1
2,10,0,12,mixedType,1
8,2,0,10,mixedType,1
5,2,0,7,mixedType,0
4,6,0,10,mixedType,1
6,4,0,10,mixedType,1
6,4,0,10,mixedType,1
7,2,0,9,mixedType,1
5,1,0,6,mixedType,0
7,3,0,10,mixedType,1
14,2,0,16,mixedType,2
1,10,0,11,mixedType,1
4,2,0,6,mixedType,0
3,5,0,8,mixedType,1
7,2,0,9,mixedType,1
5,4,0,9,mixedType,1
7,3,0,10,mixedType,1
8,2,0,10,mixedType,1
3,6,0,9,mixedType,1
9,2,0,11,mixedType,1
6,3,0,9,mixedType,1
6,3,0,9,mixedType,1
9,2,0,11,mixedType,1
3,3,0,6,mixedType,0
12,1,0,13,mixedType,1
7,1,0,8,mixedType,1
13,3,0,16,mixedType,2
6,3,0,9,mixedType,1
6,7,0,13,mixedType,1
2,6,0,8,mixedType,1
6,2,0,8,mixedType,1
5,3,0,8,mixedType,1
11,3,0,14,mixedType,2
7,2,0,9,mixedType,1
4,2,0,6,mixedType,0
5,2,0,7,mixedType,0
6,3,0,9,mixedType,1
12,3,0,15,mixedType,2
4,2,0,6,mixedType,0
12,3,0,15,mixedType,2
4,2,0,6,mixedType,0
8,2,0,10,mixedType,1
14,2,0,16,mixedType,2
6,1,0,7,mixedType,0
4,2,0,6,mixedType,0
14,2,0,16,mixedType,2
9,2,0,11,mixedType,1
4,4,0,8,mixedType,1
7,2,0,9,mixedType,1
11,5,0,16,mixedType,2
8,2,0,10,mixedType,1
15,1,0,16,mixedType,2
7,3,0,10,mixedType,1
5,3,0,8,mixedType,1
6,3,0,9,mixedType,1
16,1,2,19,mixedType,2
15,1,0,16,mixedType,2
9,2,0,11,mixedType,1
8,2,0,10,mixedType,1
12,4,0,16,mixedType,2
9,2,0,11,mixedType,1
12,3,0,15,mixedType,2
6,4,0,10,mixedType,1
15,1,0,16,mixedType,2
8,4,0,12,mixedType,1
6,2,0,8,mixedType,1
9,3,0,12,mixedType,1
9,3,0,12,mixedType,1
4,4,0,8,mixedType,1
13,3,0,16,mixedType,2
10,6,0,16,mixedType,2
2,7,0,9,mixedType,1
7,2,0,9,mixedType,1
5,3,0,8,mixedType,1
5,1,0,6,mixedType,0
6,3,0,9,mixedType,1
6,3,0,9,mixedType,1
12,4,0,16,mixedType,2
12,3,0,15,mixedType,2
3,6,0,9,mixedType,1
8,3,0,11,mixedType,1
10,3,0,13,mixedType,1
11,5,0,16,mixedType,2
1,7,0,8,mixedType,1
15,1,0,16,mixedType,2
8,1,0,9,mixedType,1
7,6,0,13,mixedType,1
8,4,0,12,mixedType,1
4,4,0,8,mixedType,1
15,1,0,16,mixedType,2
9,1,0,10,mixedType,1
5,3,0,8,mixedType,1
6,4,0,10,mixedType,1
9,1,0,10,mixedType,1
5,3,0,8,mixedType,1
1,7,0,8,mixedType,1
2,8,0,10,mixedType,1
9,3,0,12,mixedType,1
9,6,0,15,mixedType,2
4,2,0,6,mixedType,0
10,1,0,11,mixedType,1
10,2,0,12,mixedType,1
1,8,0,9,mixedType,1
5,6,0,11,mixedType,1
2,8,0,10,mixedType,1
0,0,7,7,sameType,0
11,1,0,12,mixedType,1
7,3,0,10,mixedType,1
5,3,0,8,mixedType,1
14,2,0,16,mixedType,2
6,4,0,10,mixedType,1
6,3,0,9,mixedType,1
4,4,0,8,mixedType,1
6,3,0,9,mixedType,1
6,3,0,9,mixedType,1
8,1,0,9,mixedType,1
2,6,0,8,mixedType,1
10,1,0,11,mixedType,1
8,4,0,12,mixedType,1
5,1,0,6,mixedType,0
7,1,0,8,mixedType,1
5,4,0,9,mixedType,1
13,3,0,16,mixedType,2
3,6,0,9,mixedType,1
6,1,0,7,mixedType,0
6,2,0,8,mixedType,1
3,5,0,8,mixedType,1
5,7,0,12,mixedType,1
4,5,0,9,mixedType,1
9,1,0,10,mixedType,1
11,3,0,14,mixedType,2
8,2,0,10,mixedType,1
5,2,0,7,mixedType,0
12,2,2,16,mixedType,2
14,2,0,16,mixedType,2
5,2,0,7,mixedType,0
3,6,0,9,mixedType,1
6,2,0,8,mixedType,1
13,3,0,16,mixedType,2
7,1,0,8,mixedType,1
6,2,0,8,mixedType,1
6,2,0,8,mixedType,1
2,8,0,10,mixedType,1
6,3,0,9,mixedType,1
10,3,0,13,mixedType,1
6,1,0,7,mixedType,0
6,1,0,7,mixedType,0
2,6,0,8,mixedType,1
9,1,0,10,mixedType,1
9,1,0,10,mixedType,1
8,3,0,11,mixedType,1
6,3,0,9,mixedType,1
5,3,0,8,mixedType,1
4,2,0,6,mixedType,0
2,7,0,9,mixedType,1
8,2,0,10,mixedType,1
9,3,0,12,mixedType,1
6,2,0,8,mixedType,1
2,6,0,8,mixedType,1
11,3,0,14,mixedType,2
8,3,0,11,mixedType,1
6,3,0,9,mixedType,1
7,2,0,9,mixedType,1
8,1,0,9,mixedType,1
3,6,0,9,mixedType,1
5,3,0,8,mixedType,1
9,4,0,13,mixedType,1
2,4,0,6,mixedType,0
7,2,0,9,mixedType,1
6,1,0,7,mixedType,0
6,3,0,9,mixedType,1
3,5,0,8,mixedType,1
5,3,0,8,mixedType,1
5,3,0,8,mixedType,1
7,2,0,9,mixedType,1
12,4,0,16,mixedType,2
5,2,0,7,mixedType,0
6,4,0,10,mixedType,1
13,3,0,16,mixedType,2
6,4,0,10,mixedType,1
1,8,0,9,mixedType,1
5,4,0,9,mixedType,1
2,11,0,13,mixedType,1
8,1,0,9,mixedType,1
7,2,0,9,mixedType,1
4,2,0,6,mixedType,0
3,6,0,9,mixedType,1
8,2,0,10,mixedType,1
6,2,0,8,mixedType,1
5,2,0,7,mixedType,0
8,1,0,9,mixedType,1
14,2,0,16,mixedType,2
8,4,0,12,mixedType,1
6,5,0,11,mixedType,1
7,2,0,9,mixedType,1
7,1,0,8,mixedType,1
6,2,0,8,mixedType,1
2,6,0,8,mixedType,1
4,4,0,8,mixedType,1
10,2,0,12,mixedType,1
6,2,0,8,mixedType,1
12,1,0,13,mixedType,1
2,6,0,8,mixedType,1
8,1,0,9,mixedType,1
6,4,0,10,mixedType,1
4,4,0,8,mixedType,1
8,4,0,12,mixedType,1
7,2,0,9,mixedType,1
5,3,0,8,mixedType,1
1,6,0,7,mixedType,0
8,3,0,11,mixedType,1
2,7,0,9,mixedType,1
5,3,0,8,mixedType,1
5,3,0,8,mixedType,1
9,3,0,12,mixedType,1
5,1,0,6,mixedType,0
4,6,0,10,mixedType,1
1,8,0,9,mixedType,1
5,4,0,9,mixedType,1
12,3,0,15,mixedType,2
6,4,0,10,mixedType,1
10,1,0,11,mixedType,1
3,3,0,6,mixedType,0
8,1,0,9,mixedType,1
7,3,0,10,mixedType,1
9,2,0,11,mixedType,1
7,3,0,10,mixedType,1
6,3,0,9,mixedType,1
7,3,0,10,mixedType,1
7,2,0,9,mixedType,1
5,4,0,9,mixedType,1
2,7,0,9,mixedType,1
10,1,0,11,mixedType,1
7,2,0,9,mixedType,1
9,1,0,10,mixedType,1
13,3,0,16,mixedType,2
6,3,0,9,mixedType,1
11,2,0,13,mixedType,1
8,2,0,10,mixedType,1
4,8,0,12,mixedType,1
6,3,0,9,mixedType,1
7,2,0,9,mixedType,1
6,3,0,9,mixedType,1
6,1,0,7,mixedType,0
13,2,0,15,mixedType,2
6,2,0,8,mixedType,1
12,4,0,16,mixedType,2
7,3,0,10,mixedType,1
8,3,0,11,mixedType,1
6,3,0,9,mixedType,1
5,3,0,8,mixedType,1
7,2,0,9,mixedType,1
6,2,0,8,mixedType,1
6,4,0,10,mixedType,1
7,4,0,11,mixedType,1
5,2,0,7,mixedType,0
9,2,0,11,mixedType,1
10,2,0,12,mixedType,1
15,1,0,16,mixedType,2
11,1,0,12,mixedType,1
5,3,0,8,mixedType,1
9,2,0,11,mixedType,1
4,4,0,8,mixedType,1
6,4,0,10,mixedType,1
7,2,0,9,mixedType,1
4,4,0,8,mixedType,1
9,1,0,10,mixedType,1
4,2,0,6,mixedType,0
4,2,0,6,mixedType,0
8,2,0,10,mixedType,1
9,1,0,10,mixedType,1
5,6,0,11,mixedType,1
1,9,0,10,mixedType,1
5,3,0,8,mixedType,1
9,1,0,10,mixedType,1
10,1,0,11,mixedType,1
8,4,0,12,mixedType,1
5,3,0,8,mixedType,1
8,4,0,12,mixedType,1
7,2,0,9,mixedType,1
6,3,0,9,mixedType,1
5,3,0,8,mixedType,1
2,4,0,6,mixedType,0
12,4,0,16,mixedType,2
5,4,0,9,mixedType,1
6,3,0,9,mixedType,1
11,2,0,13,mixedType,1
8,1,0,9,mixedType,1
3,6,0,9,mixedType,1
2,6,0,8,mixedType,1
7,3,0,10,mixedType,1
6,1,0,7,mixedType,0
11,5,0,16,mixedType,2
7,3,0,10,mixedType,1
6,3,0,9,mixedType,1
8,3,0,11,mixedType,1
5,2,0,7,mixedType,0
7,2,0,9,mixedType,1
14,2,0,16,mixedType,2
11,5,0,16,mixedType,2
5,2,0,7,mixedType,0
11,5,0,16,mixedType,2
5,2,0,7,mixedType,0
6,4,0,10,mixedType,1
6,4,0,10,mixedType,1
1,7,0,8,mixedType,1
3,6,0,9,mixedType,1
9,1,0,10,mixedType,1
9,1,0,10,mixedType,1
14,2,0,16,mixedType,2
9,1,0,10,mixedType,1
6,1,0,7,mixedType,0
6,2,0,8,mixedType,1
6,3,0,9,mixedType,1
5,4,0,9,mixedType,1
7,3,0,10,mixedType,1
4,2,0,6,mixedType,0
2,11,0,13,mixedType,1
1,8,0,9,mixedType,1
5,4,0,9,mixedType,1
5,1,0,6,mixedType,0
9,2,0,11,mixedType,1
5,4,0,9,mixedType,1
14,2,0,16,mixedType,2
8,2,0,10,mixedType,1
6,4,0,10,mixedType,1
6,3,0,9,mixedType,1
4,6,0,10,mixedType,1
9,4,0,13,mixedType,1
5,2,0,7,mixedType,0
8,4,0,12,mixedType,1
13,3,0,16,mixedType,2
6,4,0,10,mixedType,1
6,3,0,9,mixedType,1
9,4,0,13,mixedType,1
9,1,0,10,mixedType,1
7,0,1,8,mixedType,1
6,4,0,10,mixedType,1
8,3,0,11,mixedType,1
6,3,0,9,mixedType,1
11,4,0,15,mixedType,2
11,2,0,13,mixedType,1
5,3,0,8,mixedType,1
5,6,0,11,mixedType,1
6,1,0,7,mixedType,0
3,8,0,11,mixedType,1
1,10,0,11,mixedType,1
7,3,0,10,mixedType,1
6,3,0,9,mixedType,1
12,4,0,16,mixedType,2
7,2,0,9,mixedType,1
9,3,0,12,mixedType,1
7,2,0,9,mixedType,1
2,8,0,10,mixedType,1
10,3,0,13,mixedType,1
6,2,0,8,mixedType,1
5,6,0,11,mixedType,1
8,2,0,10,mixedType,1
7,3,0,10,mixedType,1
13,3,0,16,mixedType,2
6,2,0,8,mixedType,1
6,2,0,8,mixedType,1
5,3,0,8,mixedType,1
5,3,0,8,mixedType,1
5,2,0,7,mixedType,0
7,4,0,11,mixedType,1
7,3,0,10,mixedType,1
6,3,0,9,mixedType,1
7,1,0,8,mixedType,1
7,3,0,10,mixedType,1
9,3,0,12,mixedType,1
11,2,0,13,mixedType,1
15,1,0,16,mixedType,2
7,1,0,8,mixedType,1
6,6,0,12,mixedType,1
3,8,0,11,mixedType,1
4,2,0,6,mixedType,0
5,1,0,6,mixedType,0
4,4,0,8,mixedType,1
9,2,0,11,mixedType,1
6,3,0,9,mixedType,1
4,4,0,8,mixedType,1
6,1,0,7,mixedType,0
9,7,0,16,mixedType,2
8,2,0,10,mixedType,1
7,2,0,9,mixedType,1
5,5,0,10,mixedType,1
5,4,0,9,mixedType,1
10,1,0,11,mixedType,1
9,1,0,10,mixedType,1
9,1,0,10,mixedType,1
8,4,0,12,mixedType,1
9,1,0,10,mixedType,1
5,4,0,9,mixedType,1
7,3,0,10,mixedType,1
6,4,0,10,mixedType,1
7,1,0,8,mixedType,1
5,2,0,7,mixedType,0
8,3,0,11,mixedType,1
8,1,0,9,mixedType,1
6,4,0,10,mixedType,1
8,2,0,10,mixedType,1
15,1,0,16,mixedType,2
6,4,0,10,mixedType,1
8,3,0,11,mixedType,1
5,1,0,6,mixedType,0
6,1,0,7,mixedType,0
5,6,0,11,mixedType,1
6,3,0,9,mixedType,1
3,6,0,9,mixedType,1
7,2,0,9,mixedType,1
7,4,0,11,mixedType,1
6,3,0,9,mixedType,1
3,6,0,9,mixedType,1
4,2,0,6,mixedType,0
5,8,0,13,mixedType,1
3,7,0,10,mixedType,1
7,2,0,9,mixedType,1
14,2,0,16,mixedType,2
10,2,0,12,mixedType,1
4,4,0,8,mixedType,1
6,1,0,7,mixedType,0
5,3,0,8,mixedType,1
6,1,0,7,mixedType,0
7,2,0,9,mixedType,1
7,4,0,11,mixedType,1
7,2,0,9,mixedType,1
4,4,0,8,mixedType,1
10,1,0,11,mixedType,1
9,1,0,10,mixedType,1
7,3,0,10,mixedType,1
8,1,0,9,mixedType,1
6,1,0,7,mixedType,0
5,2,0,7,mixedType,0
8,2,0,10,mixedType,1
4,2,0,6,mixedType,0
12,4,0,16,mixedType,2
6,1,0,7,mixedType,0
6,8,1,15,mixedType,2
6,3,0,9,mixedType,1
2,6,0,8,mixedType,1
11,3,0,14,mixedType,2
9,3,0,12,mixedType,1
7,5,0,12,mixedType,1
6,1,0,7,mixedType,0
12,1,0,13,mixedType,1
8,2,0,10,mixedType,1
7,4,0,11,mixedType,1
7,3,0,10,mixedType,1
7,2,0,9,mixedType,1
4,4,0,8,mixedType,1
12,3,0,15,mixedType,2
5,4,0,9,mixedType,1
13,3,0,16,mixedType,2
3,6,0,9,mixedType,1
7,3,0,10,mixedType,1
8,2,0,10,mixedType,1
6,3,0,9,mixedType,1
4,6,0,10,mixedType,1
7,4,0,11,mixedType,1
13,2,1,16,mixedType,2
5,4,0,9,mixedType,1
1,7,0,8,mixedType,1
4,2,0,6,mixedType,0
6,3,0,9,mixedType,1
14,2,0,16,mixedType,2
14,2,0,16,mixedType,2
6,1,0,7,mixedType,0
4,2,0,6,mixedType,0
6,3,0,9,mixedType,1
6,3,0,9,mixedType,1
9,2,0,11,mixedType,1
7,2,0,9,mixedType,1
4,4,0,8,mixedType,1
14,2,0,16,mixedType,2
3,6,0,9,mixedType,1
8,3,0,11,mixedType,1
6,1,0,7,mixedType,0
7,2,0,9,mixedType,1
8,3,0,11,mixedType,1
6,2,0,8,mixedType,1
6,2,0,8,mixedType,1
5,2,0,7,mixedType,0
2,7,0,9,mixedType,1
8,3,0,11,mixedType,1
5,6,0,11,mixedType,1
2,7,0,9,mixedType,1
7,2,0,9,mixedType,1
8,2,0,10,mixedType,1
8,1,0,9,mixedType,1
7,3,0,10,mixedType,1
6,1,0,7,mixedType,0
6,0,1,7,mixedType,0
5,2,0,7,mixedType,0
4,2,0,6,mixedType,0
4,4,0,8,mixedType,1
9,2,0,11,mixedType,1
8,1,0,9,mixedType,1
6,4,0,10,mixedType,1
9,1,0,10,mixedType,1
11,2,0,13,mixedType,1
6,3,0,9,mixedType,1
7,1,0,8,mixedType,1
7,4,0,11,mixedType,1
5,4,0,9,mixedType,1
6,4,0,10,mixedType,1
3,8,0,11,mixedType,1
7,2,0,9,mixedType,1
5,2,0,7,mixedType,0
4,5,0,9,mixedType,1
7,1,0,8,mixedType,1
5,2,0,7,mixedType,0
7,2,0,9,mixedType,1
9,2,0,11,mixedType,1
6,3,0,9,mixedType,1
6,2,0,8,mixedType,1
6,4,0,10,mixedType,1
2,6,0,8,mixedType,1
5,4,0,9,mixedType,1
12,1,0,13,mixedType,1
6,3,0,9,mixedType,1
7,3,0,10,mixedType,1
15,1,0,16,mixedType,2
5,1,0,6,mixedType,0
9,1,0,10,mixedType,1
0,9,1,10,mixedType,1
2,7,0,9,mixedType,1
8,1,0,9,mixedType,1
6,2,0,8,mixedType,1
6,4,0,10,mixedType,1
4,5,0,9,mixedType,1
6,3,0,9,mixedType,1
5,2,0,7,mixedType,0
5,2,0,7,mixedType,0
0,3,3,6,mixedType,0
6,3,0,9,mixedType,1
9,2,0,11,mixedType,1
14,6,0,20,mixedType,2
5,4,0,9,mixedType,1
7,2,0,9,mixedType,1
7,1,0,8,mixedType,1
1,7,0,8,mixedType,1
7,5,0,12,mixedType,1
5,2,0,7,mixedType,0
7,3,0,10,mixedType,1
5,2,0,7,mixedType,0
4,2,0,6,mixedType,0
8,1,0,9,mixedType,1
5,3,0,8,mixedType,1
5,2,0,7,mixedType,0
4,8,0,12,mixedType,1
8,2,0,10,mixedType,1
11,2,0,13,mixedType,1
4,4,0,8,mixedType,1
7,2,0,9,mixedType,1
6,3,0,9,mixedType,1
9,3,0,12,mixedType,1
2,6,0,8,mixedType,1
7,3,0,10,mixedType,1
7,3,0,10,mixedType,1
4,8,0,12,mixedType,1
9,1,0,10,mixedType,1
3,8,0,11,mixedType,1
11,3,0,14,mixedType,2
6,1,0,7,mixedType,0
10,2,0,12,mixedType,1
7,6,0,13,mixedType,1
6,3,0,9,mixedType,1
7,3,0,10,mixedType,1
9,1,0,10,mixedType,1
8,4,0,12,mixedType,1
3,6,0,9,mixedType,1
7,3,0,10,mixedType,1
5,2,0,7,mixedType,0
3,6,0,9,mixedType,1
8,2,0,10,mixedType,1
5,1,0,6,mixedType,0
8,2,0,10,mixedType,1
5,3,0,8,mixedType,1
15,1,0,16,mixedType,2
5,3,0,8,mixedType,1
8,4,0,12,mixedType,1
10,1,0,11,mixedType,1
4,4,0,8,mixedType,1
1,9,0,10,mixedType,1
2,6,0,8,mixedType,1
4,4,0,8,mixedType,1
6,3,0,9,mixedType,1
7,1,0,8,mixedType,1
8,1,0,9,mixedType,1
5,1,0,6,mixedType,0
8,4,0,12,mixedType,1
8,2,0,10,mixedType,1
8,4,0,12,mixedType,1
15,1,0,16,mixedType,2
10,2,0,12,mixedType,1
6,8,0,14,mixedType,2
8,2,0,10,mixedType,1
7,3,0,10,mixedType,1
4,5,0,9,mixedType,1
5,2,0,7,mixedType,0
4,4,0,8,mixedType,1
14,2,0,16,mixedType,2
2,8,0,10,mixedType,1
7,1,0,8,mixedType,1
5,6,0,11,mixedType,1
1,8,0,9,mixedType,1
6,3,0,9,mixedType,1
4,9,0,13,mixedType,1
5,4,0,9,mixedType,1
5,3,0,8,mixedType,1
6,4,0,10,mixedType,1
5,4,0,9,mixedType,1
9,2,0,11,mixedType,1
7,6,0,13,mixedType,1
2,4,0,6,mixedType,0
4,2,0,6,mixedType,0
6,2,0,8,mixedType,1
4,6,0,10,mixedType,1
9,3,0,12,mixedType,1
5,2,0,7,mixedType,0
7,2,0,9,mixedType,1
9,2,0,11,mixedType,1
7,1,0,8,mixedType,1
6,2,0,8,mixedType,1
6,5,0,11,mixedType,1
5,2,0,7,mixedType,0
7,6,0,13,mixedType,1
6,2,0,8,mixedType,1
7,3,0,10,mixedType,1
14,2,0,16,mixedType,2
1,7,0,8,mixedType,1
4,8,0,12,mixedType,1
3,3,0,6,mixedType,0
6,3,0,9,mixedType,1
5,1,0,6,mixedType,0
5,6,0,11,mixedType,1
2,6,0,8,mixedType,1
5,1,0,6,mixedType,0
6,3,0,9,mixedType,1
4,2,0,6,mixedType,0
13,3,0,16,mixedType,2
3,7,0,10,mixedType,1
6,1,0,7,mixedType,0
6,3,0,9,mixedType,1
7,2,0,9,mixedType,1
9,1,0,10,mixedType,1
5,1,0,6,mixedType,0
1,10,0,11,mixedType,1
6,1,0,7,mixedType,0
11,1,0,12,mixedType,1
6,3,0,9,mixedType,1
8,2,0,10,mixedType,1
7,3,0,10,mixedType,1
8,2,0,10,mixedType,1
8,2,0,10,mixedType,1
8,3,0,11,mixedType,1
2,8,0,10,mixedType,1
11,3,0,14,mixedType,2
5,3,0,8,mixedType,1
13,3,0,16,mixedType,2
7,2,0,9,mixedType,1
1,10,0,11,mixedType,1
6,3,0,9,mixedType,1
8,1,0,9,mixedType,1
7,3,0,10,mixedType,1
9,3,0,12,mixedType,1
9,2,0,11,mixedType,1
6,2,0,8,mixedType,1
9,1,0,10,mixedType,1
6,4,0,10,mixedType,1
7,3,0,10,mixedType,1
6,6,0,12,mixedType,1
13,3,0,16,mixedType,2
10,1,0,11,mixedType,1
6,3,0,9,mixedType,1
3,3,0,6,mixedType,0
4,4,0,8,mixedType,1
6,1,0,7,mixedType,0
5,3,0,8,mixedType,1
7,4,0,11,mixedType,1
3,8,0,11,mixedType,1
14,2,0,16,mixedType,2
8,3,0,11,mixedType,1
8,1,0,9,mixedType,1
7,2,0,9,mixedType,1
9,3,0,12,mixedType,1
11,5,0,16,mixedType,2
8,2,0,10,mixedType,1
7,3,0,10,mixedType,1
3,3,0,6,mixedType,0
5,6,0,11,mixedType,1
7,3,0,10,mixedType,1
5,1,0,6,mixedType,0
14,2,0,16,mixedType,2
13,3,0,16,mixedType,2
5,2,0,7,mixedType,0
8,1,0,9,mixedType,1
6,4,0,10,mixedType,1
14,2,0,16,mixedType,2
8,2,0,10,mixedType,1
6,4,0,10,mixedType,1
7,2,0,9,mixedType,1
6,3,0,9,mixedType,1
5,3,0,8,mixedType,1
6,4,0,10,mixedType,1
4,2,0,6,mixedType,0
7,2,0,9,mixedType,1
5,3,0,8,mixedType,1
2,6,0,8,mixedType,1
8,1,0,9,mixedType,1
4,2,0,6,mixedType,0
11,5,0,16,mixedType,2
6,4,0,10,mixedType,1
7,2,0,9,mixedType,1
4,4,0,8,mixedType,1
7,3,0,10,mixedType,1
6,3,0,9,mixedType,1
0,11,1,12,mixedType,1
3,7,0,10,mixedType,1
5,3,0,8,mixedType,1
7,2,0,9,mixedType,1
8,3,0,11,mixedType,1
7,3,0,10,mixedType,1
7,3,0,10,mixedType,1
3,3,0,6,mixedType,0
7,3,0,10,mixedType,1
5,3,0,8,mixedType,1
5,3,0,8,mixedType,1
14,0,1,15,mixedType,2
8,1,0,9,mixedType,1
13,3,0,16,mixedType,2
8,2,0,10,mixedType,1
8,4,0,12,mixedType,1
8,1,0,9,mixedType,1
9,2,0,11,mixedType,1
6,2,0,8,mixedType,1
7,3,0,10,mixedType,1
9,1,0,10,mixedType,1
7,3,0,10,mixedType,1
6,1,0,7,mixedType,0
1,8,0,9,mixedType,1
3,8,0,11,mixedType,1
8,2,0,10,mixedType,1
5,4,0,9,mixedType,1
6,4,0,10,mixedType,1
7,2,0,9,mixedType,1
2,7,0,9,mixedType,1
5,2,0,7,mixedType,0
13,3,0,16,mixedType,2
6,3,0,9,mixedType,1
6,4,0,10,mixedType,1
6,1,0,7,mixedType,0
9,1,0,10,mixedType,1
4,6,0,10,mixedType,1
6,3,0,9,mixedType,1
5,4,0,9,mixedType,1
5,5,0,10,mixedType,1
1,9,0,10,mixedType,1
6,4,0,10,mixedType,1
11,1,0,12,mixedType,1
8,2,0,10,mixedType,1
2,4,0,6,mixedType,0
7,3,0,10,mixedType,1
6,1,0,7,mixedType,0
6,1,0,7,mixedType,0
2,6,0,8,mixedType,1
6,4,0,10,mixedType,1
3,5,0,8,mixedType,1
5,6,0,11,mixedType,1
5,4,0,9,mixedType,1
6,6,0,12,mixedType,1
3,8,0,11,mixedType,1
10,1,0,11,mixedType,1
15,1,0,16,mixedType,2
1,8,0,9,mixedType,1
7,4,0,11,mixedType,1
8,1,0,9,mixedType,1
5,3,0,8,mixedType,1
8,3,0,11,mixedType,1
8,1,0,9,mixedType,1
11,1,3,15,mixedType,2
2,7,0,9,mixedType,1
7,1,0,8,mixedType,1
8,2,0,10,mixedType,1
6,6,0,12,mixedType,1
7,3,0,10,mixedType,1
3,10,0,13,mixedType,1
9,3,0,12,mixedType,1
8,2,0,10,mixedType,1
8,2,0,10,mixedType,1
4,2,0,6,mixedType,0
3,6,0,9,mixedType,1
3,6,0,9,mixedType,1
2,9,0,11,mixedType,1
5,4,0,9,mixedType,1
6,4,0,10,mixedType,1
6,6,0,12,mixedType,1
7,3,0,10,mixedType,1
6,4,0,10,mixedType,1
9,1,0,10,mixedType,1
5,8,0,13,mixedType,1
6,4,0,10,mixedType,1
8,1,0,9,mixedType,1
5,3,0,8,mixedType,1
8,4,0,12,mixedType,1
5,3,0,8,mixedType,1
4,6,0,10,mixedType,1
2,7,0,9,mixedType,1
6,6,0,12,mixedType,1
7,2,0,9,mixedType,1
8,5,0,13,mixedType,1
7,3,0,10,mixedType,1
8,3,0,11,mixedType,1
13,3,0,16,mixedType,2
8,2,0,10,mixedType,1
7,2,0,9,mixedType,1
8,3,0,11,mixedType,1
6,1,0,7,mixedType,0
6,1,0,7,mixedType,0
4,4,0,8,mixedType,1
6,1,0,7,mixedType,0
9,4,0,13,mixedType,1
5,3,0,8,mixedType,1
9,2,0,11,mixedType,1
7,2,0,9,mixedType,1
11,3,1,15,mixedType,2
7,3,0,10,mixedType,1
7,3,0,10,mixedType,1
7,3,0,10,mixedType,1
14,2,0,16,mixedType,2
6,3,0,9,mixedType,1
8,1,0,9,mixedType,1
5,4,0,9,mixedType,1
5,2,0,7,mixedType,0
5,8,0,13,mixedType,1
4,2,0,6,mixedType,0
8,1,0,9,mixedType,1
4,2,0,6,mixedType,0
7,4,0,11,mixedType,1
7,2,0,9,mixedType,1
4,2,0,6,mixedType,0
6,3,0,9,mixedType,1
12,4,0,16,mixedType,2
16,1,1,18,mixedType,2
13,3,0,16,mixedType,2
4,2,0,6,mixedType,0
6,4,0,10,mixedType,1
14,2,0,16,mixedType,2
6,2,0,8,mixedType,1
7,1,0,8,mixedType,1
8,4,0,12,mixedType,1
14,2,0,16,mixedType,2
5,2,0,7,mixedType,0
1,7,0,8,mixedType,1
6,2,0,8,mixedType,1
4,8,0,12,mixedType,1
6,2,0,8,mixedType,1
5,3,0,8,mixedType,1
9,1,0,10,mixedType,1
15,1,0,16,mixedType,2
4,6,0,10,mixedType,1
1,9,0,10,mixedType,1
7,3,0,10,mixedType,1
4,5,0,9,mixedType,1
4,2,0,6,mixedType,0
2,6,0,8,mixedType,1
6,4,0,10,mixedType,1
7,3,0,10,mixedType,1
1,8,0,9,mixedType,1
6,0,3,9,mixedType,1
7,4,0,11,mixedType,1
1,8,0,9,mixedType,1
10,2,0,12,mixedType,1
8,2,0,10,mixedType,1
1,7,0,8,mixedType,1
7,3,0,10,mixedType,1
9,4,0,13,mixedType,1
7,5,0,12,mixedType,1
8,2,0,10,mixedType,1
8,1,0,9,mixedType,1
7,3,0,10,mixedType,1
6,1,0,7,mixedType,0
8,1,0,9,mixedType,1
8,1,0,9,mixedType,1
6,2,0,8,mixedType,1
7,3,0,10,mixedType,1
6,1,0,7,mixedType,0
10,6,0,16,mixedType,2
13,3,0,16,mixedType,2
6,1,0,7,mixedType,0
5,2,0,7,mixedType,0
7,2,0,9,mixedType,1
7,4,0,11,mixedType,1
13,3,0,16,mixedType,2
15,1,0,16,mixedType,2
8,1,0,9,mixedType,1
3,10,0,13,mixedType,1
9,1,0,10,mixedType,1
2,7,0,9,mixedType,1
4,2,0,6,mixedType,0
7,3,0,10,mixedType,1
6,3,0,9,mixedType,1
8,2,0,10,mixedType,1
7,3,0,10,mixedType,1
4,4,0,8,mixedType,1
8,4,0,12,mixedType,1
9,2,0,11,mixedType,1
5,4,0,9,mixedType,1
4,5,0,9,mixedType,1
11,3,0,14,mixedType,2
6,3,0,9,mixedType,1
4,2,0,6,mixedType,0
6,3,0,9,mixedType,1
1,7,0,8,mixedType,1
8,6,0,14,mixedType,2
6,2,0,8,mixedType,1
0,6,2,8,mixedType,1
5,3,0,8,mixedType,1
7,2,0,9,mixedType,1
13,3,0,16,mixedType,2
6,3,0,9,mixedType,1
6,4,0,10,mixedType,1
9,2,0,11,mixedType,1
4,8,0,12,mixedType,1
7,3,0,10,mixedType,1
9,2,0,11,mixedType,1
11,2,0,13,mixedType,1
5,1,0,6,mixedType,0
5,2,0,7,mixedType,0
7,3,0,10,mixedType,1
5,3,0,8,mixedType,1
6,1,0,7,mixedType,0
7,3,0,10,mixedType,1
6,1,0,7,mixedType,0
8,3,0,11,mixedType,1
4,5,0,9,mixedType,1
4,5,0,9,mixedType,1
8,2,0,10,mixedType,1
5,2,0,7,mixedType,0
8,2,0,10,mixedType,1
5,3,0,8,mixedType,1
13,2,0,15,mixedType,2
12,0,1,13,mixedType,1
7,1,0,8,mixedType,1
8,1,0,9,mixedType,1
6,3,0,9,mixedType,1
9,2,0,11,mixedType,1
9,1,0,10,mixedType,1
8,5,1,14,mixedType,2
12,3,0,15,mixedType,2
1,9,0,10,mixedType,1
3,6,0,9,mixedType,1
13,3,0,16,mixedType,2
3,7,0,10,mixedType,1
20,2,3,25,mixedType,2
6,4,0,10,mixedType,1
15,1,0,16,mixedType,2
8,2,0,10,mixedType,1
3,5,0,8,mixedType,1
5,4,0,9,mixedType,1
6,5,0,11,mixedType,1
5,3,0,8,mixedType,1
6,2,0,8,mixedType,1
7,3,0,10,mixedType,1
7,2,0,9,mixedType,1
3,5,0,8,mixedType,1
7,3,0,10,mixedType,1
5,3,0,8,mixedType,1
11,2,0,13,mixedType,1
7,3,0,10,mixedType,1
4,4,0,8,mixedType,1
7,3,0,10,mixedType,1
6,4,0,10,mixedType,1
4,2,0,6,mixedType,0
6,3,0,9,mixedType,1
5,2,0,7,mixedType,0
7,3,0,10,mixedType,1
2,8,0,10,mixedType,1
7,3,0,10,mixedType,1
10,3,0,13,mixedType,1
6,4,0,10,mixedType,1
10,2,0,12,mixedType,1
14,2,0,16,mixedType,2
4,4,0,8,mixedType,1
7,3,0,10,mixedType,1
9,3,0,12,mixedType,1
11,5,0,16,mixedType,2
5,2,0,7,mixedType,0
7,3,0,10,mixedType,1
5,4,0,9,mixedType,1
6,1,0,7,mixedType,0
5,8,0,13,mixedType,1
6,4,0,10,mixedType,1
6,2,0,8,mixedType,1
2,4,0,6,mixedType,0
3,3,0,6,mixedType,0
7,3,0,10,mixedType,1
7,3,0,10,mixedType,1
8,1,0,9,mixedType,1
4,8,0,12,mixedType,1
5,3,0,8,mixedType,1
6,0,1,7,mixedType,0
8,3,0,11,mixedType,1
5,8,0,13,mixedType,1
2,8,0,10,mixedType,1
4,8,0,12,mixedType,1
5,2,0,7,mixedType,0
7,2,0,9,mixedType,1
6,1,0,7,mixedType,0
4,6,0,10,mixedType,1
6,7,0,13,mixedType,1
10,2,0,12,mixedType,1
5,1,0,6,mixedType,0
8,2,0,10,mixedType,1
9,1,0,10,mixedType,1
9,1,0,10,mixedType,1
5,4,0,9,mixedType,1
3,6,0,9,mixedType,1
13,3,0,16,mixedType,2
10,1,0,11,mixedType,1
8,3,0,11,mixedType,1
7,1,0,8,mixedType,1
7,2,0,9,mixedType,1
5,2,0,7,mixedType,0
9,1,0,10,mixedType,1
8,2,0,10,mixedType,1
4,4,0,8,mixedType,1
6,2,0,8,mixedType,1
4,2,0,6,mixedType,0
4,2,0,6,mixedType,0
11,3,0,14,mixedType,2
15,1,0,16,mixedType,2
5,1,0,6,mixedType,0
8,3,0,11,mixedType,1
6,4,0,10,mixedType,1
7,3,0,10,mixedType,1
5,6,0,11,mixedType,1
8,2,0,10,mixedType,1
6,1,0,7,mixedType,0
5,3,0,8,mixedType,1
3,7,0,10,mixedType,1
7,6,0,13,mixedType,1
8,4,0,12,mixedType,1
15,1,0,16,mixedType,2
13,3,0,16,mixedType,2
10,2,0,12,mixedType,1
7,1,0,8,mixedType,1
5,3,0,8,mixedType,1
11,3,0,14,mixedType,2
7,2,0,9,mixedType,1
9,4,1,14,mixedType,2
6,1,0,7,mixedType,0
8,1,0,9,mixedType,1
4,2,0,6,mixedType,0
10,3,0,13,mixedType,1
6,3,0,9,mixedType,1
12,1,0,13,mixedType,1
4,4,0,8,mixedType,1
14,2,0,16,mixedType,2
15,1,0,16,mixedType,2
8,2,0,10,mixedType,1
2,8,0,10,mixedType,1
14,2,0,16,mixedType,2
6,2,0,8,mixedType,1
7,1,0,8,mixedType,1
8,1,0,9,mixedType,1
4,4,0,8,mixedType,1
8,3,0,11,mixedType,1
14,2,0,16,mixedType,2
9,2,0,11,mixedType,1
14,2,0,16,mixedType,2
6,3,0,9,mixedType,1
8,1,0,9,mixedType,1
5,7,0,12,mixedType,1
1,8,0,9,mixedType,1
7,3,0,10,mixedType,1
9,0,1,10,mixedType,1
1,10,0,11,mixedType,1
8,1,0,9,mixedType,1
13,3,0,16,mixedType,2
5,4,0,9,mixedType,1
4,2,0,6,mixedType,0
2,4,0,6,mixedType,0
5,1,0,6,mixedType,0
3,3,0,6,mixedType,0
8,1,0,9,mixedType,1
8,2,0,10,mixedType,1
9,2,0,11,mixedType,1
7,3,0,10,mixedType,1
4,2,0,6,mixedType,0
7,2,0,9,mixedType,1
1,6,0,7,mixedType,0
2,8,0,10,mixedType,1
4,4,0,8,mixedType,1
5,3,0,8,mixedType,1
4,2,0,6,mixedType,0
8,3,0,11,mixedType,1
11,1,0,12,mixedType,1
6,3,0,9,mixedType,1
4,4,0,8,mixedType,1
6,2,0,8,mixedType,1
6,2,0,8,mixedType,1
6,3,0,9,mixedType,1
8,4,0,12,mixedType,1
13,3,0,16,mixedType,2
3,6,0,9,mixedType,1
1,9,0,10,mixedType,1
5,3,0,8,mixedType,1
9,2,0,11,mixedType,1
1,7,0,8,mixedType,1
15,1,0,16,mixedType,2
6,1,0,7,mixedType,0
8,2,0,10,mixedType,1
6,2,0,8,mixedType,1
4,4,0,8,mixedType,1
8,3,0,11,mixedType,1
4,2,0,6,mixedType,0
9,2,0,11,mixedType,1
4,2,0,6,mixedType,0
5,3,0,8,mixedType,1
15,1,0,16,mixedType,2
5,1,0,6,mixedType,0
7,2,0,9,mixedType,1
14,2,1,17,mixedType,2
11,5,0,16,mixedType,2
4,8,0,12,mixedType,1
14,2,0,16,mixedType,2
15,1,0,16,mixedType,2
2,8,0,10,mixedType,1
8,2,0,10,mixedType,1
6,3,0,9,mixedType,1
5,1,0,6,mixedType,0
6,4,0,10,mixedType,1
7,2,0,9,mixedType,1
2,8,0,10,mixedType,1
7,1,0,8,mixedType,1
9,3,0,12,mixedType,1
5,0,1,6,mixedType,0
13,3,0,16,mixedType,2
4,2,0,6,mixedType,0
4,4,0,8,mixedType,1
8,2,0,10,mixedType,1
1,9,0,10,mixedType,1
14,2,0,16,mixedType,2
5,3,0,8,mixedType,1
7,2,0,9,mixedType,1
8,1,0,9,mixedType,1
8,1,0,9,mixedType,1
7,2,0,9,mixedType,1
4,4,0,8,mixedType,1
7,1,0,8,mixedType,1
7,1,0,8,mixedType,1
6,4,0,10,mixedType,1
4,8,0,12,mixedType,1
7,2,0,9,mixedType,1
3,6,0,9,mixedType,1
7,1,0,8,mixedType,1
4,4,0,8,mixedType,1
8,2,0,10,mixedType,1
6,3,0,9,mixedType,1
6,4,0,10,mixedType,1
5,3,0,8,mixedType,1
5,2,0,7,mixedType,0
7,2,0,9,mixedType,1
5,5,0,10,mixedType,1
4,2,0,6,mixedType,0
3,6,0,9,mixedType,1
10,2,0,12,mixedType,1
1,7,0,8,mixedType,1
12,4,0,16,mixedType,2
5,6,0,11,mixedType,1
6,4,0,10,mixedType,1
7,3,0,10,mixedType,1
7,1,0,8,mixedType,1
4,4,0,8,mixedType,1
7,1,0,8,mixedType,1
6,3,0,9,mixedType,1
11,5,0,16,mixedType,2
8,1,0,9,mixedType,1
5,5,0,10,mixedType,1
9,2,0,11,mixedType,1
4,2,0,6,mixedType,0
3,3,0,6,mixedType,0
5,2,0,7,mixedType,0
11,5,0,16,mixedType,2
7,2,0,9,mixedType,1
8,2,0,10,mixedType,1
5,2,0,7,mixedType,0
9,1,0,10,mixedType,1
6,3,0,9,mixedType,1
5,8,0,13,mixedType,1
11,3,0,14,mixedType,2
7,4,0,11,mixedType,1
9,6,2,17,mixedType,2
6,1,0,7,mixedType,0
4,8,0,12,mixedType,1
4,6,0,10,mixedType,1
6,2,0,8,mixedType,1
4,4,0,8,mixedType,1
8,2,0,10,mixedType,1
10,2,0,12,mixedType,1
7,3,0,10,mixedType,1
6,3,0,9,mixedType,1
7,3,0,10,mixedType,1
7,5,0,12,mixedType,1
14,2,0,16,mixedType,2
6,1,0,7,mixedType,0
8,1,0,9,mixedType,1
8,3,0,11,mixedType,1
6,1,0,7,mixedType,0
5,2,0,7,mixedType,0
8,1,0,9,mixedType,1
5,3,0,8,mixedType,1
7,0,1,8,mixedType,1
8,2,0,10,mixedType,1
6,2,0,8,mixedType,1
5,3,0,8,mixedType,1
5,3,0,8,mixedType,1
6,3,0,9,mixedType,1
6,3,0,9,mixedType,1
3,3,0,6,mixedType,0
3,6,0,9,mixedType,1
6,2,0,8,mixedType,1
7,2,0,9,mixedType,1
9,4,0,13,mixedType,1
8,2,0,10,mixedType,1
2,8,0,10,mixedType,1
3,5,0,8,mixedType,1
5,2,0,7,mixedType,0
5,4,0,9,mixedType,1
7,3,0,10,mixedType,1
3,2,0,5,mixedType,0
6,3,0,9,mixedType,1
4,4,0,8,mixedType,1
4,5,0,9,mixedType,1
5,2,0,7,mixedType,0
15,1,0,16,mixedType,2
12,4,0,16,mixedType,2
2,6,0,8,mixedType,1
11,1,0,12,mixedType,1
14,2,0,16,mixedType,2
3,7,0,10,mixedType,1
2,8,0,10,mixedType,1
7,4,0,11,mixedType,1
9,2,0,11,mixedType,1
7,3,0,10,mixedType,1
4,2,0,6,mixedType,0
9,3,0,12,mixedType,1
6,1,0,7,mixedType,0
4,4,0,8,mixedType,1
6,4,0,10,mixedType,1
7,3,0,10,mixedType,1
10,2,0,12,mixedType,1
7,3,0,10,mixedType,1
9,4,0,13,mixedType,1
6,2,0,8,mixedType,1
8,2,0,10,mixedType,1
6,4,0,10,mixedType,1
11,1,0,12,mixedType,1
6,5,0,11,mixedType,1
3,6,0,9,mixedType,1
9,2,0,11,mixedType,1
0,5,0,5,sameType,0
2,6,0,8,mixedType,1
14,2,0,16,mixedType,2
8,1,0,9,mixedType,1
7,2,0,9,mixedType,1
6,3,0,9,mixedType,1
8,3,0,11,mixedType,1
2,4,0,6,mixedType,0
4,2,0,6,mixedType,0
3,7,0,10,mixedType,1
10,2,0,12,mixedType,1
12,4,0,16,mixedType,2
1,11,0,12,mixedType,1
8,2,0,10,mixedType,1
5,2,0,7,mixedType,0
2,6,0,8,mixedType,1
1,7,0,8,mixedType,1
4,2,0,6,mixedType,0
5,4,0,9,mixedType,1
8,6,0,14,mixedType,2
9,3,0,12,mixedType,1
7,2,0,9,mixedType,1
7,4,0,11,mixedType,1
7,2,0,9,mixedType,1
8,2,0,10,mixedType,1
13,3,0,16,mixedType,2
1,9,0,10,mixedType,1
3,6,0,9,mixedType,1
9,3,0,12,mixedType,1
6,1,0,7,mixedType,0
6,4,0,10,mixedType,1
6,4,0,10,mixedType,1
8,2,0,10,mixedType,1
3,3,0,6,mixedType,0
8,2,0,10,mixedType,1
5,9,0,14,mixedType,2
5,4,0,9,mixedType,1
4,4,0,8,mixedType,1
5,7,0,12,mixedType,1
13,3,0,16,mixedType,2
4,4,0,8,mixedType,1
7,4,0,11,mixedType,1
2,8,0,10,mixedType,1
7,2,0,9,mixedType,1
4,2,0,6,mixedType,0
7,3,0,10,mixedType,1
6,1,0,7,mixedType,0
14,2,0,16,mixedType,2
2,6,0,8,mixedType,1
5,4,0,9,mixedType,1
6,1,0,7,mixedType,0
7,3,0,10,mixedType,1
5,3,0,8,mixedType,1
9,3,0,12,mixedType,1
4,5,0,9,mixedType,1
9,2,0,11,mixedType,1
5,3,0,8,mixedType,1
10,2,0,12,mixedType,1
7,3,0,10,mixedType,1
4,2,0,6,mixedType,0
7,3,0,10,mixedType,1
5,4,0,9,mixedType,1
7,2,0,9,mixedType,1
7,3,0,10,mixedType,1
6,3,0,9,mixedType,1
7,2,0,9,mixedType,1
6,2,0,8,mixedType,1
10,3,0,13,mixedType,1
8,3,0,11,mixedType,1
4,2,0,6,mixedType,0
10,2,0,12,mixedType,1
5,4,0,9,mixedType,1
4,2,0,6,mixedType,0
5,3,0,8,mixedType,1
8,3,0,11,mixedType,1
5,5,0,10,mixedType,1
6,2,0,8,mixedType,1
6,1,0,7,mixedType,0
7,1,0,8,mixedType,1
7,1,0,8,mixedType,1
9,3,0,12,mixedType,1
13,3,0,16,mixedType,2
7,3,0,10,mixedType,1
6,3,0,9,mixedType,1
6,2,0,8,mixedType,1
4,2,0,6,mixedType,0
2,10,0,12,mixedType,1
15,1,0,16,mixedType,2
8,4,0,12,mixedType,1
7,2,0,9,mixedType,1
5,1,0,6,mixedType,0
12,3,0,15,mixedType,2
6,3,0,9,mixedType,1
3,10,0,13,mixedType,1
4,6,0,10,mixedType,1
8,5,0,13,mixedType,1
6,2,0,8,mixedType,1
5,3,0,8,mixedType,1
5,5,0,10,mixedType,1
6,3,0,9,mixedType,1
6,1,0,7,mixedType,0
7,1,0,8,mixedType,1
6,3,0,9,mixedType,1
14,2,0,16,mixedType,2
6,4,0,10,mixedType,1
7,1,0,8,mixedType,1
7,3,0,10,mixedType,1
6,3,0,9,mixedType,1
3,7,0,10,mixedType,1
6,1,0,7,mixedType,0
6,2,0,8,mixedType,1
7,3,0,10,mixedType,1
2,6,0,8,mixedType,1
7,3,0,10,mixedType,1
4,2,0,6,mixedType,0
7,3,0,10,mixedType,1
5,2,0,7,mixedType,0
5,3,0,8,mixedType,1
6,3,0,9,mixedType,1
7,4,0,11,mixedType,1
4,4,0,8,mixedType,1
3,3,0,6,mixedType,0
7,3,0,10,mixedType,1
5,6,0,11,mixedType,1
2,6,0,8,mixedType,1
15,1,0,16,mixedType,2
6,6,0,12,mixedType,1
7,3,0,10,mixedType,1
5,2,0,7,mixedType,0
10,1,0,11,mixedType,1
12,1,0,13,mixedType,1
11,1,0,12,mixedType,1
5,2,0,7,mixedType,0
1,9,0,10,mixedType,1
5,4,0,9,mixedType,1
14,2,0,16,mixedType,2
14,2,0,16,mixedType,2
6,3,0,9,mixedType,1
9,1,0,10,mixedType,1
9,1,0,10,mixedType,1
5,3,0,8,mixedType,1
10,1,0,11,mixedType,1
8,2,0,10,mixedType,1
5,3,0,8,mixedType,1
5,2,0,7,mixedType,0
1,8,0,9,mixedType,1
6,4,0,10,mixedType,1
3,5,0,8,mixedType,1
5,4,0,9,mixedType,1
6,2,0,8,mixedType,1
4,2,0,6,mixedType,0
6,3,0,9,mixedType,1
9,2,0,11,mixedType,1
7,1,0,8,mixedType,1
7,2,0,9,mixedType,1
7,2,0,9,mixedType,1
10,2,0,12,mixedType,1
6,2,0,8,mixedType,1
11,4,1,16,mixedType,2
5,2,0,7,mixedType,0
4,2,0,6,mixedType,0
4,6,0,10,mixedType,1
6,3,0,9,mixedType,1
11,3,0,14,mixedType,2
9,2,0,11,mixedType,1
6,4,0,10,mixedType,1
9,1,0,10,mixedType,1
6,3,0,9,mixedType,1
4,8,1,13,mixedType,1
6,3,0,9,mixedType,1
5,2,0,7,mixedType,0
10,4,0,14,mixedType,2
6,2,0,8,mixedType,1
9,1,0,10,mixedType,1
6,1,0,7,mixedType,0
6,2,0,8,mixedType,1
9,2,0,11,mixedType,1
8,1,0,9,mixedType,1
4,2,0,6,mixedType,0
15,1,0,16,mixedType,2
13,3,0,16,mixedType,2
4,4,0,8,mixedType,1
8,4,0,12,mixedType,1
14,2,0,16,mixedType,2
9,2,0,11,mixedType,1
7,2,0,9,mixedType,1
7,3,0,10,mixedType,1
7,3,0,10,mixedType,1
8,2,0,10,mixedType,1
7,2,0,9,mixedType,1
6,1,0,7,mixedType,0
6,2,0,8,mixedType,1
7,3,0,10,mixedType,1
2,4,0,6,mixedType,0
6,4,0,10,mixedType,1
8,2,0,10,mixedType,1
5,4,0,9,mixedType,1
3,5,0,8,mixedType,1
7,2,0,9,mixedType,1
13,4,0,17,mixedType,2
5,2,0,7,mixedType,0
15,1,0,16,mixedType,2
2,4,0,6,mixedType,0
5,1,0,6,mixedType,0
5,1,0,6,mixedType,0
7,2,0,9,mixedType,1
6,4,0,10,mixedType,1
7,2,0,9,mixedType,1
8,2,0,10,mixedType,1
6,3,0,9,mixedType,1
8,2,0,10,mixedType,1
6,2,0,8,mixedType,1
4,4,0,8,mixedType,1
8,2,0,10,mixedType,1
1,7,0,8,mixedType,1
4,2,0,6,mixedType,0
5,6,0,11,mixedType,1
9,3,0,12,mixedType,1
8,2,0,10,mixedType,1
5,2,0,7,mixedType,0
5,4,0,9,mixedType,1
6,4,0,10,mixedType,1
7,3,0,10,mixedType,1
6,7,0,13,mixedType,1
9,4,0,13,mixedType,1
12,4,0,16,mixedType,2
2,8,0,10,mixedType,1
9,1,0,10,mixedType,1
8,1,0,9,mixedType,1
5,2,0,7,mixedType,0
5,3,0,8,mixedType,1
5,2,0,7,mixedType,0
7,4,0,11,mixedType,1
6,2,0,8,mixedType,1
8,3,0,11,mixedType,1
7,2,0,9,mixedType,1
2,8,0,10,mixedType,1
14,2,0,16,mixedType,2
8,2,0,10,mixedType,1
8,2,0,10,mixedType,1
15,1,0,16,mixedType,2
8,2,0,10,mixedType,1
10,2,0,12,mixedType,1
6,2,0,8,mixedType,1
8,1,0,9,mixedType,1
5,1,0,6,mixedType,0
6,3,0,9,mixedType,1
3,5,0,8,mixedType,1
6,3,0,9,mixedType,1
7,3,0,10,mixedType,1
3,3,0,6,mixedType,0
4,4,0,8,mixedType,1
6,3,0,9,mixedType,1
7,2,0,9,mixedType,1
8,2,0,10,mixedType,1
4,6,0,10,mixedType,1
5,1,0,6,mixedType,0
11,5,0,16,mixedType,2
7,3,0,10,mixedType,1
9,2,0,11,mixedType,1
6,2,0,8,mixedType,1
9,1,0,10,mixedType,1
9,1,0,10,mixedType,1
6,3,0,9,mixedType,1
8,5,0,13,mixedType,1
2,6,0,8,mixedType,1
6,3,0,9,mixedType,1
7,2,0,9,mixedType,1
13,3,0,16,mixedType,2
8,3,0,11,mixedType,1
5,2,0,7,mixedType,0
6,3,0,9,mixedType,1
5,3,0,8,mixedType,1
7,3,0,10,mixedType,1
4,7,0,11,mixedType,1
4,5,0,9,mixedType,1
9,3,0,12,mixedType,1
11,4,0,15,mixedType,2
6,2,0,8,mixedType,1
2,4,0,6,mixedType,0
6,2,0,8,mixedType,1
13,3,0,16,mixedType,2
5,4,0,9,mixedType,1
10,4,0,14,mixedType,2
14,2,0,16,mixedType,2
4,2,0,6,mixedType,0
9,1,0,10,mixedType,1
6,3,0,9,mixedType,1
7,3,0,10,mixedType,1
5,2,0,7,mixedType,0
9,2,0,11,mixedType,1
15,1,0,16,mixedType,2
6,2,0,8,mixedType,1
6,2,0,8,mixedType,1
12,3,0,15,mixedType,2
7,2,0,9,mixedType,1
15,1,0,16,mixedType,2
8,1,0,9,mixedType,1
2,11,0,13,mixedType,1
6,4,0,10,mixedType,1
7,3,0,10,mixedType,1
5,2,0,7,mixedType,0
11,4,1,16,mixedType,2
6,4,0,10,mixedType,1
9,2,0,11,mixedType,1
8,2,0,10,mixedType,1
14,2,0,16,mixedType,2
7,3,0,10,mixedType,1
2,10,0,12,mixedType,1
14,2,0,16,mixedType,2
7,3,0,10,mixedType,1
7,3,0,10,mixedType,1
7,3,0,10,mixedType,1
5,2,0,7,mixedType,0
3,7,0,10,mixedType,1
11,1,0,12,mixedType,1
7,2,0,9,mixedType,1
3,5,0,8,mixedType,1
8,4,0,12,mixedType,1
7,2,0,9,mixedType,1
3,7,0,10,mixedType,1
13,3,0,16,mixedType,2
6,4,0,10,mixedType,1
6,4,0,10,mixedType,1
6,3,0,9,mixedType,1
8,3,0,11,mixedType,1
8,5,0,13,mixedType,1
2,6,0,8,mixedType,1
8,2,0,10,mixedType,1
3,3,0,6,mixedType,0
10,5,0,15,mixedType,2
4,4,0,8,mixedType,1
8,2,0,10,mixedType,1
5,4,0,9,mixedType,1
3,6,0,9,mixedType,1
9,2,0,11,mixedType,1
8,0,2,10,mixedType,1
7,1,0,8,mixedType,1
6,2,0,8,mixedType,1
7,3,0,10,mixedType,1
7,1,0,8,mixedType,1
3,6,0,9,mixedType,1
8,1,0,9,mixedType,1
8,1,0,9,mixedType,1
5,1,0,6,mixedType,0
5,3,0,8,mixedType,1
6,1,0,7,mixedType,0
6,1,0,7,mixedType,0
5,6,0,11,mixedType,1
13,3,0,16,mixedType,2
1,9,0,10,mixedType,1
7,2,0,9,mixedType,1
7,2,0,9,mixedType,1
8,1,0,9,mixedType,1
4,6,0,10,mixedType,1
5,4,0,9,mixedType,1
7,7,0,14,mixedType,2
14,2,0,16,mixedType,2
6,1,0,7,mixedType,0
6,1,0,7,mixedType,0
6,1,0,7,mixedType,0
11,2,0,13,mixedType,1
6,4,0,10,mixedType,1
5,5,0,10,mixedType,1
3,6,0,9,mixedType,1
7,4,0,11,mixedType,1
8,1,0,9,mixedType,1
12,4,0,16,mixedType,2
3,8,0,11,mixedType,1
5,3,0,8,mixedType,1
5,3,0,8,mixedType,1
6,3,0,9,mixedType,1
5,3,0,8,mixedType,1
5,1,0,6,mixedType,0
9,1,0,10,mixedType,1
7,3,0,10,mixedType,1
1,8,0,9,mixedType,1
6,4,0,10,mixedType,1
7,1,0,8,mixedType,1
15,1,0,16,mixedType,2
7,2,0,9,mixedType,1
14,2,0,16,mixedType,2
4,4,0,8,mixedType,1
9,1,0,10,mixedType,1
6,2,0,8,mixedType,1
7,3,0,10,mixedType,1
2,6,0,8,mixedType,1
15,1,1,17,mixedType,2
6,1,0,7,mixedType,0
6,3,0,9,mixedType,1
6,1,0,7,mixedType,0
7,2,0,9,mixedType,1
5,2,0,7,mixedType,0
8,3,0,11,mixedType,1
3,6,0,9,mixedType,1
6,3,0,9,mixedType,1
10,1,0,11,mixedType,1
5,2,0,7,mixedType,0
2,11,0,13,mixedType,1
6,3,0,9,mixedType,1
7,3,0,10,mixedType,1
3,5,0,8,mixedType,1
8,1,0,9,mixedType,1
5,3,0,8,mixedType,1
5,1,0,6,mixedType,0
4,2,0,6,mixedType,0
5,3,0,8,mixedType,1
9,1,0,10,mixedType,1
9,0,1,10,mixedType,1
9,2,0,11,mixedType,1
6,2,0,8,mixedType,1
9,2,0,11,mixedType,1
6,4,0,10,mixedType,1
1,8,0,9,mixedType,1
8,2,0,10,mixedType,1
7,4,0,11,mixedType,1
14,2,0,16,mixedType,2
4,5,0,9,mixedType,1
6,4,0,10,mixedType,1
5,3,0,8,mixedType,1
5,4,0,9,mixedType,1
7,3,0,10,mixedType,1
8,1,0,9,mixedType,1
4,4,0,8,mixedType,1
6,1,0,7,mixedType,0
8,3,0,11,mixedType,1
8,2,0,10,mixedType,1
7,3,0,10,mixedType,1
2,9,0,11,mixedType,1
5,2,0,7,mixedType,0
6,1,0,7,mixedType,0
6,2,0,8,mixedType,1
8,2,0,10,mixedType,1
2,6,0,8,mixedType,1
4,6,0,10,mixedType,1
7,2,0,9,mixedType,1
3,8,0,11,mixedType,1
2,5,0,7,mixedType,0
14,1,0,15,mixedType,2
6,3,0,9,mixedType,1
7,1,0,8,mixedType,1
15,1,0,16,mixedType,2
8,3,0,11,mixedType,1
9,0,1,10,mixedType,1
15,1,0,16,mixedType,2
3,7,0,10,mixedType,1
6,1,0,7,mixedType,0
2,8,0,10,mixedType,1
6,5,0,11,mixedType,1
6,6,0,12,mixedType,1
11,1,0,12,mixedType,1
3,6,0,9,mixedType,1
9,2,0,11,mixedType,1
8,1,0,9,mixedType,1
7,3,0,10,mixedType,1
3,7,0,10,mixedType,1
3,7,0,10,mixedType,1
5,3,0,8,mixedType,1
7,1,0,8,mixedType,1
6,3,0,9,mixedType,1
6,3,0,9,mixedType,1
5,3,0,8,mixedType,1
7,4,0,11,mixedType,1
11,2,0,13,mixedType,1
5,4,0,9,mixedType,1
6,2,0,8,mixedType,1
7,3,0,10,mixedType,1
3,9,0,12,mixedType,1
15,1,0,16,mixedType,2
6,1,0,7,mixedType,0
2,6,0,8,mixedType,1
2,6,0,8,mixedType,1
2,8,0,10,mixedType,1
1,8,0,9,mixedType,1
8,2,0,10,mixedType,1
5,4,0,9,mixedType,1
5,2,0,7,mixedType,0
8,1,0,9,mixedType,1
13,3,0,16,mixedType,2
6,2,0,8,mixedType,1
6,3,0,9,mixedType,1
6,1,0,7,mixedType,0
6,3,0,9,mixedType,1
6,3,0,9,mixedType,1
4,4,0,8,mixedType,1
10,3,0,13,mixedType,1
7,1,0,8,mixedType,1
11,3,0,14,mixedType,2
8,5,1,14,mixedType,2
7,5,0,12,mixedType,1
9,1,0,10,mixedType,1
9,3,0,12,mixedType,1
4,4,0,8,mixedType,1
5,1,0,6,mixedType,0
6,1,0,7,mixedType,0
6,1,0,7,mixedType,0
9,1,0,10,mixedType,1
4,4,0,8,mixedType,1
2,6,0,8,mixedType,1
14,2,0,16,mixedType,2
5,1,0,6,mixedType,0
5,4,0,9,mixedType,1
5,7,0,12,mixedType,1
5,2,0,7,mixedType,0
11,1,0,12,mixedType,1
3,8,0,11,mixedType,1
2,6,0,8,mixedType,1
5,2,0,7,mixedType,0
7,2,0,9,mixedType,1
12,4,0,16,mixedType,2
9,2,0,11,mixedType,1
7,1,0,8,mixedType,1
7,3,0,10,mixedType,1
9,3,0,12,mixedType,1
5,3,0,8,mixedType,1
8,2,0,10,mixedType,1
7,3,0,10,mixedType,1
7,3,0,10,mixedType,1
6,0,1,7,mixedType,0
5,5,0,10,mixedType,1
7,2,0,9,mixedType,1
15,1,0,16,mixedType,2
7,3,0,10,mixedType,1
7,3,0,10,mixedType,1
6,3,0,9,mixedType,1
4,2,0,6,mixedType,0
4,6,0,10,mixedType,1
7,1,0,8,mixedType,1
5,1,0,6,mixedType,0
7,2,0,9,mixedType,1
14,2,0,16,mixedType,2
4,7,0,11,mixedType,1
13,3,0,16,mixedType,2
6,4,0,10,mixedType,1
5,4,0,9,mixedType,1
4,4,0,8,mixedType,1
9,2,0,11,mixedType,1
15,1,0,16,mixedType,2
7,2,0,9,mixedType,1
11,5,0,16,mixedType,2
6,4,0,10,mixedType,1
8,1,0,9,mixedType,1
15,1,0,16,mixedType,2
7,3,0,10,mixedType,1
5,4,0,9,mixedType,1
6,2,0,8,mixedType,1
7,3,0,10,mixedType,1
4,2,0,6,mixedType,0
5,3,0,8,mixedType,1
6,2,0,8,mixedType,1
5,6,0,11,mixedType,1
14,2,0,16,mixedType,2
9,1,0,10,mixedType,1
9,2,0,11,mixedType,1
11,3,0,14,mixedType,2
1,10,0,11,mixedType,1
9,1,0,10,mixedType,1
6,4,0,10,mixedType,1
6,4,0,10,mixedType,1
1,8,0,9,mixedType,1
10,1,0,11,mixedType,1
9,1,0,10,mixedType,1
7,2,0,9,mixedType,1
4,2,0,6,mixedType,0
13,3,0,16,mixedType,2
8,1,0,9,mixedType,1
6,3,0,9,mixedType,1
6,1,0,7,mixedType,0
4,4,0,8,mixedType,1
6,4,0,10,mixedType,1
5,3,0,8,mixedType,1
15,1,0,16,mixedType,2
5,3,0,8,mixedType,1
5,3,0,8,mixedType,1
8,1,0,9,mixedType,1
5,5,0,10,mixedType,1
7,3,0,10,mixedType,1
5,4,0,9,mixedType,1
6,3,0,9,mixedType,1
1,7,0,8,mixedType,1
12,4,0,16,mixedType,2
15,1,0,16,mixedType,2
18,1,1,20,mixedType,2
4,6,0,10,mixedType,1
8,1,0,9,mixedType,1
3,7,0,10,mixedType,1
6,3,0,9,mixedType,1
5,3,0,8,mixedType,1
6,3,0,9,mixedType,1
8,4,0,12,mixedType,1
3,6,0,9,mixedType,1
7,3,0,10,mixedType,1
4,4,0,8,mixedType,1
14,1,0,15,mixedType,2
6,2,0,8,mixedType,1
5,1,0,6,mixedType,0
7,3,0,10,mixedType,1
10,2,0,12,mixedType,1
4,2,0,6,mixedType,0
7,4,0,11,mixedType,1
2,7,0,9,mixedType,1
14,2,0,16,mixedType,2
9,3,0,12,mixedType,1
3,3,0,6,mixedType,0
4,4,0,8,mixedType,1
10,1,0,11,mixedType,1
4,2,0,6,mixedType,0
7,3,0,10,mixedType,1
5,4,0,9,mixedType,1
4,2,0,6,mixedType,0
1,8,0,9,mixedType,1
7,1,0,8,mixedType,1
6,3,0,9,mixedType,1
5,3,0,8,mixedType,1
7,2,0,9,mixedType,1
9,1,0,10,mixedType,1
5,2,0,7,mixedType,0
6,2,0,8,mixedType,1
7,3,0,10,mixedType,1
14,2,0,16,mixedType,2
9,3,0,12,mixedType,1
8,2,0,10,mixedType,1
0,6,0,6,sameType,0
9,3,0,12,mixedType,1
5,5,0,10,mixedType,1
4,2,0,6,mixedType,0
4,2,0,6,mixedType,0
3,8,0,11,mixedType,1
6,7,0,13,mixedType,1
5,5,0,10,mixedType,1
12,4,0,16,mixedType,2
1,7,0,8,mixedType,1
5,2,0,7,mixedType,0
5,1,0,6,mixedType,0
8,1,0,9,mixedType,1
3,7,0,10,mixedType,1
9,3,0,12,mixedType,1
7,3,0,10,mixedType,1
8,1,0,9,mixedType,1
5,4,0,9,mixedType,1
2,8,0,10,mixedType,1
6,3,0,9,mixedType,1
5,3,0,8,mixedType,1
3,8,0,11,mixedType,1
12,3,0,15,mixedType,2
6,3,0,9,mixedType,1
12,4,0,16,mixedType,2
10,3,0,13,mixedType,1
7,2,0,9,mixedType,1
5,2,0,7,mixedType,0
7,2,0,9,mixedType,1
6,4,0,10,mixedType,1
4,2,0,6,mixedType,0
4,4,0,8,mixedType,1
7,3,0,10,mixedType,1
5,3,0,8,mixedType,1
1,8,0,9,mixedType,1
5,3,0,8,mixedType,1
6,3,0,9,mixedType,1
6,3,0,9,mixedType,1
1,7,0,8,mixedType,1
4,4,0,8,mixedType,1
5,2,0,7,mixedType,0
4,6,0,10,mixedType,1
6,3,0,9,mixedType,1
11,5,0,16,mixedType,2
5,2,0,7,mixedType,0
4,2,0,6,mixedType,0
6,3,0,9,mixedType,1
6,3,0,9,mixedType,1
5,4,0,9,mixedType,1
13,1,1,15,mixedType,2
8,1,0,9,mixedType,1
4,8,0,12,mixedType,1
8,3,0,11,mixedType,1
5,2,0,7,mixedType,0
7,1,0,8,mixedType,1
7,2,0,9,mixedType,1
9,2,0,11,mixedType,1
7,3,0,10,mixedType,1
7,3,0,10,mixedType,1
5,3,0,8,mixedType,1
12,3,0,15,mixedType,2
8,1,0,9,mixedType,1
5,4,0,9,mixedType,1
15,1,0,16,mixedType,2
6,4,0,10,mixedType,1
14,2,0,16,mixedType,2
4,2,0,6,mixedType,0
9,4,0,13,mixedType,1
5,2,0,7,mixedType,0
7,1,0,8,mixedType,1
3,5,0,8,mixedType,1
6,3,0,9,mixedType,1
1,11,0,12,mixedType,1
4,2,0,6,mixedType,0
10,2,0,12,mixedType,1
7,3,0,10,mixedType,1
9,5,0,14,mixedType,2
8,3,0,11,mixedType,1
6,5,0,11,mixedType,1
8,2,0,10,mixedType,1
4,4,0,8,mixedType,1
5,3,0,8,mixedType,1
13,3,0,16,mixedType,2
6,1,0,7,mixedType,0
8,1,0,9,mixedType,1
9,1,0,10,mixedType,1
4,5,0,9,mixedType,1
4,2,0,6,mixedType,0
6,2,0,8,mixedType,1
5,1,0,6,mixedType,0
9,2,0,11,mixedType,1
2,6,0,8,mixedType,1
6,3,0,9,mixedType,1
7,3,0,10,mixedType,1
14,2,0,16,mixedType,2
4,2,0,6,mixedType,0
7,1,0,8,mixedType,1
6,6,0,12,mixedType,1
5,3,0,8,mixedType,1
3,5,0,8,mixedType,1
6,3,0,9,mixedType,1
9,4,1,14,mixedType,2
12,1,0,13,mixedType,1
8,2,0,10,mixedType,1
9,2,0,11,mixedType,1
6,2,0,8,mixedType,1
7,3,0,10,mixedType,1
12,4,0,16,mixedType,2
8,1,0,9,mixedType,1
6,2,0,8,mixedType,1
5,2,0,7,mixedType,0
2,6,0,8,mixedType,1
11,3,0,14,mixedType,2
5,4,0,9,mixedType,1
6,1,0,7,mixedType,0
5,4,0,9,mixedType,1
5,1,0,6,mixedType,0
5,4,0,9,mixedType,1
9,2,0,11,mixedType,1
2,8,0,10,mixedType,1
13,3,0,16,mixedType,2
6,3,0,9,mixedType,1
2,8,0,10,mixedType,1
1,7,0,8,mixedType,1
8,2,0,10,mixedType,1
5,5,0,10,mixedType,1
2,8,0,10,mixedType,1
8,2,0,10,mixedType,1
7,4,0,11,mixedType,1
1,8,0,9,mixedType,1
5,3,0,8,mixedType,1
7,3,0,10,mixedType,1
5,7,0,12,mixedType,1
2,11,0,13,mixedType,1
8,1,0,9,mixedType,1
5,1,0,6,mixedType,0
4,6,0,10,mixedType,1
7,2,0,9,mixedType,1
7,3,0,10,mixedType,1
4,2,0,6,mixedType,0
2,4,0,6,mixedType,0
14,2,0,16,mixedType,2
7,2,0,9,mixedType,1
5,4,0,9,mixedType,1
9,2,0,11,mixedType,1
8,6,1,15,mixedType,2
4,6,0,10,mixedType,1
14,2,0,16,mixedType,2
8,1,0,9,mixedType,1
6,4,0,10,mixedType,1
1,7,0,8,mixedType,1
5,2,0,7,mixedType,0
6,3,0,9,mixedType,1
3,6,0,9,mixedType,1
6,3,0,9,mixedType,1
4,6,0,10,mixedType,1
8,2,0,10,mixedType,1
2,6,0,8,mixedType,1
6,2,0,8,mixedType,1
6,2,0,8,mixedType,1
4,4,0,8,mixedType,1
13,3,0,16,mixedType,2
8,1,0,9,mixedType,1
6,4,0,10,mixedType,1
8,1,0,9,mixedType,1
12,3,0,15,mixedType,2
5,2,0,7,mixedType,0
1,9,0,10,mixedType,1
1,8,0,9,mixedType,1
7,4,0,11,mixedType,1
7,1,0,8,mixedType,1
14,2,0,16,mixedType,2
8,2,0,10,mixedType,1
6,3,0,9,mixedType,1
4,5,0,9,mixedType,1
4,6,0,10,mixedType,1
14,2,0,16,mixedType,2
3,10,0,13,mixedType,1
10,2,0,12,mixedType,1
4,2,0,6,mixedType,0
8,2,0,10,mixedType,1
2,6,0,8,mixedType,1
8,3,0,11,mixedType,1
10,1,0,11,mixedType,1
5,1,0,6,mixedType,0
6,2,0,8,mixedType,1
4,2,0,6,mixedType,0
8,3,0,11,mixedType,1
6,1,0,7,mixedType,0
12,1,1,14,mixedType,2
3,5,0,8,mixedType,1
12,1,0,13,mixedType,1
6,2,0,8,mixedType,1
9,1,0,10,mixedType,1
8,2,0,10,mixedType,1
7,1,0,8,mixedType,1
13,3,0,16,mixedType,2
9,1,0,10,mixedType,1
6,3,0,9,mixedType,1
10,1,0,11,mixedType,1
8,2,0,10,mixedType,1
8,2,0,10,mixedType,1
15,1,0,16,mixedType,2
7,3,0,10,mixedType,1
2,4,0,6,mixedType,0
5,3,0,8,mixedType,1
5,2,0,7,mixedType,0
7,3,0,10,mixedType,1
7,3,0,10,mixedType,1
6,3,0,9,mixedType,1
7,2,0,9,mixedType,1
9,1,0,10,mixedType,1
14,2,0,16,mixedType,2
6,4,0,10,mixedType,1
8,2,0,10,mixedType,1
6,2,0,8,mixedType,1
13,3,0,16,mixedType,2
6,2,0,8,mixedType,1
8,4,0,12,mixedType,1
5,3,0,8,mixedType,1
2,4,0,6,mixedType,0
6,4,0,10,mixedType,1
15,1,0,16,mixedType,2
5,3,0,8,mixedType,1
6,2,0,8,mixedType,1
10,3,0,13,mixedType,1
6,1,0,7,mixedType,0
7,2,0,9,mixedType,1
7,3,0,10,mixedType,1
7,6,0,13,mixedType,1
4,4,0,8,mixedType,1
4,4,0,8,mixedType,1
15,1,0,16,mixedType,2
5,4,0,9,mixedType,1
7,3,0,10,mixedType,1
5,2,0,7,mixedType,0
7,3,0,10,mixedType,1
4,4,0,8,mixedType,1
12,4,0,16,mixedType,2
6,3,0,9,mixedType,1
6,2,0,8,mixedType,1
11,3,0,14,mixedType,2
6,3,0,9,mixedType,1
6,6,0,12,mixedType,1
7,3,0,10,mixedType,1
5,2,0,7,mixedType,0
4,2,0,6,mixedType,0
6,3,0,9,mixedType,1
5,3,0,8,mixedType,1
5,3,0,8,mixedType,1
5,4,0,9,mixedType,1
4,4,0,8,mixedType,1
4,2,0,6,mixedType,0
9,1,0,10,mixedType,1
14,2,0,16,mixedType,2
5,1,0,6,mixedType,0
6,4,0,10,mixedType,1
7,2,0,9,mixedType,1
5,4,0,9,mixedType,1
11,0,1,12,mixedType,1
6,2,0,8,mixedType,1
13,3,0,16,mixedType,2
7,2,0,9,mixedType,1
5,4,0,9,mixedType,1
8,3,0,11,mixedType,1
1,11,0,12,mixedType,1
4,6,0,10,mixedType,1
9,4,0,13,mixedType,1
8,1,0,9,mixedType,1
6,4,0,10,mixedType,1
15,1,0,16,mixedType,2
6,4,0,10,mixedType,1
2,6,0,8,mixedType,1
10,4,0,14,mixedType,2
5,3,0,8,mixedType,1
9,0,2,11,mixedType,1
5,2,0,7,mixedType,0
6,1,0,7,mixedType,0
10,3,0,13,mixedType,1
6,1,0,7,mixedType,0
3,8,0,11,mixedType,1
6,2,0,8,mixedType,1
1,9,0,10,mixedType,1
6,2,0,8,mixedType,1
4,2,0,6,mixedType,0
7,3,0,10,mixedType,1
15,1,0,16,mixedType,2
6,2,0,8,mixedType,1
6,2,0,8,mixedType,1
4,2,0,6,mixedType,0
7,3,0,10,mixedType,1
4,2,0,6,mixedType,0
5,3,0,8,mixedType,1
6,1,0,7,mixedType,0
6,3,0,9,mixedType,1
8,2,0,10,mixedType,1
6,4,0,10,mixedType,1
6,1,0,7,mixedType,0
1,7,0,8,mixedType,1
5,2,0,7,mixedType,0
8,1,0,9,mixedType,1
2,4,0,6,mixedType,0
7,1,0,8,mixedType,1
6,2,0,8,mixedType,1
9,8,1,18,mixedType,2
8,1,0,9,mixedType,1
7,2,0,9,mixedType,1
9,1,0,10,mixedType,1
8,1,0,9,mixedType,1
1,7,0,8,mixedType,1
8,3,0,11,mixedType,1
8,2,0,10,mixedType,1
14,2,0,16,mixedType,2
3,3,0,6,mixedType,0
9,3,0,12,mixedType,1
6,2,0,8,mixedType,1
1,8,0,9,mixedType,1
6,3,0,9,mixedType,1
1,11,0,12,mixedType,1
10,6,0,16,mixedType,2
5,2,0,7,mixedType,0
4,4,0,8,mixedType,1
4,7,0,11,mixedType,1
3,5,0,8,mixedType,1
5,1,0,6,mixedType,0
4,2,0,6,mixedType,0
7,3,0,10,mixedType,1
5,2,0,7,mixedType,0
0,8,1,9,mixedType,1
11,4,0,15,mixedType,2
7,1,0,8,mixedType,1
4,2,0,6,mixedType,0
7,3,0,10,mixedType,1
4,4,0,8,mixedType,1
11,3,0,14,mixedType,2
4,6,0,10,mixedType,1
6,3,0,9,mixedType,1
2,6,0,8,mixedType,1
8,2,0,10,mixedType,1
5,3,0,8,mixedType,1
6,3,0,9,mixedType,1
5,4,0,9,mixedType,1
5,2,0,7,mixedType,0
8,3,0,11,mixedType,1
6,2,0,8,mixedType,1
2,4,0,6,mixedType,0
15,1,0,16,mixedType,2
7,1,0,8,mixedType,1
5,3,0,8,mixedType,1
6,3,0,9,mixedType,1
5,3,0,8,mixedType,1
6,4,0,10,mixedType,1
5,3,0,8,mixedType,1
7,2,0,9,mixedType,1
4,4,0,8,mixedType,1
6,4,0,10,mixedType,1
6,3,0,9,mixedType,1
6,3,0,9,mixedType,1
6,2,0,8,mixedType,1
14,2,0,16,mixedType,2
5,6,0,11,mixedType,1
9,2,0,11,mixedType,1
7,3,0,10,mixedType,1
3,5,0,8,mixedType,1
6,3,0,9,mixedType,1
9,3,0,12,mixedType,1
14,2,0,16,mixedType,2
8,2,0,10,mixedType,1
8,1,0,9,mixedType,1
7,3,0,10,mixedType,1
6,3,0,9,mixedType,1
8,4,0,12,mixedType,1
3,6,0,9,mixedType,1
8,5,0,13,mixedType,1
8,1,0,9,mixedType,1
6,3,0,9,mixedType,1
5,3,0,8,mixedType,1
1,7,0,8,mixedType,1
8,4,0,12,mixedType,1
4,2,0,6,mixedType,0
6,2,0,8,mixedType,1
4,4,0,8,mixedType,1
7,3,0,10,mixedType,1
13,3,0,16,mixedType,2
7,6,0,13,mixedType,1
7,2,0,9,mixedType,1
3,9,0,12,mixedType,1
5,5,0,10,mixedType,1
3,3,0,6,mixedType,0
6,4,0,10,mixedType,1
5,7,0,12,mixedType,1
9,2,0,11,mixedType,1
6,3,0,9,mixedType,1
6,4,0,10,mixedType,1
4,2,0,6,mixedType,0
9,3,0,12,mixedType,1
7,3,0,10,mixedType,1
4,6,0,10,mixedType,1
5,8,0,13,mixedType,1
9,1,0,10,mixedType,1
5,3,0,8,mixedType,1
9,3,0,12,mixedType,1
8,4,0,12,mixedType,1
6,3,0,9,mixedType,1
3,7,0,10,mixedType,1
5,4,0,9,mixedType,1
9,2,0,11,mixedType,1
7,3,0,10,mixedType,1
11,4,0,15,mixedType,2
4,4,0,8,mixedType,1
7,2,0,9,mixedType,1
6,3,0,9,mixedType,1
6,1,0,7,mixedType,0
11,3,0,14,mixedType,2
9,1,0,10,mixedType,1
7,3,0,10,mixedType,1
6,3,0,9,mixedType,1
2,6,0,8,mixedType,1
6,4,0,10,mixedType,1
3,3,0,6,mixedType,0
7,4,0,11,mixedType,1
3,6,0,9,mixedType,1
8,1,0,9,mixedType,1
1,10,0,11,mixedType,1
8,4,0,12,mixedType,1
14,2,0,16,mixedType,2
6,3,0,9,mixedType,1
10,1,0,11,mixedType,1
7,3,0,10,mixedType,1
8,3,0,11,mixedType,1
4,4,0,8,mixedType,1
3,8,0,11,mixedType,1
7,4,0,11,mixedType,1
14,2,0,16,mixedType,2
3,5,0,8,mixedType,1
4,8,0,12,mixedType,1
10,3,0,13,mixedType,1
8,2,0,10,mixedType,1
5,4,0,9,mixedType,1
2,6,0,8,mixedType,1
6,3,0,9,mixedType,1
6,3,0,9,mixedType,1
5,3,0,8,mixedType,1
7,2,0,9,mixedType,1
6,2,0,8,mixedType,1
5,3,0,8,mixedType,1
4,6,0,10,mixedType,1
9,1,0,10,mixedType,1
11,5,0,16,mixedType,2
6,4,0,10,mixedType,1
2,6,0,8,mixedType,1
9,0,1,10,mixedType,1
6,1,0,7,mixedType,0
2,6,0,8,mixedType,1
2,6,0,8,mixedType,1
2,6,0,8,mixedType,1
2,6,0,8,mixedType,1
8,3,0,11,mixedType,1
6,3,0,9,mixedType,1
2,6,0,8,mixedType,1
10,6,0,16,mixedType,2
9,3,0,12,mixedType,1
6,5,0,11,mixedType,1
7,2,0,9,mixedType,1
7,5,0,12,mixedType,1
1,10,0,11,mixedType,1
7,1,0,8,mixedType,1
0,9,1,10,mixedType,1
1,9,0,10,mixedType,1
6,4,0,10,mixedType,1
6,6,0,12,mixedType,1
4,2,0,6,mixedType,0
4,4,0,8,mixedType,1
12,4,0,16,mixedType,2
12,3,0,15,mixedType,2
1,7,0,8,mixedType,1
8,2,0,10,mixedType,1
6,2,0,8,mixedType,1
14,2,0,16,mixedType,2
8,2,0,10,mixedType,1
14,2,0,16,mixedType,2
6,3,0,9,mixedType,1
6,4,0,10,mixedType,1
5,3,0,8,mixedType,1
7,2,0,9,mixedType,1
7,2,0,9,mixedType,1
6,2,0,8,mixedType,1
9,2,0,11,mixedType,1
5,0,1,6,mixedType,0
7,3,0,10,mixedType,1
6,3,0,9,mixedType,1
6,4,0,10,mixedType,1
6,3,0,9,mixedType,1
5,3,0,8,mixedType,1
7,3,0,10,mixedType,1
8,2,0,10,mixedType,1
6,3,0,9,mixedType,1
3,6,0,9,mixedType,1
15,1,0,16,mixedType,2
4,4,0,8,mixedType,1
6,3,0,9,mixedType,1
12,4,0,16,mixedType,2
5,4,0,9,mixedType,1
1,9,0,10,mixedType,1
2,7,0,9,mixedType,1
5,3,0,8,mixedType,1
4,2,0,6,mixedType,0
8,3,0,11,mixedType,1
7,6,0,13,mixedType,1
9,1,0,10,mixedType,1
14,2,0,16,mixedType,2
14,2,0,16,mixedType,2
6,1,0,7,mixedType,0
6,2,0,8,mixedType,1
7,1,0,8,mixedType,1
5,4,0,9,mixedType,1
7,3,0,10,mixedType,1
9,1,0,10,mixedType,1
8,1,0,9,mixedType,1
5,4,0,9,mixedType,1
8,4,0,12,mixedType,1
7,1,0,8,mixedType,1
7,3,0,10,mixedType,1
4,4,0,8,mixedType,1
15,5,0,20,mixedType,2
7,2,0,9,mixedType,1
3,5,0,8,mixedType,1
5,3,0,8,mixedType,1
3,6,0,9,mixedType,1
8,1,0,9,mixedType,1
5,3,0,8,mixedType,1
5,5,0,10,mixedType,1
6,2,0,8,mixedType,1
8,4,0,12,mixedType,1
7,5,0,12,mixedType,1
4,4,0,8,mixedType,1
6,3,0,9,mixedType,1
8,3,0,11,mixedType,1
6,2,0,8,mixedType,1
10,1,0,11,mixedType,1
6,2,0,8,mixedType,1
13,3,0,16,mixedType,2
3,6,0,9,mixedType,1
7,1,0,8,mixedType,1
6,4,0,10,mixedType,1
5,4,0,9,mixedType,1
6,1,0,7,mixedType,0
5,3,0,8,mixedType,1
2,6,0,8,mixedType,1
8,2,0,10,mixedType,1
11,2,0,13,mixedType,1
6,2,0,8,mixedType,1
9,2,0,11,mixedType,1
11,3,0,14,mixedType,2
6,3,0,9,mixedType,1
7,3,0,10,mixedType,1
8,2,0,10,mixedType,1
9,1,0,10,mixedType,1
10,2,0,12,mixedType,1
4,9,0,13,mixedType,1
9,1,0,10,mixedType,1
8,2,0,10,mixedType,1
3,5,0,8,mixedType,1
6,2,0,8,mixedType,1
7,1,0,8,mixedType,1
7,3,0,10,mixedType,1
4,5,0,9,mixedType,1
13,3,0,16,mixedType,2
11,1,0,12,mixedType,1
5,3,0,8,mixedType,1
6,1,0,7,mixedType,0
4,2,0,6,mixedType,0
13,3,0,16,mixedType,2
8,2,0,10,mixedType,1
5,1,0,6,mixedType,0
14,2,0,16,mixedType,2
5,3,0,8,mixedType,1
6,3,0,9,mixedType,1
1,8,0,9,mixedType,1
7,3,0,10,mixedType,1
5,3,0,8,mixedType,1
4,2,0,6,mixedType,0
5,4,0,9,mixedType,1
12,3,0,15,mixedType,2
4,5,0,9,mixedType,1
5,1,0,6,mixedType,0
1,8,0,9,mixedType,1
3,5,0,8,mixedType,1
6,3,0,9,mixedType,1
5,3,0,8,mixedType,1
12,4,0,16,mixedType,2
6,3,0,9,mixedType,1
14,2,0,16,mixedType,2
5,3,0,8,mixedType,1
4,2,0,6,mixedType,0
5,3,0,8,mixedType,1
7,2,0,9,mixedType,1
6,3,0,9,mixedType,1
9,2,0,11,mixedType,1
6,3,0,9,mixedType,1
7,4,0,11,mixedType,1
8,2,0,10,mixedType,1
3,6,0,9,mixedType,1
8,1,0,9,mixedType,1
6,4,0,10,mixedType,1
7,5,0,12,mixedType,1
4,6,0,10,mixedType,1
15,3,0,18,mixedType,2
7,5,0,12,mixedType,1
5,1,0,6,mixedType,0
1,11,0,12,mixedType,1
7,2,0,9,mixedType,1
12,3,0,15,mixedType,2
6,1,0,7,mixedType,0
6,3,0,9,mixedType,1
6,4,0,10,mixedType,1
2,4,0,6,mixedType,0
6,4,0,10,mixedType,1
1,8,0,9,mixedType,1
9,1,0,10,mixedType,1
13,3,0,16,mixedType,2
6,4,0,10,mixedType,1
8,5,0,13,mixedType,1
6,1,0,7,mixedType,0
6,2,0,8,mixedType,1
5,1,0,6,mixedType,0
6,3,0,9,mixedType,1
1,8,0,9,mixedType,1
8,3,0,11,mixedType,1
11,3,0,14,mixedType,2
8,3,0,11,mixedType,1
4,6,0,10,mixedType,1
5,1,0,6,mixedType,0
7,2,0,9,mixedType,1
8,3,0,11,mixedType,1
9,3,0,12,mixedType,1
6,1,0,7,mixedType,0
2,6,0,8,mixedType,1
3,7,0,10,mixedType,1
9,4,0,13,mixedType,1
6,6,2,14,mixedType,2
7,3,0,10,mixedType,1
9,2,0,11,mixedType,1
5,3,0,8,mixedType,1
4,7,0,11,mixedType,1
5,4,0,9,mixedType,1
11,2,0,13,mixedType,1
2,8,0,10,mixedType,1
8,1,0,9,mixedType,1
6,2,0,8,mixedType,1
8,2,0,10,mixedType,1
9,0,1,10,mixedType,1
6,1,0,7,mixedType,0
7,2,0,9,mixedType,1
7,3,0,10,mixedType,1
3,7,0,10,mixedType,1
4,2,0,6,mixedType,0
8,1,0,9,mixedType,1
7,3,0,10,mixedType,1
7,2,0,9,mixedType,1
6,3,0,9,mixedType,1
5,1,0,6,mixedType,0
7,3,0,10,mixedType,1
7,3,0,10,mixedType,1
7,3,0,10,mixedType,1
6,1,0,7,mixedType,0
12,3,0,15,mixedType,2
7,1,0,8,mixedType,1
6,3,0,9,mixedType,1
7,3,0,10,mixedType,1
3,3,0,6,mixedType,0
6,4,0,10,mixedType,1
10,3,0,13,mixedType,1
3,7,0,10,mixedType,1
9,4,0,13,mixedType,1
10,1,0,11,mixedType,1
8,2,0,10,mixedType,1
6,4,0,10,mixedType,1
6,4,0,10,mixedType,1
2,10,0,12,mixedType,1
5,5,0,10,mixedType,1
5,3,0,8,mixedType,1
6,4,0,10,mixedType,1
6,2,0,8,mixedType,1
6,6,0,12,mixedType,1
6,1,0,7,mixedType,0
5,3,0,8,mixedType,1
8,3,0,11,mixedType,1
5,1,0,6,mixedType,0
5,3,0,8,mixedType,1
5,1,0,6,mixedType,0
5,2,0,7,mixedType,0
9,1,0,10,mixedType,1
5,2,0,7,mixedType,0
9,1,0,10,mixedType,1
4,6,0,10,mixedType,1
13,3,0,16,mixedType,2
15,1,0,16,mixedType,2
4,2,0,6,mixedType,0
6,3,0,9,mixedType,1
3,6,0,9,mixedType,1
7,1,0,8,mixedType,1
6,1,0,7,mixedType,0
8,2,0,10,mixedType,1
8,3,0,11,mixedType,1
12,4,0,16,mixedType,2
8,1,0,9,mixedType,1
5,2,0,7,mixedType,0
5,2,0,7,mixedType,0
11,3,0,14,mixedType,2
3,5,0,8,mixedType,1
4,4,0,8,mixedType,1
9,1,0,10,mixedType,1
5,3,0,8,mixedType,1
8,1,0,9,mixedType,1
7,2,0,9,mixedType,1
6,4,0,10,mixedType,1
5,2,0,7,mixedType,0
6,2,0,8,mixedType,1
7,1,0,8,mixedType,1
15,1,0,16,mixedType,2
8,1,0,9,mixedType,1
8,2,0,10,mixedType,1
2,8,0,10,mixedType,1
5,1,0,6,mixedType,0
8,1,0,9,mixedType,1
5,3,0,8,mixedType,1
6,2,0,8,mixedType,1
5,2,0,7,mixedType,0
3,7,0,10,mixedType,1
8,3,0,11,mixedType,1
4,8,2,14,mixedType,2
7,1,0,8,mixedType,1
8,3,0,11,mixedType,1
3,7,0,10,mixedType,1
5,4,0,9,mixedType,1
6,3,0,9,mixedType,1
8,5,0,13,mixedType,1
9,2,0,11,mixedType,1
5,3,0,8,mixedType,1
5,4,0,9,mixedType,1
9,1,0,10,mixedType,1
3,5,0,8,mixedType,1
5,4,0,9,mixedType,1
13,3,0,16,mixedType,2
12,4,0,16,mixedType,2
8,1,0,9,mixedType,1
6,4,0,10,mixedType,1
15,1,0,16,mixedType,2
6,4,0,10,mixedType,1
2,7,0,9,mixedType,1
6,2,0,8,mixedType,1
13,3,0,16,mixedType,2
5,4,0,9,mixedType,1
4,2,0,6,mixedType,0
6,4,0,10,mixedType,1
7,3,0,10,mixedType,1
6,4,0,10,mixedType,1
5,2,0,7,mixedType,0
5,3,0,8,mixedType,1
6,4,0,10,mixedType,1
3,6,0,9,mixedType,1
10,8,0,18,mixedType,2
6,3,0,9,mixedType,1
8,1,0,9,mixedType,1
13,3,0,16,mixedType,2
5,4,0,9,mixedType,1
7,1,0,8,mixedType,1
7,3,0,10,mixedType,1
6,0,1,7,mixedType,0
8,2,0,10,mixedType,1
8,2,0,10,mixedType,1
7,1,0,8,mixedType,1
6,5,0,11,mixedType,1
7,3,0,10,mixedType,1
13,3,0,16,mixedType,2
8,2,0,10,mixedType,1
11,3,0,14,mixedType,2
8,3,0,11,mixedType,1
6,2,0,8,mixedType,1
8,1,0,9,mixedType,1
7,2,0,9,mixedType,1
5,3,0,8,mixedType,1
8,4,0,12,mixedType,1
8,1,0,9,mixedType,1
4,5,0,9,mixedType,1
13,3,0,16,mixedType,2
5,8,0,13,mixedType,1
14,2,0,16,mixedType,2
12,4,0,16,mixedType,2
1,8,0,9,mixedType,1
2,6,0,8,mixedType,1
4,4,0,8,mixedType,1
2,6,0,8,mixedType,1
9,1,0,10,mixedType,1
2,7,0,9,mixedType,1
8,1,0,9,mixedType,1
5,1,0,6,mixedType,0
5,3,0,8,mixedType,1
5,2,0,7,mixedType,0
7,2,0,9,mixedType,1
1,8,0,9,mixedType,1
7,2,0,9,mixedType,1
5,2,0,7,mixedType,0
7,3,0,10,mixedType,1
3,7,0,10,mixedType,1
15,1,0,16,mixedType,2
5,3,0,8,mixedType,1
15,1,0,16,mixedType,2
9,2,0,11,mixedType,1
8,2,0,10,mixedType,1
5,2,0,7,mixedType,0
5,4,0,9,mixedType,1
2,4,0,6,mixedType,0
7,3,0,10,mixedType,1
4,4,0,8,mixedType,1
6,2,0,8,mixedType,1
5,2,0,7,mixedType,0
4,2,0,6,mixedType,0
6,3,0,9,mixedType,1
7,3,0,10,mixedType,1
7,4,0,11,mixedType,1
3,5,0,8,mixedType,1
4,2,0,6,mixedType,0
6,4,0,10,mixedType,1
6,1,0,7,mixedType,0
6,4,0,10,mixedType,1
6,4,0,10,mixedType,1
6,2,0,8,mixedType,1
16,3,1,20,mixedType,2
7,2,0,9,mixedType,1
5,3,0,8,mixedType,1
7,3,0,10,mixedType,1
5,3,0,8,mixedType,1
5,2,0,7,mixedType,0
2,6,0,8,mixedType,1
6,3,0,9,mixedType,1
7,3,0,10,mixedType,1
5,2,0,7,mixedType,0
10,2,0,12,mixedType,1
6,1,0,7,mixedType,0
3,5,0,8,mixedType,1
6,3,0,9,mixedType,1
7,2,0,9,mixedType,1
3,5,0,8,mixedType,1
7,3,0,10,mixedType,1
6,4,0,10,mixedType,1
12,3,0,15,mixedType,2
9,3,0,12,mixedType,1
8,1,0,9,mixedType,1
8,2,0,10,mixedType,1
5,4,0,9,mixedType,1
6,2,0,8,mixedType,1
6,3,0,9,mixedType,1
1,8,0,9,mixedType,1
6,1,0,7,mixedType,0
9,1,0,10,mixedType,1
13,3,0,16,mixedType,2
6,2,1,9,mixedType,1
6,3,0,9,mixedType,1
9,1,0,10,mixedType,1
8,1,0,9,mixedType,1
15,1,0,16,mixedType,2
6,3,0,9,mixedType,1
6,1,0,7,mixedType,0
7,3,0,10,mixedType,1
11,3,0,14,mixedType,2
4,6,0,10,mixedType,1
11,1,3,15,mixedType,2
7,3,0,10,mixedType,1
5,3,0,8,mixedType,1
8,3,0,11,mixedType,1
5,4,0,9,mixedType,1
7,6,0,13,mixedType,1
5,2,0,7,mixedType,0
5,8,1,14,mixedType,2
8,2,0,10,mixedType,1
2,8,0,10,mixedType,1
4,4,0,8,mixedType,1
6,3,0,9,mixedType,1
2,6,0,8,mixedType,1
4,4,0,8,mixedType,1
5,5,0,10,mixedType,1
6,2,0,8,mixedType,1
5,2,0,7,mixedType,0
4,2,0,6,mixedType,0
2,7,0,9,mixedType,1
7,3,0,10,mixedType,1
1,9,0,10,mixedType,1
14,2,0,16,mixedType,2
5,4,0,9,mixedType,1
7,2,0,9,mixedType,1
8,2,0,10,mixedType,1
8,2,0,10,mixedType,1
5,3,0,8,mixedType,1
5,3,0,8,mixedType,1
7,3,0,10,mixedType,1
6,3,0,9,mixedType,1
1,7,0,8,mixedType,1
4,0,3,7,mixedType,0
8,3,0,11,mixedType,1
8,1,0,9,mixedType,1
8,4,0,12,mixedType,1
8,2,0,10,mixedType,1
6,4,0,10,mixedType,1
9,1,0,10,mixedType,1
12,3,0,15,mixedType,2
6,3,0,9,mixedType,1
3,5,0,8,mixedType,1
7,2,0,9,mixedType,1
10,2,0,12,mixedType,1
9,1,0,10,mixedType,1
4,4,0,8,mixedType,1
7,5,0,12,mixedType,1
8,2,0,10,mixedType,1
3,5,0,8,mixedType,1
6,1,0,7,mixedType,0
5,3,0,8,mixedType,1
6,3,0,9,mixedType,1
6,3,0,9,mixedType,1
14,2,0,16,mixedType,2
2,8,0,10,mixedType,1
9,2,0,11,mixedType,1
1,7,0,8,mixedType,1
8,1,0,9,mixedType,1
8,1,0,9,mixedType,1
5,3,0,8,mixedType,1
3,6,0,9,mixedType,1
8,2,0,10,mixedType,1
1,8,0,9,mixedType,1
8,1,0,9,mixedType,1
1,11,0,12,mixedType,1
6,3,0,9,mixedType,1
8,2,0,10,mixedType,1
5,4,0,9,mixedType,1
13,3,0,16,mixedType,2
7,1,0,8,mixedType,1
7,3,0,10,mixedType,1
5,4,0,9,mixedType,1
5,3,0,8,mixedType,1
9,1,0,10,mixedType,1
8,1,0,9,mixedType,1
0,8,1,9,mixedType,1
5,3,0,8,mixedType,1
7,4,0,11,mixedType,1
7,1,0,8,mixedType,1
6,4,0,10,mixedType,1
8,1,0,9,mixedType,1
4,4,0,8,mixedType,1
8,4,0,12,mixedType,1
7,3,0,10,mixedType,1
8,1,0,9,mixedType,1
5,2,0,7,mixedType,0
3,5,0,8,mixedType,1
6,1,0,7,mixedType,0
4,6,0,10,mixedType,1
4,4,0,8,mixedType,1
4,4,0,8,mixedType,1
8,2,0,10,mixedType,1
7,2,0,9,mixedType,1
8,2,0,10,mixedType,1
10,2,0,12,mixedType,1
10,3,0,13,mixedType,1
2,8,0,10,mixedType,1
14,2,0,16,mixedType,2
1,8,0,9,mixedType,1
8,4,0,12,mixedType,1
8,1,0,9,mixedType,1
7,3,0,10,mixedType,1
5,4,0,9,mixedType,1
5,3,0,8,mixedType,1
8,4,0,12,mixedType,1
13,3,0,16,mixedType,2
4,2,0,6,mixedType,0
8,3,0,11,mixedType,1
7,1,0,8,mixedType,1
11,2,0,13,mixedType,1
8,2,0,10,mixedType,1
6,4,0,10,mixedType,1
7,1,0,8,mixedType,1
9,2,0,11,mixedType,1
5,6,0,11,mixedType,1
6,3,0,9,mixedType,1
9,1,0,10,mixedType,1
5,4,0,9,mixedType,1
5,2,0,7,mixedType,0
6,1,0,7,mixedType,0
7,4,0,11,mixedType,1
5,2,0,7,mixedType,0
5,3,0,8,mixedType,1
10,2,0,12,mixedType,1
7,2,0,9,mixedType,1
9,3,0,12,mixedType,1
7,3,0,10,mixedType,1
9,2,0,11,mixedType,1
12,3,0,15,mixedType,2
5,3,0,8,mixedType,1
5,1,0,6,mixedType,0
1,8,0,9,mixedType,1
13,3,0,16,mixedType,2
6,1,0,7,mixedType,0
7,1,0,8,mixedType,1
2,8,0,10,mixedType,1
8,4,0,12,mixedType,1
6,1,0,7,mixedType,0
15,1,0,16,mixedType,2
4,4,0,8,mixedType,1
5,3,0,8,mixedType,1
8,1,0,9,mixedType,1
6,2,0,8,mixedType,1
12,2,1,15,mixedType,2
7,3,0,10,mixedType,1
9,1,0,10,mixedType,1
8,1,0,9,mixedType,1
3,5,0,8,mixedType,1
6,4,0,10,mixedType,1
4,6,0,10,mixedType,1
4,6,0,10,mixedType,1
4,4,0,8,mixedType,1
7,3,0,10,mixedType,1
7,3,0,10,mixedType,1
8,1,0,9,mixedType,1
5,3,0,8,mixedType,1
9,3,0,12,mixedType,1
5,4,0,9,mixedType,1
6,3,0,9,mixedType,1
7,1,0,8,mixedType,1
7,3,0,10,mixedType,1
5,3,0,8,mixedType,1
5,3,0,8,mixedType,1
8,3,0,11,mixedType,1
5,1,0,6,mixedType,0
7,3,0,10,mixedType,1
6,2,0,8,mixedType,1
5,3,0,8,mixedType,1
3,10,0,13,mixedType,1
6,4,0,10,mixedType,1
5,4,0,9,mixedType,1
6,2,0,8,mixedType,1
2,6,0,8,mixedType,1
6,4,0,10,mixedType,1
5,2,0,7,mixedType,0
7,3,0,10,mixedType,1
5,1,0,6,mixedType,0
1,8,0,9,mixedType,1
8,2,0,10,mixedType,1
7,1,0,8,mixedType,1
4,2,0,6,mixedType,0
5,4,0,9,mixedType,1
9,1,0,10,mixedType,1
8,3,0,11,mixedType,1
8,1,0,9,mixedType,1
6,3,0,9,mixedType,1
7,2,0,9,mixedType,1
10,6,0,16,mixedType,2
7,4,0,11,mixedType,1
5,1,0,6,mixedType,0
6,4,0,10,mixedType,1
5,2,0,7,mixedType,0
6,4,0,10,mixedType,1
10,2,0,12,mixedType,1
7,3,0,10,mixedType,1
7,1,0,8,mixedType,1
10,4,0,14,mixedType,2
7,2,0,9,mixedType,1
8,2,0,10,mixedType,1
12,4,0,16,mixedType,2
6,3,0,9,mixedType,1
7,3,0,10,mixedType,1
4,6,0,10,mixedType,1
2,6,0,8,mixedType,1
7,2,0,9,mixedType,1
4,6,0,10,mixedType,1
7,3,0,10,mixedType,1
4,2,0,6,mixedType,0
6,3,0,9,mixedType,1
7,2,0,9,mixedType,1
3,6,0,9,mixedType,1
6,4,0,10,mixedType,1
5,2,0,7,mixedType,0
13,3,0,16,mixedType,2
12,4,0,16,mixedType,2
8,2,0,10,mixedType,1
8,1,0,9,mixedType,1
8,2,0,10,mixedType,1
15,1,0,16,mixedType,2
6,3,0,9,mixedType,1
5,2,0,7,mixedType,0
7,3,0,10,mixedType,1
8,1,0,9,mixedType,1
2,6,0,8,mixedType,1
4,4,0,8,mixedType,1
8,2,0,10,mixedType,1
7,4,0,11,mixedType,1
7,3,0,10,mixedType,1
8,2,0,10,mixedType,1
8,5,0,13,mixedType,1
7,2,0,9,mixedType,1
5,2,0,7,mixedType,0
5,1,0,6,mixedType,0
8,1,0,9,mixedType,1
2,7,0,9,mixedType,1
6,3,0,9,mixedType,1
6,1,0,7,mixedType,0
7,3,0,10,mixedType,1
6,3,0,9,mixedType,1
15,1,0,16,mixedType,2
6,4,0,10,mixedType,1
8,3,0,11,mixedType,1
11,3,0,14,mixedType,2
4,2,0,6,mixedType,0
9,3,0,12,mixedType,1
4,5,0,9,mixedType,1
6,4,0,10,mixedType,1
5,3,0,8,mixedType,1
5,2,0,7,mixedType,0
4,2,0,6,mixedType,0
8,2,0,10,mixedType,1
4,2,0,6,mixedType,0
7,2,0,9,mixedType,1
7,2,0,9,mixedType,1
5,2,0,7,mixedType,0
5,2,0,7,mixedType,0
6,3,0,9,mixedType,1
7,2,0,9,mixedType,1
9,1,0,10,mixedType,1
5,2,0,7,mixedType,0
7,3,0,10,mixedType,1
2,7,0,9,mixedType,1
6,3,0,9,mixedType,1
6,2,0,8,mixedType,1
8,1,0,9,mixedType,1
7,1,0,8,mixedType,1
5,3,0,8,mixedType,1
5,8,0,13,mixedType,1
8,1,0,9,mixedType,1
5,2,0,7,mixedType,0
8,3,0,11,mixedType,1
5,3,0,8,mixedType,1
5,2,0,7,mixedType,0
5,3,0,8,mixedType,1
7,3,0,10,mixedType,1
6,3,0,9,mixedType,1
13,3,0,16,mixedType,2
10,2,0,12,mixedType,1
4,4,0,8,mixedType,1
8,3,0,11,mixedType,1
8,1,0,9,mixedType,1
4,2,0,6,mixedType,0
8,2,0,10,mixedType,1
3,6,0,9,mixedType,1
4,7,0,11,mixedType,1
7,6,0,13,mixedType,1
5,2,0,7,mixedType,0
12,4,0,16,mixedType,2
7,3,0,10,mixedType,1
12,3,0,15,mixedType,2
6,4,0,10,mixedType,1
4,2,0,6,mixedType,0
5,8,0,13,mixedType,1
5,3,0,8,mixedType,1
13,3,0,16,mixedType,2
8,3,0,11,mixedType,1
8,1,0,9,mixedType,1
4,2,0,6,mixedType,0
14,2,0,16,mixedType,2
6,1,0,7,mixedType,0
8,1,0,9,mixedType,1
10,11,0,21,mixedType,2
7,1,0,8,mixedType,1
8,2,0,10,mixedType,1
7,1,0,8,mixedType,1
9,1,0,10,mixedType,1
2,8,0,10,mixedType,1
15,1,0,16,mixedType,2
12,3,0,15,mixedType,2
8,2,0,10,mixedType,1
5,4,0,9,mixedType,1
3,6,0,9,mixedType,1
5,1,0,6,mixedType,0
7,2,0,9,mixedType,1
6,2,0,8,mixedType,1
6,3,0,9,mixedType,1
5,2,0,7,mixedType,0
4,4,0,8,mixedType,1
2,8,0,10,mixedType,1
12,3,0,15,mixedType,2
4,7,0,11,mixedType,1
5,2,0,7,mixedType,0
7,3,0,10,mixedType,1
5,4,0,9,mixedType,1
6,3,0,9,mixedType,1
7,2,0,9,mixedType,1
12,4,0,16,mixedType,2
2,6,0,8,mixedType,1
6,3,0,9,mixedType,1
9,3,0,12,mixedType,1
5,2,0,7,mixedType,0
7,3,0,10,mixedType,1
1,7,0,8,mixedType,1
7,2,0,9,mixedType,1
10,4,0,14,mixedType,2
6,4,0,10,mixedType,1
9,3,0,12,mixedType,1
7,2,0,9,mixedType,1
8,1,0,9,mixedType,1
7,3,0,10,mixedType,1
12,3,0,15,mixedType,2
4,6,0,10,mixedType,1
8,2,0,10,mixedType,1
3,6,0,9,mixedType,1
7,3,0,10,mixedType,1
10,2,0,12,mixedType,1
8,4,0,12,mixedType,1
5,2,0,7,mixedType,0
6,3,0,9,mixedType,1
5,4,0,9,mixedType,1
9,3,0,12,mixedType,1
2,8,0,10,mixedType,1
1,8,0,9,mixedType,1
5,3,0,8,mixedType,1
8,2,0,10,mixedType,1
6,2,0,8,mixedType,1
8,2,0,10,mixedType,1
5,4,0,9,mixedType,1
6,4,0,10,mixedType,1
5,4,0,9,mixedType,1
13,3,0,16,mixedType,2
6,1,0,7,mixedType,0
10,3,0,13,mixedType,1
8,1,0,9,mixedType,1
4,5,0,9,mixedType,1
7,3,0,10,mixedType,1
0,12,1,13,mixedType,1
6,1,0,7,mixedType,0
6,3,0,9,mixedType,1
12,4,0,16,mixedType,2
9,2,0,11,mixedType,1
6,2,0,8,mixedType,1
2,6,0,8,mixedType,1
9,1,0,10,mixedType,1
13,3,0,16,mixedType,2
9,7,0,16,mixedType,2
5,2,0,7,mixedType,0
7,1,0,8,mixedType,1
13,3,0,16,mixedType,2
4,2,0,6,mixedType,0
10,3,0,13,mixedType,1
5,3,0,8,mixedType,1
6,1,0,7,mixedType,0
7,3,0,10,mixedType,1
8,1,0,9,mixedType,1
3,9,0,12,mixedType,1
9,3,3,15,mixedType,2
3,7,0,10,mixedType,1
9,3,0,12,mixedType,1
8,2,0,10,mixedType,1
7,2,0,9,mixedType,1
3,6,0,9,mixedType,1
8,3,0,11,mixedType,1
4,2,0,6,mixedType,0
6,3,0,9,mixedType,1
2,6,0,8,mixedType,1
4,2,0,6,mixedType,0
5,4,0,9,mixedType,1
11,3,0,14,mixedType,2
5,3,0,8,mixedType,1
4,4,0,8,mixedType,1
7,2,0,9,mixedType,1
7,3,0,10,mixedType,1
10,1,0,11,mixedType,1
6,2,0,8,mixedType,1
11,3,0,14,mixedType,2
8,3,0,11,mixedType,1
6,3,0,9,mixedType,1
14,2,0,16,mixedType,2
6,3,0,9,mixedType,1
8,1,0,9,mixedType,1
4,6,0,10,mixedType,1
5,6,0,11,mixedType,1
7,4,0,11,mixedType,1
9,2,0,11,mixedType,1
13,3,0,16,mixedType,2
15,1,0,16,mixedType,2
6,3,0,9,mixedType,1
7,1,0,8,mixedType,1
6,1,0,7,mixedType,0
8,2,0,10,mixedType,1
6,2,0,8,mixedType,1
3,8,0,11,mixedType,1
9,1,0,10,mixedType,1
5,2,0,7,mixedType,0
10,3,0,13,mixedType,1
5,2,0,7,mixedType,0
9,1,0,10,mixedType,1
4,4,0,8,mixedType,1
7,3,0,10,mixedType,1
6,3,0,9,mixedType,1
6,3,0,9,mixedType,1
8,2,0,10,mixedType,1
15,1,0,16,mixedType,2
7,3,0,10,mixedType,1
15,1,0,16,mixedType,2
7,2,0,9,mixedType,1
9,1,0,10,mixedType,1
1,8,0,9,mixedType,1
6,2,0,8,mixedType,1
14,2,0,16,mixedType,2
9,1,0,10,mixedType,1
4,2,0,6,mixedType,0
6,4,0,10,mixedType,1
5,1,0,6,mixedType,0
6,1,0,7,mixedType,0
5,3,0,8,mixedType,1
5,3,0,8,mixedType,1
15,1,0,16,mixedType,2
14,2,0,16,mixedType,2
6,3,0,9,mixedType,1
9,1,0,10,mixedType,1
2,8,0,10,mixedType,1
4,4,0,8,mixedType,1
6,6,0,12,mixedType,1
8,1,0,9,mixedType,1
5,4,0,9,mixedType,1
10,3,0,13,mixedType,1
8,1,0,9,mixedType,1
6,2,0,8,mixedType,1
5,4,0,9,mixedType,1
5,2,0,7,mixedType,0
12,1,0,13,mixedType,1
7,2,0,9,mixedType,1
6,3,0,9,mixedType,1
4,4,0,8,mixedType,1
6,2,0,8,mixedType,1
4,2,0,6,mixedType,0
8,2,0,10,mixedType,1
7,3,0,10,mixedType,1
9,2,0,11,mixedType,1
5,3,0,8,mixedType,1
8,1,0,9,mixedType,1
9,1,0,10,mixedType,1
3,5,0,8,mixedType,1
6,1,0,7,mixedType,0
2,10,0,12,mixedType,1
5,4,0,9,mixedType,1
6,4,0,10,mixedType,1
9,3,0,12,mixedType,1
2,8,0,10,mixedType,1
4,6,0,10,mixedType,1
9,2,0,11,mixedType,1
6,1,0,7,mixedType,0
8,3,0,11,mixedType,1
7,2,0,9,mixedType,1
9,2,0,11,mixedType,1
5,4,0,9,mixedType,1
6,3,0,9,mixedType,1
7,1,0,8,mixedType,1
4,6,0,10,mixedType,1
9,1,0,10,mixedType,1
4,2,0,6,mixedType,0
9,3,0,12,mixedType,1
5,5,0,10,mixedType,1
3,7,0,10,mixedType,1
11,5,0,16,mixedType,2
5,4,0,9,mixedType,1
2,9,0,11,mixedType,1
6,2,0,8,mixedType,1
6,3,0,9,mixedType,1
6,4,0,10,mixedType,1
6,2,0,8,mixedType,1
6,1,0,7,mixedType,0
7,3,0,10,mixedType,1
5,2,0,7,mixedType,0
14,2,0,16,mixedType,2
2,10,0,12,mixedType,1
6,3,0,9,mixedType,1
8,3,0,11,mixedType,1
6,3,0,9,mixedType,1
3,3,0,6,mixedType,0
6,3,0,9,mixedType,1
6,3,0,9,mixedType,1
14,2,0,16,mixedType,2
7,3,0,10,mixedType,1
2,8,0,10,mixedType,1
4,4,0,8,mixedType,1
5,3,0,8,mixedType,1
2,8,0,10,mixedType,1
6,2,0,8,mixedType,1
10,3,0,13,mixedType,1
6,4,0,10,mixedType,1
3,3,0,6,mixedType,0
6,1,0,7,mixedType,0
4,8,0,12,mixedType,1
6,2,0,8,mixedType,1
14,2,0,16,mixedType,2
13,3,0,16,mixedType,2
6,2,0,8,mixedType,1
6,2,0,8,mixedType,1
2,6,0,8,mixedType,1
3,5,0,8,mixedType,1
7,2,0,9,mixedType,1
5,3,0,8,mixedType,1
6,1,0,7,mixedType,0
6,3,0,9,mixedType,1
9,3,0,12,mixedType,1
12,1,0,13,mixedType,1
8,1,0,9,mixedType,1
6,3,0,9,mixedType,1
7,3,0,10,mixedType,1
5,3,0,8,mixedType,1
6,4,0,10,mixedType,1
7,4,0,11,mixedType,1
8,2,0,10,mixedType,1
6,2,0,8,mixedType,1
2,4,0,6,mixedType,0
1,11,0,12,mixedType,1
6,4,0,10,mixedType,1
9,6,0,15,mixedType,2
14,2,0,16,mixedType,2
3,5,0,8,mixedType,1
5,2,0,7,mixedType,0
5,3,0,8,mixedType,1
3,3,0,6,mixedType,0
6,2,0,8,mixedType,1
8,1,0,9,mixedType,1
4,4,0,8,mixedType,1
15,1,0,16,mixedType,2
6,4,0,10,mixedType,1
5,2,0,7,mixedType,0
4,8,0,12,mixedType,1
7,2,0,9,mixedType,1
6,3,0,9,mixedType,1
5,2,0,7,mixedType,0
4,5,0,9,mixedType,1
9,1,0,10,mixedType,1
2,6,0,8,mixedType,1
8,3,0,11,mixedType,1
13,3,0,16,mixedType,2
4,6,0,10,mixedType,1
6,4,0,10,mixedType,1
8,4,0,12,mixedType,1
12,3,0,15,mixedType,2
6,1,0,7,mixedType,0
6,3,0,9,mixedType,1
5,3,0,8,mixedType,1
7,3,0,10,mixedType,1
6,4,0,10,mixedType,1
7,4,0,11,mixedType,1
10,1,0,11,mixedType,1
8,2,0,10,mixedType,1
8,3,0,11,mixedType,1
7,3,0,10,mixedType,1
9,2,0,11,mixedType,1
8,2,0,10,mixedType,1
7,1,0,8,mixedType,1
6,4,0,10,mixedType,1
9,1,0,10,mixedType,1
5,3,0,8,mixedType,1
15,1,0,16,mixedType,2
7,1,0,8,mixedType,1
6,2,0,8,mixedType,1
2,6,0,8,mixedType,1
8,3,0,11,mixedType,1
4,6,0,10,mixedType,1
1,10,0,11,mixedType,1
6,2,0,8,mixedType,1
6,3,0,9,mixedType,1
15,1,0,16,mixedType,2
2,7,0,9,mixedType,1
5,4,0,9,mixedType,1
12,3,0,15,mixedType,2
6,2,0,8,mixedType,1
7,2,0,9,mixedType,1
8,2,0,10,mixedType,1
5,2,0,7,mixedType,0
10,2,0,12,mixedType,1
8,4,0,12,mixedType,1
4,2,0,6,mixedType,0
4,2,0,6,mixedType,0
12,3,0,15,mixedType,2
7,2,0,9,mixedType,1
8,5,0,13,mixedType,1
6,4,0,10,mixedType,1
3,7,0,10,mixedType,1
6,2,0,8,mixedType,1
7,3,0,10,mixedType,1
11,2,0,13,mixedType,1
8,2,0,10,mixedType,1
6,3,0,9,mixedType,1
5,4,0,9,mixedType,1
8,2,0,10,mixedType,1
6,2,0,8,mixedType,1
14,2,0,16,mixedType,2
6,4,0,10,mixedType,1
4,4,0,8,mixedType,1
5,3,0,8,mixedType,1
15,1,0,16,mixedType,2
6,3,0,9,mixedType,1
5,4,0,9,mixedType,1
7,2,0,9,mixedType,1
15,1,0,16,mixedType,2
6,1,0,7,mixedType,0
6,2,0,8,mixedType,1
6,0,4,10,mixedType,1
8,1,0,9,mixedType,1
5,3,0,8,mixedType,1
4,2,0,6,mixedType,0
9,0,3,12,mixedType,1
6,3,0,9,mixedType,1
5,2,0,7,mixedType,0
6,3,0,9,mixedType,1
5,3,0,8,mixedType,1
6,2,0,8,mixedType,1
9,3,0,12,mixedType,1
7,2,0,9,mixedType,1
14,2,0,16,mixedType,2
7,1,0,8,mixedType,1
4,2,0,6,mixedType,0
7,5,0,12,mixedType,1
8,1,0,9,mixedType,1
2,8,0,10,mixedType,1
4,5,0,9,mixedType,1
6,1,0,7,mixedType,0
6,3,0,9,mixedType,1
8,1,0,9,mixedType,1
6,0,1,7,mixedType,0
8,2,0,10,mixedType,1
7,3,0,10,mixedType,1
5,2,0,7,mixedType,0
14,2,0,16,mixedType,2
6,6,0,12,mixedType,1
11,1,0,12,mixedType,1
9,4,0,13,mixedType,1
7,2,0,9,mixedType,1
10,3,0,13,mixedType,1
13,3,0,16,mixedType,2
7,2,0,9,mixedType,1
13,3,0,16,mixedType,2
6,3,0,9,mixedType,1
8,1,0,9,mixedType,1
5,4,0,9,mixedType,1
2,10,0,12,mixedType,1
3,6,0,9,mixedType,1
7,1,0,8,mixedType,1
5,3,0,8,mixedType,1
8,1,0,9,mixedType,1
7,1,0,8,mixedType,1
8,1,0,9,mixedType,1
0,8,0,8,sameType,1
6,3,0,9,mixedType,1
3,8,0,11,mixedType,1
8,1,0,9,mixedType,1
8,1,0,9,mixedType,1
2,6,0,8,mixedType,1
7,3,0,10,mixedType,1
9,1,0,10,mixedType,1
6,4,0,10,mixedType,1
4,6,0,10,mixedType,1
5,4,0,9,mixedType,1
1,8,0,9,mixedType,1
15,1,1,17,mixedType,2
16,1,1,18,mixedType,2
12,1,0,13,mixedType,1
6,3,0,9,mixedType,1
0,6,2,8,mixedType,1
5,3,0,8,mixedType,1
5,4,0,9,mixedType,1
1,8,0,9,mixedType,1
9,2,0,11,mixedType,1
10,4,0,14,mixedType,2
7,1,0,8,mixedType,1
14,2,0,16,mixedType,2
5,1,0,6,mixedType,0
5,3,0,8,mixedType,1
7,1,0,8,mixedType,1
5,2,0,7,mixedType,0
6,4,0,10,mixedType,1
8,4,0,12,mixedType,1
9,3,0,12,mixedType,1
12,4,0,16,mixedType,2
5,3,0,8,mixedType,1
4,2,0,6,mixedType,0
7,3,0,10,mixedType,1
9,2,0,11,mixedType,1
6,2,0,8,mixedType,1
5,5,0,10,mixedType,1
5,4,0,9,mixedType,1
6,1,0,7,mixedType,0
7,4,0,11,mixedType,1
2,7,0,9,mixedType,1
5,4,0,9,mixedType,1
7,2,0,9,mixedType,1
2,6,0,8,mixedType,1
13,3,0,16,mixedType,2
10,5,0,15,mixedType,2
12,3,0,15,mixedType,2
8,8,0,16,mixedType,2
9,2,0,11,mixedType,1
8,5,0,13,mixedType,1
5,3,0,8,mixedType,1
6,3,0,9,mixedType,1
8,2,0,10,mixedType,1
6,2,0,8,mixedType,1
7,5,0,12,mixedType,1
5,2,0,7,mixedType,0
7,3,0,10,mixedType,1
7,3,0,10,mixedType,1
6,4,0,10,mixedType,1
10,4,0,14,mixedType,2
7,3,0,10,mixedType,1
6,1,0,7,mixedType,0
6,2,0,8,mixedType,1
13,3,0,16,mixedType,2
6,4,0,10,mixedType,1
3,10,0,13,mixedType,1
4,2,0,6,mixedType,0
15,1,0,16,mixedType,2
6,4,0,10,mixedType,1
7,4,0,11,mixedType,1
5,1,0,6,mixedType,0
13,3,0,16,mixedType,2
7,5,0,12,mixedType,1
5,3,0,8,mixedType,1
8,2,0,10,mixedType,1
10,2,0,12,mixedType,1
4,8,0,12,mixedType,1
2,8,0,10,mixedType,1
5,2,0,7,mixedType,0
4,2,0,6,mixedType,0
5,3,0,8,mixedType,1
6,2,0,8,mixedType,1
9,1,0,10,mixedType,1
13,3,0,16,mixedType,2
9,1,0,10,mixedType,1
7,3,0,10,mixedType,1
4,4,0,8,mixedType,1
8,1,0,9,mixedType,1
4,4,0,8,mixedType,1
2,6,0,8,mixedType,1
5,7,0,12,mixedType,1
6,2,0,8,mixedType,1
8,1,0,9,mixedType,1
2,8,0,10,mixedType,1
5,1,0,6,mixedType,0
2,8,0,10,mixedType,1
3,3,0,6,mixedType,0
7,2,0,9,mixedType,1
5,2,0,7,mixedType,0
3,6,0,9,mixedType,1
13,3,0,16,mixedType,2
6,4,0,10,mixedType,1
7,3,0,10,mixedType,1
2,8,0,10,mixedType,1
13,3,0,16,mixedType,2
6,3,0,9,mixedType,1
11,3,0,14,mixedType,2
6,2,0,8,mixedType,1
13,3,0,16,mixedType,2
7,2,0,9,mixedType,1
7,2,0,9,mixedType,1
7,2,0,9,mixedType,1
5,5,0,10,mixedType,1
1,8,0,9,mixedType,1
5,4,0,9,mixedType,1
4,6,0,10,mixedType,1
2,4,0,6,mixedType,0
12,4,0,16,mixedType,2
3,7,0,10,mixedType,1
6,6,0,12,mixedType,1
5,1,0,6,mixedType,0
7,1,0,8,mixedType,1
4,6,0,10,mixedType,1
6,2,0,8,mixedType,1
6,1,0,7,mixedType,0
14,2,0,16,mixedType,2
4,4,0,8,mixedType,1
8,3,0,11,mixedType,1
6,1,0,7,mixedType,0
8,2,0,10,mixedType,1
7,3,0,10,mixedType,1
13,3,0,16,mixedType,2
8,3,0,11,mixedType,1
1,9,0,10,mixedType,1
1,7,0,8,mixedType,1
7,3,0,10,mixedType,1
4,4,0,8,mixedType,1
6,3,0,9,mixedType,1
2,8,0,10,mixedType,1
2,6,0,8,mixedType,1
8,1,0,9,mixedType,1
9,1,0,10,mixedType,1
6,3,0,9,mixedType,1
4,4,0,8,mixedType,1
9,3,0,12,mixedType,1
8,2,0,10,mixedType,1
6,4,0,10,mixedType,1
4,2,0,6,mixedType,0
7,2,0,9,mixedType,1
6,2,0,8,mixedType,1
5,2,0,7,mixedType,0
5,3,0,8,mixedType,1
7,1,0,8,mixedType,1
3,5,0,8,mixedType,1
2,6,0,8,mixedType,1
7,2,0,9,mixedType,1
7,1,0,8,mixedType,1
7,1,0,8,mixedType,1
8,2,0,10,mixedType,1
7,2,0,9,mixedType,1
15,1,1,17,mixedType,2
3,6,0,9,mixedType,1
0,4,2,6,mixedType,0
6,3,0,9,mixedType,1
4,4,0,8,mixedType,1
5,5,0,10,mixedType,1
5,3,0,8,mixedType,1
4,2,0,6,mixedType,0
5,2,0,7,mixedType,0
3,3,0,6,mixedType,0
3,6,0,9,mixedType,1
7,3,0,10,mixedType,1
9,4,1,14,mixedType,2
16,4,0,20,mixedType,2
14,2,0,16,mixedType,2
4,4,0,8,mixedType,1
4,2,0,6,mixedType,0
7,2,0,9,mixedType,1
6,3,0,9,mixedType,1
2,6,0,8,mixedType,1
9,1,0,10,mixedType,1
5,1,0,6,mixedType,0
6,3,0,9,mixedType,1
5,4,0,9,mixedType,1
4,4,0,8,mixedType,1
7,3,0,10,mixedType,1
6,3,0,9,mixedType,1
4,2,0,6,mixedType,0
6,3,0,9,mixedType,1
4,5,0,9,mixedType,1
5,2,0,7,mixedType,0
7,2,0,9,mixedType,1
8,3,0,11,mixedType,1
5,2,0,7,mixedType,0
4,4,0,8,mixedType,1
12,4,0,16,mixedType,2
5,10,1,16,mixedType,2
9,4,0,13,mixedType,1
6,3,0,9,mixedType,1
6,3,0,9,mixedType,1
7,2,0,9,mixedType,1
6,3,0,9,mixedType,1
5,3,0,8,mixedType,1
9,3,0,12,mixedType,1
7,3,0,10,mixedType,1
10,2,0,12,mixedType,1
5,2,0,7,mixedType,0
4,4,0,8,mixedType,1
7,3,0,10,mixedType,1
7,2,0,9,mixedType,1
9,4,0,13,mixedType,1
7,1,0,8,mixedType,1
5,3,0,8,mixedType,1
6,1,0,7,mixedType,0
6,3,0,9,mixedType,1
7,4,0,11,mixedType,1
8,2,0,10,mixedType,1
1,12,0,13,mixedType,1
8,2,0,10,mixedType,1
5,3,0,8,mixedType,1
9,6,0,15,mixedType,2
4,2,0,6,mixedType,0
12,3,0,15,mixedType,2
5,2,0,7,mixedType,0
6,3,0,9,mixedType,1
6,4,0,10,mixedType,1
5,2,0,7,mixedType,0
5,1,0,6,mixedType,0
14,2,0,16,mixedType,2
2,8,0,10,mixedType,1
1,7,0,8,mixedType,1
2,6,0,8,mixedType,1
7,3,0,10,mixedType,1
6,4,0,10,mixedType,1
6,4,0,10,mixedType,1
6,3,0,9,mixedType,1
9,4,0,13,mixedType,1
11,2,0,13,mixedType,1
9,1,0,10,mixedType,1
9,1,0,10,mixedType,1
7,3,0,10,mixedType,1
3,6,0,9,mixedType,1
8,1,0,9,mixedType,1
6,3,0,9,mixedType,1
14,2,0,16,mixedType,2
5,4,0,9,mixedType,1
7,3,0,10,mixedType,1
5,2,0,7,mixedType,0
6,1,0,7,mixedType,0
6,3,0,9,mixedType,1
4,9,0,13,mixedType,1
4,2,0,6,mixedType,0
8,2,0,10,mixedType,1
10,1,0,11,mixedType,1
10,2,0,12,mixedType,1
15,1,0,16,mixedType,2
5,1,0,6,mixedType,0
6,3,0,9,mixedType,1
11,3,0,14,mixedType,2
9,4,0,13,mixedType,1
6,3,0,9,mixedType,1
6,3,0,9,mixedType,1
6,3,0,9,mixedType,1
11,3,0,14,mixedType,2
5,3,0,8,mixedType,1
5,2,0,7,mixedType,0
7,1,0,8,mixedType,1
5,2,0,7,mixedType,0
9,3,0,12,mixedType,1
7,4,0,11,mixedType,1
9,4,0,13,mixedType,1
9,3,0,12,mixedType,1
12,4,0,16,mixedType,2
8,1,0,9,mixedType,1
7,4,0,11,mixedType,1
8,2,0,10,mixedType,1
6,2,0,8,mixedType,1
11,3,0,14,mixedType,2
7,6,0,13,mixedType,1
5,3,0,8,mixedType,1
2,6,0,8,mixedType,1
9,1,0,10,mixedType,1
4,6,0,10,mixedType,1
4,2,0,6,mixedType,0
5,3,0,8,mixedType,1
11,5,0,16,mixedType,2
6,4,0,10,mixedType,1
7,3,0,10,mixedType,1
9,1,0,10,mixedType,1
15,1,0,16,mixedType,2
5,2,0,7,mixedType,0
7,3,0,10,mixedType,1
8,3,0,11,mixedType,1
6,2,0,8,mixedType,1
3,5,0,8,mixedType,1
4,2,0,6,mixedType,0
9,1,0,10,mixedType,1
5,1,0,6,mixedType,0
3,5,0,8,mixedType,1
7,4,0,11,mixedType,1
6,2,0,8,mixedType,1
6,4,0,10,mixedType,1
11,5,0,16,mixedType,2
8,2,0,10,mixedType,1
8,1,0,9,mixedType,1
6,4,0,10,mixedType,1
4,2,0,6,mixedType,0
1,8,0,9,mixedType,1
6,4,0,10,mixedType,1
7,3,0,10,mixedType,1
7,2,0,9,mixedType,1
6,3,0,9,mixedType,1
7,4,0,11,mixedType,1
5,2,0,7,mixedType,0
10,2,0,12,mixedType,1
5,2,0,7,mixedType,0
5,2,0,7,mixedType,0
16,4,0,20,mixedType,2
7,1,0,8,mixedType,1
6,6,0,12,mixedType,1
6,4,0,10,mixedType,1
7,3,0,10,mixedType,1
1,8,0,9,mixedType,1
15,1,0,16,mixedType,2
8,2,0,10,mixedType,1
4,4,0,8,mixedType,1
6,2,0,8,mixedType,1
5,3,0,8,mixedType,1
9,4,0,13,mixedType,1
3,9,0,12,mixedType,1
11,3,0,14,mixedType,2
4,2,0,6,mixedType,0
6,1,0,7,mixedType,0
5,2,0,7,mixedType,0
7,2,0,9,mixedType,1
4,4,0,8,mixedType,1
7,2,0,9,mixedType,1
7,2,0,9,mixedType,1
5,2,0,7,mixedType,0
5,5,0,10,mixedType,1
4,2,0,6,mixedType,0
12,4,0,16,mixedType,2
14,6,1,21,mixedType,2
13,3,0,16,mixedType,2
8,2,0,10,mixedType,1
5,3,0,8,mixedType,1
5,3,0,8,mixedType,1
5,3,0,8,mixedType,1
6,6,0,12,mixedType,1
12,1,1,14,mixedType,2
15,1,0,16,mixedType,2
6,3,0,9,mixedType,1
6,3,0,9,mixedType,1
10,2,0,12,mixedType,1
12,4,0,16,mixedType,2
8,1,0,9,mixedType,1
8,2,0,10,mixedType,1
12,8,0,20,mixedType,2
8,2,0,10,mixedType,1
9,1,0,10,mixedType,1
7,1,0,8,mixedType,1
5,2,0,7,mixedType,0
7,3,0,10,mixedType,1
14,2,0,16,mixedType,2
4,4,0,8,mixedType,1
7,2,0,9,mixedType,1
6,3,0,9,mixedType,1
14,2,0,16,mixedType,2
9,1,0,10,mixedType,1
3,7,0,10,mixedType,1
4,6,0,10,mixedType,1
2,6,0,8,mixedType,1
9,4,1,14,mixedType,2
9,3,0,12,mixedType,1
5,4,0,9,mixedType,1
2,6,0,8,mixedType,1
3,8,0,11,mixedType,1
5,5,0,10,mixedType,1
8,0,1,9,mixedType,1
14,2,0,16,mixedType,2
6,2,0,8,mixedType,1
8,1,0,9,mixedType,1
6,2,0,8,mixedType,1
8,1,0,9,mixedType,1
7,3,0,10,mixedType,1
8,2,0,10,mixedType,1
5,2,0,7,mixedType,0
6,2,0,8,mixedType,1
4,4,0,8,mixedType,1
8,3,0,11,mixedType,1
8,2,0,10,mixedType,1
6,3,0,9,mixedType,1
2,4,0,6,mixedType,0
4,4,0,8,mixedType,1
6,2,0,8,mixedType,1
9,2,0,11,mixedType,1
6,3,0,9,mixedType,1
4,6,0,10,mixedType,1
12,4,0,16,mixedType,2
9,2,0,11,mixedType,1
7,1,0,8,mixedType,1
7,3,0,10,mixedType,1
12,3,0,15,mixedType,2
1,7,0,8,mixedType,1
7,3,0,10,mixedType,1
6,2,0,8,mixedType,1
6,1,0,7,mixedType,0
6,3,0,9,mixedType,1
8,3,0,11,mixedType,1
6,2,0,8,mixedType,1
8,1,0,9,mixedType,1
8,2,0,10,mixedType,1
4,5,0,9,mixedType,1
9,3,0,12,mixedType,1
12,4,0,16,mixedType,2
7,3,0,10,mixedType,1
11,4,0,15,mixedType,2
10,2,0,12,mixedType,1
7,2,0,9,mixedType,1
6,3,0,9,mixedType,1
6,2,0,8,mixedType,1
3,6,0,9,mixedType,1
6,1,0,7,mixedType,0
7,2,0,9,mixedType,1
5,4,0,9,mixedType,1
7,4,0,11,mixedType,1
5,3,0,8,mixedType,1
4,4,0,8,mixedType,1
5,2,0,7,mixedType,0
2,7,0,9,mixedType,1
15,1,0,16,mixedType,2
10,3,0,13,mixedType,1
3,3,0,6,mixedType,0
9,1,0,10,mixedType,1
9,2,0,11,mixedType,1
6,4,0,10,mixedType,1
6,2,0,8,mixedType,1
7,3,0,10,mixedType,1
6,6,0,12,mixedType,1
7,3,0,10,mixedType,1
2,8,0,10,mixedType,1
7,3,0,10,mixedType,1
10,2,0,12,mixedType,1
8,2,0,10,mixedType,1
6,5,0,11,mixedType,1
8,3,0,11,mixedType,1
7,2,0,9,mixedType,1
9,3,0,12,mixedType,1
6,1,0,7,mixedType,0
10,3,2,15,mixedType,2
6,2,0,8,mixedType,1
6,3,0,9,mixedType,1
4,2,0,6,mixedType,0
7,3,0,10,mixedType,1
6,4,0,10,mixedType,1
5,3,0,8,mixedType,1
8,2,0,10,mixedType,1
6,3,0,9,mixedType,1
2,6,0,8,mixedType,1
14,2,0,16,mixedType,2
12,3,0,15,mixedType,2
4,4,0,8,mixedType,1
6,3,0,9,mixedType,1
5,8,0,13,mixedType,1
7,4,0,11,mixedType,1
5,2,0,7,mixedType,0
6,3,0,9,mixedType,1
12,4,0,16,mixedType,2
1,8,0,9,mixedType,1
5,3,0,8,mixedType,1
7,2,0,9,mixedType,1
3,5,0,8,mixedType,1
12,3,0,15,mixedType,2
6,2,0,8,mixedType,1
5,3,0,8,mixedType,1
1,8,0,9,mixedType,1
7,3,0,10,mixedType,1
15,1,0,16,mixedType,2
10,3,0,13,mixedType,1
5,4,0,9,mixedType,1
8,2,0,10,mixedType,1
8,2,0,10,mixedType,1
4,4,0,8,mixedType,1
14,2,0,16,mixedType,2
8,2,0,10,mixedType,1
13,3,0,16,mixedType,2
8,2,0,10,mixedType,1
3,3,0,6,mixedType,0
8,1,0,9,mixedType,1
5,3,0,8,mixedType,1
2,7,0,9,mixedType,1
6,3,0,9,mixedType,1
5,2,0,7,mixedType,0
10,6,0,16,mixedType,2
4,2,0,6,mixedType,0
10,1,0,11,mixedType,1
5,2,0,7,mixedType,0
7,5,0,12,mixedType,1
7,4,0,11,mixedType,1
6,1,0,7,mixedType,0
14,1,0,15,mixedType,2
6,3,0,9,mixedType,1
7,2,0,9,mixedType,1
7,3,0,10,mixedType,1
2,7,0,9,mixedType,1
14,2,0,16,mixedType,2
7,3,0,10,mixedType,1
8,2,0,10,mixedType,1
6,3,0,9,mixedType,1
5,4,0,9,mixedType,1
10,2,0,12,mixedType,1
12,4,0,16,mixedType,2
7,2,0,9,mixedType,1
11,2,0,13,mixedType,1
2,6,0,8,mixedType,1
15,1,0,16,mixedType,2
4,2,0,6,mixedType,0
4,2,0,6,mixedType,0
11,3,0,14,mixedType,2
8,3,0,11,mixedType,1
5,2,0,7,mixedType,0
7,6,0,13,mixedType,1
6,4,0,10,mixedType,1
8,1,0,9,mixedType,1
2,4,0,6,mixedType,0
12,4,0,16,mixedType,2
14,2,0,16,mixedType,2
3,6,0,9,mixedType,1
3,8,0,11,mixedType,1
6,1,0,7,mixedType,0
3,3,0,6,mixedType,0
13,3,0,16,mixedType,2
4,4,0,8,mixedType,1
6,2,0,8,mixedType,1
5,3,0,8,mixedType,1
2,4,0,6,mixedType,0
14,2,0,16,mixedType,2
10,3,0,13,mixedType,1
7,5,0,12,mixedType,1
8,3,0,11,mixedType,1
7,3,0,10,mixedType,1
5,3,0,8,mixedType,1
2,7,0,9,mixedType,1
6,3,0,9,mixedType,1
1,10,0,11,mixedType,1
9,1,0,10,mixedType,1
8,2,0,10,mixedType,1
7,3,0,10,mixedType,1
6,6,0,12,mixedType,1
4,2,0,6,mixedType,0
2,6,0,8,mixedType,1
6,3,0,9,mixedType,1
13,3,0,16,mixedType,2
6,3,0,9,mixedType,1
7,2,0,9,mixedType,1
4,4,0,8,mixedType,1
14,2,0,16,mixedType,2
7,6,0,13,mixedType,1
4,6,0,10,mixedType,1
6,3,0,9,mixedType,1
2,9,0,11,mixedType,1
2,4,0,6,mixedType,0
9,1,0,10,mixedType,1
7,2,0,9,mixedType,1
9,2,0,11,mixedType,1
7,2,0,9,mixedType,1
14,2,0,16,mixedType,2
10,3,0,13,mixedType,1
6,4,0,10,mixedType,1
6,2,0,8,mixedType,1
15,1,0,16,mixedType,2
1,8,0,9,mixedType,1
7,2,0,9,mixedType,1
6,3,0,9,mixedType,1
9,4,1,14,mixedType,2
5,4,0,9,mixedType,1
8,2,0,10,mixedType,1
8,1,0,9,mixedType,1
8,1,0,9,mixedType,1
5,3,0,8,mixedType,1
8,2,0,10,mixedType,1
3,6,0,9,mixedType,1
9,2,0,11,mixedType,1
7,1,0,8,mixedType,1
7,3,0,10,mixedType,1
5,3,0,8,mixedType,1
6,3,0,9,mixedType,1
4,2,0,6,mixedType,0
4,2,0,6,mixedType,0
9,2,0,11,mixedType,1
12,4,0,16,mixedType,2
7,6,0,13,mixedType,1
15,1,0,16,mixedType,2
7,3,0,10,mixedType,1
3,5,0,8,mixedType,1
5,1,0,6,mixedType,0
5,4,0,9,mixedType,1
6,4,0,10,mixedType,1
3,6,0,9,mixedType,1
8,2,0,10,mixedType,1
4,7,0,11,mixedType,1
6,3,0,9,mixedType,1
4,4,0,8,mixedType,1
3,8,0,11,mixedType,1
3,3,0,6,mixedType,0
3,6,0,9,mixedType,1
6,1,0,7,mixedType,0
6,1,0,7,mixedType,0
4,4,0,8,mixedType,1
3,7,0,10,mixedType,1
7,4,0,11,mixedType,1
11,3,0,14,mixedType,2
5,4,0,9,mixedType,1
12,3,0,15,mixedType,2
6,1,0,7,mixedType,0
6,3,0,9,mixedType,1
11,3,0,14,mixedType,2
5,1,0,6,mixedType,0
8,2,0,10,mixedType,1
6,4,0,10,mixedType,1
5,4,0,9,mixedType,1
10,1,0,11,mixedType,1
6,3,0,9,mixedType,1
8,5,0,13,mixedType,1
6,2,0,8,mixedType,1
2,9,0,11,mixedType,1
3,6,0,9,mixedType,1
5,4,0,9,mixedType,1
6,3,0,9,mixedType,1
5,8,0,13,mixedType,1
5,3,0,8,mixedType,1
13,3,0,16,mixedType,2
7,2,0,9,mixedType,1
2,6,0,8,mixedType,1
5,4,0,9,mixedType,1
7,3,0,10,mixedType,1
6,4,0,10,mixedType,1
9,1,0,10,mixedType,1
7,2,0,9,mixedType,1
9,3,0,12,mixedType,1
7,2,0,9,mixedType,1
6,1,0,7,mixedType,0
7,2,0,9,mixedType,1
6,1,0,7,mixedType,0
4,2,0,6,mixedType,0
4,5,0,9,mixedType,1
8,3,0,11,mixedType,1
8,1,0,9,mixedType,1
4,5,0,9,mixedType,1
6,4,0,10,mixedType,1
3,10,0,13,mixedType,1
7,3,0,10,mixedType,1
6,2,0,8,mixedType,1
4,8,0,12,mixedType,1
5,3,0,8,mixedType,1
5,3,0,8,mixedType,1
4,2,0,6,mixedType,0
1,8,0,9,mixedType,1
1,7,0,8,mixedType,1
6,2,0,8,mixedType,1
8,2,0,10,mixedType,1
4,4,0,8,mixedType,1
3,3,0,6,mixedType,0
10,3,0,13,mixedType,1
5,6,0,11,mixedType,1
3,6,0,9,mixedType,1
7,1,0,8,mixedType,1
7,2,0,9,mixedType,1
11,1,0,12,mixedType,1
5,7,0,12,mixedType,1
12,4,0,16,mixedType,2
11,1,0,12,mixedType,1
7,2,0,9,mixedType,1
7,4,0,11,mixedType,1
6,3,0,9,mixedType,1
5,2,0,7,mixedType,0
9,3,0,12,mixedType,1
7,1,0,8,mixedType,1
5,11,0,16,mixedType,2
6,1,0,7,mixedType,0
6,3,0,9,mixedType,1
6,1,0,7,mixedType,0
15,1,0,16,mixedType,2
4,2,0,6,mixedType,0
6,3,0,9,mixedType,1
7,3,0,10,mixedType,1
8,3,0,11,mixedType,1
6,4,0,10,mixedType,1
5,2,0,7,mixedType,0
5,3,0,8,mixedType,1
14,2,0,16,mixedType,2
4,4,0,8,mixedType,1
8,0,1,9,mixedType,1
6,1,0,7,mixedType,0
7,2,0,9,mixedType,1
6,3,0,9,mixedType,1
9,1,0,10,mixedType,1
9,1,0,10,mixedType,1
7,3,0,10,mixedType,1
7,3,0,10,mixedType,1
7,1,0,8,mixedType,1
7,3,0,10,mixedType,1
10,3,0,13,mixedType,1
6,1,0,7,mixedType,0
12,3,0,15,mixedType,2
7,2,0,9,mixedType,1
14,2,0,16,mixedType,2
2,4,0,6,mixedType,0
8,1,0,9,mixedType,1
10,2,0,12,mixedType,1
11,3,0,14,mixedType,2
6,3,0,9,mixedType,1
9,3,0,12,mixedType,1
6,3,0,9,mixedType,1
6,4,0,10,mixedType,1
6,3,0,9,mixedType,1
2,8,0,10,mixedType,1
8,2,0,10,mixedType,1
10,3,0,13,mixedType,1
5,3,0,8,mixedType,1
9,2,0,11,mixedType,1
8,2,0,10,mixedType,1
6,3,0,9,mixedType,1
6,2,0,8,mixedType,1
9,1,0,10,mixedType,1
15,1,0,16,mixedType,2
8,1,0,9,mixedType,1
11,2,0,13,mixedType,1
7,2,0,9,mixedType,1
7,2,0,9,mixedType,1
4,5,0,9,mixedType,1
8,2,0,10,mixedType,1
7,3,0,10,mixedType,1
6,4,0,10,mixedType,1
10,4,6,20,mixedType,2
11,1,0,12,mixedType,1
7,3,0,10,mixedType,1
8,2,0,10,mixedType,1
5,5,0,10,mixedType,1
5,3,0,8,mixedType,1
6,2,0,8,mixedType,1
9,3,0,12,mixedType,1
14,2,0,16,mixedType,2
6,1,0,7,mixedType,0
2,4,0,6,mixedType,0
4,2,0,6,mixedType,0
4,4,0,8,mixedType,1
1,10,0,11,mixedType,1
9,1,0,10,mixedType,1
12,4,0,16,mixedType,2
11,1,0,12,mixedType,1
8,2,0,10,mixedType,1
5,3,0,8,mixedType,1
5,3,0,8,mixedType,1
6,4,0,10,mixedType,1
7,3,0,10,mixedType,1
6,3,0,9,mixedType,1
9,4,0,13,mixedType,1
5,1,0,6,mixedType,0
10,5,1,16,mixedType,2
4,2,0,6,mixedType,0
8,2,0,10,mixedType,1
1,9,0,10,mixedType,1
6,3,0,9,mixedType,1
12,4,0,16,mixedType,2
4,4,0,8,mixedType,1
11,3,0,14,mixedType,2
8,4,0,12,mixedType,1
11,2,0,13,mixedType,1
9,1,0,10,mixedType,1
14,2,0,16,mixedType,2
4,2,0,6,mixedType,0
5,5,0,10,mixedType,1
12,1,0,13,mixedType,1
2,8,0,10,mixedType,1
8,2,0,10,mixedType,1
14,2,0,16,mixedType,2
5,5,0,10,mixedType,1
7,3,0,10,mixedType,1
4,2,0,6,mixedType,0
12,3,0,15,mixedType,2
9,3,0,12,mixedType,1
7,2,0,9,mixedType,1
5,1,0,6,mixedType,0
2,8,0,10,mixedType,1
7,3,0,10,mixedType,1
9,1,0,10,mixedType,1
7,1,0,8,mixedType,1
1,7,0,8,mixedType,1
6,1,0,7,mixedType,0
4,4,0,8,mixedType,1
10,4,0,14,mixedType,2
3,8,0,11,mixedType,1
4,6,0,10,mixedType,1
15,1,0,16,mixedType,2
7,2,0,9,mixedType,1
6,2,0,8,mixedType,1
8,4,0,12,mixedType,1
2,4,0,6,mixedType,0
13,3,0,16,mixedType,2
4,2,0,6,mixedType,0
4,5,0,9,mixedType,1
6,3,0,9,mixedType,1
6,3,0,9,mixedType,1
13,3,0,16,mixedType,2
1,12,0,13,mixedType,1
8,2,0,10,mixedType,1
7,3,0,10,mixedType,1
12,3,0,15,mixedType,2
5,3,0,8,mixedType,1
7,2,0,9,mixedType,1
5,7,0,12,mixedType,1
5,1,0,6,mixedType,0
6,2,0,8,mixedType,1
6,1,0,7,mixedType,0
7,2,0,9,mixedType,1
8,1,0,9,mixedType,1
6,1,0,7,mixedType,0
6,3,0,9,mixedType,1
6,3,0,9,mixedType,1
4,4,0,8,mixedType,1
6,3,0,9,mixedType,1
6,7,0,13,mixedType,1
2,8,0,10,mixedType,1
3,6,0,9,mixedType,1
7,2,0,9,mixedType,1
9,3,0,12,mixedType,1
11,4,0,15,mixedType,2
5,1,0,6,mixedType,0
13,3,0,16,mixedType,2
9,1,0,10,mixedType,1
9,0,1,10,mixedType,1
4,9,0,13,mixedType,1
7,6,0,13,mixedType,1
14,2,0,16,mixedType,2
6,4,0,10,mixedType,1
3,8,0,11,mixedType,1
7,2,0,9,mixedType,1
11,5,0,16,mixedType,2
9,1,0,10,mixedType,1
6,1,0,7,mixedType,0
6,2,0,8,mixedType,1
2,6,0,8,mixedType,1
5,3,0,8,mixedType,1
7,2,0,9,mixedType,1
7,4,0,11,mixedType,1
3,8,0,11,mixedType,1
4,4,0,8,mixedType,1
5,2,0,7,mixedType,0
13,3,0,16,mixedType,2
8,1,0,9,mixedType,1
5,4,0,9,mixedType,1
5,8,0,13,mixedType,1
6,3,0,9,mixedType,1
6,2,0,8,mixedType,1
6,2,0,8,mixedType,1
3,5,0,8,mixedType,1
10,6,0,16,mixedType,2
6,3,0,9,mixedType,1
8,2,0,10,mixedType,1
9,1,0,10,mixedType,1
11,3,0,14,mixedType,2
5,2,0,7,mixedType,0
6,3,0,9,mixedType,1
14,2,0,16,mixedType,2
6,1,0,7,mixedType,0
14,2,0,16,mixedType,2
7,3,0,10,mixedType,1
2,7,0,9,mixedType,1
7,2,0,9,mixedType,1
8,2,0,10,mixedType,1
12,4,0,16,mixedType,2
5,2,0,7,mixedType,0
9,1,0,10,mixedType,1
6,3,0,9,mixedType,1
5,3,0,8,mixedType,1
4,2,0,6,mixedType,0
6,2,0,8,mixedType,1
5,2,0,7,mixedType,0
5,2,0,7,mixedType,0
5,1,0,6,mixedType,0
6,3,0,9,mixedType,1
5,4,0,9,mixedType,1
4,2,0,6,mixedType,0
4,4,0,8,mixedType,1
11,3,0,14,mixedType,2
4,2,0,6,mixedType,0
6,3,0,9,mixedType,1
10,1,0,11,mixedType,1
14,2,0,16,mixedType,2
0,6,1,7,mixedType,0
7,2,0,9,mixedType,1
4,4,0,8,mixedType,1
6,3,0,9,mixedType,1
6,3,0,9,mixedType,1
15,1,0,16,mixedType,2
6,1,0,7,mixedType,0
5,4,0,9,mixedType,1
11,3,0,14,mixedType,2
2,6,0,8,mixedType,1
5,5,0,10,mixedType,1
6,2,0,8,mixedType,1
5,4,0,9,mixedType,1
6,3,0,9,mixedType,1
7,3,0,10,mixedType,1
4,4,0,8,mixedType,1
0,9,1,10,mixedType,1
12,4,0,16,mixedType,2
8,1,0,9,mixedType,1
8,1,0,9,mixedType,1
7,2,0,9,mixedType,1
4,2,0,6,mixedType,0
7,3,0,10,mixedType,1
3,6,0,9,mixedType,1
9,4,0,13,mixedType,1
7,3,0,10,mixedType,1
7,3,0,10,mixedType,1
10,3,0,13,mixedType,1
9,2,0,11,mixedType,1
6,4,0,10,mixedType,1
1,8,0,9,mixedType,1
6,4,0,10,mixedType,1
6,3,0,9,mixedType,1
1,8,0,9,mixedType,1
5,4,0,9,mixedType,1
4,4,0,8,mixedType,1
7,3,0,10,mixedType,1
3,6,0,9,mixedType,1
8,1,0,9,mixedType,1
14,2,0,16,mixedType,2
8,3,0,11,mixedType,1
7,6,0,13,mixedType,1
6,2,0,8,mixedType,1
5,3,0,8,mixedType,1
4,4,0,8,mixedType,1
4,6,0,10,mixedType,1
5,3,0,8,mixedType,1
6,2,0,8,mixedType,1
7,1,0,8,mixedType,1
1,8,0,9,mixedType,1
6,3,0,9,mixedType,1
14,2,0,16,mixedType,2
7,3,0,10,mixedType,1
5,1,0,6,mixedType,0
1,9,0,10,mixedType,1
5,4,0,9,mixedType,1
13,3,0,16,mixedType,2
9,2,0,11,mixedType,1
10,2,0,12,mixedType,1
1,8,0,9,mixedType,1
7,3,0,10,mixedType,1
5,2,0,7,mixedType,0
7,3,0,10,mixedType,1
3,6,0,9,mixedType,1
4,4,0,8,mixedType,1
7,2,0,9,mixedType,1
11,2,0,13,mixedType,1
6,3,0,9,mixedType,1
7,3,0,10,mixedType,1
5,3,0,8,mixedType,1
7,2,0,9,mixedType,1
3,6,0,9,mixedType,1
12,4,0,16,mixedType,2
6,1,0,7,mixedType,0
5,3,0,8,mixedType,1
8,2,0,10,mixedType,1
5,3,0,8,mixedType,1
14,2,0,16,mixedType,2
14,2,0,16,mixedType,2
6,3,0,9,mixedType,1
9,1,0,10,mixedType,1
7,5,0,12,mixedType,1
15,1,0,16,mixedType,2
8,2,0,10,mixedType,1
6,3,0,9,mixedType,1
1,8,0,9,mixedType,1
2,7,0,9,mixedType,1
14,2,0,16,mixedType,2
13,3,0,16,mixedType,2
7,2,0,9,mixedType,1
4,2,0,6,mixedType,0
1,9,0,10,mixedType,1
5,3,0,8,mixedType,1
11,5,0,16,mixedType,2
6,2,0,8,mixedType,1
4,4,0,8,mixedType,1
8,2,0,10,mixedType,1
1,7,0,8,mixedType,1
4,4,0,8,mixedType,1
7,1,0,8,mixedType,1
11,5,0,16,mixedType,2
6,2,0,8,mixedType,1
2,8,0,10,mixedType,1
6,3,0,9,mixedType,1
5,1,0,6,mixedType,0
3,3,0,6,mixedType,0
8,3,0,11,mixedType,1
6,2,0,8,mixedType,1
5,4,0,9,mixedType,1
4,2,0,6,mixedType,0
8,2,0,10,mixedType,1
5,4,0,9,mixedType,1
5,3,0,8,mixedType,1
10,1,0,11,mixedType,1
4,4,0,8,mixedType,1
4,2,0,6,mixedType,0
10,3,0,13,mixedType,1
5,3,0,8,mixedType,1
5,3,0,8,mixedType,1
6,4,0,10,mixedType,1
12,4,0,16,mixedType,2
5,6,0,11,mixedType,1
8,2,0,10,mixedType,1
6,1,0,7,mixedType,0
6,1,0,7,mixedType,0
18,1,1,20,mixedType,2
6,4,0,10,mixedType,1
7,5,0,12,mixedType,1
1,7,0,8,mixedType,1
2,6,0,8,mixedType,1
6,2,0,8,mixedType,1
1,9,0,10,mixedType,1
8,2,0,10,mixedType,1
9,1,0,10,mixedType,1
11,3,0,14,mixedType,2
7,2,0,9,mixedType,1
5,2,0,7,mixedType,0
13,1,1,15,mixedType,2
5,3,0,8,mixedType,1
6,3,0,9,mixedType,1
12,4,0,16,mixedType,2
6,3,0,9,mixedType,1
5,4,0,9,mixedType,1
12,6,2,20,mixedType,2
7,3,0,10,mixedType,1
7,2,0,9,mixedType,1
7,3,0,10,mixedType,1
4,4,0,8,mixedType,1
15,1,0,16,mixedType,2
15,1,0,16,mixedType,2
6,3,0,9,mixedType,1
7,3,0,10,mixedType,1
6,3,0,9,mixedType,1
6,3,0,9,mixedType,1
5,2,0,7,mixedType,0
6,1,0,7,mixedType,0
4,2,0,6,mixedType,0
4,5,0,9,mixedType,1
8,2,0,10,mixedType,1
6,4,0,10,mixedType,1
6,1,0,7,mixedType,0
8,2,0,10,mixedType,1
13,3,0,16,mixedType,2
7,3,0,10,mixedType,1
8,2,0,10,mixedType,1
2,7,0,9,mixedType,1
5,2,0,7,mixedType,0
4,2,0,6,mixedType,0
7,2,0,9,mixedType,1
6,2,0,8,mixedType,1
5,2,0,7,mixedType,0
5,3,0,8,mixedType,1
5,2,0,7,mixedType,0
8,2,0,10,mixedType,1
6,3,0,9,mixedType,1
7,3,0,10,mixedType,1
15,1,1,17,mixedType,2
6,2,0,8,mixedType,1
6,3,0,9,mixedType,1
9,3,0,12,mixedType,1
5,2,0,7,mixedType,0
4,2,0,6,mixedType,0
13,3,0,16,mixedType,2
8,1,0,9,mixedType,1
6,6,0,12,mixedType,1
7,4,0,11,mixedType,1
17,2,1,20,mixedType,2
6,1,0,7,mixedType,0
6,6,0,12,mixedType,1
1,7,0,8,mixedType,1
11,3,0,14,mixedType,2
5,1,0,6,mixedType,0
6,3,0,9,mixedType,1
4,5,0,9,mixedType,1
4,4,0,8,mixedType,1
5,3,0,8,mixedType,1
2,10,0,12,mixedType,1
7,2,0,9,mixedType,1
3,6,0,9,mixedType,1
6,3,0,9,mixedType,1
9,1,0,10,mixedType,1
14,2,0,16,mixedType,2
6,3,0,9,mixedType,1
6,4,0,10,mixedType,1
6,2,0,8,mixedType,1
8,1,0,9,mixedType,1
5,2,0,7,mixedType,0
6,2,0,8,mixedType,1
5,3,0,8,mixedType,1
4,2,0,6,mixedType,0
9,1,0,10,mixedType,1
9,3,0,12,mixedType,1
6,4,0,10,mixedType,1
8,2,0,10,mixedType,1
4,5,0,9,mixedType,1
6,3,0,9,mixedType,1
8,2,0,10,mixedType,1
2,7,0,9,mixedType,1
2,6,0,8,mixedType,1
8,2,0,10,mixedType,1
5,4,0,9,mixedType,1
3,6,0,9,mixedType,1
7,2,0,9,mixedType,1
1,7,0,8,mixedType,1
4,2,0,6,mixedType,0
9,2,0,11,mixedType,1
9,2,0,11,mixedType,1
5,5,0,10,mixedType,1
3,6,0,9,mixedType,1
7,3,0,10,mixedType,1
8,2,0,10,mixedType,1
10,2,0,12,mixedType,1
2,8,0,10,mixedType,1
6,2,0,8,mixedType,1
4,6,0,10,mixedType,1
6,2,0,8,mixedType,1
7,1,0,8,mixedType,1
9,3,0,12,mixedType,1
13,3,0,16,mixedType,2
8,1,0,9,mixedType,1
6,3,0,9,mixedType,1
4,4,0,8,mixedType,1
6,4,0,10,mixedType,1
4,6,0,10,mixedType,1
5,2,0,7,mixedType,0
2,6,0,8,mixedType,1
6,1,0,7,mixedType,0
7,3,0,10,mixedType,1
5,1,0,6,mixedType,0
8,2,0,10,mixedType,1
15,1,0,16,mixedType,2
6,1,0,7,mixedType,0
8,1,0,9,mixedType,1
8,3,0,11,mixedType,1
12,4,0,16,mixedType,2
6,1,0,7,mixedType,0
5,3,0,8,mixedType,1
4,6,0,10,mixedType,1
6,4,0,10,mixedType,1
7,2,0,9,mixedType,1
5,5,0,10,mixedType,1
4,4,0,8,mixedType,1
7,2,0,9,mixedType,1
4,4,0,8,mixedType,1
6,1,0,7,mixedType,0
6,3,0,9,mixedType,1
6,3,0,9,mixedType,1
6,3,0,9,mixedType,1
6,4,0,10,mixedType,1
11,3,0,14,mixedType,2
2,8,0,10,mixedType,1
9,2,0,11,mixedType,1
4,4,0,8,mixedType,1
6,2,0,8,mixedType,1
6,2,0,8,mixedType,1
8,1,0,9,mixedType,1
3,5,0,8,mixedType,1
4,8,0,12,mixedType,1
9,2,0,11,mixedType,1
7,5,0,12,mixedType,1
8,1,0,9,mixedType,1
2,10,0,12,mixedType,1
6,4,0,10,mixedType,1
5,4,0,9,mixedType,1
7,3,0,10,mixedType,1
14,2,0,16,mixedType,2
3,6,0,9,mixedType,1
7,3,0,10,mixedType,1
6,1,0,7,mixedType,0
5,1,0,6,mixedType,0
5,3,0,8,mixedType,1
5,2,0,7,mixedType,0
5,1,0,6,mixedType,0
5,3,0,8,mixedType,1
6,2,0,8,mixedType,1
7,3,0,10,mixedType,1
6,3,0,9,mixedType,1
6,3,0,9,mixedType,1
7,3,0,10,mixedType,1
6,4,0,10,mixedType,1
3,6,0,9,mixedType,1
5,1,0,6,mixedType,0
5,3,0,8,mixedType,1
2,8,0,10,mixedType,1
3,6,0,9,mixedType,1
11,1,0,12,mixedType,1
4,2,0,6,mixedType,0
5,4,0,9,mixedType,1
5,3,0,8,mixedType,1
3,3,0,6,mixedType,0
6,2,0,8,mixedType,1
7,2,0,9,mixedType,1
6,3,0,9,mixedType,1
3,7,0,10,mixedType,1
7,3,0,10,mixedType,1
4,2,0,6,mixedType,0
9,2,0,11,mixedType,1
10,1,0,11,mixedType,1
6,2,0,8,mixedType,1
10,1,0,11,mixedType,1
6,2,0,8,mixedType,1
4,4,0,8,mixedType,1
5,7,0,12,mixedType,1
20,1,1,22,mixedType,2
14,2,0,16,mixedType,2
15,1,0,16,mixedType,2
5,3,0,8,mixedType,1
7,4,0,11,mixedType,1
7,1,0,8,mixedType,1
5,8,0,13,mixedType,1
8,1,0,9,mixedType,1
5,4,0,9,mixedType,1
7,4,0,11,mixedType,1
7,1,0,8,mixedType,1
5,3,0,8,mixedType,1
6,2,0,8,mixedType,1
7,1,0,8,mixedType,1
6,3,0,9,mixedType,1
6,5,0,11,mixedType,1
10,2,0,12,mixedType,1
5,2,0,7,mixedType,0
9,3,0,12,mixedType,1
10,4,0,14,mixedType,2
5,0,0,5,sameType,0
6,1,0,7,mixedType,0
5,3,0,8,mixedType,1
8,4,0,12,mixedType,1
6,2,0,8,mixedType,1
5,2,0,7,mixedType,0
9,2,0,11,mixedType,1
4,2,0,6,mixedType,0
6,3,0,9,mixedType,1
5,1,0,6,mixedType,0
6,4,0,10,mixedType,1
5,6,0,11,mixedType,1
8,7,0,15,mixedType,2
5,2,0,7,mixedType,0
3,6,0,9,mixedType,1
3,6,0,9,mixedType,1
14,2,0,16,mixedType,2
9,1,0,10,mixedType,1
6,8,1,15,mixedType,2
6,3,0,9,mixedType,1
10,4,0,14,mixedType,2
8,1,0,9,mixedType,1
11,1,0,12,mixedType,1
6,1,0,7,mixedType,0
4,2,0,6,mixedType,0
8,2,0,10,mixedType,1
5,2,0,7,mixedType,0
2,6,0,8,mixedType,1
9,2,0,11,mixedType,1
5,2,0,7,mixedType,0
3,10,0,13,mixedType,1
4,2,0,6,mixedType,0
12,3,0,15,mixedType,2
5,1,0,6,mixedType,0
9,2,0,11,mixedType,1
6,4,0,10,mixedType,1
2,6,0,8,mixedType,1
6,6,0,12,mixedType,1
5,3,0,8,mixedType,1
9,1,0,10,mixedType,1
8,1,0,9,mixedType,1
5,3,0,8,mixedType,1
1,9,0,10,mixedType,1
7,3,0,10,mixedType,1
3,3,0,6,mixedType,0
3,7,0,10,mixedType,1
3,6,0,9,mixedType,1
8,2,0,10,mixedType,1
12,4,0,16,mixedType,2
4,6,0,10,mixedType,1
7,3,0,10,mixedType,1
15,1,0,16,mixedType,2
6,3,0,9,mixedType,1
6,3,0,9,mixedType,1
6,3,0,9,mixedType,1
7,3,0,10,mixedType,1
7,1,0,8,mixedType,1
8,1,0,9,mixedType,1
7,3,0,10,mixedType,1
8,2,0,10,mixedType,1
6,2,0,8,mixedType,1
13,3,0,16,mixedType,2
5,3,0,8,mixedType,1
4,5,0,9,mixedType,1
3,6,0,9,mixedType,1
4,2,0,6,mixedType,0
7,3,0,10,mixedType,1
3,6,0,9,mixedType,1
6,3,0,9,mixedType,1
5,2,0,7,mixedType,0
7,2,0,9,mixedType,1
1,7,0,8,mixedType,1
7,2,0,9,mixedType,1
3,6,0,9,mixedType,1
6,3,0,9,mixedType,1
7,2,0,9,mixedType,1
9,2,0,11,mixedType,1
2,6,0,8,mixedType,1
7,3,0,10,mixedType,1
10,2,0,12,mixedType,1
7,1,0,8,mixedType,1
1,8,0,9,mixedType,1
7,3,0,10,mixedType,1
5,4,0,9,mixedType,1
9,2,0,11,mixedType,1
14,2,0,16,mixedType,2
9,2,0,11,mixedType,1
8,1,0,9,mixedType,1
5,1,0,6,mixedType,0
3,8,0,11,mixedType,1
6,2,0,8,mixedType,1
4,4,0,8,mixedType,1
5,6,0,11,mixedType,1
7,2,0,9,mixedType,1
8,2,0,10,mixedType,1
7,6,0,13,mixedType,1
5,7,0,12,mixedType,1
9,1,0,10,mixedType,1
5,3,0,8,mixedType,1
15,1,0,16,mixedType,2
7,3,0,10,mixedType,1
11,1,0,12,mixedType,1
8,2,0,10,mixedType,1
6,3,0,9,mixedType,1
4,2,0,6,mixedType,0
2,6,0,8,mixedType,1
7,2,0,9,mixedType,1
7,3,0,10,mixedType,1
5,2,0,7,mixedType,0
6,3,0,9,mixedType,1
9,2,0,11,mixedType,1
1,8,0,9,mixedType,1
15,1,0,16,mixedType,2
11,3,0,14,mixedType,2
8,2,0,10,mixedType,1
7,3,0,10,mixedType,1
4,6,0,10,mixedType,1
7,1,0,8,mixedType,1
6,2,0,8,mixedType,1
5,2,0,7,mixedType,0
9,1,0,10,mixedType,1
4,4,0,8,mixedType,1
4,4,0,8,mixedType,1
5,2,0,7,mixedType,0
6,3,0,9,mixedType,1
8,2,0,10,mixedType,1
7,3,0,10,mixedType,1
2,6,0,8,mixedType,1
6,3,0,9,mixedType,1
11,3,0,14,mixedType,2
4,4,0,8,mixedType,1
6,2,0,8,mixedType,1
13,3,0,16,mixedType,2
4,6,0,10,mixedType,1
6,5,0,11,mixedType,1
7,3,0,10,mixedType,1
5,4,0,9,mixedType,1
4,4,0,8,mixedType,1
9,4,0,13,mixedType,1
6,1,0,7,mixedType,0
3,6,0,9,mixedType,1
13,3,0,16,mixedType,2
4,2,0,6,mixedType,0
4,2,0,6,mixedType,0
6,4,0,10,mixedType,1
4,5,0,9,mixedType,1
7,3,0,10,mixedType,1
8,1,0,9,mixedType,1
5,2,0,7,mixedType,0
7,4,0,11,mixedType,1
1,8,0,9,mixedType,1
6,3,0,9,mixedType,1
8,1,0,9,mixedType,1
9,3,0,12,mixedType,1
7,1,0,8,mixedType,1
8,1,0,9,mixedType,1
7,2,0,9,mixedType,1
5,3,0,8,mixedType,1
6,4,0,10,mixedType,1
14,2,0,16,mixedType,2
12,4,0,16,mixedType,2
7,2,0,9,mixedType,1
15,2,1,18,mixedType,2
14,2,0,16,mixedType,2
13,3,0,16,mixedType,2
5,3,0,8,mixedType,1
6,4,0,10,mixedType,1
2,6,0,8,mixedType,1
7,8,0,15,mixedType,2
1,8,0,9,mixedType,1
7,2,0,9,mixedType,1
5,6,0,11,mixedType,1
7,1,0,8,mixedType,1
9,1,0,10,mixedType,1
6,3,0,9,mixedType,1
5,7,0,12,mixedType,1
5,1,0,6,mixedType,0
9,2,0,11,mixedType,1
4,5,0,9,mixedType,1
3,5,0,8,mixedType,1
4,2,0,6,mixedType,0
7,2,0,9,mixedType,1
6,1,0,7,mixedType,0
2,8,0,10,mixedType,1
9,1,0,10,mixedType,1
4,4,0,8,mixedType,1
1,10,0,11,mixedType,1
6,1,0,7,mixedType,0
5,1,0,6,mixedType,0
7,3,0,10,mixedType,1
4,2,0,6,mixedType,0
6,3,0,9,mixedType,1
6,2,0,8,mixedType,1
4,2,0,6,mixedType,0
13,3,0,16,mixedType,2
7,1,0,8,mixedType,1
5,2,0,7,mixedType,0
8,1,0,9,mixedType,1
5,6,0,11,mixedType,1
8,5,0,13,mixedType,1
5,3,0,8,mixedType,1
3,6,0,9,mixedType,1
4,7,0,11,mixedType,1
3,7,0,10,mixedType,1
7,6,0,13,mixedType,1
8,2,0,10,mixedType,1
9,3,0,12,mixedType,1
5,2,0,7,mixedType,0
6,3,0,9,mixedType,1
5,7,0,12,mixedType,1
3,6,0,9,mixedType,1
6,4,0,10,mixedType,1
8,2,0,10,mixedType,1
5,1,0,6,mixedType,0
5,5,0,10,mixedType,1
4,7,0,11,mixedType,1
7,2,0,9,mixedType,1
6,4,0,10,mixedType,1
9,3,0,12,mixedType,1
2,8,0,10,mixedType,1
6,4,0,10,mixedType,1
5,8,0,13,mixedType,1
5,4,0,9,mixedType,1
6,4,0,10,mixedType,1
9,4,0,13,mixedType,1
7,3,0,10,mixedType,1
6,1,0,7,mixedType,0
10,4,1,15,mixedType,2
7,3,0,10,mixedType,1
5,5,0,10,mixedType,1
7,2,0,9,mixedType,1
10,2,0,12,mixedType,1
4,5,0,9,mixedType,1
5,2,0,7,mixedType,0
2,8,0,10,mixedType,1
7,3,0,10,mixedType,1
9,1,0,10,mixedType,1
2,7,0,9,mixedType,1
8,1,0,9,mixedType,1
5,2,0,7,mixedType,0
5,1,0,6,mixedType,0
7,3,0,10,mixedType,1
6,2,0,8,mixedType,1
6,2,0,8,mixedType,1
9,2,0,11,mixedType,1
8,3,0,11,mixedType,1
8,2,0,10,mixedType,1
9,1,0,10,mixedType,1
5,3,0,8,mixedType,1
13,3,0,16,mixedType,2
6,2,0,8,mixedType,1
4,2,0,6,mixedType,0
4,4,0,8,mixedType,1
7,5,0,12,mixedType,1
7,3,0,10,mixedType,1
2,4,0,6,mixedType,0
8,2,0,10,mixedType,1
3,6,0,9,mixedType,1
15,1,0,16,mixedType,2
10,1,0,11,mixedType,1
8,3,0,11,mixedType,1
9,4,0,13,mixedType,1
14,2,0,16,mixedType,2
11,3,0,14,mixedType,2
6,3,0,9,mixedType,1
5,3,0,8,mixedType,1
15,1,0,16,mixedType,2
6,1,0,7,mixedType,0
7,5,0,12,mixedType,1
11,3,0,14,mixedType,2
1,6,0,7,mixedType,0
7,3,0,10,mixedType,1
3,7,0,10,mixedType,1
9,1,0,10,mixedType,1
6,1,0,7,mixedType,0
7,1,0,8,mixedType,1
6,2,0,8,mixedType,1
8,4,3,15,mixedType,2
6,1,0,7,mixedType,0
9,2,0,11,mixedType,1
9,3,0,12,mixedType,1
13,3,0,16,mixedType,2
4,6,0,10,mixedType,1
3,10,0,13,mixedType,1
8,2,0,10,mixedType,1
4,4,0,8,mixedType,1
7,2,0,9,mixedType,1
7,2,0,9,mixedType,1
2,7,0,9,mixedType,1
6,1,0,7,mixedType,0
15,1,1,17,mixedType,2
4,4,0,8,mixedType,1
8,1,0,9,mixedType,1
15,1,0,16,mixedType,2
9,1,0,10,mixedType,1
14,2,0,16,mixedType,2
14,2,0,16,mixedType,2
1,8,0,9,mixedType,1
7,2,0,9,mixedType,1
2,6,0,8,mixedType,1
8,1,0,9,mixedType,1
13,3,0,16,mixedType,2
3,6,0,9,mixedType,1
2,7,0,9,mixedType,1
2,4,0,6,mixedType,0
7,3,0,10,mixedType,1
5,2,0,7,mixedType,0
4,4,0,8,mixedType,1
5,1,0,6,mixedType,0
9,3,0,12,mixedType,1
4,4,0,8,mixedType,1
7,3,0,10,mixedType,1
5,4,0,9,mixedType,1
4,4,0,8,mixedType,1
8,1,0,9,mixedType,1
6,3,0,9,mixedType,1
7,2,0,9,mixedType,1
4,2,0,6,mixedType,0
4,4,0,8,mixedType,1
6,3,0,9,mixedType,1
13,3,0,16,mixedType,2
11,3,0,14,mixedType,2
1,8,0,9,mixedType,1
9,2,0,11,mixedType,1
7,2,0,9,mixedType,1
9,1,0,10,mixedType,1
8,1,0,9,mixedType,1
6,2,0,8,mixedType,1
7,3,0,10,mixedType,1
6,3,0,9,mixedType,1
6,2,0,8,mixedType,1
8,2,0,10,mixedType,1
6,3,0,9,mixedType,1
6,2,0,8,mixedType,1
14,2,0,16,mixedType,2
6,4,0,10,mixedType,1
3,6,0,9,mixedType,1
8,1,0,9,mixedType,1
5,2,0,7,mixedType,0
6,6,0,12,mixedType,1
15,1,0,16,mixedType,2
5,0,1,6,mixedType,0
9,2,0,11,mixedType,1
6,2,0,8,mixedType,1
7,3,0,10,mixedType,1
8,2,0,10,mixedType,1
5,2,0,7,mixedType,0
8,2,0,10,mixedType,1
11,1,0,12,mixedType,1
10,1,0,11,mixedType,1
6,3,0,9,mixedType,1
10,2,0,12,mixedType,1
4,2,0,6,mixedType,0
5,2,0,7,mixedType,0
9,4,0,13,mixedType,1
7,1,0,8,mixedType,1
6,1,0,7,mixedType,0
6,2,0,8,mixedType,1
5,4,0,9,mixedType,1
7,3,0,10,mixedType,1
7,3,0,10,mixedType,1
3,3,0,6,mixedType,0
10,2,0,12,mixedType,1
6,2,0,8,mixedType,1
7,1,0,8,mixedType,1
14,2,0,16,mixedType,2
3,9,0,12,mixedType,1
6,3,0,9,mixedType,1
6,1,0,7,mixedType,0
15,1,0,16,mixedType,2
4,4,0,8,mixedType,1
3,5,0,8,mixedType,1
4,4,0,8,mixedType,1
7,2,0,9,mixedType,1
9,1,0,10,mixedType,1
6,6,0,12,mixedType,1
7,2,0,9,mixedType,1
9,3,0,12,mixedType,1
5,3,0,8,mixedType,1
8,0,4,12,mixedType,1
8,2,0,10,mixedType,1
7,2,0,9,mixedType,1
15,1,1,17,mixedType,2
5,4,0,9,mixedType,1
5,3,0,8,mixedType,1
6,4,0,10,mixedType,1
7,2,0,9,mixedType,1
2,10,0,12,mixedType,1
9,1,0,10,mixedType,1
2,7,0,9,mixedType,1
5,3,0,8,mixedType,1
6,3,0,9,mixedType,1
7,2,0,9,mixedType,1
3,7,0,10,mixedType,1
6,4,0,10,mixedType,1
6,3,0,9,mixedType,1
8,2,0,10,mixedType,1
3,7,0,10,mixedType,1
8,3,0,11,mixedType,1
7,3,0,10,mixedType,1
2,7,0,9,mixedType,1
8,1,0,9,mixedType,1
14,2,0,16,mixedType,2
2,8,0,10,mixedType,1
6,2,0,8,mixedType,1
7,4,0,11,mixedType,1
7,3,0,10,mixedType,1
4,2,0,6,mixedType,0
8,1,0,9,mixedType,1
7,6,0,13,mixedType,1
6,6,0,12,mixedType,1
6,3,0,9,mixedType,1
5,3,0,8,mixedType,1
6,1,0,7,mixedType,0
8,4,0,12,mixedType,1
13,3,0,16,mixedType,2
6,6,0,12,mixedType,1
5,1,0,6,mixedType,0
6,4,0,10,mixedType,1
6,3,0,9,mixedType,1
7,3,0,10,mixedType,1
7,1,0,8,mixedType,1
7,1,0,8,mixedType,1
6,2,0,8,mixedType,1
4,6,0,10,mixedType,1
8,3,0,11,mixedType,1
7,2,0,9,mixedType,1
5,2,0,7,mixedType,0
13,3,0,16,mixedType,2
2,4,0,6,mixedType,0
8,1,0,9,mixedType,1
3,6,0,9,mixedType,1
6,3,0,9,mixedType,1
7,2,0,9,mixedType,1
9,2,0,11,mixedType,1
6,3,0,9,mixedType,1
10,1,0,11,mixedType,1
1,8,0,9,mixedType,1
5,6,0,11,mixedType,1
6,1,0,7,mixedType,0
6,1,0,7,mixedType,0
5,4,0,9,mixedType,1
3,5,0,8,mixedType,1
7,3,0,10,mixedType,1
2,8,0,10,mixedType,1
4,2,0,6,mixedType,0
8,2,0,10,mixedType,1
6,2,0,8,mixedType,1
10,3,0,13,mixedType,1
7,1,0,8,mixedType,1
6,3,0,9,mixedType,1
13,3,0,16,mixedType,2
5,3,0,8,mixedType,1
5,3,0,8,mixedType,1
8,1,0,9,mixedType,1
6,0,1,7,mixedType,0
7,2,0,9,mixedType,1
9,2,0,11,mixedType,1
11,5,0,16,mixedType,2
7,2,0,9,mixedType,1
8,1,0,9,mixedType,1
6,4,0,10,mixedType,1
7,3,0,10,mixedType,1
5,3,0,8,mixedType,1
5,2,0,7,mixedType,0
6,3,0,9,mixedType,1
5,3,0,8,mixedType,1
13,3,0,16,mixedType,2
14,2,0,16,mixedType,2
8,1,0,9,mixedType,1
8,3,0,11,mixedType,1
1,8,0,9,mixedType,1
7,3,0,10,mixedType,1
14,2,0,16,mixedType,2
5,3,0,8,mixedType,1
8,1,0,9,mixedType,1
15,1,0,16,mixedType,2
5,5,0,10,mixedType,1
4,4,0,8,mixedType,1
7,6,0,13,mixedType,1
6,3,0,9,mixedType,1
5,2,0,7,mixedType,0
6,2,0,8,mixedType,1
5,3,0,8,mixedType,1
6,4,0,10,mixedType,1
9,1,0,10,mixedType,1
1,5,0,6,mixedType,0
8,2,0,10,mixedType,1
5,4,0,9,mixedType,1
8,3,0,11,mixedType,1
13,3,0,16,mixedType,2
7,1,0,8,mixedType,1
7,1,0,8,mixedType,1
15,1,0,16,mixedType,2
7,3,0,10,mixedType,1
6,3,0,9,mixedType,1
1,7,0,8,mixedType,1
6,1,0,7,mixedType,0
6,1,0,7,mixedType,0
8,2,0,10,mixedType,1
7,1,0,8,mixedType,1
5,4,0,9,mixedType,1
6,3,0,9,mixedType,1
11,3,0,14,mixedType,2
6,4,0,10,mixedType,1
5,4,0,9,mixedType,1
6,3,0,9,mixedType,1
5,3,0,8,mixedType,1
13,3,0,16,mixedType,2
5,1,0,6,mixedType,0
5,2,0,7,mixedType,0
8,1,0,9,mixedType,1
8,2,0,10,mixedType,1
6,0,1,7,mixedType,0
6,3,0,9,mixedType,1
3,5,0,8,mixedType,1
3,7,0,10,mixedType,1
5,4,0,9,mixedType,1
6,1,0,7,mixedType,0
6,2,0,8,mixedType,1
4,6,0,10,mixedType,1
5,3,0,8,mixedType,1
5,4,0,9,mixedType,1
6,3,0,9,mixedType,1
14,2,0,16,mixedType,2
9,4,0,13,mixedType,1
4,6,0,10,mixedType,1
11,2,0,13,mixedType,1
7,1,0,8,mixedType,1
5,0,1,6,mixedType,0
1,8,0,9,mixedType,1
6,2,0,8,mixedType,1
12,4,0,16,mixedType,2
12,4,0,16,mixedType,2
8,3,0,11,mixedType,1
6,4,0,10,mixedType,1
5,4,0,9,mixedType,1
6,2,0,8,mixedType,1
1,7,0,8,mixedType,1
10,1,0,11,mixedType,1
5,3,0,8,mixedType,1
12,3,0,15,mixedType,2
0,7,2,9,mixedType,1
7,3,0,10,mixedType,1
5,2,0,7,mixedType,0
3,3,0,6,mixedType,0
6,2,0,8,mixedType,1
10,2,0,12,mixedType,1
8,1,0,9,mixedType,1
9,2,0,11,mixedType,1
8,4,0,12,mixedType,1
4,4,0,8,mixedType,1
8,2,0,10,mixedType,1
1,11,0,12,mixedType,1
6,2,0,8,mixedType,1
8,4,0,12,mixedType,1
8,2,0,10,mixedType,1
5,4,0,9,mixedType,1
8,1,0,9,mixedType,1
8,2,0,10,mixedType,1
5,6,0,11,mixedType,1
14,2,0,16,mixedType,2
7,3,0,10,mixedType,1
7,3,0,10,mixedType,1
7,3,0,10,mixedType,1
11,3,0,14,mixedType,2
7,1,0,8,mixedType,1
2,7,0,9,mixedType,1
9,7,0,16,mixedType,2
7,2,0,9,mixedType,1
2,6,0,8,mixedType,1
7,3,0,10,mixedType,1
9,4,0,13,mixedType,1
4,2,0,6,mixedType,0
8,2,0,10,mixedType,1
9,3,0,12,mixedType,1
9,4,0,13,mixedType,1
8,3,0,11,mixedType,1
13,3,0,16,mixedType,2
5,6,0,11,mixedType,1
7,2,0,9,mixedType,1
4,6,0,10,mixedType,1
5,3,0,8,mixedType,1
4,5,0,9,mixedType,1
7,3,0,10,mixedType,1
7,3,0,10,mixedType,1
8,3,0,11,mixedType,1
5,3,0,8,mixedType,1
7,3,0,10,mixedType,1
6,1,0,7,mixedType,0
6,3,0,9,mixedType,1
7,3,0,10,mixedType,1
5,6,0,11,mixedType,1
3,6,0,9,mixedType,1
4,2,0,6,mixedType,0
5,3,0,8,mixedType,1
4,2,0,6,mixedType,0
1,8,0,9,mixedType,1
9,3,0,12,mixedType,1
9,1,0,10,mixedType,1
10,2,0,12,mixedType,1
12,1,0,13,mixedType,1
9,2,0,11,mixedType,1
5,6,0,11,mixedType,1
7,4,0,11,mixedType,1
6,4,0,10,mixedType,1
20,5,0,25,mixedType,2
7,3,0,10,mixedType,1
9,3,0,12,mixedType,1
4,4,0,8,mixedType,1
6,5,0,11,mixedType,1
5,3,0,8,mixedType,1
2,7,0,9,mixedType,1
2,8,0,10,mixedType,1
6,2,0,8,mixedType,1
10,6,0,16,mixedType,2
7,2,0,9,mixedType,1
7,3,0,10,mixedType,1
5,2,0,7,mixedType,0
8,4,0,12,mixedType,1
6,1,0,7,mixedType,0
7,1,0,8,mixedType,1
13,3,0,16,mixedType,2
4,4,0,8,mixedType,1
6,4,0,10,mixedType,1
5,3,0,8,mixedType,1
13,3,0,16,mixedType,2
9,1,0,10,mixedType,1
5,2,0,7,mixedType,0
5,8,0,13,mixedType,1
7,2,0,9,mixedType,1
5,2,0,7,mixedType,0
14,2,0,16,mixedType,2
6,4,0,10,mixedType,1
6,1,0,7,mixedType,0
6,7,0,13,mixedType,1
9,1,0,10,mixedType,1
2,8,0,10,mixedType,1
9,1,0,10,mixedType,1
10,1,0,11,mixedType,1
6,3,0,9,mixedType,1
15,1,0,16,mixedType,2
10,1,0,11,mixedType,1
8,1,0,9,mixedType,1
6,2,0,8,mixedType,1
12,3,0,15,mixedType,2
8,1,0,9,mixedType,1
8,8,0,16,mixedType,2
8,1,0,9,mixedType,1
2,7,0,9,mixedType,1
5,2,0,7,mixedType,0
6,4,0,10,mixedType,1
8,5,0,13,mixedType,1
5,0,6,11,mixedType,1
4,6,0,10,mixedType,1
6,3,0,9,mixedType,1
4,2,0,6,mixedType,0
3,8,0,11,mixedType,1
6,2,0,8,mixedType,1
9,3,0,12,mixedType,1
6,1,0,7,mixedType,0
6,3,0,9,mixedType,1
7,4,0,11,mixedType,1
7,3,0,10,mixedType,1
8,3,0,11,mixedType,1
5,1,0,6,mixedType,0
7,2,0,9,mixedType,1
7,1,0,8,mixedType,1
5,3,0,8,mixedType,1
7,4,0,11,mixedType,1
5,2,0,7,mixedType,0
6,2,0,8,mixedType,1
8,4,0,12,mixedType,1
6,3,0,9,mixedType,1
9,2,0,11,mixedType,1
7,2,0,9,mixedType,1
6,2,0,8,mixedType,1
7,5,0,12,mixedType,1
4,6,0,10,mixedType,1
4,2,0,6,mixedType,0
9,1,0,10,mixedType,1
7,2,0,9,mixedType,1
11,1,0,12,mixedType,1
5,4,0,9,mixedType,1
7,1,0,8,mixedType,1
6,5,0,11,mixedType,1
7,2,0,9,mixedType,1
8,2,0,10,mixedType,1
5,7,0,12,mixedType,1
5,1,0,6,mixedType,0
7,2,0,9,mixedType,1
5,3,0,8,mixedType,1
9,3,0,12,mixedType,1
5,4,0,9,mixedType,1
8,1,0,9,mixedType,1
8,3,0,11,mixedType,1
7,8,0,15,mixedType,2
8,3,0,11,mixedType,1
12,3,0,15,mixedType,2
11,5,0,16,mixedType,2
5,5,0,10,mixedType,1
2,8,0,10,mixedType,1
6,3,0,9,mixedType,1
7,3,0,10,mixedType,1
4,5,0,9,mixedType,1
4,4,0,8,mixedType,1
6,2,0,8,mixedType,1
3,3,0,6,mixedType,0
4,2,0,6,mixedType,0
12,4,0,16,mixedType,2
9,1,0,10,mixedType,1
10,1,0,11,mixedType,1
7,2,0,9,mixedType,1
12,3,0,15,mixedType,2
6,3,0,9,mixedType,1
8,3,0,11,mixedType,1
12,3,0,15,mixedType,2
6,2,0,8,mixedType,1
1,8,0,9,mixedType,1
7,2,0,9,mixedType,1
6,3,0,9,mixedType,1
1,8,0,9,mixedType,1
5,1,0,6,mixedType,0
10,1,0,11,mixedType,1
6,1,0,7,mixedType,0
6,2,0,8,mixedType,1
8,2,0,10,mixedType,1
3,6,0,9,mixedType,1
5,2,0,7,mixedType,0
3,8,0,11,mixedType,1
7,2,0,9,mixedType,1
4,6,0,10,mixedType,1
7,4,0,11,mixedType,1
8,2,0,10,mixedType,1
5,2,0,7,mixedType,0
7,3,0,10,mixedType,1
7,3,0,10,mixedType,1
5,4,0,9,mixedType,1
5,3,0,8,mixedType,1
5,3,0,8,mixedType,1
3,6,0,9,mixedType,1
5,6,0,11,mixedType,1
6,3,0,9,mixedType,1
6,4,0,10,mixedType,1
9,3,0,12,mixedType,1
6,1,0,7,mixedType,0
13,3,0,16,mixedType,2
13,3,0,16,mixedType,2
6,1,0,7,mixedType,0
2,7,0,9,mixedType,1
12,3,0,15,mixedType,2
7,2,0,9,mixedType,1
7,3,0,10,mixedType,1
11,2,0,13,mixedType,1
5,1,0,6,mixedType,0
6,3,0,9,mixedType,1
8,2,0,10,mixedType,1
7,4,0,11,mixedType,1
6,3,0,9,mixedType,1
2,8,0,10,mixedType,1
14,2,0,16,mixedType,2
4,6,0,10,mixedType,1
7,2,0,9,mixedType,1
5,3,0,8,mixedType,1
6,4,0,10,mixedType,1
5,0,0,5,sameType,0
8,1,0,9,mixedType,1
6,1,0,7,mixedType,0
8,2,0,10,mixedType,1
9,1,0,10,mixedType,1
7,3,0,10,mixedType,1
14,2,0,16,mixedType,2
6,4,0,10,mixedType,1
11,3,0,14,mixedType,2
5,2,0,7,mixedType,0
7,3,0,10,mixedType,1
7,3,0,10,mixedType,1
5,2,0,7,mixedType,0
8,1,0,9,mixedType,1
14,2,0,16,mixedType,2
11,2,1,14,mixedType,2
6,1,0,7,mixedType,0
7,2,0,9,mixedType,1
8,2,0,10,mixedType,1
6,1,0,7,mixedType,0
8,2,0,10,mixedType,1
4,7,0,11,mixedType,1
6,4,0,10,mixedType,1
10,3,0,13,mixedType,1
8,1,0,9,mixedType,1
8,0,2,10,mixedType,1
8,2,0,10,mixedType,1
4,6,0,10,mixedType,1
11,3,0,14,mixedType,2
8,2,0,10,mixedType,1
1,5,0,6,mixedType,0
5,2,0,7,mixedType,0
11,3,0,14,mixedType,2
6,1,0,7,mixedType,0
7,5,0,12,mixedType,1
6,6,0,12,mixedType,1
7,1,0,8,mixedType,1
7,2,0,9,mixedType,1
9,3,0,12,mixedType,1
3,6,0,9,mixedType,1
6,3,0,9,mixedType,1
4,10,0,14,mixedType,2
8,2,0,10,mixedType,1
6,7,0,13,mixedType,1
3,7,0,10,mixedType,1
7,6,0,13,mixedType,1
15,1,0,16,mixedType,2
13,3,0,16,mixedType,2
4,4,0,8,mixedType,1
5,2,0,7,mixedType,0
9,5,0,14,mixedType,2
6,4,0,10,mixedType,1
7,3,0,10,mixedType,1
9,1,0,10,mixedType,1
5,3,0,8,mixedType,1
8,1,0,9,mixedType,1
1,8,0,9,mixedType,1
7,4,0,11,mixedType,1
6,4,0,10,mixedType,1
5,4,0,9,mixedType,1
8,2,0,10,mixedType,1
8,1,0,9,mixedType,1
1,9,0,10,mixedType,1
6,1,0,7,mixedType,0
8,1,0,9,mixedType,1
6,3,0,9,mixedType,1
8,2,0,10,mixedType,1
5,2,0,7,mixedType,0
5,8,0,13,mixedType,1
5,1,0,6,mixedType,0
5,3,0,8,mixedType,1
9,1,0,10,mixedType,1
14,2,0,16,mixedType,2
4,2,0,6,mixedType,0
5,3,0,8,mixedType,1
7,3,0,10,mixedType,1
8,2,0,10,mixedType,1
5,2,0,7,mixedType,0
5,2,0,7,mixedType,0
7,2,0,9,mixedType,1
3,3,0,6,mixedType,0
9,3,0,12,mixedType,1
1,8,0,9,mixedType,1
5,7,0,12,mixedType,1
4,4,0,8,mixedType,1
6,3,0,9,mixedType,1
3,6,0,9,mixedType,1
5,4,0,9,mixedType,1
6,6,0,12,mixedType,1
15,4,0,19,mixedType,2
7,1,0,8,mixedType,1
7,4,0,11,mixedType,1
1,9,0,10,mixedType,1
6,4,0,10,mixedType,1
9,3,0,12,mixedType,1
12,4,0,16,mixedType,2
6,4,0,10,mixedType,1
6,1,0,7,mixedType,0
5,4,0,9,mixedType,1
6,3,0,9,mixedType,1
4,4,0,8,mixedType,1
7,9,0,16,mixedType,2
5,3,0,8,mixedType,1
6,3,0,9,mixedType,1
6,1,0,7,mixedType,0
5,4,0,9,mixedType,1
7,2,0,9,mixedType,1
5,3,0,8,mixedType,1
2,4,0,6,mixedType,0
6,4,0,10,mixedType,1
7,3,0,10,mixedType,1
3,9,3,15,mixedType,2
4,4,0,8,mixedType,1
5,3,0,8,mixedType,1
7,2,0,9,mixedType,1
3,3,0,6,mixedType,0
4,4,0,8,mixedType,1
14,1,1,16,mixedType,2
5,3,0,8,mixedType,1
1,9,0,10,mixedType,1
6,1,0,7,mixedType,0
4,8,0,12,mixedType,1
14,2,0,16,mixedType,2
5,2,0,7,mixedType,0
3,8,0,11,mixedType,1
6,6,0,12,mixedType,1
13,3,0,16,mixedType,2
2,8,0,10,mixedType,1
5,3,0,8,mixedType,1
9,1,0,10,mixedType,1
3,5,0,8,mixedType,1
3,6,0,9,mixedType,1
9,1,0,10,mixedType,1
6,2,0,8,mixedType,1
14,2,0,16,mixedType,2
7,1,0,8,mixedType,1
1,8,0,9,mixedType,1
4,2,0,6,mixedType,0
7,3,0,10,mixedType,1
8,2,0,10,mixedType,1
5,2,0,7,mixedType,0
6,3,0,9,mixedType,1
4,6,0,10,mixedType,1
9,2,0,11,mixedType,1
5,2,0,7,mixedType,0
9,1,0,10,mixedType,1
15,1,0,16,mixedType,2
5,4,0,9,mixedType,1
10,1,0,11,mixedType,1
11,3,0,14,mixedType,2
4,8,0,12,mixedType,1
6,4,0,10,mixedType,1
7,2,0,9,mixedType,1
5,3,0,8,mixedType,1
5,4,0,9,mixedType,1
6,2,0,8,mixedType,1
8,1,0,9,mixedType,1
3,3,0,6,mixedType,0
4,4,0,8,mixedType,1
3,3,0,6,mixedType,0
7,2,0,9,mixedType,1
5,6,0,11,mixedType,1
3,8,0,11,mixedType,1
5,3,0,8,mixedType,1
7,4,0,11,mixedType,1
5,3,0,8,mixedType,1
5,4,0,9,mixedType,1
5,4,0,9,mixedType,1
9,1,0,10,mixedType,1
8,3,0,11,mixedType,1
5,4,0,9,mixedType,1
8,6,0,14,mixedType,2
5,4,0,9,mixedType,1
9,3,0,12,mixedType,1
5,2,0,7,mixedType,0
7,3,0,10,mixedType,1
7,2,0,9,mixedType,1
4,6,0,10,mixedType,1
15,1,0,16,mixedType,2
14,2,0,16,mixedType,2
8,2,0,10,mixedType,1
5,4,0,9,mixedType,1
7,3,0,10,mixedType,1
5,6,0,11,mixedType,1
5,6,0,11,mixedType,1
6,2,0,8,mixedType,1
1,8,0,9,mixedType,1
6,1,0,7,mixedType,0
8,1,0,9,mixedType,1
1,7,0,8,mixedType,1
4,4,0,8,mixedType,1
8,1,0,9,mixedType,1
7,2,0,9,mixedType,1
14,2,0,16,mixedType,2
6,6,0,12,mixedType,1
5,4,0,9,mixedType,1
7,2,0,9,mixedType,1
8,3,0,11,mixedType,1
4,8,0,12,mixedType,1
9,3,0,12,mixedType,1
14,2,0,16,mixedType,2
13,4,0,17,mixedType,2
6,4,0,10,mixedType,1
6,4,0,10,mixedType,1
9,2,0,11,mixedType,1
9,2,0,11,mixedType,1
5,3,0,8,mixedType,1
7,3,0,10,mixedType,1
6,0,1,7,mixedType,0
5,5,0,10,mixedType,1
4,4,0,8,mixedType,1
14,2,0,16,mixedType,2
1,7,0,8,mixedType,1
2,6,0,8,mixedType,1
6,1,0,7,mixedType,0
3,5,0,8,mixedType,1
3,8,0,11,mixedType,1
0,8,1,9,mixedType,1
5,2,0,7,mixedType,0
5,2,0,7,mixedType,0
9,1,0,10,mixedType,1
9,1,0,10,mixedType,1
6,3,0,9,mixedType,1
6,1,0,7,mixedType,0
16,4,0,20,mixedType,2
2,7,0,9,mixedType,1
2,8,0,10,mixedType,1
12,3,0,15,mixedType,2
5,4,0,9,mixedType,1
7,2,0,9,mixedType,1
0,7,0,7,sameType,0
3,8,0,11,mixedType,1
8,1,0,9,mixedType,1
15,1,0,16,mixedType,2
5,3,0,8,mixedType,1
12,3,0,15,mixedType,2
9,1,0,10,mixedType,1
4,2,0,6,mixedType,0
15,1,0,16,mixedType,2
5,2,0,7,mixedType,0
9,1,0,10,mixedType,1
7,2,0,9,mixedType,1
3,5,0,8,mixedType,1
5,1,0,6,mixedType,0
6,3,0,9,mixedType,1
4,4,0,8,mixedType,1
9,3,0,12,mixedType,1
6,1,0,7,mixedType,0
12,3,0,15,mixedType,2
13,3,0,16,mixedType,2
6,1,0,7,mixedType,0
5,3,0,8,mixedType,1
4,2,0,6,mixedType,0
2,9,0,11,mixedType,1
6,5,0,11,mixedType,1
6,3,0,9,mixedType,1
2,8,0,10,mixedType,1
1,9,0,10,mixedType,1
14,1,1,16,mixedType,2
4,2,0,6,mixedType,0
3,6,0,9,mixedType,1
13,2,0,15,mixedType,2
2,7,0,9,mixedType,1
14,2,0,16,mixedType,2
1,10,0,11,mixedType,1
6,2,0,8,mixedType,1
4,4,0,8,mixedType,1
8,2,0,10,mixedType,1
4,4,0,8,mixedType,1
6,3,0,9,mixedType,1
7,2,0,9,mixedType,1
6,3,0,9,mixedType,1
7,3,0,10,mixedType,1
10,0,1,11,mixedType,1
7,3,0,10,mixedType,1
5,6,0,11,mixedType,1
5,6,0,11,mixedType,1
4,4,0,8,mixedType,1
8,2,0,10,mixedType,1
9,4,0,13,mixedType,1
3,7,0,10,mixedType,1
6,3,0,9,mixedType,1
5,3,0,8,mixedType,1
7,2,0,9,mixedType,1
6,2,0,8,mixedType,1
6,2,0,8,mixedType,1
7,1,0,8,mixedType,1
7,3,0,10,mixedType,1
3,3,0,6,mixedType,0
7,1,0,8,mixedType,1
5,3,0,8,mixedType,1
6,3,0,9,mixedType,1
9,1,0,10,mixedType,1
8,2,0,10,mixedType,1
5,3,0,8,mixedType,1
6,4,0,10,mixedType,1
6,3,0,9,mixedType,1
7,2,0,9,mixedType,1
9,2,0,11,mixedType,1
5,2,0,7,mixedType,0
11,3,0,14,mixedType,2
12,4,0,16,mixedType,2
5,2,0,7,mixedType,0
8,2,0,10,mixedType,1
6,2,0,8,mixedType,1
7,2,0,9,mixedType,1
8,1,0,9,mixedType,1
7,1,0,8,mixedType,1
3,7,0,10,mixedType,1
10,2,0,12,mixedType,1
8,2,0,10,mixedType,1
5,5,0,10,mixedType,1
5,3,0,8,mixedType,1
4,4,0,8,mixedType,1
7,4,0,11,mixedType,1
5,1,0,6,mixedType,0
9,2,0,11,mixedType,1
5,2,0,7,mixedType,0
4,8,0,12,mixedType,1
10,0,1,11,mixedType,1
5,8,0,13,mixedType,1
2,4,0,6,mixedType,0
6,3,0,9,mixedType,1
14,2,0,16,mixedType,2
6,2,0,8,mixedType,1
3,6,0,9,mixedType,1
11,2,0,13,mixedType,1
6,3,0,9,mixedType,1
9,3,0,12,mixedType,1
5,1,0,6,mixedType,0
10,6,0,16,mixedType,2
5,2,0,7,mixedType,0
3,8,0,11,mixedType,1
4,5,0,9,mixedType,1
7,3,0,10,mixedType,1
5,3,0,8,mixedType,1
13,3,0,16,mixedType,2
14,2,0,16,mixedType,2
8,1,0,9,mixedType,1
6,1,0,7,mixedType,0
10,2,0,12,mixedType,1
9,2,0,11,mixedType,1
6,1,0,7,mixedType,0
4,4,0,8,mixedType,1
7,3,0,10,mixedType,1
4,4,0,8,mixedType,1
7,3,0,10,mixedType,1
6,1,0,7,mixedType,0
6,3,0,9,mixedType,1
5,4,0,9,mixedType,1
5,1,0,6,mixedType,0
11,3,0,14,mixedType,2
7,3,0,10,mixedType,1
4,4,0,8,mixedType,1
6,1,0,7,mixedType,0
6,1,0,7,mixedType,0
9,1,0,10,mixedType,1
4,2,0,6,mixedType,0
4,2,0,6,mixedType,0
7,2,0,9,mixedType,1
6,3,0,9,mixedType,1
6,1,0,7,mixedType,0
14,2,0,16,mixedType,2
7,3,0,10,mixedType,1
10,3,0,13,mixedType,1
8,1,0,9,mixedType,1
6,3,0,9,mixedType,1
5,3,0,8,mixedType,1
1,7,0,8,mixedType,1
9,3,0,12,mixedType,1
2,6,0,8,mixedType,1
6,2,0,8,mixedType,1
4,2,0,6,mixedType,0
13,3,0,16,mixedType,2
6,3,0,9,mixedType,1
8,3,0,11,mixedType,1
13,3,0,16,mixedType,2
13,3,0,16,mixedType,2
14,2,0,16,mixedType,2
4,2,0,6,mixedType,0
6,2,0,8,mixedType,1
5,4,0,9,mixedType,1
4,4,0,8,mixedType,1
7,1,0,8,mixedType,1
7,4,0,11,mixedType,1
3,6,0,9,mixedType,1
7,3,0,10,mixedType,1
7,5,0,12,mixedType,1
6,1,0,7,mixedType,0
6,3,0,9,mixedType,1
16,1,2,19,mixedType,2
6,5,0,11,mixedType,1
7,3,0,10,mixedType,1
8,2,0,10,mixedType,1
6,3,0,9,mixedType,1
11,2,0,13,mixedType,1
11,3,0,14,mixedType,2
4,4,0,8,mixedType,1
13,3,0,16,mixedType,2
8,2,0,10,mixedType,1
6,4,0,10,mixedType,1
6,4,0,10,mixedType,1
6,2,0,8,mixedType,1
8,2,0,10,mixedType,1
4,6,0,10,mixedType,1
7,3,0,10,mixedType,1
2,4,0,6,mixedType,0
5,3,0,8,mixedType,1
10,2,0,12,mixedType,1
2,4,0,6,mixedType,0
5,4,0,9,mixedType,1
5,5,0,10,mixedType,1
9,3,0,12,mixedType,1
6,2,0,8,mixedType,1
6,2,0,8,mixedType,1
8,1,0,9,mixedType,1
1,11,0,12,mixedType,1
4,4,0,8,mixedType,1
12,4,0,16,mixedType,2
11,2,0,13,mixedType,1
9,1,0,10,mixedType,1
4,5,0,9,mixedType,1
5,1,0,6,mixedType,0
5,1,0,6,mixedType,0
4,4,0,8,mixedType,1
5,1,0,6,mixedType,0
8,4,0,12,mixedType,1
14,2,0,16,mixedType,2
4,6,0,10,mixedType,1
8,4,0,12,mixedType,1
9,2,0,11,mixedType,1
5,1,0,6,mixedType,0
4,2,0,6,mixedType,0
9,3,0,12,mixedType,1
5,5,0,10,mixedType,1
10,1,0,11,mixedType,1
8,3,0,11,mixedType,1
4,4,0,8,mixedType,1
5,2,0,7,mixedType,0
10,1,0,11,mixedType,1
6,2,0,8,mixedType,1
14,2,0,16,mixedType,2
2,4,0,6,mixedType,0
13,4,0,17,mixedType,2
6,4,0,10,mixedType,1
1,7,0,8,mixedType,1
4,4,0,8,mixedType,1
5,3,0,8,mixedType,1
4,2,0,6,mixedType,0
2,7,0,9,mixedType,1
7,3,0,10,mixedType,1
6,1,0,7,mixedType,0
8,4,0,12,mixedType,1
8,5,3,16,mixedType,2
6,3,0,9,mixedType,1
6,3,0,9,mixedType,1
8,1,0,9,mixedType,1
14,4,2,20,mixedType,2
5,1,0,6,mixedType,0
3,5,0,8,mixedType,1
4,2,0,6,mixedType,0
7,3,0,10,mixedType,1
5,3,0,8,mixedType,1
9,1,0,10,mixedType,1
6,3,0,9,mixedType,1
2,4,0,6,mixedType,0
7,3,0,10,mixedType,1
5,1,0,6,mixedType,0
7,3,0,10,mixedType,1
15,1,0,16,mixedType,2
7,4,0,11,mixedType,1
7,4,0,11,mixedType,1
5,4,0,9,mixedType,1
7,3,0,10,mixedType,1
4,4,0,8,mixedType,1
5,4,0,9,mixedType,1
6,3,0,9,mixedType,1
7,3,0,10,mixedType,1
7,1,0,8,mixedType,1
9,1,0,10,mixedType,1
10,2,0,12,mixedType,1
14,2,0,16,mixedType,2
8,1,0,9,mixedType,1
7,3,0,10,mixedType,1
8,4,0,12,mixedType,1
6,3,0,9,mixedType,1
8,2,0,10,mixedType,1
6,3,0,9,mixedType,1
2,6,0,8,mixedType,1
5,2,0,7,mixedType,0
4,2,0,6,mixedType,0
1,8,0,9,mixedType,1
7,3,0,10,mixedType,1
12,3,0,15,mixedType,2
7,2,0,9,mixedType,1
7,2,0,9,mixedType,1
6,3,0,9,mixedType,1
3,6,0,9,mixedType,1
11,3,0,14,mixedType,2
5,4,0,9,mixedType,1
6,3,0,9,mixedType,1
8,3,0,11,mixedType,1
6,6,0,12,mixedType,1
4,4,0,8,mixedType,1
9,1,0,10,mixedType,1
2,8,0,10,mixedType,1
1,8,0,9,mixedType,1
10,2,0,12,mixedType,1
13,3,0,16,mixedType,2
5,2,0,7,mixedType,0
4,5,0,9,mixedType,1
2,6,0,8,mixedType,1
5,1,0,6,mixedType,0
4,4,0,8,mixedType,1
1,8,0,9,mixedType,1
9,3,0,12,mixedType,1
4,2,0,6,mixedType,0
11,5,0,16,mixedType,2
4,8,0,12,mixedType,1
5,3,0,8,mixedType,1
12,4,0,16,mixedType,2
3,5,0,8,mixedType,1
4,5,0,9,mixedType,1
4,2,0,6,mixedType,0
6,3,0,9,mixedType,1
5,2,0,7,mixedType,0
6,4,0,10,mixedType,1
4,6,0,10,mixedType,1
4,4,0,8,mixedType,1
7,3,0,10,mixedType,1
4,4,0,8,mixedType,1
7,3,0,10,mixedType,1
7,2,0,9,mixedType,1
9,2,0,11,mixedType,1
9,1,0,10,mixedType,1
8,1,0,9,mixedType,1
6,1,0,7,mixedType,0
9,2,0,11,mixedType,1
7,6,0,13,mixedType,1
6,3,0,9,mixedType,1
6,4,0,10,mixedType,1
6,2,0,8,mixedType,1
3,3,0,6,mixedType,0
7,1,0,8,mixedType,1
12,4,0,16,mixedType,2
12,3,0,15,mixedType,2
11,2,0,13,mixedType,1
3,7,0,10,mixedType,1
5,2,0,7,mixedType,0
6,3,0,9,mixedType,1
7,2,0,9,mixedType,1
7,3,0,10,mixedType,1
7,2,0,9,mixedType,1
2,4,0,6,mixedType,0
8,3,0,11,mixedType,1
7,1,0,8,mixedType,1
4,4,0,8,mixedType,1
3,5,0,8,mixedType,1
7,2,0,9,mixedType,1
15,1,0,16,mixedType,2
6,3,0,9,mixedType,1
7,4,0,11,mixedType,1
9,4,0,13,mixedType,1
7,2,0,9,mixedType,1
4,4,0,8,mixedType,1
8,2,0,10,mixedType,1
8,1,0,9,mixedType,1
5,3,0,8,mixedType,1
6,1,0,7,mixedType,0
6,2,0,8,mixedType,1
4,4,0,8,mixedType,1
11,5,0,16,mixedType,2
10,1,0,11,mixedType,1
14,2,0,16,mixedType,2
11,3,0,14,mixedType,2
14,2,0,16,mixedType,2
2,7,0,9,mixedType,1
7,2,0,9,mixedType,1
5,2,0,7,mixedType,0
8,3,0,11,mixedType,1
12,4,0,16,mixedType,2
6,2,0,8,mixedType,1
13,3,0,16,mixedType,2
9,3,0,12,mixedType,1
11,1,0,12,mixedType,1
9,1,0,10,mixedType,1
9,3,0,12,mixedType,1
7,4,0,11,mixedType,1
2,6,0,8,mixedType,1
11,2,0,13,mixedType,1
4,2,0,6,mixedType,0
7,2,0,9,mixedType,1
5,4,0,9,mixedType,1
7,1,0,8,mixedType,1
6,2,0,8,mixedType,1
7,2,0,9,mixedType,1
13,3,0,16,mixedType,2
8,1,0,9,mixedType,1
4,4,0,8,mixedType,1
8,1,0,9,mixedType,1
7,1,0,8,mixedType,1
7,3,0,10,mixedType,1
4,4,0,8,mixedType,1
5,2,0,7,mixedType,0
12,3,0,15,mixedType,2
7,3,0,10,mixedType,1
8,2,0,10,mixedType,1
7,3,0,10,mixedType,1
5,5,0,10,mixedType,1
5,2,0,7,mixedType,0
7,4,0,11,mixedType,1
9,1,0,10,mixedType,1
13,3,0,16,mixedType,2
6,1,0,7,mixedType,0
8,1,0,9,mixedType,1
9,3,0,12,mixedType,1
8,1,0,9,mixedType,1
5,3,0,8,mixedType,1
3,5,0,8,mixedType,1
13,3,0,16,mixedType,2
7,4,0,11,mixedType,1
4,6,0,10,mixedType,1
9,3,0,12,mixedType,1
9,1,0,10,mixedType,1
2,8,0,10,mixedType,1
8,3,0,11,mixedType,1
7,2,0,9,mixedType,1
7,3,0,10,mixedType,1
7,2,0,9,mixedType,1
6,3,0,9,mixedType,1
4,4,0,8,mixedType,1
14,2,0,16,mixedType,2
8,1,0,9,mixedType,1
6,4,0,10,mixedType,1
5,4,0,9,mixedType,1
7,2,0,9,mixedType,1
8,4,0,12,mixedType,1
5,2,0,7,mixedType,0
7,6,0,13,mixedType,1
5,2,0,7,mixedType,0
6,2,0,8,mixedType,1
6,1,0,7,mixedType,0
7,1,0,8,mixedType,1
7,4,0,11,mixedType,1
6,2,0,8,mixedType,1
2,4,0,6,mixedType,0
4,4,0,8,mixedType,1
8,2,0,10,mixedType,1
5,8,0,13,mixedType,1
15,1,0,16,mixedType,2
5,5,0,10,mixedType,1
9,3,0,12,mixedType,1
14,2,0,16,mixedType,2
5,3,0,8,mixedType,1
6,4,0,10,mixedType,1
6,2,0,8,mixedType,1
14,2,0,16,mixedType,2
15,1,0,16,mixedType,2
4,4,0,8,mixedType,1
2,8,0,10,mixedType,1
5,3,0,8,mixedType,1
5,2,0,7,mixedType,0
14,2,0,16,mixedType,2
7,6,0,13,mixedType,1
4,2,0,6,mixedType,0
9,2,0,11,mixedType,1
3,6,0,9,mixedType,1
8,1,0,9,mixedType,1
12,0,1,13,mixedType,1
8,1,0,9,mixedType,1
5,3,0,8,mixedType,1
7,3,0,10,mixedType,1
8,2,0,10,mixedType,1
5,1,0,6,mixedType,0
14,2,0,16,mixedType,2
1,9,0,10,mixedType,1
7,3,0,10,mixedType,1
1,8,0,9,mixedType,1
5,1,0,6,mixedType,0
10,2,0,12,mixedType,1
6,3,0,9,mixedType,1
5,1,0,6,mixedType,0
7,1,0,8,mixedType,1
6,4,0,10,mixedType,1
5,2,0,7,mixedType,0
7,1,0,8,mixedType,1
5,6,0,11,mixedType,1
6,3,0,9,mixedType,1
14,2,0,16,mixedType,2
4,9,0,13,mixedType,1
15,1,0,16,mixedType,2
9,1,0,10,mixedType,1
5,2,0,7,mixedType,0
3,8,0,11,mixedType,1
6,2,0,8,mixedType,1
7,3,0,10,mixedType,1
4,2,0,6,mixedType,0
12,4,0,16,mixedType,2
4,7,0,11,mixedType,1
7,1,0,8,mixedType,1
6,2,0,8,mixedType,1
9,2,0,11,mixedType,1
4,4,0,8,mixedType,1
4,2,0,6,mixedType,0
7,4,0,11,mixedType,1
9,4,0,13,mixedType,1
14,2,0,16,mixedType,2
6,1,0,7,mixedType,0
6,1,0,7,mixedType,0
14,2,0,16,mixedType,2
15,1,0,16,mixedType,2
9,1,0,10,mixedType,1
4,4,0,8,mixedType,1
14,2,0,16,mixedType,2
7,3,0,10,mixedType,1
8,2,0,10,mixedType,1
5,2,0,7,mixedType,0
1,9,0,10,mixedType,1
9,4,2,15,mixedType,2
6,2,0,8,mixedType,1
7,1,0,8,mixedType,1
9,0,1,10,mixedType,1
12,1,0,13,mixedType,1
8,4,0,12,mixedType,1
8,3,0,11,mixedType,1
5,4,0,9,mixedType,1
2,10,0,12,mixedType,1
10,1,0,11,mixedType,1
4,2,0,6,mixedType,0
5,4,0,9,mixedType,1
8,2,0,10,mixedType,1
6,2,0,8,mixedType,1
10,2,0,12,mixedType,1
1,8,0,9,mixedType,1
8,1,0,9,mixedType,1
8,1,0,9,mixedType,1
5,5,0,10,mixedType,1
2,6,0,8,mixedType,1
12,3,0,15,mixedType,2
6,3,0,9,mixedType,1
8,2,0,10,mixedType,1
14,2,0,16,mixedType,2
10,1,0,11,mixedType,1
14,2,0,16,mixedType,2
7,1,0,8,mixedType,1
7,6,0,13,mixedType,1
9,3,0,12,mixedType,1
14,2,0,16,mixedType,2
5,6,0,11,mixedType,1
12,4,0,16,mixedType,2
4,6,0,10,mixedType,1
6,1,0,7,mixedType,0
6,6,0,12,mixedType,1
10,3,1,14,mixedType,2
5,2,0,7,mixedType,0
6,2,0,8,mixedType,1
10,6,0,16,mixedType,2
8,1,0,9,mixedType,1
6,2,0,8,mixedType,1
12,3,0,15,mixedType,2
6,6,0,12,mixedType,1
11,5,0,16,mixedType,2
2,7,0,9,mixedType,1
7,4,0,11,mixedType,1
5,2,0,7,mixedType,0
6,2,0,8,mixedType,1
11,3,0,14,mixedType,2
7,2,0,9,mixedType,1
3,5,0,8,mixedType,1
4,2,0,6,mixedType,0
5,4,0,9,mixedType,1
11,1,0,12,mixedType,1
8,1,0,9,mixedType,1
5,7,0,12,mixedType,1
6,3,0,9,mixedType,1
2,8,0,10,mixedType,1
9,1,0,10,mixedType,1
14,2,0,16,mixedType,2
4,4,0,8,mixedType,1
7,1,0,8,mixedType,1
3,6,0,9,mixedType,1
5,7,0,12,mixedType,1
14,2,0,16,mixedType,2
6,4,0,10,mixedType,1
8,2,0,10,mixedType,1
6,3,0,9,mixedType,1
8,4,0,12,mixedType,1
9,3,0,12,mixedType,1
7,3,0,10,mixedType,1
4,8,0,12,mixedType,1
1,8,0,9,mixedType,1
4,4,0,8,mixedType,1
10,3,0,13,mixedType,1
7,3,0,10,mixedType,1
3,5,0,8,mixedType,1
5,3,0,8,mixedType,1
10,2,0,12,mixedType,1
7,3,0,10,mixedType,1
6,3,0,9,mixedType,1
6,4,0,10,mixedType,1
9,4,1,14,mixedType,2
3,6,0,9,mixedType,1
14,2,0,16,mixedType,2
14,2,0,16,mixedType,2
15,1,0,16,mixedType,2
5,3,0,8,mixedType,1
10,2,0,12,mixedType,1
5,4,0,9,mixedType,1
15,1,0,16,mixedType,2
8,2,0,10,mixedType,1
9,2,0,11,mixedType,1
13,3,0,16,mixedType,2
7,3,0,10,mixedType,1
4,6,0,10,mixedType,1
7,3,0,10,mixedType,1
8,1,0,9,mixedType,1
6,2,0,8,mixedType,1
1,8,0,9,mixedType,1
1,8,0,9,mixedType,1
14,2,0,16,mixedType,2
5,3,0,8,mixedType,1
14,2,0,16,mixedType,2
5,3,0,8,mixedType,1
8,2,0,10,mixedType,1
8,2,0,10,mixedType,1
5,2,0,7,mixedType,0
6,2,0,8,mixedType,1
1,8,0,9,mixedType,1
15,1,0,16,mixedType,2
4,2,0,6,mixedType,0
2,8,0,10,mixedType,1
6,3,0,9,mixedType,1
4,6,0,10,mixedType,1
6,2,0,8,mixedType,1
2,7,0,9,mixedType,1
13,3,0,16,mixedType,2
4,2,0,6,mixedType,0
8,4,3,15,mixedType,2
6,4,0,10,mixedType,1
6,1,0,7,mixedType,0
7,4,0,11,mixedType,1
5,8,0,13,mixedType,1
9,2,0,11,mixedType,1
4,2,0,6,mixedType,0
3,3,0,6,mixedType,0
1,10,0,11,mixedType,1
7,1,0,8,mixedType,1
6,2,0,8,mixedType,1
7,3,0,10,mixedType,1
2,6,0,8,mixedType,1
6,3,0,9,mixedType,1
12,4,0,16,mixedType,2
9,1,0,10,mixedType,1
7,3,0,10,mixedType,1
1,8,0,9,mixedType,1
7,2,0,9,mixedType,1
7,6,0,13,mixedType,1
7,2,0,9,mixedType,1
6,3,0,9,mixedType,1
5,2,0,7,mixedType,0
12,3,0,15,mixedType,2
6,6,0,12,mixedType,1
5,3,0,8,mixedType,1
5,4,0,9,mixedType,1
8,1,0,9,mixedType,1
9,2,0,11,mixedType,1
5,2,0,7,mixedType,0
8,1,0,9,mixedType,1
6,1,0,7,mixedType,0
9,1,0,10,mixedType,1
5,2,0,7,mixedType,0
3,7,0,10,mixedType,1
7,1,0,8,mixedType,1
7,2,0,9,mixedType,1
7,2,0,9,mixedType,1
6,3,0,9,mixedType,1
5,1,0,6,mixedType,0
8,2,0,10,mixedType,1
5,3,0,8,mixedType,1
9,3,0,12,mixedType,1
2,7,0,9,mixedType,1
4,6,0,10,mixedType,1
8,2,0,10,mixedType,1
7,2,0,9,mixedType,1
5,3,0,8,mixedType,1
3,7,0,10,mixedType,1
8,1,0,9,mixedType,1
5,3,0,8,mixedType,1
7,3,0,10,mixedType,1
6,2,0,8,mixedType,1
7,2,0,9,mixedType,1
6,4,0,10,mixedType,1
6,2,0,8,mixedType,1
4,4,0,8,mixedType,1
6,4,0,10,mixedType,1
6,3,0,9,mixedType,1
12,2,1,15,mixedType,2
13,3,0,16,mixedType,2
6,4,0,10,mixedType,1
6,3,0,9,mixedType,1
5,2,0,7,mixedType,0
9,5,0,14,mixedType,2
4,4,0,8,mixedType,1
6,2,0,8,mixedType,1
5,8,0,13,mixedType,1
6,1,0,7,mixedType,0
14,2,0,16,mixedType,2
14,2,0,16,mixedType,2
3,6,0,9,mixedType,1
15,1,0,16,mixedType,2
4,4,0,8,mixedType,1
4,2,0,6,mixedType,0
5,1,0,6,mixedType,0
6,2,0,8,mixedType,1
8,3,0,11,mixedType,1
9,4,0,13,mixedType,1
4,2,0,6,mixedType,0
5,3,0,8,mixedType,1
5,3,0,8,mixedType,1
7,1,0,8,mixedType,1
5,3,0,8,mixedType,1
6,4,0,10,mixedType,1
12,1,0,13,mixedType,1
6,3,0,9,mixedType,1
9,2,0,11,mixedType,1
5,3,0,8,mixedType,1
5,2,0,7,mixedType,0
4,7,0,11,mixedType,1
3,6,0,9,mixedType,1
6,4,0,10,mixedType,1
6,3,0,9,mixedType,1
4,6,0,10,mixedType,1
15,1,0,16,mixedType,2
15,1,0,16,mixedType,2
7,2,0,9,mixedType,1
7,4,0,11,mixedType,1
9,4,0,13,mixedType,1
11,3,0,14,mixedType,2
6,4,0,10,mixedType,1
5,2,0,7,mixedType,0
8,1,0,9,mixedType,1
7,2,0,9,mixedType,1
7,3,0,10,mixedType,1
4,2,0,6,mixedType,0
9,2,0,11,mixedType,1
4,2,0,6,mixedType,0
4,6,0,10,mixedType,1
4,4,0,8,mixedType,1
13,3,0,16,mixedType,2
2,8,0,10,mixedType,1
6,2,0,8,mixedType,1
5,2,0,7,mixedType,0
7,4,0,11,mixedType,1
7,1,0,8,mixedType,1
7,3,0,10,mixedType,1
4,4,0,8,mixedType,1
5,4,0,9,mixedType,1
12,4,0,16,mixedType,2
6,4,0,10,mixedType,1
9,1,0,10,mixedType,1
13,3,0,16,mixedType,2
4,4,0,8,mixedType,1
6,3,0,9,mixedType,1
7,2,0,9,mixedType,1
5,3,0,8,mixedType,1
5,5,0,10,mixedType,1
4,2,0,6,mixedType,0
2,4,0,6,mixedType,0
6,5,0,11,mixedType,1
10,2,0,12,mixedType,1
2,7,0,9,mixedType,1
5,3,0,8,mixedType,1
2,4,0,6,mixedType,0
11,1,0,12,mixedType,1
6,1,0,7,mixedType,0
8,1,0,9,mixedType,1
7,2,0,9,mixedType,1
5,2,0,7,mixedType,0
5,3,0,8,mixedType,1
6,4,0,10,mixedType,1
2,6,0,8,mixedType,1
2,6,0,8,mixedType,1
9,2,0,11,mixedType,1
5,4,0,9,mixedType,1
7,3,0,10,mixedType,1
7,3,0,10,mixedType,1
3,6,0,9,mixedType,1
8,2,0,10,mixedType,1
7,3,0,10,mixedType,1
7,3,0,10,mixedType,1
8,1,0,9,mixedType,1
7,3,0,10,mixedType,1
8,1,0,9,mixedType,1
3,6,0,9,mixedType,1
11,4,0,15,mixedType,2
4,12,0,16,mixedType,2
8,1,0,9,mixedType,1
1,10,0,11,mixedType,1
4,2,0,6,mixedType,0
5,3,0,8,mixedType,1
12,3,0,15,mixedType,2
2,8,0,10,mixedType,1
8,1,0,9,mixedType,1
6,1,0,7,mixedType,0
4,2,0,6,mixedType,0
0,5,0,5,sameType,0
5,2,0,7,mixedType,0
13,3,0,16,mixedType,2
14,2,0,16,mixedType,2
4,2,0,6,mixedType,0
9,3,0,12,mixedType,1
8,2,0,10,mixedType,1
3,3,0,6,mixedType,0
11,1,0,12,mixedType,1
7,1,0,8,mixedType,1
7,2,0,9,mixedType,1
3,3,0,6,mixedType,0
7,3,0,10,mixedType,1
5,4,0,9,mixedType,1
4,4,0,8,mixedType,1
1,8,0,9,mixedType,1
6,1,0,7,mixedType,0
7,3,0,10,mixedType,1
6,1,0,7,mixedType,0
6,2,0,8,mixedType,1
9,4,1,14,mixedType,2
8,2,0,10,mixedType,1
14,2,0,16,mixedType,2
2,7,0,9,mixedType,1
6,3,0,9,mixedType,1
10,3,0,13,mixedType,1
6,2,0,8,mixedType,1
1,9,0,10,mixedType,1
5,3,0,8,mixedType,1
6,3,0,9,mixedType,1
5,3,0,8,mixedType,1
15,1,0,16,mixedType,2
6,1,0,7,mixedType,0
4,4,0,8,mixedType,1
4,4,0,8,mixedType,1
7,2,0,9,mixedType,1
2,6,0,8,mixedType,1
13,3,0,16,mixedType,2
6,3,0,9,mixedType,1
5,8,0,13,mixedType,1
5,3,0,8,mixedType,1
6,2,0,8,mixedType,1
6,1,0,7,mixedType,0
6,1,0,7,mixedType,0
7,1,0,8,mixedType,1
8,1,0,9,mixedType,1
14,2,0,16,mixedType,2
7,1,0,8,mixedType,1
6,2,0,8,mixedType,1
7,1,0,8,mixedType,1
9,2,0,11,mixedType,1
9,1,0,10,mixedType,1
4,6,0,10,mixedType,1
9,2,0,11,mixedType,1
7,3,0,10,mixedType,1
5,3,0,8,mixedType,1
5,4,0,9,mixedType,1
5,4,0,9,mixedType,1
3,6,0,9,mixedType,1
4,6,0,10,mixedType,1
4,2,0,6,mixedType,0
5,2,0,7,mixedType,0
8,2,0,10,mixedType,1
5,3,0,8,mixedType,1
9,1,0,10,mixedType,1
13,3,0,16,mixedType,2
9,1,0,10,mixedType,1
6,2,0,8,mixedType,1
7,2,0,9,mixedType,1
7,1,0,8,mixedType,1
5,2,0,7,mixedType,0
5,3,0,8,mixedType,1
8,4,0,12,mixedType,1
8,2,0,10,mixedType,1
6,2,0,8,mixedType,1
9,1,0,10,mixedType,1
6,1,0,7,mixedType,0
9,2,0,11,mixedType,1
6,2,0,8,mixedType,1
6,2,0,8,mixedType,1
3,7,0,10,mixedType,1
4,6,0,10,mixedType,1
14,2,0,16,mixedType,2
8,2,0,10,mixedType,1
11,5,0,16,mixedType,2
1,7,0,8,mixedType,1
5,4,0,9,mixedType,1
10,4,0,14,mixedType,2
11,3,0,14,mixedType,2
6,2,0,8,mixedType,1
5,7,0,12,mixedType,1
2,8,0,10,mixedType,1
4,4,0,8,mixedType,1
9,2,0,11,mixedType,1
6,3,0,9,mixedType,1
6,3,0,9,mixedType,1
6,3,0,9,mixedType,1
6,1,0,7,mixedType,0
6,1,0,7,mixedType,0
11,5,0,16,mixedType,2
9,3,0,12,mixedType,1
14,2,0,16,mixedType,2
7,3,0,10,mixedType,1
6,5,0,11,mixedType,1
4,6,0,10,mixedType,1
3,5,0,8,mixedType,1
7,3,0,10,mixedType,1
9,2,0,11,mixedType,1
6,2,0,8,mixedType,1
5,2,0,7,mixedType,0
14,4,0,18,mixedType,2
2,8,0,10,mixedType,1
3,5,2,10,mixedType,1
10,3,0,13,mixedType,1
6,2,0,8,mixedType,1
6,6,0,12,mixedType,1
11,5,0,16,mixedType,2
2,6,0,8,mixedType,1
12,3,0,15,mixedType,2
5,4,0,9,mixedType,1
8,2,0,10,mixedType,1
5,3,0,8,mixedType,1
5,4,0,9,mixedType,1
11,5,0,16,mixedType,2
4,4,0,8,mixedType,1
8,4,0,12,mixedType,1
8,4,0,12,mixedType,1
6,2,0,8,mixedType,1
5,3,0,8,mixedType,1
3,3,0,6,mixedType,0
4,4,0,8,mixedType,1
2,6,0,8,mixedType,1
3,5,0,8,mixedType,1
5,2,0,7,mixedType,0
5,1,0,6,mixedType,0
5,2,0,7,mixedType,0
7,2,0,9,mixedType,1
5,3,0,8,mixedType,1
11,3,0,14,mixedType,2
5,3,0,8,mixedType,1
2,4,0,6,mixedType,0
5,2,0,7,mixedType,0
9,4,0,13,mixedType,1
15,1,0,16,mixedType,2
10,2,0,12,mixedType,1
9,2,0,11,mixedType,1
6,2,0,8,mixedType,1
3,6,0,9,mixedType,1
6,2,0,8,mixedType,1
6,3,0,9,mixedType,1
3,6,0,9,mixedType,1
3,8,0,11,mixedType,1
6,1,0,7,mixedType,0
5,3,0,8,mixedType,1
2,8,0,10,mixedType,1
7,2,0,9,mixedType,1
8,2,0,10,mixedType,1
9,3,0,12,mixedType,1
13,3,0,16,mixedType,2
11,3,0,14,mixedType,2
1,11,0,12,mixedType,1
12,4,0,16,mixedType,2
5,3,0,8,mixedType,1
12,4,0,16,mixedType,2
12,4,0,16,mixedType,2
3,6,0,9,mixedType,1
5,6,0,11,mixedType,1
7,4,0,11,mixedType,1
8,4,0,12,mixedType,1
6,4,0,10,mixedType,1
5,3,0,8,mixedType,1
3,6,0,9,mixedType,1
7,1,0,8,mixedType,1
2,6,0,8,mixedType,1
8,4,0,12,mixedType,1
7,3,0,10,mixedType,1
4,4,0,8,mixedType,1
6,2,0,8,mixedType,1
8,2,0,10,mixedType,1
7,3,0,10,mixedType,1
2,7,0,9,mixedType,1
6,4,0,10,mixedType,1
7,3,0,10,mixedType,1
3,5,0,8,mixedType,1
6,10,0,16,mixedType,2
6,3,0,9,mixedType,1
8,1,0,9,mixedType,1
6,3,0,9,mixedType,1
7,3,0,10,mixedType,1
6,3,0,9,mixedType,1
3,8,0,11,mixedType,1
7,4,0,11,mixedType,1
7,3,0,10,mixedType,1
13,3,0,16,mixedType,2
4,2,0,6,mixedType,0
2,9,0,11,mixedType,1
4,4,0,8,mixedType,1
6,3,0,9,mixedType,1
4,2,0,6,mixedType,0
4,4,0,8,mixedType,1
4,2,0,6,mixedType,0
3,6,0,9,mixedType,1
13,3,0,16,mixedType,2
9,1,0,10,mixedType,1
4,2,0,6,mixedType,0
9,3,0,12,mixedType,1
7,3,0,10,mixedType,1
6,1,0,7,mixedType,0
5,1,0,6,mixedType,0
15,1,1,17,mixedType,2
5,1,0,6,mixedType,0
8,1,0,9,mixedType,1
9,1,0,10,mixedType,1
4,6,0,10,mixedType,1
8,2,0,10,mixedType,1
5,2,0,7,mixedType,0
7,2,0,9,mixedType,1
5,6,0,11,mixedType,1
8,0,1,9,mixedType,1
14,2,0,16,mixedType,2
7,2,0,9,mixedType,1
6,1,0,7,mixedType,0
7,3,0,10,mixedType,1
3,5,0,8,mixedType,1
6,6,0,12,mixedType,1
3,6,0,9,mixedType,1
8,1,0,9,mixedType,1
2,4,0,6,mixedType,0
5,3,0,8,mixedType,1
1,7,0,8,mixedType,1
14,2,0,16,mixedType,2
4,9,0,13,mixedType,1
9,10,0,19,mixedType,2
3,6,0,9,mixedType,1
7,1,0,8,mixedType,1
7,3,0,10,mixedType,1
8,1,0,9,mixedType,1
2,6,0,8,mixedType,1
4,4,0,8,mixedType,1
6,1,0,7,mixedType,0
14,2,0,16,mixedType,2
1,8,0,9,mixedType,1
4,6,0,10,mixedType,1
2,7,0,9,mixedType,1
6,3,0,9,mixedType,1
5,2,0,7,mixedType,0
10,4,0,14,mixedType,2
3,6,0,9,mixedType,1
5,11,0,16,mixedType,2
14,2,0,16,mixedType,2
7,4,0,11,mixedType,1
5,2,0,7,mixedType,0
5,2,0,7,mixedType,0
4,4,0,8,mixedType,1
9,1,0,10,mixedType,1
9,3,0,12,mixedType,1
6,4,0,10,mixedType,1
8,2,0,10,mixedType,1
12,4,1,17,mixedType,2
6,2,0,8,mixedType,1
5,1,0,6,mixedType,0
8,0,1,9,mixedType,1
9,2,0,11,mixedType,1
2,4,0,6,mixedType,0
7,2,0,9,mixedType,1
2,8,0,10,mixedType,1
9,1,0,10,mixedType,1
14,2,0,16,mixedType,2
3,5,0,8,mixedType,1
8,2,0,10,mixedType,1
6,2,0,8,mixedType,1
6,1,0,7,mixedType,0
10,2,0,12,mixedType,1
8,2,0,10,mixedType,1
5,3,0,8,mixedType,1
10,3,0,13,mixedType,1
8,1,0,9,mixedType,1
7,2,0,9,mixedType,1
10,3,0,13,mixedType,1
10,3,0,13,mixedType,1
7,1,0,8,mixedType,1
5,2,0,7,mixedType,0
6,3,0,9,mixedType,1
5,1,0,6,mixedType,0
1,9,0,10,mixedType,1
12,3,0,15,mixedType,2
10,2,0,12,mixedType,1
2,4,0,6,mixedType,0
6,3,0,9,mixedType,1
13,3,0,16,mixedType,2
11,3,0,14,mixedType,2
6,1,0,7,mixedType,0
4,2,0,6,mixedType,0
4,4,0,8,mixedType,1
5,4,0,9,mixedType,1
12,4,0,16,mixedType,2
13,3,0,16,mixedType,2
7,3,0,10,mixedType,1
7,2,0,9,mixedType,1
15,1,0,16,mixedType,2
12,4,0,16,mixedType,2
15,1,0,16,mixedType,2
5,2,0,7,mixedType,0
8,3,0,11,mixedType,1
12,4,0,16,mixedType,2
4,2,0,6,mixedType,0
15,1,0,16,mixedType,2
7,1,0,8,mixedType,1
11,3,0,14,mixedType,2
6,2,0,8,mixedType,1
4,6,0,10,mixedType,1
7,5,0,12,mixedType,1
5,3,0,8,mixedType,1
1,8,0,9,mixedType,1
6,2,0,8,mixedType,1
5,3,0,8,mixedType,1
5,5,0,10,mixedType,1
5,3,0,8,mixedType,1
14,2,0,16,mixedType,2
8,1,0,9,mixedType,1
12,4,0,16,mixedType,2
7,1,0,8,mixedType,1
9,2,0,11,mixedType,1
3,8,0,11,mixedType,1
7,2,0,9,mixedType,1
8,2,0,10,mixedType,1
15,1,0,16,mixedType,2
8,2,0,10,mixedType,1
5,4,0,9,mixedType,1
6,2,0,8,mixedType,1
6,4,0,10,mixedType,1
5,1,0,6,mixedType,0
9,3,0,12,mixedType,1
7,3,0,10,mixedType,1
10,0,2,12,mixedType,1
5,1,0,6,mixedType,0
7,1,0,8,mixedType,1
3,6,0,9,mixedType,1
14,2,0,16,mixedType,2
15,1,0,16,mixedType,2
6,4,0,10,mixedType,1
6,3,0,9,mixedType,1
7,1,0,8,mixedType,1
6,2,0,8,mixedType,1
6,1,0,7,mixedType,0
7,1,0,8,mixedType,1
6,3,0,9,mixedType,1
9,1,0,10,mixedType,1
11,3,0,14,mixedType,2
8,2,0,10,mixedType,1
12,3,0,15,mixedType,2
6,3,0,9,mixedType,1
11,3,0,14,mixedType,2
8,2,0,10,mixedType,1
6,3,0,9,mixedType,1
5,6,0,11,mixedType,1
1,9,0,10,mixedType,1
6,2,0,8,mixedType,1
8,2,0,10,mixedType,1
1,9,0,10,mixedType,1
13,3,0,16,mixedType,2
9,3,0,12,mixedType,1
7,1,0,8,mixedType,1
7,2,0,9,mixedType,1
3,5,0,8,mixedType,1
8,2,0,10,mixedType,1
4,5,0,9,mixedType,1
8,2,0,10,mixedType,1
7,1,0,8,mixedType,1
6,1,0,7,mixedType,0
13,1,1,15,mixedType,2
7,3,0,10,mixedType,1
7,1,0,8,mixedType,1
7,1,0,8,mixedType,1
5,1,0,6,mixedType,0
5,4,0,9,mixedType,1
7,1,0,8,mixedType,1
7,3,0,10,mixedType,1
2,4,0,6,mixedType,0
5,2,0,7,mixedType,0
7,3,0,10,mixedType,1
12,1,0,13,mixedType,1
7,2,0,9,mixedType,1
9,3,0,12,mixedType,1
8,1,0,9,mixedType,1
6,4,0,10,mixedType,1
5,3,0,8,mixedType,1
6,4,0,10,mixedType,1
5,6,0,11,mixedType,1
6,3,0,9,mixedType,1
8,1,0,9,mixedType,1
6,4,0,10,mixedType,1
6,4,0,10,mixedType,1
6,3,0,9,mixedType,1
8,4,0,12,mixedType,1
7,2,0,9,mixedType,1
6,3,0,9,mixedType,1
6,2,0,8,mixedType,1
8,2,0,10,mixedType,1
13,3,0,16,mixedType,2
6,3,0,9,mixedType,1
7,3,0,10,mixedType,1
4,6,0,10,mixedType,1
6,4,0,10,mixedType,1
4,8,0,12,mixedType,1
5,4,0,9,mixedType,1
6,1,0,7,mixedType,0
6,4,0,10,mixedType,1
7,1,0,8,mixedType,1
6,1,0,7,mixedType,0
8,2,0,10,mixedType,1
6,3,0,9,mixedType,1
6,3,0,9,mixedType,1
7,2,0,9,mixedType,1
11,1,0,12,mixedType,1
1,8,0,9,mixedType,1
1,7,0,8,mixedType,1
7,4,0,11,mixedType,1
8,1,0,9,mixedType,1
14,2,0,16,mixedType,2
7,3,0,10,mixedType,1
5,7,0,12,mixedType,1
5,1,0,6,mixedType,0
9,3,0,12,mixedType,1
2,8,0,10,mixedType,1
13,4,0,17,mixedType,2
5,4,0,9,mixedType,1
6,3,0,9,mixedType,1
8,3,0,11,mixedType,1
2,8,0,10,mixedType,1
4,4,0,8,mixedType,1
6,2,0,8,mixedType,1
5,5,0,10,mixedType,1
5,3,0,8,mixedType,1
3,6,0,9,mixedType,1
6,2,0,8,mixedType,1
8,3,0,11,mixedType,1
8,2,0,10,mixedType,1
13,3,0,16,mixedType,2
4,2,0,6,mixedType,0
5,4,0,9,mixedType,1
6,4,0,10,mixedType,1
11,3,0,14,mixedType,2
8,2,0,10,mixedType,1
6,1,0,7,mixedType,0
9,3,0,12,mixedType,1
3,6,0,9,mixedType,1
6,4,0,10,mixedType,1
14,2,0,16,mixedType,2
14,2,0,16,mixedType,2
11,1,0,12,mixedType,1
4,6,0,10,mixedType,1
8,3,0,11,mixedType,1
3,3,0,6,mixedType,0
1,8,0,9,mixedType,1
9,2,0,11,mixedType,1
7,1,0,8,mixedType,1
6,3,0,9,mixedType,1
9,1,0,10,mixedType,1
1,8,0,9,mixedType,1
10,2,0,12,mixedType,1
12,3,0,15,mixedType,2
5,1,0,6,mixedType,0
5,2,0,7,mixedType,0
7,4,0,11,mixedType,1
7,3,0,10,mixedType,1
6,4,0,10,mixedType,1
4,2,0,6,mixedType,0
6,3,0,9,mixedType,1
5,1,0,6,mixedType,0
6,3,0,9,mixedType,1
13,3,0,16,mixedType,2
5,5,0,10,mixedType,1
3,5,0,8,mixedType,1
5,4,0,9,mixedType,1
9,3,0,12,mixedType,1
5,3,1,9,mixedType,1
5,3,0,8,mixedType,1
8,1,0,9,mixedType,1
4,4,0,8,mixedType,1
6,3,0,9,mixedType,1
8,4,0,12,mixedType,1
7,2,0,9,mixedType,1
7,3,0,10,mixedType,1
8,3,0,11,mixedType,1
7,3,0,10,mixedType,1
9,1,0,10,mixedType,1
8,2,0,10,mixedType,1
5,3,0,8,mixedType,1
7,1,0,8,mixedType,1
1,8,0,9,mixedType,1
19,1,1,21,mixedType,2
8,2,0,10,mixedType,1
7,3,0,10,mixedType,1
14,2,0,16,mixedType,2
7,3,0,10,mixedType,1
7,2,0,9,mixedType,1
14,2,0,16,mixedType,2
5,3,0,8,mixedType,1
6,1,0,7,mixedType,0
7,2,0,9,mixedType,1
9,1,0,10,mixedType,1
14,2,0,16,mixedType,2
7,1,0,8,mixedType,1
8,2,0,10,mixedType,1
10,3,0,13,mixedType,1
9,2,0,11,mixedType,1
12,4,0,16,mixedType,2
0,8,1,9,mixedType,1
7,4,0,11,mixedType,1
7,5,0,12,mixedType,1
7,3,0,10,mixedType,1
7,1,0,8,mixedType,1
9,4,0,13,mixedType,1
8,2,0,10,mixedType,1
8,1,0,9,mixedType,1
8,1,0,9,mixedType,1
9,1,0,10,mixedType,1
8,2,0,10,mixedType,1
1,8,0,9,mixedType,1
5,3,0,8,mixedType,1
7,6,0,13,mixedType,1
5,2,0,7,mixedType,0
0,11,1,12,mixedType,1
3,6,0,9,mixedType,1
14,2,0,16,mixedType,2
5,2,0,7,mixedType,0
3,5,0,8,mixedType,1
6,2,0,8,mixedType,1
2,9,0,11,mixedType,1
10,2,0,12,mixedType,1
4,4,0,8,mixedType,1
6,3,0,9,mixedType,1
5,2,0,7,mixedType,0
5,2,0,7,mixedType,0
6,7,0,13,mixedType,1
8,2,0,10,mixedType,1
6,4,0,10,mixedType,1
6,4,0,10,mixedType,1
7,2,0,9,mixedType,1
7,3,0,10,mixedType,1
2,4,0,6,mixedType,0
10,2,0,12,mixedType,1
4,4,0,8,mixedType,1
2,4,0,6,mixedType,0
4,2,0,6,mixedType,0
5,4,0,9,mixedType,1
6,4,0,10,mixedType,1
11,1,0,12,mixedType,1
8,5,0,13,mixedType,1
5,4,0,9,mixedType,1
7,3,0,10,mixedType,1
2,8,0,10,mixedType,1
7,6,0,13,mixedType,1
6,3,0,9,mixedType,1
6,4,0,10,mixedType,1
7,4,0,11,mixedType,1
9,1,0,10,mixedType,1
6,2,0,8,mixedType,1
6,2,0,8,mixedType,1
9,6,1,16,mixedType,2
2,8,0,10,mixedType,1
11,3,0,14,mixedType,2
7,3,0,10,mixedType,1
5,2,0,7,mixedType,0
5,2,0,7,mixedType,0
4,8,0,12,mixedType,1
6,4,0,10,mixedType,1
4,2,0,6,mixedType,0
6,1,0,7,mixedType,0
9,2,0,11,mixedType,1
6,3,0,9,mixedType,1
8,2,0,10,mixedType,1
1,7,0,8,mixedType,1
8,2,0,10,mixedType,1
11,2,2,15,mixedType,2
5,7,0,12,mixedType,1
6,4,0,10,mixedType,1
1,9,0,10,mixedType,1
6,3,0,9,mixedType,1
13,3,0,16,mixedType,2
7,3,0,10,mixedType,1
1,10,0,11,mixedType,1
7,1,0,8,mixedType,1
2,4,0,6,mixedType,0
4,14,0,18,mixedType,2
5,1,0,6,mixedType,0
9,1,0,10,mixedType,1
3,5,0,8,mixedType,1
5,4,0,9,mixedType,1
9,1,0,10,mixedType,1
4,2,0,6,mixedType,0
5,5,0,10,mixedType,1
4,8,0,12,mixedType,1
6,3,0,9,mixedType,1
8,2,0,10,mixedType,1
6,3,0,9,mixedType,1
4,2,0,6,mixedType,0
6,3,0,9,mixedType,1
12,4,0,16,mixedType,2
8,1,0,9,mixedType,1
11,3,0,14,mixedType,2
8,1,0,9,mixedType,1
1,9,0,10,mixedType,1
6,3,0,9,mixedType,1
8,2,0,10,mixedType,1
6,3,0,9,mixedType,1
2,6,0,8,mixedType,1
5,3,0,8,mixedType,1
6,1,0,7,mixedType,0
5,3,0,8,mixedType,1
9,2,0,11,mixedType,1
8,1,0,9,mixedType,1
8,2,0,10,mixedType,1
12,4,0,16,mixedType,2
6,1,0,7,mixedType,0
5,4,0,9,mixedType,1
12,1,0,13,mixedType,1
6,2,0,8,mixedType,1
7,3,0,10,mixedType,1
8,3,3,14,mixedType,2
7,2,0,9,mixedType,1
8,1,0,9,mixedType,1
1,8,0,9,mixedType,1
4,4,0,8,mixedType,1
7,2,0,9,mixedType,1
7,3,0,10,mixedType,1
7,3,0,10,mixedType,1
7,1,0,8,mixedType,1
4,8,0,12,mixedType,1
5,4,0,9,mixedType,1
15,1,0,16,mixedType,2
6,2,0,8,mixedType,1
6,3,0,9,mixedType,1
1,10,0,11,mixedType,1
6,2,0,8,mixedType,1
8,1,0,9,mixedType,1
7,4,0,11,mixedType,1
3,5,0,8,mixedType,1
7,1,0,8,mixedType,1
15,1,0,16,mixedType,2
6,1,0,7,mixedType,0
9,2,0,11,mixedType,1
3,6,0,9,mixedType,1
6,2,0,8,mixedType,1
11,2,0,13,mixedType,1
7,8,1,16,mixedType,2
9,4,0,13,mixedType,1
3,6,0,9,mixedType,1
7,2,0,9,mixedType,1
4,2,0,6,mixedType,0
6,5,0,11,mixedType,1
3,6,0,9,mixedType,1
8,2,0,10,mixedType,1
6,3,0,9,mixedType,1
9,1,0,10,mixedType,1
8,2,0,10,mixedType,1
6,2,0,8,mixedType,1
7,1,0,8,mixedType,1
1,9,0,10,mixedType,1
10,0,1,11,mixedType,1
8,1,0,9,mixedType,1
4,4,0,8,mixedType,1
5,4,0,9,mixedType,1
4,6,0,10,mixedType,1
11,5,0,16,mixedType,2
3,6,0,9,mixedType,1
6,1,0,7,mixedType,0
14,2,0,16,mixedType,2
3,6,0,9,mixedType,1
8,4,0,12,mixedType,1
9,4,0,13,mixedType,1
7,2,0,9,mixedType,1
9,1,0,10,mixedType,1
6,3,0,9,mixedType,1
5,3,0,8,mixedType,1
7,2,0,9,mixedType,1
2,8,0,10,mixedType,1
15,1,0,16,mixedType,2
5,3,0,8,mixedType,1
1,6,0,7,mixedType,0
3,5,0,8,mixedType,1
8,2,0,10,mixedType,1
9,2,0,11,mixedType,1
6,2,0,8,mixedType,1
6,4,0,10,mixedType,1
7,3,0,10,mixedType,1
6,4,0,10,mixedType,1
7,2,0,9,mixedType,1
1,8,0,9,mixedType,1
15,1,0,16,mixedType,2
3,6,0,9,mixedType,1
5,3,0,8,mixedType,1
5,5,0,10,mixedType,1
8,2,0,10,mixedType,1
9,1,0,10,mixedType,1
6,2,0,8,mixedType,1
7,2,0,9,mixedType,1
8,1,0,9,mixedType,1
5,2,0,7,mixedType,0
7,3,0,10,mixedType,1
6,1,0,7,mixedType,0
4,4,0,8,mixedType,1
5,2,0,7,mixedType,0
7,3,0,10,mixedType,1
7,1,0,8,mixedType,1
7,6,0,13,mixedType,1
5,3,0,8,mixedType,1
6,3,0,9,mixedType,1
4,4,0,8,mixedType,1
5,2,0,7,mixedType,0
11,3,0,14,mixedType,2
8,3,0,11,mixedType,1
7,2,0,9,mixedType,1
1,8,0,9,mixedType,1
1,7,0,8,mixedType,1
9,1,0,10,mixedType,1
7,4,0,11,mixedType,1
13,3,0,16,mixedType,2
4,6,0,10,mixedType,1
4,5,0,9,mixedType,1
15,1,0,16,mixedType,2
15,1,0,16,mixedType,2
6,5,0,11,mixedType,1
7,3,0,10,mixedType,1
6,3,0,9,mixedType,1
5,2,0,7,mixedType,0
2,6,0,8,mixedType,1
7,1,0,8,mixedType,1
2,6,0,8,mixedType,1
8,1,0,9,mixedType,1
10,1,0,11,mixedType,1
2,4,0,6,mixedType,0
8,4,0,12,mixedType,1
4,4,0,8,mixedType,1
6,1,0,7,mixedType,0
8,1,0,9,mixedType,1
9,2,0,11,mixedType,1
9,3,0,12,mixedType,1
4,2,0,6,mixedType,0
2,7,0,9,mixedType,1
1,7,0,8,mixedType,1
6,2,0,8,mixedType,1
7,5,0,12,mixedType,1
9,4,0,13,mixedType,1
4,5,0,9,mixedType,1
15,1,0,16,mixedType,2
5,1,0,6,mixedType,0
4,6,0,10,mixedType,1
2,4,0,6,mixedType,0
9,1,0,10,mixedType,1
15,1,0,16,mixedType,2
8,1,0,9,mixedType,1
2,8,0,10,mixedType,1
4,2,0,6,mixedType,0
4,2,0,6,mixedType,0
9,3,0,12,mixedType,1
4,2,0,6,mixedType,0
10,6,0,16,mixedType,2
5,2,0,7,mixedType,0
5,2,0,7,mixedType,0
8,2,0,10,mixedType,1
6,3,0,9,mixedType,1
4,6,0,10,mixedType,1
4,4,0,8,mixedType,1
12,4,0,16,mixedType,2
8,3,0,11,mixedType,1
8,2,0,10,mixedType,1
7,2,0,9,mixedType,1
6,3,0,9,mixedType,1
6,3,0,9,mixedType,1
14,2,0,16,mixedType,2
8,3,0,11,mixedType,1
13,3,0,16,mixedType,2
8,4,0,12,mixedType,1
5,3,0,8,mixedType,1
13,3,0,16,mixedType,2
9,1,0,10,mixedType,1
8,1,0,9,mixedType,1
2,6,0,8,mixedType,1
8,4,0,12,mixedType,1
8,1,0,9,mixedType,1
6,2,0,8,mixedType,1
4,2,0,6,mixedType,0
14,2,0,16,mixedType,2
5,3,0,8,mixedType,1
9,1,0,10,mixedType,1
7,2,0,9,mixedType,1
7,2,0,9,mixedType,1
8,1,0,9,mixedType,1
8,1,0,9,mixedType,1
5,2,0,7,mixedType,0
6,3,0,9,mixedType,1
6,1,0,7,mixedType,0
11,3,0,14,mixedType,2
6,2,0,8,mixedType,1
3,6,0,9,mixedType,1
11,2,0,13,mixedType,1
6,2,0,8,mixedType,1
9,2,0,11,mixedType,1
6,3,0,9,mixedType,1
6,3,0,9,mixedType,1
10,11,0,21,mixedType,2
6,3,0,9,mixedType,1
3,9,0,12,mixedType,1
4,6,0,10,mixedType,1
7,3,0,10,mixedType,1
7,3,0,10,mixedType,1
6,2,0,8,mixedType,1
8,2,0,10,mixedType,1
1,8,0,9,mixedType,1
6,3,0,9,mixedType,1
6,1,0,7,mixedType,0
5,2,0,7,mixedType,0
7,3,0,10,mixedType,1
14,2,0,16,mixedType,2
4,6,0,10,mixedType,1
3,6,0,9,mixedType,1
6,4,0,10,mixedType,1
5,2,0,7,mixedType,0
6,2,0,8,mixedType,1
6,3,0,9,mixedType,1
12,4,0,16,mixedType,2
2,6,0,8,mixedType,1
8,2,0,10,mixedType,1
10,2,0,12,mixedType,1
6,4,0,10,mixedType,1
10,1,0,11,mixedType,1
11,1,0,12,mixedType,1
7,3,0,10,mixedType,1
6,2,0,8,mixedType,1
4,9,0,13,mixedType,1
10,4,0,14,mixedType,2
11,1,0,12,mixedType,1
10,2,0,12,mixedType,1
4,6,0,10,mixedType,1
5,2,0,7,mixedType,0
8,2,0,10,mixedType,1
12,4,0,16,mixedType,2
10,4,1,15,mixedType,2
7,3,0,10,mixedType,1
7,3,0,10,mixedType,1
10,2,0,12,mixedType,1
14,2,0,16,mixedType,2
6,4,0,10,mixedType,1
6,4,0,10,mixedType,1
5,3,0,8,mixedType,1
7,3,0,10,mixedType,1
7,3,0,10,mixedType,1
8,1,0,9,mixedType,1
1,8,0,9,mixedType,1
9,2,0,11,mixedType,1
6,2,0,8,mixedType,1
2,11,0,13,mixedType,1
6,3,0,9,mixedType,1
8,2,0,10,mixedType,1
6,3,0,9,mixedType,1
13,3,0,16,mixedType,2
7,2,0,9,mixedType,1
7,2,0,9,mixedType,1
3,6,0,9,mixedType,1
7,2,0,9,mixedType,1
3,6,0,9,mixedType,1
6,1,0,7,mixedType,0
5,2,0,7,mixedType,0
7,3,0,10,mixedType,1
4,5,0,9,mixedType,1
1,8,0,9,mixedType,1
1,8,0,9,mixedType,1
9,3,0,12,mixedType,1
5,3,0,8,mixedType,1
6,3,0,9,mixedType,1
5,3,0,8,mixedType,1
7,2,0,9,mixedType,1
8,1,0,9,mixedType,1
8,4,0,12,mixedType,1
11,1,0,12,mixedType,1
7,7,0,14,mixedType,2
8,2,0,10,mixedType,1
6,3,0,9,mixedType,1
9,2,0,11,mixedType,1
7,3,0,10,mixedType,1
7,3,0,10,mixedType,1
8,4,0,12,mixedType,1
7,2,0,9,mixedType,1
8,2,0,10,mixedType,1
9,1,0,10,mixedType,1
6,4,0,10,mixedType,1
8,2,0,10,mixedType,1
7,3,0,10,mixedType,1
6,2,0,8,mixedType,1
0,12,1,13,mixedType,1
12,3,0,15,mixedType,2
1,12,0,13,mixedType,1
5,2,0,7,mixedType,0
6,2,0,8,mixedType,1
7,3,0,10,mixedType,1
2,8,0,10,mixedType,1
5,3,0,8,mixedType,1
6,3,0,9,mixedType,1
2,9,0,11,mixedType,1
13,3,0,16,mixedType,2
4,2,0,6,mixedType,0
10,6,0,16,mixedType,2
8,2,0,10,mixedType,1
8,1,0,9,mixedType,1
6,2,0,8,mixedType,1
7,3,0,10,mixedType,1
4,2,0,6,mixedType,0
7,2,0,9,mixedType,1
7,1,0,8,mixedType,1
5,2,0,7,mixedType,0
7,2,0,9,mixedType,1
5,4,0,9,mixedType,1
2,4,0,6,mixedType,0
5,2,0,7,mixedType,0
7,3,0,10,mixedType,1
5,1,0,6,mixedType,0
5,1,0,6,mixedType,0
6,4,0,10,mixedType,1
14,2,0,16,mixedType,2
6,3,0,9,mixedType,1
1,8,0,9,mixedType,1
10,3,0,13,mixedType,1
6,3,0,9,mixedType,1
6,4,0,10,mixedType,1
8,2,0,10,mixedType,1
7,3,0,10,mixedType,1
11,1,0,12,mixedType,1
8,4,2,14,mixedType,2
5,2,0,7,mixedType,0
7,5,0,12,mixedType,1
11,2,0,13,mixedType,1
9,1,0,10,mixedType,1
7,2,0,9,mixedType,1
5,2,0,7,mixedType,0
3,3,0,6,mixedType,0
5,1,0,6,mixedType,0
6,4,0,10,mixedType,1
7,3,0,10,mixedType,1
13,3,0,16,mixedType,2
5,1,0,6,mixedType,0
6,2,0,8,mixedType,1
8,2,0,10,mixedType,1
1,7,0,8,mixedType,1
5,1,0,6,mixedType,0
12,3,0,15,mixedType,2
5,2,0,7,mixedType,0
7,2,0,9,mixedType,1
8,2,0,10,mixedType,1
6,3,0,9,mixedType,1
5,3,0,8,mixedType,1
6,2,0,8,mixedType,1
5,3,0,8,mixedType,1
8,1,0,9,mixedType,1
6,3,0,9,mixedType,1
3,6,0,9,mixedType,1
6,3,0,9,mixedType,1
9,4,0,13,mixedType,1
9,3,0,12,mixedType,1
6,4,0,10,mixedType,1
9,1,0,10,mixedType,1
3,6,0,9,mixedType,1
6,2,0,8,mixedType,1
4,4,0,8,mixedType,1
7,2,0,9,mixedType,1
7,6,1,14,mixedType,2
6,2,0,8,mixedType,1
2,8,0,10,mixedType,1
15,1,1,17,mixedType,2
6,3,0,9,mixedType,1
12,4,0,16,mixedType,2
4,4,0,8,mixedType,1
6,4,0,10,mixedType,1
5,4,0,9,mixedType,1
4,2,0,6,mixedType,0
4,6,0,10,mixedType,1
7,1,0,8,mixedType,1
5,1,0,6,mixedType,0
9,2,0,11,mixedType,1
7,4,0,11,mixedType,1
5,3,0,8,mixedType,1
5,4,0,9,mixedType,1
1,9,0,10,mixedType,1
6,2,0,8,mixedType,1
7,3,0,10,mixedType,1
8,4,0,12,mixedType,1
6,1,0,7,mixedType,0
6,1,0,7,mixedType,0
6,3,0,9,mixedType,1
3,10,0,13,mixedType,1
6,3,0,9,mixedType,1
15,1,0,16,mixedType,2
9,3,0,12,mixedType,1
6,4,0,10,mixedType,1
8,2,0,10,mixedType,1
4,4,0,8,mixedType,1
7,2,0,9,mixedType,1
6,3,0,9,mixedType,1
5,3,0,8,mixedType,1
11,2,0,13,mixedType,1
8,2,0,10,mixedType,1
14,2,0,16,mixedType,2
4,4,0,8,mixedType,1
2,6,0,8,mixedType,1
4,6,0,10,mixedType,1
12,1,0,13,mixedType,1
7,2,0,9,mixedType,1
7,5,0,12,mixedType,1
7,3,0,10,mixedType,1
6,4,0,10,mixedType,1
4,4,0,8,mixedType,1
7,2,0,9,mixedType,1
8,1,0,9,mixedType,1
5,6,0,11,mixedType,1
5,3,0,8,mixedType,1
5,3,0,8,mixedType,1
7,4,0,11,mixedType,1
11,3,0,14,mixedType,2
5,1,0,6,mixedType,0
10,3,0,13,mixedType,1
6,3,0,9,mixedType,1
7,3,0,10,mixedType,1
8,3,0,11,mixedType,1
5,5,0,10,mixedType,1
6,4,0,10,mixedType,1
6,4,0,10,mixedType,1
12,4,0,16,mixedType,2
4,5,0,9,mixedType,1
9,2,0,11,mixedType,1
6,2,0,8,mixedType,1
7,2,0,9,mixedType,1
12,4,0,16,mixedType,2
8,3,0,11,mixedType,1
6,3,0,9,mixedType,1
11,3,0,14,mixedType,2
5,2,0,7,mixedType,0
5,5,0,10,mixedType,1
5,2,0,7,mixedType,0
2,4,0,6,mixedType,0
8,3,0,11,mixedType,1
8,1,0,9,mixedType,1
3,8,0,11,mixedType,1
4,4,0,8,mixedType,1
8,2,0,10,mixedType,1
1,9,0,10,mixedType,1
8,1,0,9,mixedType,1
10,2,0,12,mixedType,1
9,3,0,12,mixedType,1
2,8,0,10,mixedType,1
9,1,0,10,mixedType,1
11,1,0,12,mixedType,1
7,3,0,10,mixedType,1
10,2,0,12,mixedType,1
6,3,0,9,mixedType,1
4,6,0,10,mixedType,1
6,4,0,10,mixedType,1
7,2,0,9,mixedType,1
6,2,0,8,mixedType,1
8,2,0,10,mixedType,1
4,2,0,6,mixedType,0
10,2,0,12,mixedType,1
5,1,0,6,mixedType,0
5,2,0,7,mixedType,0
8,4,0,12,mixedType,1
3,5,0,8,mixedType,1
6,2,0,8,mixedType,1
6,2,0,8,mixedType,1
8,2,0,10,mixedType,1
8,1,0,9,mixedType,1
13,3,0,16,mixedType,2
5,4,0,9,mixedType,1
7,1,0,8,mixedType,1
15,1,0,16,mixedType,2
14,2,0,16,mixedType,2
7,2,0,9,mixedType,1
4,2,0,6,mixedType,0
6,3,0,9,mixedType,1
7,2,0,9,mixedType,1
7,2,0,9,mixedType,1
5,3,0,8,mixedType,1
14,2,0,16,mixedType,2
8,1,0,9,mixedType,1
6,3,0,9,mixedType,1
5,4,0,9,mixedType,1
4,4,0,8,mixedType,1
7,3,0,10,mixedType,1
6,1,0,7,mixedType,0
6,2,0,8,mixedType,1
3,10,0,13,mixedType,1
8,4,0,12,mixedType,1
8,2,0,10,mixedType,1
7,3,0,10,mixedType,1
6,3,0,9,mixedType,1
6,2,0,8,mixedType,1
8,2,0,10,mixedType,1
7,3,0,10,mixedType,1
10,1,0,11,mixedType,1
8,4,0,12,mixedType,1
5,2,0,7,mixedType,0
5,2,0,7,mixedType,0
3,6,0,9,mixedType,1
7,2,0,9,mixedType,1
4,4,0,8,mixedType,1
7,3,0,10,mixedType,1
7,4,0,11,mixedType,1
9,1,0,10,mixedType,1
7,2,0,9,mixedType,1
11,3,0,14,mixedType,2
5,3,0,8,mixedType,1
6,3,0,9,mixedType,1
6,2,0,8,mixedType,1
15,1,0,16,mixedType,2
6,4,0,10,mixedType,1
7,2,0,9,mixedType,1
3,5,0,8,mixedType,1
8,2,0,10,mixedType,1
6,4,0,10,mixedType,1
7,4,0,11,mixedType,1
2,8,0,10,mixedType,1
11,5,0,16,mixedType,2
4,2,0,6,mixedType,0
6,4,0,10,mixedType,1
9,1,0,10,mixedType,1
7,3,0,10,mixedType,1
7,3,0,10,mixedType,1
5,4,0,9,mixedType,1
14,2,0,16,mixedType,2
6,1,0,7,mixedType,0
13,3,0,16,mixedType,2
7,3,0,10,mixedType,1
8,2,0,10,mixedType,1
6,1,0,7,mixedType,0
6,3,0,9,mixedType,1
10,6,0,16,mixedType,2
3,3,0,6,mixedType,0
6,1,0,7,mixedType,0
8,1,0,9,mixedType,1
8,1,0,9,mixedType,1
6,3,0,9,mixedType,1
3,6,0,9,mixedType,1
9,1,0,10,mixedType,1
4,8,0,12,mixedType,1
9,1,0,10,mixedType,1
9,1,0,10,mixedType,1
8,2,0,10,mixedType,1
6,2,0,8,mixedType,1
8,1,0,9,mixedType,1
9,1,0,10,mixedType,1
6,2,0,8,mixedType,1
9,1,0,10,mixedType,1
8,2,0,10,mixedType,1
13,3,0,16,mixedType,2
6,4,0,10,mixedType,1
7,2,0,9,mixedType,1
6,3,0,9,mixedType,1
10,0,1,11,mixedType,1
7,4,0,11,mixedType,1
4,2,0,6,mixedType,0
4,2,0,6,mixedType,0
7,3,0,10,mixedType,1
7,2,0,9,mixedType,1
3,5,0,8,mixedType,1
7,3,0,10,mixedType,1
7,1,0,8,mixedType,1
7,6,0,13,mixedType,1
7,3,0,10,mixedType,1
6,2,0,8,mixedType,1
6,3,0,9,mixedType,1
6,1,0,7,mixedType,0
7,2,0,9,mixedType,1
4,5,0,9,mixedType,1
5,4,0,9,mixedType,1
2,6,0,8,mixedType,1
7,2,0,9,mixedType,1
2,6,0,8,mixedType,1
2,8,0,10,mixedType,1
7,2,0,9,mixedType,1
3,6,0,9,mixedType,1
10,1,0,11,mixedType,1
3,3,0,6,mixedType,0
4,4,0,8,mixedType,1
5,1,0,6,mixedType,0
2,4,0,6,mixedType,0
3,5,0,8,mixedType,1
2,7,0,9,mixedType,1
11,1,0,12,mixedType,1
7,6,0,13,mixedType,1
14,2,0,16,mixedType,2
7,1,0,8,mixedType,1
9,0,1,10,mixedType,1
6,2,0,8,mixedType,1
8,1,0,9,mixedType,1
5,4,0,9,mixedType,1
5,2,0,7,mixedType,0
10,6,0,16,mixedType,2
3,6,0,9,mixedType,1
4,2,0,6,mixedType,0
12,3,0,15,mixedType,2
5,4,0,9,mixedType,1
3,7,0,10,mixedType,1
2,8,0,10,mixedType,1
9,1,0,10,mixedType,1
1,7,0,8,mixedType,1
9,3,0,12,mixedType,1
8,2,0,10,mixedType,1
8,1,0,9,mixedType,1
9,1,0,10,mixedType,1
6,1,0,7,mixedType,0
7,2,0,9,mixedType,1
15,1,0,16,mixedType,2
6,3,0,9,mixedType,1
9,4,0,13,mixedType,1
5,5,0,10,mixedType,1
10,1,0,11,mixedType,1
5,3,0,8,mixedType,1
4,2,0,6,mixedType,0
9,1,0,10,mixedType,1
7,2,0,9,mixedType,1
3,8,0,11,mixedType,1
8,1,0,9,mixedType,1
5,1,0,6,mixedType,0
4,4,0,8,mixedType,1
4,6,0,10,mixedType,1
4,6,0,10,mixedType,1
4,7,0,11,mixedType,1
13,3,0,16,mixedType,2
8,2,0,10,mixedType,1
9,2,0,11,mixedType,1
5,4,0,9,mixedType,1
6,1,0,7,mixedType,0
5,3,0,8,mixedType,1
10,3,0,13,mixedType,1
7,1,0,8,mixedType,1
4,4,0,8,mixedType,1
8,4,0,12,mixedType,1
6,1,0,7,mixedType,0
5,2,0,7,mixedType,0
6,4,0,10,mixedType,1
5,4,0,9,mixedType,1
12,1,0,13,mixedType,1
7,3,0,10,mixedType,1
10,1,0,11,mixedType,1
2,8,0,10,mixedType,1
7,2,0,9,mixedType,1
15,1,0,16,mixedType,2
14,2,0,16,mixedType,2
7,1,0,8,mixedType,1
11,0,1,12,mixedType,1
4,4,0,8,mixedType,1
4,4,0,8,mixedType,1
1,7,0,8,mixedType,1
9,2,0,11,mixedType,1
6,3,0,9,mixedType,1
8,3,0,11,mixedType,1
5,2,0,7,mixedType,0
4,2,0,6,mixedType,0
6,3,0,9,mixedType,1
8,2,0,10,mixedType,1
12,4,0,16,mixedType,2
3,7,0,10,mixedType,1
6,1,0,7,mixedType,0
7,1,0,8,mixedType,1
9,3,0,12,mixedType,1
4,5,0,9,mixedType,1
3,6,0,9,mixedType,1
5,3,0,8,mixedType,1
8,2,0,10,mixedType,1
1,8,0,9,mixedType,1
5,2,0,7,mixedType,0
8,3,0,11,mixedType,1
12,3,0,15,mixedType,2
6,2,0,8,mixedType,1
13,4,0,17,mixedType,2
6,2,0,8,mixedType,1
5,4,0,9,mixedType,1
7,2,0,9,mixedType,1
6,2,0,8,mixedType,1
8,0,2,10,mixedType,1
8,3,0,11,mixedType,1
5,4,0,9,mixedType,1
11,5,0,16,mixedType,2
6,3,0,9,mixedType,1
5,3,0,8,mixedType,1
5,2,0,7,mixedType,0
6,2,0,8,mixedType,1
9,1,0,10,mixedType,1
7,2,0,9,mixedType,1
8,3,0,11,mixedType,1
4,8,0,12,mixedType,1
7,2,0,9,mixedType,1
8,6,0,14,mixedType,2
8,4,0,12,mixedType,1
7,1,0,8,mixedType,1
6,3,0,9,mixedType,1
11,1,0,12,mixedType,1
5,3,0,8,mixedType,1
6,2,0,8,mixedType,1
2,8,0,10,mixedType,1
9,3,0,12,mixedType,1
5,4,0,9,mixedType,1
5,7,0,12,mixedType,1
6,1,0,7,mixedType,0
2,2,1,5,mixedType,0
8,1,0,9,mixedType,1
1,9,0,10,mixedType,1
2,6,0,8,mixedType,1
7,2,0,9,mixedType,1
6,2,0,8,mixedType,1
8,3,0,11,mixedType,1
6,3,0,9,mixedType,1
13,3,0,16,mixedType,2
6,2,0,8,mixedType,1
7,3,0,10,mixedType,1
8,1,0,9,mixedType,1
11,3,0,14,mixedType,2
6,4,0,10,mixedType,1
10,2,0,12,mixedType,1
4,2,0,6,mixedType,0
6,3,0,9,mixedType,1
4,6,0,10,mixedType,1
15,1,0,16,mixedType,2
6,1,0,7,mixedType,0
9,1,0,10,mixedType,1
5,3,0,8,mixedType,1
8,3,0,11,mixedType,1
4,9,0,13,mixedType,1
1,8,0,9,mixedType,1
6,1,0,7,mixedType,0
5,3,0,8,mixedType,1
7,2,0,9,mixedType,1
15,1,0,16,mixedType,2
7,1,0,8,mixedType,1
6,4,0,10,mixedType,1
3,6,0,9,mixedType,1
12,4,0,16,mixedType,2
7,2,0,9,mixedType,1
15,1,0,16,mixedType,2
5,4,0,9,mixedType,1
6,2,0,8,mixedType,1
5,2,0,7,mixedType,0
7,1,0,8,mixedType,1
5,3,0,8,mixedType,1
6,3,0,9,mixedType,1
7,2,0,9,mixedType,1
8,2,0,10,mixedType,1
4,2,0,6,mixedType,0
5,2,0,7,mixedType,0
7,3,0,10,mixedType,1
14,2,0,16,mixedType,2
15,1,0,16,mixedType,2
9,4,0,13,mixedType,1
7,2,0,9,mixedType,1
14,2,0,16,mixedType,2
8,4,0,12,mixedType,1
5,4,0,9,mixedType,1
8,1,0,9,mixedType,1
9,1,0,10,mixedType,1
4,6,0,10,mixedType,1
8,1,0,9,mixedType,1
4,4,0,8,mixedType,1
2,6,0,8,mixedType,1
12,4,0,16,mixedType,2
6,3,0,9,mixedType,1
2,6,0,8,mixedType,1
7,2,0,9,mixedType,1
6,3,0,9,mixedType,1
5,2,0,7,mixedType,0
3,6,0,9,mixedType,1
14,2,0,16,mixedType,2
6,1,0,7,mixedType,0
7,3,0,10,mixedType,1
6,2,0,8,mixedType,1
3,10,0,13,mixedType,1
6,3,0,9,mixedType,1
6,3,0,9,mixedType,1
9,2,0,11,mixedType,1
4,2,0,6,mixedType,0
8,3,0,11,mixedType,1
3,7,0,10,mixedType,1
8,2,0,10,mixedType,1
1,9,0,10,mixedType,1
2,8,0,10,mixedType,1
4,4,0,8,mixedType,1
1,9,0,10,mixedType,1
6,3,0,9,mixedType,1
6,2,0,8,mixedType,1
7,3,0,10,mixedType,1
5,1,0,6,mixedType,0
5,3,0,8,mixedType,1
3,5,0,8,mixedType,1
6,2,0,8,mixedType,1
6,3,0,9,mixedType,1
6,4,0,10,mixedType,1
7,1,0,8,mixedType,1
6,1,0,7,mixedType,0
14,2,0,16,mixedType,2
5,1,0,6,mixedType,0
7,3,0,10,mixedType,1
6,2,0,8,mixedType,1
12,1,0,13,mixedType,1
8,1,0,9,mixedType,1
7,3,0,10,mixedType,1
20,5,0,25,mixedType,2
5,3,0,8,mixedType,1
6,1,0,7,mixedType,0
13,3,0,16,mixedType,2
7,3,0,10,mixedType,1
6,4,0,10,mixedType,1
7,2,0,9,mixedType,1
2,6,0,8,mixedType,1
7,2,0,9,mixedType,1
7,3,0,10,mixedType,1
6,2,0,8,mixedType,1
8,2,0,10,mixedType,1
13,3,0,16,mixedType,2
6,2,0,8,mixedType,1
4,2,0,6,mixedType,0
6,3,0,9,mixedType,1
6,3,0,9,mixedType,1
7,1,0,8,mixedType,1
5,2,0,7,mixedType,0
4,4,0,8,mixedType,1
6,4,0,10,mixedType,1
6,3,0,9,mixedType,1
11,1,0,12,mixedType,1
3,5,0,8,mixedType,1
15,1,0,16,mixedType,2
6,1,0,7,mixedType,0
9,3,0,12,mixedType,1
6,1,0,7,mixedType,0
8,1,0,9,mixedType,1
5,3,0,8,mixedType,1
9,1,0,10,mixedType,1
6,3,0,9,mixedType,1
6,6,0,12,mixedType,1
8,2,0,10,mixedType,1
1,8,0,9,mixedType,1
7,3,0,10,mixedType,1
13,3,0,16,mixedType,2
6,3,0,9,mixedType,1
10,2,0,12,mixedType,1
5,8,0,13,mixedType,1
4,2,0,6,mixedType,0
4,4,0,8,mixedType,1
3,9,0,12,mixedType,1
5,5,0,10,mixedType,1
6,3,0,9,mixedType,1
5,3,0,8,mixedType,1
3,6,0,9,mixedType,1
4,4,0,8,mixedType,1
4,4,0,8,mixedType,1
5,2,0,7,mixedType,0
6,2,0,8,mixedType,1
6,3,0,9,mixedType,1
11,4,0,15,mixedType,2
6,2,0,8,mixedType,1
7,1,0,8,mixedType,1
8,2,0,10,mixedType,1
8,3,0,11,mixedType,1
2,8,0,10,mixedType,1
6,3,0,9,mixedType,1
15,1,0,16,mixedType,2
7,3,0,10,mixedType,1
5,2,0,7,mixedType,0
7,3,0,10,mixedType,1
3,5,0,8,mixedType,1
9,1,0,10,mixedType,1
8,4,3,15,mixedType,2
6,2,0,8,mixedType,1
4,2,0,6,mixedType,0
6,3,0,9,mixedType,1
2,8,0,10,mixedType,1
6,0,1,7,mixedType,0
8,2,0,10,mixedType,1
3,6,0,9,mixedType,1
9,4,0,13,mixedType,1
8,4,0,12,mixedType,1
15,1,0,16,mixedType,2
5,3,0,8,mixedType,1
7,2,0,9,mixedType,1
5,6,0,11,mixedType,1
2,6,0,8,mixedType,1
15,1,0,16,mixedType,2
7,3,0,10,mixedType,1
7,3,0,10,mixedType,1
5,4,0,9,mixedType,1
5,4,0,9,mixedType,1
6,6,0,12,mixedType,1
8,2,0,10,mixedType,1
14,2,0,16,mixedType,2
5,1,0,6,mixedType,0
8,3,0,11,mixedType,1
4,4,0,8,mixedType,1
6,4,0,10,mixedType,1
12,1,0,13,mixedType,1
3,3,0,6,mixedType,0
7,3,0,10,mixedType,1
16,1,1,18,mixedType,2
7,3,0,10,mixedType,1
5,4,0,9,mixedType,1
8,2,0,10,mixedType,1
14,2,0,16,mixedType,2
2,7,0,9,mixedType,1
7,3,0,10,mixedType,1
9,1,0,10,mixedType,1
14,2,0,16,mixedType,2
10,2,0,12,mixedType,1
5,4,0,9,mixedType,1
6,4,0,10,mixedType,1
5,3,0,8,mixedType,1
12,3,0,15,mixedType,2
7,6,0,13,mixedType,1
13,3,0,16,mixedType,2
9,4,0,13,mixedType,1
4,2,0,6,mixedType,0
7,3,0,10,mixedType,1
11,3,0,14,mixedType,2
6,2,0,8,mixedType,1
13,3,0,16,mixedType,2
6,3,0,9,mixedType,1
6,3,0,9,mixedType,1
3,6,0,9,mixedType,1
4,6,0,10,mixedType,1
8,2,0,10,mixedType,1
4,4,0,8,mixedType,1
7,3,0,10,mixedType,1
6,3,0,9,mixedType,1
7,2,0,9,mixedType,1
5,4,0,9,mixedType,1
4,4,0,8,mixedType,1
7,2,0,9,mixedType,1
7,2,0,9,mixedType,1
6,0,0,6,sameType,0
7,3,0,10,mixedType,1
8,5,0,13,mixedType,1
8,1,0,9,mixedType,1
8,2,0,10,mixedType,1
5,3,0,8,mixedType,1
9,3,0,12,mixedType,1
6,4,0,10,mixedType,1
9,0,1,10,mixedType,1
6,1,0,7,mixedType,0
7,2,0,9,mixedType,1
2,8,0,10,mixedType,1
2,7,0,9,mixedType,1
15,1,0,16,mixedType,2
2,7,0,9,mixedType,1
8,2,0,10,mixedType,1
5,3,0,8,mixedType,1
6,3,0,9,mixedType,1
10,2,0,12,mixedType,1
5,3,0,8,mixedType,1
7,2,0,9,mixedType,1
10,0,3,13,mixedType,1
10,1,0,11,mixedType,1
8,1,0,9,mixedType,1
2,6,0,8,mixedType,1
1,9,0,10,mixedType,1
3,6,0,9,mixedType,1
5,2,0,7,mixedType,0
7,3,0,10,mixedType,1
6,5,0,11,mixedType,1
12,3,0,15,mixedType,2
7,2,0,9,mixedType,1
7,4,2,13,mixedType,2
12,4,0,16,mixedType,2
7,3,0,10,mixedType,1
6,3,0,9,mixedType,1
15,1,1,17,mixedType,2
9,1,0,10,mixedType,1
11,3,0,14,mixedType,2
6,2,0,8,mixedType,1
8,2,0,10,mixedType,1
8,2,0,10,mixedType,1
2,8,0,10,mixedType,1
6,2,0,8,mixedType,1
2,9,0,11,mixedType,1
8,2,0,10,mixedType,1
2,8,0,10,mixedType,1
4,4,0,8,mixedType,1
4,2,0,6,mixedType,0
6,3,0,9,mixedType,1
8,1,0,9,mixedType,1
5,4,0,9,mixedType,1
4,2,0,6,mixedType,0
13,3,0,16,mixedType,2
7,3,0,10,mixedType,1
6,1,0,7,mixedType,0
14,2,0,16,mixedType,2
9,1,0,10,mixedType,1
2,8,0,10,mixedType,1
6,2,0,8,mixedType,1
7,3,0,10,mixedType,1
1,8,0,9,mixedType,1
6,4,0,10,mixedType,1
5,2,0,7,mixedType,0
5,1,0,6,mixedType,0
4,4,0,8,mixedType,1
2,7,0,9,mixedType,1
11,2,0,13,mixedType,1
8,3,0,11,mixedType,1
2,6,0,8,mixedType,1
6,2,0,8,mixedType,1
6,4,0,10,mixedType,1
4,2,0,6,mixedType,0
6,4,0,10,mixedType,1
7,3,0,10,mixedType,1
8,1,0,9,mixedType,1
7,3,0,10,mixedType,1
6,3,0,9,mixedType,1
5,3,0,8,mixedType,1
9,1,0,10,mixedType,1
3,8,0,11,mixedType,1
5,4,0,9,mixedType,1
8,1,0,9,mixedType,1
6,3,0,9,mixedType,1
6,2,0,8,mixedType,1
7,2,0,9,mixedType,1
4,2,0,6,mixedType,0
8,2,0,10,mixedType,1
1,8,0,9,mixedType,1
5,3,0,8,mixedType,1
7,1,0,8,mixedType,1
5,2,0,7,mixedType,0
2,10,0,12,mixedType,1
6,2,0,8,mixedType,1
6,6,0,12,mixedType,1
6,1,0,7,mixedType,0
8,2,0,10,mixedType,1
6,1,0,7,mixedType,0
6,3,0,9,mixedType,1
9,2,0,11,mixedType,1
8,2,0,10,mixedType,1
11,2,0,13,mixedType,1
14,2,0,16,mixedType,2
5,7,0,12,mixedType,1
6,4,0,10,mixedType,1
6,1,0,7,mixedType,0
2,8,0,10,mixedType,1
8,3,0,11,mixedType,1
5,5,0,10,mixedType,1
6,3,0,9,mixedType,1
5,3,0,8,mixedType,1
1,7,0,8,mixedType,1
3,8,0,11,mixedType,1
8,1,0,9,mixedType,1
5,3,0,8,mixedType,1
15,1,0,16,mixedType,2
6,3,0,9,mixedType,1
6,3,0,9,mixedType,1
5,2,0,7,mixedType,0
5,3,0,8,mixedType,1
12,4,0,16,mixedType,2
4,5,0,9,mixedType,1
6,2,0,8,mixedType,1
6,2,0,8,mixedType,1
7,3,0,10,mixedType,1
4,4,0,8,mixedType,1
4,2,0,6,mixedType,0
2,6,0,8,mixedType,1
12,3,0,15,mixedType,2
6,1,0,7,mixedType,0
1,9,0,10,mixedType,1
7,2,1,10,mixedType,1
6,3,0,9,mixedType,1
5,1,0,6,mixedType,0
4,4,0,8,mixedType,1
8,2,0,10,mixedType,1
6,2,0,8,mixedType,1
1,8,0,9,mixedType,1
5,1,0,6,mixedType,0
3,6,0,9,mixedType,1
11,5,0,16,mixedType,2
6,4,0,10,mixedType,1
5,3,0,8,mixedType,1
7,3,0,10,mixedType,1
9,1,0,10,mixedType,1
4,4,0,8,mixedType,1
12,3,0,15,mixedType,2
6,6,0,12,mixedType,1
4,6,0,10,mixedType,1
5,3,0,8,mixedType,1
11,5,0,16,mixedType,2
8,2,0,10,mixedType,1
6,1,0,7,mixedType,0
1,10,0,11,mixedType,1
5,2,0,7,mixedType,0
7,4,0,11,mixedType,1
6,3,0,9,mixedType,1
6,2,0,8,mixedType,1
5,6,0,11,mixedType,1
5,4,0,9,mixedType,1
7,2,0,9,mixedType,1
5,1,0,6,mixedType,0
5,3,0,8,mixedType,1
3,5,0,8,mixedType,1
7,4,0,11,mixedType,1
8,4,0,12,mixedType,1
4,2,0,6,mixedType,0
1,8,0,9,mixedType,1
7,2,0,9,mixedType,1
6,4,0,10,mixedType,1
3,6,0,9,mixedType,1
4,4,0,8,mixedType,1
9,2,0,11,mixedType,1
8,3,0,11,mixedType,1
9,2,0,11,mixedType,1
3,10,0,13,mixedType,1
9,3,0,12,mixedType,1
5,3,0,8,mixedType,1
4,2,0,6,mixedType,0
6,4,0,10,mixedType,1
4,2,0,6,mixedType,0
7,2,0,9,mixedType,1
14,2,0,16,mixedType,2
8,1,0,9,mixedType,1
8,2,0,10,mixedType,1
6,2,0,8,mixedType,1
7,3,0,10,mixedType,1
5,4,0,9,mixedType,1
2,8,0,10,mixedType,1
13,3,0,16,mixedType,2
11,2,0,13,mixedType,1
9,2,0,11,mixedType,1
7,2,0,9,mixedType,1
4,2,0,6,mixedType,0
7,3,0,10,mixedType,1
8,3,0,11,mixedType,1
4,2,0,6,mixedType,0
6,3,0,9,mixedType,1
2,6,0,8,mixedType,1
8,1,0,9,mixedType,1
7,2,0,9,mixedType,1
6,3,0,9,mixedType,1
6,2,0,8,mixedType,1
3,6,0,9,mixedType,1
6,3,0,9,mixedType,1
6,4,0,10,mixedType,1
9,2,0,11,mixedType,1
4,6,0,10,mixedType,1
6,5,0,11,mixedType,1
7,3,0,10,mixedType,1
7,3,0,10,mixedType,1
3,6,0,9,mixedType,1
6,4,0,10,mixedType,1
11,4,0,15,mixedType,2
11,3,0,14,mixedType,2
1,9,0,10,mixedType,1
5,1,0,6,mixedType,0
7,2,0,9,mixedType,1
8,2,0,10,mixedType,1
6,3,0,9,mixedType,1
7,3,0,10,mixedType,1
8,1,0,9,mixedType,1
6,3,0,9,mixedType,1
5,3,0,8,mixedType,1
6,3,0,9,mixedType,1
7,3,0,10,mixedType,1
5,3,0,8,mixedType,1
3,9,0,12,mixedType,1
14,2,0,16,mixedType,2
5,4,0,9,mixedType,1
2,7,0,9,mixedType,1
6,4,0,10,mixedType,1
8,1,0,9,mixedType,1
3,3,0,6,mixedType,0
5,3,0,8,mixedType,1
8,2,0,10,mixedType,1
8,3,0,11,mixedType,1
2,8,0,10,mixedType,1
6,3,0,9,mixedType,1
6,3,0,9,mixedType,1
13,3,0,16,mixedType,2
3,8,0,11,mixedType,1
8,2,0,10,mixedType,1
4,5,0,9,mixedType,1
6,3,0,9,mixedType,1
0,6,2,8,mixedType,1
5,2,0,7,mixedType,0
4,4,0,8,mixedType,1
5,4,0,9,mixedType,1
7,3,0,10,mixedType,1
2,7,0,9,mixedType,1
5,3,0,8,mixedType,1
6,3,0,9,mixedType,1
2,4,0,6,mixedType,0
5,1,0,6,mixedType,0
7,3,0,10,mixedType,1
13,3,0,16,mixedType,2
3,6,0,9,mixedType,1
9,3,0,12,mixedType,1
7,4,0,11,mixedType,1
8,1,0,9,mixedType,1
14,3,0,17,mixedType,2
6,1,0,7,mixedType,0
5,3,0,8,mixedType,1
6,4,0,10,mixedType,1
7,2,0,9,mixedType,1
3,3,0,6,mixedType,0
4,6,0,10,mixedType,1
15,1,0,16,mixedType,2
6,3,0,9,mixedType,1
9,3,0,12,mixedType,1
5,6,0,11,mixedType,1
5,4,0,9,mixedType,1
7,3,0,10,mixedType,1
5,3,0,8,mixedType,1
7,3,0,10,mixedType,1
12,4,0,16,mixedType,2
7,2,0,9,mixedType,1
9,2,0,11,mixedType,1
7,4,0,11,mixedType,1
9,3,0,12,mixedType,1
5,1,0,6,mixedType,0
6,1,0,7,mixedType,0
9,1,0,10,mixedType,1
13,3,0,16,mixedType,2
6,2,0,8,mixedType,1
12,4,0,16,mixedType,2
8,2,0,10,mixedType,1
8,2,0,10,mixedType,1
1,8,0,9,mixedType,1
1,9,0,10,mixedType,1
10,4,0,14,mixedType,2
7,3,0,10,mixedType,1
2,6,0,8,mixedType,1
6,2,0,8,mixedType,1
3,9,0,12,mixedType,1
14,2,0,16,mixedType,2
6,2,0,8,mixedType,1
6,2,0,8,mixedType,1
3,7,0,10,mixedType,1
1,10,0,11,mixedType,1
6,3,0,9,mixedType,1
4,2,0,6,mixedType,0
1,9,0,10,mixedType,1
5,2,0,7,mixedType,0
6,10,0,16,mixedType,2
9,1,0,10,mixedType,1
4,2,0,6,mixedType,0
6,2,0,8,mixedType,1
5,1,0,6,mixedType,0
3,7,0,10,mixedType,1
7,3,0,10,mixedType,1
13,3,0,16,mixedType,2
12,4,0,16,mixedType,2
7,5,0,12,mixedType,1
5,1,0,6,mixedType,0
6,3,0,9,mixedType,1
5,3,0,8,mixedType,1
2,7,0,9,mixedType,1
5,3,0,8,mixedType,1
11,1,0,12,mixedType,1
15,1,0,16,mixedType,2
7,6,0,13,mixedType,1
6,3,0,9,mixedType,1
4,6,0,10,mixedType,1
4,2,0,6,mixedType,0
1,10,0,11,mixedType,1
4,5,0,9,mixedType,1
6,4,0,10,mixedType,1
4,2,0,6,mixedType,0
8,3,0,11,mixedType,1
5,5,0,10,mixedType,1
9,1,0,10,mixedType,1
7,2,0,9,mixedType,1
5,3,0,8,mixedType,1
7,2,0,9,mixedType,1
9,4,0,13,mixedType,1
7,3,0,10,mixedType,1
5,8,0,13,mixedType,1
15,1,0,16,mixedType,2
10,4,0,14,mixedType,2
5,2,0,7,mixedType,0
15,5,0,20,mixedType,2
5,2,0,7,mixedType,0
8,1,0,9,mixedType,1
8,2,0,10,mixedType,1
9,1,0,10,mixedType,1
5,3,0,8,mixedType,1
5,2,0,7,mixedType,0
7,1,0,8,mixedType,1
6,1,0,7,mixedType,0
6,4,0,10,mixedType,1
5,3,0,8,mixedType,1
11,1,0,12,mixedType,1
7,2,0,9,mixedType,1
6,5,0,11,mixedType,1
2,8,0,10,mixedType,1
4,2,0,6,mixedType,0
14,2,0,16,mixedType,2
6,1,0,7,mixedType,0
4,4,0,8,mixedType,1
6,1,0,7,mixedType,0
7,3,0,10,mixedType,1
5,3,0,8,mixedType,1
5,3,0,8,mixedType,1
7,3,0,10,mixedType,1
8,2,0,10,mixedType,1
6,6,0,12,mixedType,1
6,3,0,9,mixedType,1
6,3,0,9,mixedType,1
5,4,0,9,mixedType,1
8,4,0,12,mixedType,1
4,4,0,8,mixedType,1
14,2,0,16,mixedType,2
5,3,0,8,mixedType,1
5,0,1,6,mixedType,0
5,2,0,7,mixedType,0
6,3,0,9,mixedType,1
10,6,0,16,mixedType,2
8,1,0,9,mixedType,1
8,1,0,9,mixedType,1
8,1,0,9,mixedType,1
6,3,0,9,mixedType,1
6,3,0,9,mixedType,1
7,3,0,10,mixedType,1
10,1,0,11,mixedType,1
4,6,0,10,mixedType,1
4,2,0,6,mixedType,0
4,2,0,6,mixedType,0
14,2,0,16,mixedType,2
6,4,0,10,mixedType,1
9,4,0,13,mixedType,1
9,2,0,11,mixedType,1
2,6,0,8,mixedType,1
6,2,0,8,mixedType,1
5,2,0,7,mixedType,0
7,5,0,12,mixedType,1
5,3,0,8,mixedType,1
8,1,0,9,mixedType,1
5,3,0,8,mixedType,1
6,3,0,9,mixedType,1
9,3,0,12,mixedType,1
5,3,0,8,mixedType,1
8,1,0,9,mixedType,1
10,1,0,11,mixedType,1
6,3,0,9,mixedType,1
7,3,0,10,mixedType,1
11,3,0,14,mixedType,2
4,4,0,8,mixedType,1
6,3,0,9,mixedType,1
8,2,0,10,mixedType,1
8,2,0,10,mixedType,1
6,1,0,7,mixedType,0
8,1,0,9,mixedType,1
7,1,0,8,mixedType,1
3,3,0,6,mixedType,0
11,3,0,14,mixedType,2
5,2,0,7,mixedType,0
7,2,0,9,mixedType,1
9,4,0,13,mixedType,1
7,4,0,11,mixedType,1
4,4,0,8,mixedType,1
4,6,0,10,mixedType,1
6,1,0,7,mixedType,0
7,4,0,11,mixedType,1
5,5,0,10,mixedType,1
2,6,0,8,mixedType,1
2,8,0,10,mixedType,1
6,1,0,7,mixedType,0
7,2,0,9,mixedType,1
6,4,0,10,mixedType,1
2,7,0,9,mixedType,1
6,4,0,10,mixedType,1
6,1,0,7,mixedType,0
13,3,0,16,mixedType,2
7,2,0,9,mixedType,1
1,8,0,9,mixedType,1
7,3,0,10,mixedType,1
7,3,0,10,mixedType,1
7,3,0,10,mixedType,1
8,1,0,9,mixedType,1
8,2,0,10,mixedType,1
4,5,0,9,mixedType,1
6,6,2,14,mixedType,2
4,4,0,8,mixedType,1
8,1,0,9,mixedType,1
8,4,0,12,mixedType,1
7,1,0,8,mixedType,1
8,4,0,12,mixedType,1
11,3,0,14,mixedType,2
7,1,0,8,mixedType,1
4,4,0,8,mixedType,1
5,3,0,8,mixedType,1
13,3,0,16,mixedType,2
8,1,0,9,mixedType,1
12,4,0,16,mixedType,2
5,3,0,8,mixedType,1
8,3,0,11,mixedType,1
8,10,0,18,mixedType,2
14,2,0,16,mixedType,2
13,3,0,16,mixedType,2
7,5,0,12,mixedType,1
6,8,0,14,mixedType,2
8,2,0,10,mixedType,1
2,8,0,10,mixedType,1
8,4,2,14,mixedType,2
10,2,0,12,mixedType,1
6,1,0,7,mixedType,0
6,3,0,9,mixedType,1
6,5,0,11,mixedType,1
7,1,0,8,mixedType,1
7,1,0,8,mixedType,1
4,4,0,8,mixedType,1
8,1,0,9,mixedType,1
8,4,0,12,mixedType,1
9,2,0,11,mixedType,1
6,2,0,8,mixedType,1
4,2,0,6,mixedType,0
15,1,0,16,mixedType,2
6,4,0,10,mixedType,1
7,2,0,9,mixedType,1
8,2,0,10,mixedType,1
7,3,0,10,mixedType,1
2,8,0,10,mixedType,1
8,1,0,9,mixedType,1
6,3,0,9,mixedType,1
6,2,0,8,mixedType,1
2,8,0,10,mixedType,1
6,6,0,12,mixedType,1
6,4,0,10,mixedType,1
6,2,0,8,mixedType,1
2,7,0,9,mixedType,1
6,3,0,9,mixedType,1
7,1,0,8,mixedType,1
7,3,0,10,mixedType,1
7,3,0,10,mixedType,1
5,2,0,7,mixedType,0
8,2,0,10,mixedType,1
6,2,0,8,mixedType,1
15,1,0,16,mixedType,2
1,8,0,9,mixedType,1
9,2,0,11,mixedType,1
2,4,0,6,mixedType,0
10,2,0,12,mixedType,1
9,1,0,10,mixedType,1
5,4,0,9,mixedType,1
2,6,0,8,mixedType,1
8,2,0,10,mixedType,1
6,1,0,7,mixedType,0
2,7,0,9,mixedType,1
5,1,0,6,mixedType,0
15,1,0,16,mixedType,2
6,4,0,10,mixedType,1
6,2,0,8,mixedType,1
5,4,0,9,mixedType,1
9,4,0,13,mixedType,1
9,4,0,13,mixedType,1
7,3,0,10,mixedType,1
3,6,0,9,mixedType,1
5,2,0,7,mixedType,0
2,6,0,8,mixedType,1
4,5,0,9,mixedType,1
12,3,0,15,mixedType,2
3,7,0,10,mixedType,1
5,2,0,7,mixedType,0
4,2,0,6,mixedType,0
8,1,0,9,mixedType,1
7,4,0,11,mixedType,1
5,1,0,6,mixedType,0
13,3,0,16,mixedType,2
1,5,0,6,mixedType,0
8,3,0,11,mixedType,1
4,2,0,6,mixedType,0
13,3,0,16,mixedType,2
14,2,0,16,mixedType,2
6,3,0,9,mixedType,1
9,3,0,12,mixedType,1
1,8,0,9,mixedType,1
8,4,0,12,mixedType,1
2,8,0,10,mixedType,1
7,3,0,10,mixedType,1
7,6,0,13,mixedType,1
8,2,0,10,mixedType,1
6,1,0,7,mixedType,0
7,2,0,9,mixedType,1
8,2,0,10,mixedType,1
4,11,0,15,mixedType,2
7,3,0,10,mixedType,1
6,2,0,8,mixedType,1
5,4,0,9,mixedType,1
9,3,0,12,mixedType,1
7,1,0,8,mixedType,1
7,4,0,11,mixedType,1
14,2,0,16,mixedType,2
8,6,3,17,mixedType,2
10,1,0,11,mixedType,1
7,5,0,12,mixedType,1
14,2,0,16,mixedType,2
8,1,0,9,mixedType,1
6,1,0,7,mixedType,0
6,3,0,9,mixedType,1
2,6,0,8,mixedType,1
5,2,0,7,mixedType,0
6,4,0,10,mixedType,1
6,3,0,9,mixedType,1
15,1,0,16,mixedType,2
8,2,0,10,mixedType,1
6,1,0,7,mixedType,0
8,1,0,9,mixedType,1
6,3,0,9,mixedType,1
1,7,0,8,mixedType,1
8,1,0,9,mixedType,1
9,1,0,10,mixedType,1
6,4,0,10,mixedType,1
8,2,0,10,mixedType,1
7,6,0,13,mixedType,1
3,3,0,6,mixedType,0
8,1,0,9,mixedType,1
8,2,0,10,mixedType,1
6,6,0,12,mixedType,1
6,2,0,8,mixedType,1
4,2,0,6,mixedType,0
3,3,0,6,mixedType,0
14,2,0,16,mixedType,2
6,2,0,8,mixedType,1
4,2,0,6,mixedType,0
8,2,0,10,mixedType,1
9,1,0,10,mixedType,1
2,8,0,10,mixedType,1
6,1,0,7,mixedType,0
12,1,0,13,mixedType,1
6,3,0,9,mixedType,1
6,4,0,10,mixedType,1
8,1,0,9,mixedType,1
14,2,0,16,mixedType,2
9,4,0,13,mixedType,1
9,3,0,12,mixedType,1
7,2,0,9,mixedType,1
5,4,0,9,mixedType,1
10,2,0,12,mixedType,1
4,6,0,10,mixedType,1
7,4,0,11,mixedType,1
7,1,0,8,mixedType,1
7,1,0,8,mixedType,1
7,4,0,11,mixedType,1
6,3,0,9,mixedType,1
11,2,0,13,mixedType,1
5,4,0,9,mixedType,1
6,2,0,8,mixedType,1
6,1,0,7,mixedType,0
9,4,0,13,mixedType,1
11,2,0,13,mixedType,1
21,1,1,23,mixedType,2
15,1,0,16,mixedType,2
5,2,0,7,mixedType,0
5,1,0,6,mixedType,0
7,2,0,9,mixedType,1
7,3,0,10,mixedType,1
15,1,0,16,mixedType,2
5,2,0,7,mixedType,0
6,3,0,9,mixedType,1
5,4,0,9,mixedType,1
7,3,0,10,mixedType,1
5,3,0,8,mixedType,1
14,1,2,17,mixedType,2
1,9,0,10,mixedType,1
6,1,0,7,mixedType,0
9,2,0,11,mixedType,1
12,4,0,16,mixedType,2
6,2,0,8,mixedType,1
6,4,0,10,mixedType,1
15,1,0,16,mixedType,2
4,7,0,11,mixedType,1
8,2,0,10,mixedType,1
10,6,0,16,mixedType,2
8,2,0,10,mixedType,1
13,3,0,16,mixedType,2
5,2,0,7,mixedType,0
14,2,0,16,mixedType,2
2,8,0,10,mixedType,1
8,1,0,9,mixedType,1
5,2,0,7,mixedType,0
4,7,0,11,mixedType,1
15,1,0,16,mixedType,2
7,1,0,8,mixedType,1
10,0,1,11,mixedType,1
12,4,0,16,mixedType,2
4,6,0,10,mixedType,1
6,2,0,8,mixedType,1
9,1,0,10,mixedType,1
2,6,0,8,mixedType,1
8,1,0,9,mixedType,1
9,4,0,13,mixedType,1
5,6,0,11,mixedType,1
6,2,0,8,mixedType,1
10,1,2,13,mixedType,1
10,3,0,13,mixedType,1
6,2,0,8,mixedType,1
5,4,0,9,mixedType,1
10,2,0,12,mixedType,1
14,2,0,16,mixedType,2
6,4,0,10,mixedType,1
6,2,0,8,mixedType,1
6,1,0,7,mixedType,0
11,3,0,14,mixedType,2
6,3,0,9,mixedType,1
6,1,0,7,mixedType,0
13,3,0,16,mixedType,2
8,2,0,10,mixedType,1
6,4,0,10,mixedType,1
6,2,0,8,mixedType,1
9,3,0,12,mixedType,1
6,3,0,9,mixedType,1
6,4,0,10,mixedType,1
6,3,0,9,mixedType,1
6,3,0,9,mixedType,1
8,2,0,10,mixedType,1
6,1,0,7,mixedType,0
4,9,0,13,mixedType,1
14,2,0,16,mixedType,2
9,2,0,11,mixedType,1
5,4,0,9,mixedType,1
5,3,0,8,mixedType,1
5,6,0,11,mixedType,1
8,1,0,9,mixedType,1
8,2,0,10,mixedType,1
7,2,0,9,mixedType,1
1,9,0,10,mixedType,1
7,3,0,10,mixedType,1
4,5,0,9,mixedType,1
8,1,0,9,mixedType,1
7,3,0,10,mixedType,1
7,1,0,8,mixedType,1
2,7,0,9,mixedType,1
5,4,0,9,mixedType,1
5,2,0,7,mixedType,0
4,4,0,8,mixedType,1
4,7,0,11,mixedType,1
7,2,0,9,mixedType,1
5,3,0,8,mixedType,1
14,2,0,16,mixedType,2
8,2,0,10,mixedType,1
4,6,0,10,mixedType,1
11,0,1,12,mixedType,1
4,4,0,8,mixedType,1
9,1,0,10,mixedType,1
6,3,0,9,mixedType,1
8,2,0,10,mixedType,1
12,4,0,16,mixedType,2
8,1,0,9,mixedType,1
8,3,0,11,mixedType,1
7,2,0,9,mixedType,1
7,3,0,10,mixedType,1
4,4,0,8,mixedType,1
5,4,0,9,mixedType,1
4,5,0,9,mixedType,1
8,3,0,11,mixedType,1
7,2,0,9,mixedType,1
6,1,0,7,mixedType,0
7,2,0,9,mixedType,1
6,3,0,9,mixedType,1
15,1,0,16,mixedType,2
13,3,0,16,mixedType,2
9,1,0,10,mixedType,1
6,2,0,8,mixedType,1
6,3,0,9,mixedType,1
6,4,0,10,mixedType,1
7,2,0,9,mixedType,1
6,2,0,8,mixedType,1
7,2,0,9,mixedType,1
6,2,0,8,mixedType,1
1,11,0,12,mixedType,1
7,2,0,9,mixedType,1
8,1,0,9,mixedType,1
9,5,2,16,mixedType,2
7,1,0,8,mixedType,1
4,2,0,6,mixedType,0
8,3,0,11,mixedType,1
10,4,0,14,mixedType,2
9,1,0,10,mixedType,1
6,3,0,9,mixedType,1
2,7,0,9,mixedType,1
5,3,0,8,mixedType,1
9,2,0,11,mixedType,1
1,7,0,8,mixedType,1
6,3,0,9,mixedType,1
6,6,0,12,mixedType,1
9,4,0,13,mixedType,1
10,0,1,11,mixedType,1
12,1,0,13,mixedType,1
5,2,0,7,mixedType,0
11,3,0,14,mixedType,2
5,6,0,11,mixedType,1
13,3,0,16,mixedType,2
9,2,0,11,mixedType,1
0,10,1,11,mixedType,1
3,6,0,9,mixedType,1
10,3,0,13,mixedType,1
7,3,0,10,mixedType,1
5,7,0,12,mixedType,1
6,3,0,9,mixedType,1
6,3,0,9,mixedType,1
5,4,0,9,mixedType,1
7,6,0,13,mixedType,1
6,2,0,8,mixedType,1
10,4,0,14,mixedType,2
14,2,0,16,mixedType,2
14,4,0,18,mixedType,2
7,1,0,8,mixedType,1
4,2,0,6,mixedType,0
6,2,0,8,mixedType,1
8,2,0,10,mixedType,1
6,3,0,9,mixedType,1
1,8,0,9,mixedType,1
10,2,0,12,mixedType,1
3,3,0,6,mixedType,0
7,2,0,9,mixedType,1
7,4,0,11,mixedType,1
8,2,0,10,mixedType,1
13,3,0,16,mixedType,2
4,8,0,12,mixedType,1
15,1,0,16,mixedType,2
5,3,0,8,mixedType,1
13,3,0,16,mixedType,2
8,4,0,12,mixedType,1
13,3,0,16,mixedType,2
7,3,0,10,mixedType,1
1,8,0,9,mixedType,1
15,1,0,16,mixedType,2
7,3,0,10,mixedType,1
3,5,0,8,mixedType,1
15,1,0,16,mixedType,2
4,6,0,10,mixedType,1
6,3,0,9,mixedType,1
6,3,0,9,mixedType,1
15,1,0,16,mixedType,2
6,3,0,9,mixedType,1
14,1,1,16,mixedType,2
13,3,0,16,mixedType,2
5,4,0,9,mixedType,1
8,1,0,9,mixedType,1
6,4,0,10,mixedType,1
8,2,0,10,mixedType,1
7,2,0,9,mixedType,1
7,1,0,8,mixedType,1
3,8,0,11,mixedType,1
13,3,0,16,mixedType,2
15,1,0,16,mixedType,2
8,1,0,9,mixedType,1
8,1,0,9,mixedType,1
2,4,0,6,mixedType,0
2,7,0,9,mixedType,1
6,4,0,10,mixedType,1
8,1,0,9,mixedType,1
8,4,0,12,mixedType,1
14,2,0,16,mixedType,2
3,6,0,9,mixedType,1
9,3,0,12,mixedType,1
3,5,0,8,mixedType,1
5,3,0,8,mixedType,1
7,3,0,10,mixedType,1
7,3,0,10,mixedType,1
6,2,0,8,mixedType,1
7,3,0,10,mixedType,1
6,5,0,11,mixedType,1
3,9,0,12,mixedType,1
6,4,0,10,mixedType,1
7,4,0,11,mixedType,1
8,3,0,11,mixedType,1
9,3,0,12,mixedType,1
11,2,0,13,mixedType,1
6,2,0,8,mixedType,1
15,1,0,16,mixedType,2
11,3,0,14,mixedType,2
8,2,0,10,mixedType,1
5,4,0,9,mixedType,1
6,3,0,9,mixedType,1
6,2,0,8,mixedType,1
1,8,0,9,mixedType,1
15,1,0,16,mixedType,2
14,2,0,16,mixedType,2
7,8,1,16,mixedType,2
7,2,0,9,mixedType,1
9,2,0,11,mixedType,1
15,1,0,16,mixedType,2
7,2,0,9,mixedType,1
10,2,0,12,mixedType,1
5,4,0,9,mixedType,1
5,4,0,9,mixedType,1
6,2,0,8,mixedType,1
6,4,0,10,mixedType,1
3,9,0,12,mixedType,1
14,2,0,16,mixedType,2
6,2,0,8,mixedType,1
5,2,0,7,mixedType,0
8,2,0,10,mixedType,1
14,2,0,16,mixedType,2
4,5,0,9,mixedType,1
9,3,0,12,mixedType,1
8,1,0,9,mixedType,1
6,4,0,10,mixedType,1
6,1,0,7,mixedType,0
7,3,0,10,mixedType,1
5,2,0,7,mixedType,0
7,3,0,10,mixedType,1
4,4,0,8,mixedType,1
5,4,0,9,mixedType,1
14,2,0,16,mixedType,2
16,1,1,18,mixedType,2
7,3,0,10,mixedType,1
5,3,0,8,mixedType,1
6,2,0,8,mixedType,1
5,3,0,8,mixedType,1
4,2,0,6,mixedType,0
8,3,0,11,mixedType,1
4,8,0,12,mixedType,1
3,6,0,9,mixedType,1
8,1,0,9,mixedType,1
8,3,0,11,mixedType,1
4,4,0,8,mixedType,1
6,3,0,9,mixedType,1
3,3,0,6,mixedType,0
9,3,0,12,mixedType,1
13,3,0,16,mixedType,2
5,2,0,7,mixedType,0
5,9,0,14,mixedType,2
8,4,0,12,mixedType,1
5,1,0,6,mixedType,0
6,3,0,9,mixedType,1
6,1,0,7,mixedType,0
1,11,0,12,mixedType,1
12,0,1,13,mixedType,1
6,6,0,12,mixedType,1
9,2,0,11,mixedType,1
5,3,0,8,mixedType,1
6,3,0,9,mixedType,1
6,5,0,11,mixedType,1
2,7,0,9,mixedType,1
8,2,0,10,mixedType,1
5,8,0,13,mixedType,1
9,2,0,11,mixedType,1
7,4,0,11,mixedType,1
7,2,0,9,mixedType,1
3,6,0,9,mixedType,1
8,1,0,9,mixedType,1
4,6,0,10,mixedType,1
12,4,0,16,mixedType,2
3,6,0,9,mixedType,1
7,3,0,10,mixedType,1
9,4,0,13,mixedType,1
15,1,0,16,mixedType,2
6,4,0,10,mixedType,1
4,4,0,8,mixedType,1
8,2,0,10,mixedType,1
7,3,0,10,mixedType,1
5,3,0,8,mixedType,1
5,2,0,7,mixedType,0
14,2,0,16,mixedType,2
4,2,0,6,mixedType,0
7,3,0,10,mixedType,1
8,2,0,10,mixedType,1
14,2,0,16,mixedType,2
4,6,0,10,mixedType,1
7,3,0,10,mixedType,1
3,5,0,8,mixedType,1
5,4,0,9,mixedType,1
6,3,0,9,mixedType,1
6,6,0,12,mixedType,1
6,3,0,9,mixedType,1
14,2,0,16,mixedType,2
5,4,0,9,mixedType,1
7,3,0,10,mixedType,1
6,1,0,7,mixedType,0
6,3,0,9,mixedType,1
5,4,0,9,mixedType,1
7,4,0,11,mixedType,1
5,3,0,8,mixedType,1
5,2,0,7,mixedType,0
4,4,0,8,mixedType,1
7,3,0,10,mixedType,1
13,3,0,16,mixedType,2
5,3,0,8,mixedType,1
7,6,0,13,mixedType,1
5,3,0,8,mixedType,1
2,8,0,10,mixedType,1
2,8,0,10,mixedType,1
2,7,0,9,mixedType,1
8,1,0,9,mixedType,1
5,3,0,8,mixedType,1
4,4,0,8,mixedType,1
9,2,0,11,mixedType,1
7,1,0,8,mixedType,1
6,1,0,7,mixedType,0
6,2,0,8,mixedType,1
6,3,0,9,mixedType,1
8,2,0,10,mixedType,1
2,8,0,10,mixedType,1
13,3,0,16,mixedType,2
6,3,0,9,mixedType,1
2,8,0,10,mixedType,1
12,3,1,16,mixedType,2
6,3,0,9,mixedType,1
3,6,0,9,mixedType,1
7,2,0,9,mixedType,1
4,4,0,8,mixedType,1
6,3,0,9,mixedType,1
6,3,0,9,mixedType,1
14,2,0,16,mixedType,2
7,3,0,10,mixedType,1
14,2,0,16,mixedType,2
7,3,0,10,mixedType,1
6,3,0,9,mixedType,1
6,1,0,7,mixedType,0
3,6,0,9,mixedType,1
7,1,0,8,mixedType,1
5,2,0,7,mixedType,0
8,2,0,10,mixedType,1
8,2,0,10,mixedType,1
8,2,0,10,mixedType,1
7,1,0,8,mixedType,1
14,2,0,16,mixedType,2
8,1,0,9,mixedType,1
6,1,0,7,mixedType,0
4,2,0,6,mixedType,0
10,3,1,14,mixedType,2
5,3,0,8,mixedType,1
4,4,0,8,mixedType,1
5,3,0,8,mixedType,1
3,6,0,9,mixedType,1
7,3,0,10,mixedType,1
5,1,0,6,mixedType,0
10,2,0,12,mixedType,1
6,6,0,12,mixedType,1
5,2,0,7,mixedType,0
6,3,0,9,mixedType,1
15,1,0,16,mixedType,2
13,3,0,16,mixedType,2
9,2,0,11,mixedType,1
4,4,0,8,mixedType,1
3,8,0,11,mixedType,1
6,6,0,12,mixedType,1
8,2,0,10,mixedType,1
8,2,0,10,mixedType,1
5,4,0,9,mixedType,1
6,4,0,10,mixedType,1
8,1,0,9,mixedType,1
4,2,0,6,mixedType,0
7,3,0,10,mixedType,1
11,2,0,13,mixedType,1
6,1,0,7,mixedType,0
4,2,0,6,mixedType,0
7,1,0,8,mixedType,1
5,2,0,7,mixedType,0
1,8,0,9,mixedType,1
8,2,0,10,mixedType,1
6,1,0,7,mixedType,0
8,1,0,9,mixedType,1
6,3,0,9,mixedType,1
4,4,0,8,mixedType,1
8,2,0,10,mixedType,1
2,10,0,12,mixedType,1
5,1,0,6,mixedType,0
10,4,0,14,mixedType,2
13,3,0,16,mixedType,2
6,3,0,9,mixedType,1
7,3,0,10,mixedType,1
5,4,0,9,mixedType,1
5,3,0,8,mixedType,1
12,4,0,16,mixedType,2
6,3,0,9,mixedType,1
5,2,0,7,mixedType,0
6,1,0,7,mixedType,0
6,2,0,8,mixedType,1
8,3,0,11,mixedType,1
5,1,0,6,mixedType,0
6,2,0,8,mixedType,1
4,4,0,8,mixedType,1
1,7,0,8,mixedType,1
13,3,0,16,mixedType,2
5,4,0,9,mixedType,1
3,8,0,11,mixedType,1
9,1,0,10,mixedType,1
8,1,0,9,mixedType,1
7,1,0,8,mixedType,1
4,2,0,6,mixedType,0
4,4,0,8,mixedType,1
11,3,0,14,mixedType,2
6,6,0,12,mixedType,1
7,3,0,10,mixedType,1
4,4,0,8,mixedType,1
6,3,0,9,mixedType,1
6,4,0,10,mixedType,1
10,2,0,12,mixedType,1
8,1,0,9,mixedType,1
7,3,0,10,mixedType,1
6,2,0,8,mixedType,1
6,2,0,8,mixedType,1
5,4,0,9,mixedType,1
9,2,0,11,mixedType,1
6,3,0,9,mixedType,1
7,2,0,9,mixedType,1
5,4,0,9,mixedType,1
5,4,0,9,mixedType,1
14,2,0,16,mixedType,2
7,3,0,10,mixedType,1
5,3,0,8,mixedType,1
7,2,0,9,mixedType,1
4,2,0,6,mixedType,0
7,5,0,12,mixedType,1
10,2,0,12,mixedType,1
7,4,0,11,mixedType,1
1,10,0,11,mixedType,1
2,11,0,13,mixedType,1
4,2,0,6,mixedType,0
7,4,0,11,mixedType,1
6,2,0,8,mixedType,1
7,2,0,9,mixedType,1
5,4,0,9,mixedType,1
6,2,0,8,mixedType,1
7,3,0,10,mixedType,1
7,2,0,9,mixedType,1
3,3,0,6,mixedType,0
5,2,0,7,mixedType,0
1,8,0,9,mixedType,1
4,6,0,10,mixedType,1
9,2,0,11,mixedType,1
1,9,0,10,mixedType,1
11,3,0,14,mixedType,2
4,2,0,6,mixedType,0
9,1,0,10,mixedType,1
12,4,0,16,mixedType,2
6,2,0,8,mixedType,1
2,6,0,8,mixedType,1
2,4,0,6,mixedType,0
6,2,0,8,mixedType,1
4,5,0,9,mixedType,1
7,2,0,9,mixedType,1
5,1,0,6,mixedType,0
10,3,0,13,mixedType,1
4,6,0,10,mixedType,1
3,6,0,9,mixedType,1
7,3,0,10,mixedType,1
6,3,0,9,mixedType,1
7,3,0,10,mixedType,1
12,4,0,16,mixedType,2
2,4,0,6,mixedType,0
6,10,1,17,mixedType,2
7,2,0,9,mixedType,1
5,2,0,7,mixedType,0
7,2,0,9,mixedType,1
6,2,0,8,mixedType,1
15,1,0,16,mixedType,2
1,7,0,8,mixedType,1
9,1,0,10,mixedType,1
2,7,0,9,mixedType,1
12,3,0,15,mixedType,2
2,9,0,11,mixedType,1
5,3,0,8,mixedType,1
5,3,0,8,mixedType,1
4,6,0,10,mixedType,1
9,1,0,10,mixedType,1
14,2,0,16,mixedType,2
5,3,0,8,mixedType,1
7,3,0,10,mixedType,1
8,2,0,10,mixedType,1
11,3,0,14,mixedType,2
6,1,0,7,mixedType,0
7,2,0,9,mixedType,1
6,4,0,10,mixedType,1
7,3,0,10,mixedType,1
4,2,0,6,mixedType,0
4,4,0,8,mixedType,1
5,2,0,7,mixedType,0
14,2,0,16,mixedType,2
5,3,0,8,mixedType,1
11,5,0,16,mixedType,2
12,4,0,16,mixedType,2
3,6,0,9,mixedType,1
6,3,0,9,mixedType,1
2,6,0,8,mixedType,1
9,1,0,10,mixedType,1
9,2,0,11,mixedType,1
6,3,0,9,mixedType,1
6,3,0,9,mixedType,1
7,3,0,10,mixedType,1
6,6,0,12,mixedType,1
1,5,0,6,mixedType,0
7,3,0,10,mixedType,1
7,2,0,9,mixedType,1
8,4,0,12,mixedType,1
1,7,0,8,mixedType,1
6,4,0,10,mixedType,1
3,10,0,13,mixedType,1
13,3,0,16,mixedType,2
5,4,0,9,mixedType,1
4,4,0,8,mixedType,1
8,2,0,10,mixedType,1
6,4,0,10,mixedType,1
6,6,0,12,mixedType,1
5,2,0,7,mixedType,0
11,5,0,16,mixedType,2
11,2,0,13,mixedType,1
8,1,0,9,mixedType,1
5,3,0,8,mixedType,1
6,1,0,7,mixedType,0
5,4,0,9,mixedType,1
6,3,0,9,mixedType,1
4,2,0,6,mixedType,0
8,1,0,9,mixedType,1
9,1,0,10,mixedType,1
5,3,0,8,mixedType,1
6,2,0,8,mixedType,1
13,3,0,16,mixedType,2
5,4,0,9,mixedType,1
8,2,0,10,mixedType,1
3,6,0,9,mixedType,1
9,1,0,10,mixedType,1
7,2,0,9,mixedType,1
6,3,0,9,mixedType,1
5,2,0,7,mixedType,0
2,7,0,9,mixedType,1
7,4,0,11,mixedType,1
6,1,0,7,mixedType,0
11,1,0,12,mixedType,1
5,3,0,8,mixedType,1
7,3,0,10,mixedType,1
6,4,0,10,mixedType,1
5,3,0,8,mixedType,1
9,1,0,10,mixedType,1
7,2,0,9,mixedType,1
6,3,0,9,mixedType,1
6,4,0,10,mixedType,1
2,8,0,10,mixedType,1
8,2,0,10,mixedType,1
6,3,0,9,mixedType,1
3,7,0,10,mixedType,1
7,1,0,8,mixedType,1
5,4,0,9,mixedType,1
0,6,1,7,mixedType,0
6,1,0,7,mixedType,0
5,3,0,8,mixedType,1
5,2,0,7,mixedType,0
9,5,0,14,mixedType,2
14,2,0,16,mixedType,2
5,2,0,7,mixedType,0
8,3,0,11,mixedType,1
8,4,0,12,mixedType,1
11,5,0,16,mixedType,2
10,2,0,12,mixedType,1
7,3,0,10,mixedType,1
4,4,0,8,mixedType,1
3,6,0,9,mixedType,1
5,6,3,14,mixedType,2
4,5,0,9,mixedType,1
6,4,0,10,mixedType,1
2,10,0,12,mixedType,1
6,2,0,8,mixedType,1
4,7,0,11,mixedType,1
7,1,0,8,mixedType,1
14,2,0,16,mixedType,2
5,4,0,9,mixedType,1
6,2,0,8,mixedType,1
9,3,0,12,mixedType,1
7,1,0,8,mixedType,1
7,1,0,8,mixedType,1
6,4,0,10,mixedType,1
4,2,0,6,mixedType,0
5,4,0,9,mixedType,1
1,8,0,9,mixedType,1
7,1,0,8,mixedType,1
9,2,0,11,mixedType,1
0,6,0,6,sameType,0
6,2,0,8,mixedType,1
6,3,0,9,mixedType,1
8,3,0,11,mixedType,1
8,2,0,10,mixedType,1
4,2,0,6,mixedType,0
5,1,0,6,mixedType,0
11,5,0,16,mixedType,2
4,6,0,10,mixedType,1
6,3,0,9,mixedType,1
6,4,0,10,mixedType,1
1,10,0,11,mixedType,1
5,1,0,6,mixedType,0
10,0,1,11,mixedType,1
7,3,0,10,mixedType,1
8,4,0,12,mixedType,1
6,6,0,12,mixedType,1
7,5,0,12,mixedType,1
6,4,0,10,mixedType,1
14,2,0,16,mixedType,2
7,1,0,8,mixedType,1
4,4,0,8,mixedType,1
7,3,0,10,mixedType,1
7,3,0,10,mixedType,1
5,4,0,9,mixedType,1
6,1,0,7,mixedType,0
6,3,0,9,mixedType,1
5,2,0,7,mixedType,0
8,2,0,10,mixedType,1
4,4,0,8,mixedType,1
9,4,1,14,mixedType,2
4,4,0,8,mixedType,1
7,5,0,12,mixedType,1
5,2,0,7,mixedType,0
7,2,0,9,mixedType,1
8,2,0,10,mixedType,1
7,3,0,10,mixedType,1
4,4,0,8,mixedType,1
6,1,0,7,mixedType,0
9,5,0,14,mixedType,2
4,4,0,8,mixedType,1
7,3,0,10,mixedType,1
13,3,0,16,mixedType,2
8,2,0,10,mixedType,1
4,2,0,6,mixedType,0
7,2,0,9,mixedType,1
2,4,0,6,mixedType,0
6,2,0,8,mixedType,1
6,4,0,10,mixedType,1
7,3,0,10,mixedType,1
4,2,0,6,mixedType,0
7,1,0,8,mixedType,1
5,2,0,7,mixedType,0
4,6,0,10,mixedType,1
5,3,0,8,mixedType,1
7,1,0,8,mixedType,1
14,2,0,16,mixedType,2
2,6,0,8,mixedType,1
2,6,0,8,mixedType,1
7,3,0,10,mixedType,1
14,2,0,16,mixedType,2
5,2,0,7,mixedType,0
4,4,0,8,mixedType,1
6,3,0,9,mixedType,1
5,2,0,7,mixedType,0
2,7,0,9,mixedType,1
10,5,1,16,mixedType,2
7,3,0,10,mixedType,1
4,2,0,6,mixedType,0
7,3,0,10,mixedType,1
7,5,0,12,mixedType,1
7,2,0,9,mixedType,1
4,4,0,8,mixedType,1
7,1,0,8,mixedType,1
2,7,0,9,mixedType,1
7,2,0,9,mixedType,1
8,4,0,12,mixedType,1
6,3,0,9,mixedType,1
14,2,0,16,mixedType,2
6,3,0,9,mixedType,1
13,3,0,16,mixedType,2
9,1,0,10,mixedType,1
13,3,0,16,mixedType,2
11,2,1,14,mixedType,2
2,7,0,9,mixedType,1
11,3,0,14,mixedType,2
13,3,0,16,mixedType,2
4,7,0,11,mixedType,1
4,4,0,8,mixedType,1
9,1,0,10,mixedType,1
7,3,0,10,mixedType,1
5,2,0,7,mixedType,0
6,1,0,7,mixedType,0
5,3,0,8,mixedType,1
15,1,0,16,mixedType,2
5,4,0,9,mixedType,1
14,2,0,16,mixedType,2
7,3,0,10,mixedType,1
13,3,0,16,mixedType,2
4,2,0,6,mixedType,0
8,1,0,9,mixedType,1
7,3,0,10,mixedType,1
9,3,0,12,mixedType,1
8,1,0,9,mixedType,1
2,7,0,9,mixedType,1
6,2,0,8,mixedType,1
5,1,0,6,mixedType,0
5,2,0,7,mixedType,0
6,3,0,9,mixedType,1
3,5,0,8,mixedType,1
6,1,0,7,mixedType,0
12,3,0,15,mixedType,2
2,8,0,10,mixedType,1
6,1,0,7,mixedType,0
6,4,0,10,mixedType,1
2,8,0,10,mixedType,1
4,6,0,10,mixedType,1
8,2,0,10,mixedType,1
7,2,0,9,mixedType,1
6,1,0,7,mixedType,0
12,4,0,16,mixedType,2
7,2,0,9,mixedType,1
14,2,0,16,mixedType,2
12,4,0,16,mixedType,2
7,2,0,9,mixedType,1
9,2,0,11,mixedType,1
6,3,0,9,mixedType,1
6,4,0,10,mixedType,1
11,1,0,12,mixedType,1
6,3,0,9,mixedType,1
5,3,0,8,mixedType,1
3,8,0,11,mixedType,1
2,4,0,6,mixedType,0
8,4,0,12,mixedType,1
17,1,1,19,mixedType,2
5,3,0,8,mixedType,1
8,2,0,10,mixedType,1
5,6,0,11,mixedType,1
8,2,0,10,mixedType,1
5,6,0,11,mixedType,1
8,1,0,9,mixedType,1
4,7,0,11,mixedType,1
7,3,0,10,mixedType,1
13,3,0,16,mixedType,2
7,5,0,12,mixedType,1
4,4,0,8,mixedType,1
2,6,0,8,mixedType,1
13,3,0,16,mixedType,2
4,2,0,6,mixedType,0
9,1,0,10,mixedType,1
7,2,0,9,mixedType,1
8,6,0,14,mixedType,2
4,4,0,8,mixedType,1
15,1,0,16,mixedType,2
5,1,0,6,mixedType,0
5,4,0,9,mixedType,1
12,4,0,16,mixedType,2
9,1,0,10,mixedType,1
8,2,0,10,mixedType,1
6,3,0,9,mixedType,1
7,1,0,8,mixedType,1
4,6,0,10,mixedType,1
5,2,0,7,mixedType,0
6,2,0,8,mixedType,1
4,2,0,6,mixedType,0
11,5,0,16,mixedType,2
13,3,0,16,mixedType,2
6,1,0,7,mixedType,0
6,3,0,9,mixedType,1
7,3,0,10,mixedType,1
6,7,1,14,mixedType,2
11,3,0,14,mixedType,2
6,6,0,12,mixedType,1
8,1,0,9,mixedType,1
7,3,0,10,mixedType,1
5,1,0,6,mixedType,0
9,4,0,13,mixedType,1
8,2,0,10,mixedType,1
10,2,0,12,mixedType,1
9,1,0,10,mixedType,1
5,3,0,8,mixedType,1
5,2,0,7,mixedType,0
12,3,0,15,mixedType,2
6,7,0,13,mixedType,1
3,5,0,8,mixedType,1
7,4,0,11,mixedType,1
11,3,0,14,mixedType,2
4,4,0,8,mixedType,1
5,3,0,8,mixedType,1
5,4,0,9,mixedType,1
1,10,0,11,mixedType,1
1,9,0,10,mixedType,1
2,8,0,10,mixedType,1
12,1,1,14,mixedType,2
8,1,0,9,mixedType,1
7,3,0,10,mixedType,1
7,3,0,10,mixedType,1
6,3,0,9,mixedType,1
8,1,0,9,mixedType,1
13,3,0,16,mixedType,2
6,3,0,9,mixedType,1
7,3,0,10,mixedType,1
6,7,0,13,mixedType,1
9,3,0,12,mixedType,1
3,10,0,13,mixedType,1
7,2,0,9,mixedType,1
6,4,0,10,mixedType,1
7,3,0,10,mixedType,1
7,3,0,10,mixedType,1
8,2,0,10,mixedType,1
15,1,0,16,mixedType,2
5,3,0,8,mixedType,1
7,1,0,8,mixedType,1
5,4,0,9,mixedType,1
4,2,0,6,mixedType,0
6,3,0,9,mixedType,1
7,1,0,8,mixedType,1
8,5,0,13,mixedType,1
13,3,0,16,mixedType,2
5,6,0,11,mixedType,1
5,1,0,6,mixedType,0
4,4,0,8,mixedType,1
5,3,0,8,mixedType,1
5,2,0,7,mixedType,0
14,2,0,16,mixedType,2
7,2,0,9,mixedType,1
8,4,0,12,mixedType,1
4,2,0,6,mixedType,0
4,4,0,8,mixedType,1
4,4,0,8,mixedType,1
7,3,0,10,mixedType,1
9,1,0,10,mixedType,1
5,2,0,7,mixedType,0
13,3,0,16,mixedType,2
8,1,0,9,mixedType,1
6,3,0,9,mixedType,1
8,1,0,9,mixedType,1
7,4,0,11,mixedType,1
5,1,0,6,mixedType,0
14,2,0,16,mixedType,2
9,2,0,11,mixedType,1
6,2,0,8,mixedType,1
5,4,0,9,mixedType,1
6,3,0,9,mixedType,1
5,2,0,7,mixedType,0
15,1,0,16,mixedType,2
8,1,0,9,mixedType,1
6,4,0,10,mixedType,1
3,6,0,9,mixedType,1
7,1,0,8,mixedType,1
11,5,0,16,mixedType,2
6,3,0,9,mixedType,1
13,3,0,16,mixedType,2
9,1,0,10,mixedType,1
5,3,0,8,mixedType,1
14,2,0,16,mixedType,2
7,5,3,15,mixedType,2
7,2,0,9,mixedType,1
7,3,0,10,mixedType,1
9,1,0,10,mixedType,1
7,1,0,8,mixedType,1
7,3,0,10,mixedType,1
4,4,0,8,mixedType,1
6,4,0,10,mixedType,1
7,2,0,9,mixedType,1
5,2,0,7,mixedType,0
6,7,0,13,mixedType,1
2,6,0,8,mixedType,1
6,4,0,10,mixedType,1
7,2,0,9,mixedType,1
7,2,0,9,mixedType,1
4,2,0,6,mixedType,0
4,4,0,8,mixedType,1
6,4,0,10,mixedType,1
12,1,0,13,mixedType,1
6,3,0,9,mixedType,1
15,1,0,16,mixedType,2
7,2,0,9,mixedType,1
7,5,0,12,mixedType,1
6,2,0,8,mixedType,1
7,2,0,9,mixedType,1
5,3,0,8,mixedType,1
7,6,0,13,mixedType,1
4,4,0,8,mixedType,1
8,2,0,10,mixedType,1
9,1,0,10,mixedType,1
14,2,0,16,mixedType,2
3,5,0,8,mixedType,1
5,2,0,7,mixedType,0
1,8,0,9,mixedType,1
6,6,0,12,mixedType,1
8,1,0,9,mixedType,1
2,4,0,6,mixedType,0
6,0,1,7,mixedType,0
8,2,0,10,mixedType,1
8,3,0,11,mixedType,1
6,4,0,10,mixedType,1
7,3,0,10,mixedType,1
7,3,0,10,mixedType,1
13,3,0,16,mixedType,2
9,4,0,13,mixedType,1
5,3,0,8,mixedType,1
6,4,0,10,mixedType,1
8,2,0,10,mixedType,1
4,2,0,6,mixedType,0
1,10,0,11,mixedType,1
4,4,0,8,mixedType,1
4,6,0,10,mixedType,1
6,2,0,8,mixedType,1
4,6,0,10,mixedType,1
5,7,0,12,mixedType,1
8,1,0,9,mixedType,1
8,2,0,10,mixedType,1
13,3,0,16,mixedType,2
6,4,0,10,mixedType,1
6,2,0,8,mixedType,1
7,3,0,10,mixedType,1
5,3,0,8,mixedType,1
8,1,0,9,mixedType,1
9,2,0,11,mixedType,1
6,3,0,9,mixedType,1
9,4,0,13,mixedType,1
7,3,0,10,mixedType,1
4,6,0,10,mixedType,1
6,3,0,9,mixedType,1
7,3,0,10,mixedType,1
6,3,0,9,mixedType,1
15,1,0,16,mixedType,2
6,1,0,7,mixedType,0
14,2,0,16,mixedType,2
6,3,0,9,mixedType,1
4,4,0,8,mixedType,1
6,3,0,9,mixedType,1
4,6,0,10,mixedType,1
6,4,0,10,mixedType,1
5,3,0,8,mixedType,1
6,1,0,7,mixedType,0
6,5,0,11,mixedType,1
6,1,0,7,mixedType,0
7,3,0,10,mixedType,1
12,4,0,16,mixedType,2
4,2,0,6,mixedType,0
2,6,0,8,mixedType,1
15,1,0,16,mixedType,2
5,3,0,8,mixedType,1
5,4,0,9,mixedType,1
5,3,0,8,mixedType,1
7,4,0,11,mixedType,1
6,3,0,9,mixedType,1
5,1,0,6,mixedType,0
5,2,0,7,mixedType,0
12,3,0,15,mixedType,2
7,4,0,11,mixedType,1
6,1,0,7,mixedType,0
8,1,0,9,mixedType,1
3,3,0,6,mixedType,0
3,6,0,9,mixedType,1
8,2,0,10,mixedType,1
1,7,0,8,mixedType,1
6,3,0,9,mixedType,1
3,6,0,9,mixedType,1
12,4,0,16,mixedType,2
3,6,0,9,mixedType,1
5,3,0,8,mixedType,1
4,4,0,8,mixedType,1
9,1,0,10,mixedType,1
7,2,0,9,mixedType,1
7,1,0,8,mixedType,1
4,5,0,9,mixedType,1
11,5,0,16,mixedType,2
5,3,0,8,mixedType,1
7,3,0,10,mixedType,1
6,2,0,8,mixedType,1
4,4,0,8,mixedType,1
5,3,0,8,mixedType,1
8,3,0,11,mixedType,1
3,6,0,9,mixedType,1
9,4,0,13,mixedType,1
5,3,0,8,mixedType,1
9,2,0,11,mixedType,1
7,3,0,10,mixedType,1
11,10,0,21,mixedType,2
5,3,0,8,mixedType,1
3,8,0,11,mixedType,1
4,4,0,8,mixedType,1
3,5,0,8,mixedType,1
13,3,0,16,mixedType,2
3,5,0,8,mixedType,1
7,3,0,10,mixedType,1
7,3,0,10,mixedType,1
4,4,0,8,mixedType,1
8,4,0,12,mixedType,1
6,4,0,10,mixedType,1
7,2,0,9,mixedType,1
7,3,0,10,mixedType,1
6,4,0,10,mixedType,1
7,3,0,10,mixedType,1
15,1,0,16,mixedType,2
5,3,0,8,mixedType,1
4,7,0,11,mixedType,1
4,2,0,6,mixedType,0
10,2,0,12,mixedType,1
9,3,0,12,mixedType,1
5,4,0,9,mixedType,1
14,2,0,16,mixedType,2
7,2,0,9,mixedType,1
9,2,0,11,mixedType,1
10,3,0,13,mixedType,1
6,1,0,7,mixedType,0
8,2,0,10,mixedType,1
4,2,0,6,mixedType,0
6,3,0,9,mixedType,1
8,1,0,9,mixedType,1
5,3,0,8,mixedType,1
5,6,0,11,mixedType,1
9,1,0,10,mixedType,1
6,4,0,10,mixedType,1
7,3,0,10,mixedType,1
12,4,0,16,mixedType,2
2,4,0,6,mixedType,0
8,2,0,10,mixedType,1
1,8,0,9,mixedType,1
6,4,0,10,mixedType,1
9,4,0,13,mixedType,1
5,4,0,9,mixedType,1
5,3,0,8,mixedType,1
6,2,0,8,mixedType,1
9,1,0,10,mixedType,1
10,2,0,12,mixedType,1
6,3,0,9,mixedType,1
9,1,0,10,mixedType,1
11,2,0,13,mixedType,1
8,2,0,10,mixedType,1
9,2,0,11,mixedType,1
12,3,0,15,mixedType,2
4,4,0,8,mixedType,1
3,6,0,9,mixedType,1
8,1,0,9,mixedType,1
9,5,0,14,mixedType,2
4,5,0,9,mixedType,1
7,2,0,9,mixedType,1
2,8,0,10,mixedType,1
7,2,0,9,mixedType,1
3,6,0,9,mixedType,1
12,4,0,16,mixedType,2
15,1,0,16,mixedType,2
5,3,0,8,mixedType,1
5,0,0,5,sameType,0
6,2,0,8,mixedType,1
8,1,0,9,mixedType,1
6,3,0,9,mixedType,1
6,1,0,7,mixedType,0
6,1,0,7,mixedType,0
7,3,0,10,mixedType,1
4,6,0,10,mixedType,1
7,3,0,10,mixedType,1
6,3,0,9,mixedType,1
8,1,0,9,mixedType,1
7,4,0,11,mixedType,1
2,6,0,8,mixedType,1
3,6,0,9,mixedType,1
15,1,0,16,mixedType,2
6,2,0,8,mixedType,1
6,1,0,7,mixedType,0
7,2,0,9,mixedType,1
4,2,0,6,mixedType,0
4,6,0,10,mixedType,1
7,2,0,9,mixedType,1
7,2,0,9,mixedType,1
5,4,0,9,mixedType,1
5,3,0,8,mixedType,1
5,4,0,9,mixedType,1
13,3,0,16,mixedType,2
2,8,0,10,mixedType,1
15,1,0,16,mixedType,2
2,6,0,8,mixedType,1
2,8,0,10,mixedType,1
8,2,0,10,mixedType,1
9,2,0,11,mixedType,1
6,1,0,7,mixedType,0
5,4,0,9,mixedType,1
6,3,0,9,mixedType,1
14,2,0,16,mixedType,2
5,2,0,7,mixedType,0
6,2,0,8,mixedType,1
6,3,0,9,mixedType,1
7,2,0,9,mixedType,1
8,1,0,9,mixedType,1
12,4,0,16,mixedType,2
6,2,0,8,mixedType,1
11,1,0,12,mixedType,1
8,2,0,10,mixedType,1
8,2,0,10,mixedType,1
12,4,0,16,mixedType,2
5,3,0,8,mixedType,1
9,2,0,11,mixedType,1
8,2,0,10,mixedType,1
4,2,0,6,mixedType,0
7,3,0,10,mixedType,1
7,4,0,11,mixedType,1
9,1,0,10,mixedType,1
14,2,0,16,mixedType,2
8,2,0,10,mixedType,1
7,1,0,8,mixedType,1
6,2,0,8,mixedType,1
5,4,0,9,mixedType,1
14,2,0,16,mixedType,2
5,8,3,16,mixedType,2
5,2,0,7,mixedType,0
5,2,0,7,mixedType,0
7,2,0,9,mixedType,1
6,3,0,9,mixedType,1
7,3,0,10,mixedType,1
14,1,1,16,mixedType,2
5,3,0,8,mixedType,1
7,3,0,10,mixedType,1
5,3,0,8,mixedType,1
5,2,0,7,mixedType,0
6,1,0,7,mixedType,0
2,8,0,10,mixedType,1
6,2,0,8,mixedType,1
7,8,0,15,mixedType,2
5,7,0,12,mixedType,1
11,5,0,16,mixedType,2
8,1,0,9,mixedType,1
6,3,0,9,mixedType,1
7,6,0,13,mixedType,1
7,2,0,9,mixedType,1
4,4,0,8,mixedType,1
8,1,0,9,mixedType,1
6,4,0,10,mixedType,1
7,4,0,11,mixedType,1
7,2,0,9,mixedType,1
4,7,0,11,mixedType,1
4,5,0,9,mixedType,1
9,4,2,15,mixedType,2
4,2,0,6,mixedType,0
5,4,0,9,mixedType,1
7,3,0,10,mixedType,1
12,3,0,15,mixedType,2
4,5,0,9,mixedType,1
1,7,0,8,mixedType,1
8,3,0,11,mixedType,1
5,1,0,6,mixedType,0
13,3,0,16,mixedType,2
6,3,0,9,mixedType,1
11,3,0,14,mixedType,2
4,4,0,8,mixedType,1
5,1,0,6,mixedType,0
7,1,0,8,mixedType,1
7,2,0,9,mixedType,1
7,3,0,10,mixedType,1
6,3,0,9,mixedType,1
3,5,0,8,mixedType,1
6,4,0,10,mixedType,1
8,1,0,9,mixedType,1
5,1,0,6,mixedType,0
5,2,0,7,mixedType,0
4,4,0,8,mixedType,1
7,4,0,11,mixedType,1
13,3,0,16,mixedType,2
5,3,0,8,mixedType,1
12,4,0,16,mixedType,2
8,1,0,9,mixedType,1
6,1,0,7,mixedType,0
7,3,0,10,mixedType,1
3,10,0,13,mixedType,1
5,3,0,8,mixedType,1
6,3,0,9,mixedType,1
7,2,0,9,mixedType,1
8,3,0,11,mixedType,1
8,2,0,10,mixedType,1
8,2,0,10,mixedType,1
1,9,0,10,mixedType,1
5,4,0,9,mixedType,1
2,6,0,8,mixedType,1
9,1,0,10,mixedType,1
7,2,0,9,mixedType,1
9,3,0,12,mixedType,1
6,2,0,8,mixedType,1
14,2,0,16,mixedType,2
6,4,0,10,mixedType,1
8,4,0,12,mixedType,1
9,3,0,12,mixedType,1
6,3,0,9,mixedType,1
4,2,0,6,mixedType,0
4,4,0,8,mixedType,1
7,3,0,10,mixedType,1
7,2,0,9,mixedType,1
5,3,0,8,mixedType,1
8,3,0,11,mixedType,1
5,1,0,6,mixedType,0
8,4,0,12,mixedType,1
7,4,0,11,mixedType,1
14,2,0,16,mixedType,2
7,1,0,8,mixedType,1
7,6,0,13,mixedType,1
9,1,0,10,mixedType,1
6,4,0,10,mixedType,1
8,1,0,9,mixedType,1
11,1,0,12,mixedType,1
6,1,0,7,mixedType,0
5,3,0,8,mixedType,1
5,3,0,8,mixedType,1
4,4,0,8,mixedType,1
5,3,0,8,mixedType,1
5,5,0,10,mixedType,1
8,1,0,9,mixedType,1
9,2,0,11,mixedType,1
4,4,0,8,mixedType,1
7,3,0,10,mixedType,1
11,2,0,13,mixedType,1
5,2,0,7,mixedType,0
6,3,0,9,mixedType,1
1,7,0,8,mixedType,1
2,6,0,8,mixedType,1
1,8,0,9,mixedType,1
4,6,0,10,mixedType,1
11,5,0,16,mixedType,2
8,2,0,10,mixedType,1
0,0,12,12,sameType,0
12,3,0,15,mixedType,2
7,3,0,10,mixedType,1
12,4,0,16,mixedType,2
7,3,0,10,mixedType,1
4,8,3,15,mixedType,2
6,3,0,9,mixedType,1
12,4,0,16,mixedType,2
5,4,0,9,mixedType,1
2,11,0,13,mixedType,1
7,2,0,9,mixedType,1
8,1,0,9,mixedType,1
9,4,0,13,mixedType,1
15,1,0,16,mixedType,2
1,9,0,10,mixedType,1
7,3,0,10,mixedType,1
5,4,0,9,mixedType,1
6,4,0,10,mixedType,1
7,3,0,10,mixedType,1
14,2,0,16,mixedType,2
7,2,0,9,mixedType,1
5,2,0,7,mixedType,0
11,2,0,13,mixedType,1
8,2,0,10,mixedType,1
9,2,0,11,mixedType,1
11,3,0,14,mixedType,2
8,2,0,10,mixedType,1
8,2,0,10,mixedType,1
8,3,0,11,mixedType,1
8,2,0,10,mixedType,1
6,1,0,7,mixedType,0
5,4,0,9,mixedType,1
8,1,0,9,mixedType,1
5,3,0,8,mixedType,1
9,1,0,10,mixedType,1
7,3,0,10,mixedType,1
3,6,0,9,mixedType,1
5,2,0,7,mixedType,0
7,1,0,8,mixedType,1
4,2,0,6,mixedType,0
6,4,0,10,mixedType,1
7,2,0,9,mixedType,1
5,4,0,9,mixedType,1
10,2,0,12,mixedType,1
10,2,0,12,mixedType,1
9,1,0,10,mixedType,1
6,4,0,10,mixedType,1
6,4,0,10,mixedType,1
6,1,0,7,mixedType,0
5,1,0,6,mixedType,0
8,1,0,9,mixedType,1
3,5,0,8,mixedType,1
13,3,0,16,mixedType,2
2,4,0,6,mixedType,0
6,3,0,9,mixedType,1
8,1,0,9,mixedType,1
6,4,0,10,mixedType,1
14,2,0,16,mixedType,2
8,2,0,10,mixedType,1
7,1,0,8,mixedType,1
8,2,0,10,mixedType,1
6,4,0,10,mixedType,1
5,3,0,8,mixedType,1
3,7,0,10,mixedType,1
15,1,0,16,mixedType,2
7,4,0,11,mixedType,1
9,1,0,10,mixedType,1
6,5,0,11,mixedType,1
4,2,0,6,mixedType,0
2,4,0,6,mixedType,0
8,2,0,10,mixedType,1
6,6,0,12,mixedType,1
5,2,0,7,mixedType,0
14,2,0,16,mixedType,2
9,3,0,12,mixedType,1
3,3,0,6,mixedType,0
4,2,0,6,mixedType,0
2,6,0,8,mixedType,1
5,1,0,6,mixedType,0
8,1,0,9,mixedType,1
7,3,0,10,mixedType,1
10,4,0,14,mixedType,2
7,4,0,11,mixedType,1
9,1,0,10,mixedType,1
4,2,0,6,mixedType,0
18,2,0,20,mixedType,2
5,3,0,8,mixedType,1
5,2,0,7,mixedType,0
6,3,0,9,mixedType,1
2,7,0,9,mixedType,1
4,2,0,6,mixedType,0
6,3,0,9,mixedType,1
6,3,0,9,mixedType,1
1,8,0,9,mixedType,1
8,1,0,9,mixedType,1
5,6,0,11,mixedType,1
7,4,0,11,mixedType,1
6,3,0,9,mixedType,1
1,7,0,8,mixedType,1
7,3,0,10,mixedType,1
13,3,0,16,mixedType,2
9,2,0,11,mixedType,1
6,2,0,8,mixedType,1
5,4,0,9,mixedType,1
2,8,0,10,mixedType,1
5,3,0,8,mixedType,1
4,4,0,8,mixedType,1
9,1,0,10,mixedType,1
6,4,0,10,mixedType,1
4,9,0,13,mixedType,1
9,4,0,13,mixedType,1
8,1,0,9,mixedType,1
6,3,0,9,mixedType,1
6,2,0,8,mixedType,1
7,4,0,11,mixedType,1
5,5,0,10,mixedType,1
4,4,0,8,mixedType,1
5,3,0,8,mixedType,1
5,4,0,9,mixedType,1
5,2,0,7,mixedType,0
4,2,0,6,mixedType,0
15,1,0,16,mixedType,2
10,3,1,14,mixedType,2
11,3,0,14,mixedType,2
5,2,0,7,mixedType,0
8,2,0,10,mixedType,1
6,3,0,9,mixedType,1
15,1,0,16,mixedType,2
1,5,0,6,mixedType,0
7,3,0,10,mixedType,1
7,3,0,10,mixedType,1
12,4,0,16,mixedType,2
5,3,0,8,mixedType,1
3,6,0,9,mixedType,1
5,3,0,8,mixedType,1
5,2,0,7,mixedType,0
6,1,0,7,mixedType,0
6,1,0,7,mixedType,0
8,2,0,10,mixedType,1
9,2,0,11,mixedType,1
12,4,0,16,mixedType,2
7,1,0,8,mixedType,1
8,2,0,10,mixedType,1
4,5,0,9,mixedType,1
7,4,0,11,mixedType,1
13,3,0,16,mixedType,2
9,1,0,10,mixedType,1
13,3,0,16,mixedType,2
8,1,0,9,mixedType,1
8,1,0,9,mixedType,1
6,3,0,9,mixedType,1
6,3,0,9,mixedType,1
8,2,0,10,mixedType,1
7,3,0,10,mixedType,1
6,5,0,11,mixedType,1
6,2,0,8,mixedType,1
12,3,0,15,mixedType,2
6,2,0,8,mixedType,1
4,4,0,8,mixedType,1
9,2,0,11,mixedType,1
4,7,0,11,mixedType,1
6,3,0,9,mixedType,1
4,2,0,6,mixedType,0
9,1,0,10,mixedType,1
6,1,0,7,mixedType,0
15,1,0,16,mixedType,2
6,1,0,7,mixedType,0
11,1,0,12,mixedType,1
6,7,0,13,mixedType,1
6,2,0,8,mixedType,1
9,2,0,11,mixedType,1
11,4,0,15,mixedType,2
5,3,0,8,mixedType,1
6,1,0,7,mixedType,0
2,6,0,8,mixedType,1
12,4,0,16,mixedType,2
5,3,0,8,mixedType,1
9,4,0,13,mixedType,1
6,1,0,7,mixedType,0
8,4,0,12,mixedType,1
6,2,0,8,mixedType,1
5,3,0,8,mixedType,1
6,2,0,8,mixedType,1
2,4,0,6,mixedType,0
6,1,0,7,mixedType,0
2,6,0,8,mixedType,1
15,1,0,16,mixedType,2
4,5,0,9,mixedType,1
5,1,0,6,mixedType,0
12,4,0,16,mixedType,2
10,1,0,11,mixedType,1
6,1,0,7,mixedType,0
1,8,0,9,mixedType,1
7,2,0,9,mixedType,1
13,1,2,16,mixedType,2
7,6,0,13,mixedType,1
6,3,0,9,mixedType,1
9,3,0,12,mixedType,1
1,8,0,9,mixedType,1
8,4,0,12,mixedType,1
7,2,0,9,mixedType,1
5,4,0,9,mixedType,1
5,2,0,7,mixedType,0
5,3,0,8,mixedType,1
8,2,0,10,mixedType,1
8,3,0,11,mixedType,1
7,3,0,10,mixedType,1
6,3,0,9,mixedType,1
9,1,0,10,mixedType,1
8,1,0,9,mixedType,1
5,2,0,7,mixedType,0
6,2,0,8,mixedType,1
6,3,0,9,mixedType,1
5,1,0,6,mixedType,0
4,4,0,8,mixedType,1
7,1,0,8,mixedType,1
6,1,0,7,mixedType,0
6,2,0,8,mixedType,1
6,3,0,9,mixedType,1
3,6,0,9,mixedType,1
5,2,0,7,mixedType,0
7,2,0,9,mixedType,1
4,4,0,8,mixedType,1
3,6,0,9,mixedType,1
6,4,0,10,mixedType,1
4,4,0,8,mixedType,1
14,2,0,16,mixedType,2
7,4,0,11,mixedType,1
6,4,0,10,mixedType,1
6,3,0,9,mixedType,1
6,4,0,10,mixedType,1
6,5,0,11,mixedType,1
3,6,0,9,mixedType,1
7,3,0,10,mixedType,1
6,3,0,9,mixedType,1
9,1,0,10,mixedType,1
1,8,0,9,mixedType,1
5,2,0,7,mixedType,0
6,3,0,9,mixedType,1
4,6,0,10,mixedType,1
7,3,0,10,mixedType,1
5,3,0,8,mixedType,1
1,10,0,11,mixedType,1
6,4,0,10,mixedType,1
6,1,0,7,mixedType,0
6,3,0,9,mixedType,1
13,2,0,15,mixedType,2
8,2,0,10,mixedType,1
12,3,0,15,mixedType,2
6,2,0,8,mixedType,1
10,2,0,12,mixedType,1
5,4,0,9,mixedType,1
7,1,0,8,mixedType,1
7,1,0,8,mixedType,1
5,3,0,8,mixedType,1
5,3,0,8,mixedType,1
7,3,0,10,mixedType,1
7,1,0,8,mixedType,1
4,2,0,6,mixedType,0
2,11,0,13,mixedType,1
6,4,0,10,mixedType,1
3,6,0,9,mixedType,1
9,1,0,10,mixedType,1
13,3,0,16,mixedType,2
14,2,0,16,mixedType,2
7,2,0,9,mixedType,1
8,1,0,9,mixedType,1
11,1,0,12,mixedType,1
4,4,0,8,mixedType,1
9,1,0,10,mixedType,1
3,6,0,9,mixedType,1
2,4,0,6,mixedType,0
11,2,0,13,mixedType,1
7,2,0,9,mixedType,1
1,8,0,9,mixedType,1
6,1,0,7,mixedType,0
4,4,0,8,mixedType,1
9,1,0,10,mixedType,1
9,7,0,16,mixedType,2
7,3,0,10,mixedType,1
8,1,0,9,mixedType,1
10,1,0,11,mixedType,1
5,4,0,9,mixedType,1
4,2,0,6,mixedType,0
6,4,0,10,mixedType,1
8,1,0,9,mixedType,1
5,4,0,9,mixedType,1
8,1,0,9,mixedType,1
5,3,0,8,mixedType,1
6,4,0,10,mixedType,1
8,0,1,9,mixedType,1
9,3,0,12,mixedType,1
4,2,0,6,mixedType,0
7,1,0,8,mixedType,1
5,4,0,9,mixedType,1
4,4,0,8,mixedType,1
13,2,0,15,mixedType,2
5,4,0,9,mixedType,1
6,2,0,8,mixedType,1
5,4,0,9,mixedType,1
7,2,0,9,mixedType,1
11,3,0,14,mixedType,2
1,10,0,11,mixedType,1
7,3,0,10,mixedType,1
8,2,0,10,mixedType,1
7,2,0,9,mixedType,1
11,3,0,14,mixedType,2
6,2,0,8,mixedType,1
14,2,0,16,mixedType,2
7,3,0,10,mixedType,1
5,4,0,9,mixedType,1
7,3,0,10,mixedType,1
6,2,0,8,mixedType,1
6,1,0,7,mixedType,0
8,1,0,9,mixedType,1
5,3,0,8,mixedType,1
3,6,0,9,mixedType,1
6,4,0,10,mixedType,1
4,2,0,6,mixedType,0
7,3,0,10,mixedType,1
6,4,0,10,mixedType,1
14,2,0,16,mixedType,2
8,1,0,9,mixedType,1
9,1,0,10,mixedType,1
8,2,0,10,mixedType,1
12,4,0,16,mixedType,2
7,3,0,10,mixedType,1
6,3,0,9,mixedType,1
11,2,0,13,mixedType,1
6,4,0,10,mixedType,1
0,9,0,9,sameType,1
13,3,0,16,mixedType,2
4,2,0,6,mixedType,0
12,3,0,15,mixedType,2
1,10,0,11,mixedType,1
8,3,0,11,mixedType,1
8,5,0,13,mixedType,1
6,4,0,10,mixedType,1
4,6,0,10,mixedType,1
5,1,0,6,mixedType,0
6,2,0,8,mixedType,1
5,3,0,8,mixedType,1
2,8,0,10,mixedType,1
6,3,0,9,mixedType,1
7,3,0,10,mixedType,1
8,1,0,9,mixedType,1
8,2,0,10,mixedType,1
3,3,0,6,mixedType,0
7,2,0,9,mixedType,1
10,3,0,13,mixedType,1
5,1,0,6,mixedType,0
5,6,0,11,mixedType,1
13,3,0,16,mixedType,2
7,3,0,10,mixedType,1
5,3,0,8,mixedType,1
6,2,0,8,mixedType,1
8,2,0,10,mixedType,1
0,9,2,11,mixedType,1
5,2,0,7,mixedType,0
4,4,0,8,mixedType,1
5,3,0,8,mixedType,1
4,4,0,8,mixedType,1
9,3,0,12,mixedType,1
4,2,4,10,mixedType,1
8,1,0,9,mixedType,1
6,4,0,10,mixedType,1
5,2,0,7,mixedType,0
2,6,0,8,mixedType,1
1,9,0,10,mixedType,1
1,8,0,9,mixedType,1
3,6,0,9,mixedType,1
6,2,0,8,mixedType,1
7,2,0,9,mixedType,1
3,0,4,7,mixedType,0
2,8,0,10,mixedType,1
15,1,0,16,mixedType,2
6,4,0,10,mixedType,1
6,0,1,7,mixedType,0
7,3,0,10,mixedType,1
14,2,0,16,mixedType,2
11,3,0,14,mixedType,2
12,4,0,16,mixedType,2
4,2,0,6,mixedType,0
5,2,0,7,mixedType,0
5,2,0,7,mixedType,0
6,1,0,7,mixedType,0
14,2,0,16,mixedType,2
8,2,0,10,mixedType,1
11,2,0,13,mixedType,1
5,1,0,6,mixedType,0
6,3,0,9,mixedType,1
7,1,0,8,mixedType,1
15,1,0,16,mixedType,2
5,2,0,7,mixedType,0
7,3,0,10,mixedType,1
11,2,0,13,mixedType,1
8,3,0,11,mixedType,1
8,3,0,11,mixedType,1
8,4,0,12,mixedType,1
7,1,0,8,mixedType,1
6,7,0,13,mixedType,1
11,3,0,14,mixedType,2
9,1,0,10,mixedType,1
2,8,0,10,mixedType,1
7,5,0,12,mixedType,1
12,4,0,16,mixedType,2
9,4,0,13,mixedType,1
1,9,0,10,mixedType,1
15,1,0,16,mixedType,2
7,3,0,10,mixedType,1
7,4,0,11,mixedType,1
7,2,0,9,mixedType,1
9,3,0,12,mixedType,1
5,1,0,6,mixedType,0
7,4,0,11,mixedType,1
7,4,0,11,mixedType,1
6,3,0,9,mixedType,1
6,1,0,7,mixedType,0
6,4,0,10,mixedType,1
2,4,0,6,mixedType,0
15,1,0,16,mixedType,2
5,4,0,9,mixedType,1
2,8,0,10,mixedType,1
5,3,0,8,mixedType,1
8,3,0,11,mixedType,1
7,3,0,10,mixedType,1
9,7,0,16,mixedType,2
5,5,0,10,mixedType,1
7,3,0,10,mixedType,1
8,2,0,10,mixedType,1
10,2,0,12,mixedType,1
5,3,0,8,mixedType,1
7,2,0,9,mixedType,1
6,2,0,8,mixedType,1
5,3,0,8,mixedType,1
9,1,0,10,mixedType,1
7,2,0,9,mixedType,1
5,3,0,8,mixedType,1
8,4,0,12,mixedType,1
6,2,0,8,mixedType,1
4,9,0,13,mixedType,1
7,3,0,10,mixedType,1
14,2,0,16,mixedType,2
7,3,0,10,mixedType,1
4,6,0,10,mixedType,1
2,6,0,8,mixedType,1
5,3,0,8,mixedType,1
7,3,0,10,mixedType,1
6,2,0,8,mixedType,1
6,2,0,8,mixedType,1
4,2,0,6,mixedType,0
5,1,0,6,mixedType,0
3,6,0,9,mixedType,1
6,6,0,12,mixedType,1
7,4,0,11,mixedType,1
13,3,0,16,mixedType,2
2,6,0,8,mixedType,1
7,3,0,10,mixedType,1
6,2,0,8,mixedType,1
13,3,0,16,mixedType,2
9,1,0,10,mixedType,1
1,7,0,8,mixedType,1
9,1,0,10,mixedType,1
9,4,0,13,mixedType,1
9,1,0,10,mixedType,1
5,3,0,8,mixedType,1
7,3,0,10,mixedType,1
6,4,0,10,mixedType,1
11,2,0,13,mixedType,1
8,2,0,10,mixedType,1
3,6,0,9,mixedType,1
6,3,0,9,mixedType,1
4,4,0,8,mixedType,1
11,1,0,12,mixedType,1
5,5,0,10,mixedType,1
6,4,0,10,mixedType,1
1,8,0,9,mixedType,1
7,3,0,10,mixedType,1
14,2,0,16,mixedType,2
7,2,0,9,mixedType,1
14,2,0,16,mixedType,2
7,2,0,9,mixedType,1
3,5,0,8,mixedType,1
12,1,0,13,mixedType,1
7,3,0,10,mixedType,1
1,5,0,6,mixedType,0
7,3,0,10,mixedType,1
9,4,0,13,mixedType,1
6,1,0,7,mixedType,0
4,2,0,6,mixedType,0
6,0,1,7,mixedType,0
3,8,0,11,mixedType,1
11,3,0,14,mixedType,2
4,2,0,6,mixedType,0
8,2,0,10,mixedType,1
8,1,0,9,mixedType,1
5,7,0,12,mixedType,1
7,2,0,9,mixedType,1
4,2,0,6,mixedType,0
5,2,0,7,mixedType,0
3,3,0,6,mixedType,0
9,1,0,10,mixedType,1
5,2,0,7,mixedType,0
6,3,0,9,mixedType,1
6,2,0,8,mixedType,1
4,7,0,11,mixedType,1
6,2,0,8,mixedType,1
10,4,2,16,mixedType,2
7,2,0,9,mixedType,1
13,3,0,16,mixedType,2
6,3,0,9,mixedType,1
7,3,0,10,mixedType,1
12,4,0,16,mixedType,2
6,3,0,9,mixedType,1
8,1,0,9,mixedType,1
6,1,0,7,mixedType,0
7,3,0,10,mixedType,1
5,3,0,8,mixedType,1
12,11,0,23,mixedType,2
7,2,0,9,mixedType,1
6,3,0,9,mixedType,1
12,3,0,15,mixedType,2
10,1,0,11,mixedType,1
5,4,0,9,mixedType,1
6,4,4,14,mixedType,2
5,4,0,9,mixedType,1
5,3,0,8,mixedType,1
7,2,0,9,mixedType,1
6,3,0,9,mixedType,1
10,3,1,14,mixedType,2
5,2,0,7,mixedType,0
8,1,0,9,mixedType,1
12,2,1,15,mixedType,2
8,3,0,11,mixedType,1
4,4,0,8,mixedType,1
7,3,0,10,mixedType,1
5,3,0,8,mixedType,1
7,3,0,10,mixedType,1
1,8,0,9,mixedType,1
7,2,0,9,mixedType,1
9,3,0,12,mixedType,1
6,8,0,14,mixedType,2
6,3,0,9,mixedType,1
9,2,0,11,mixedType,1
15,3,2,20,mixedType,2
8,1,0,9,mixedType,1
6,6,0,12,mixedType,1
7,4,0,11,mixedType,1
7,2,0,9,mixedType,1
8,1,0,9,mixedType,1
11,1,0,12,mixedType,1
2,7,0,9,mixedType,1
5,2,0,7,mixedType,0
7,1,0,8,mixedType,1
7,2,0,9,mixedType,1
6,1,0,7,mixedType,0
7,1,0,8,mixedType,1
4,6,0,10,mixedType,1
5,3,0,8,mixedType,1
7,3,0,10,mixedType,1
9,1,0,10,mixedType,1
6,4,0,10,mixedType,1
9,2,0,11,mixedType,1
4,2,0,6,mixedType,0
5,4,0,9,mixedType,1
2,9,0,11,mixedType,1
5,4,0,9,mixedType,1
2,8,0,10,mixedType,1
7,3,0,10,mixedType,1
13,3,0,16,mixedType,2
9,1,0,10,mixedType,1
7,4,0,11,mixedType,1
7,4,0,11,mixedType,1
8,4,0,12,mixedType,1
3,3,0,6,mixedType,0
7,3,0,10,mixedType,1
8,3,0,11,mixedType,1
15,1,0,16,mixedType,2
4,6,0,10,mixedType,1
3,3,0,6,mixedType,0
0,9,1,10,mixedType,1
10,1,0,11,mixedType,1
14,2,0,16,mixedType,2
6,3,0,9,mixedType,1
1,8,0,9,mixedType,1
11,3,0,14,mixedType,2
6,3,0,9,mixedType,1
5,3,0,8,mixedType,1
5,1,0,6,mixedType,0
6,3,0,9,mixedType,1
8,4,0,12,mixedType,1
9,1,0,10,mixedType,1
15,1,0,16,mixedType,2
9,1,0,10,mixedType,1
5,3,0,8,mixedType,1
14,1,0,15,mixedType,2
6,2,0,8,mixedType,1
6,3,0,9,mixedType,1
5,5,0,10,mixedType,1
4,4,0,8,mixedType,1
6,3,0,9,mixedType,1
6,2,0,8,mixedType,1
5,4,0,9,mixedType,1
4,4,0,8,mixedType,1
15,1,0,16,mixedType,2
6,4,0,10,mixedType,1
6,2,0,8,mixedType,1
6,4,0,10,mixedType,1
8,1,0,9,mixedType,1
5,3,0,8,mixedType,1
2,6,0,8,mixedType,1
8,2,0,10,mixedType,1
4,4,0,8,mixedType,1
7,3,0,10,mixedType,1
7,5,0,12,mixedType,1
4,4,0,8,mixedType,1
5,2,0,7,mixedType,0
6,3,0,9,mixedType,1
4,2,0,6,mixedType,0
5,3,0,8,mixedType,1
6,1,0,7,mixedType,0
5,3,0,8,mixedType,1
5,2,0,7,mixedType,0
6,3,0,9,mixedType,1
8,1,0,9,mixedType,1
3,6,0,9,mixedType,1
11,1,0,12,mixedType,1
3,6,0,9,mixedType,1
4,2,0,6,mixedType,0
14,2,0,16,mixedType,2
12,1,0,13,mixedType,1
8,4,0,12,mixedType,1
14,2,0,16,mixedType,2
5,1,0,6,mixedType,0
5,4,0,9,mixedType,1
9,1,0,10,mixedType,1
5,3,0,8,mixedType,1
15,1,1,17,mixedType,2
9,2,0,11,mixedType,1
6,1,0,7,mixedType,0
1,8,0,9,mixedType,1
6,3,0,9,mixedType,1
6,3,0,9,mixedType,1
7,2,0,9,mixedType,1
8,1,0,9,mixedType,1
7,4,0,11,mixedType,1
9,2,0,11,mixedType,1
3,7,0,10,mixedType,1
14,2,0,16,mixedType,2
6,2,0,8,mixedType,1
6,1,0,7,mixedType,0
6,2,0,8,mixedType,1
6,2,0,8,mixedType,1
6,2,0,8,mixedType,1
8,1,0,9,mixedType,1
4,2,0,6,mixedType,0
1,10,0,11,mixedType,1
7,4,0,11,mixedType,1
4,4,0,8,mixedType,1
6,4,0,10,mixedType,1
12,3,0,15,mixedType,2
6,2,0,8,mixedType,1
6,3,0,9,mixedType,1
1,8,0,9,mixedType,1
8,2,0,10,mixedType,1
8,3,0,11,mixedType,1
7,3,0,10,mixedType,1
2,8,0,10,mixedType,1
6,4,0,10,mixedType,1
15,1,0,16,mixedType,2
7,6,0,13,mixedType,1
6,2,0,8,mixedType,1
8,2,0,10,mixedType,1
5,2,0,7,mixedType,0
10,2,0,12,mixedType,1
6,3,0,9,mixedType,1
3,6,0,9,mixedType,1
5,6,0,11,mixedType,1
3,6,0,9,mixedType,1
6,4,0,10,mixedType,1
6,2,0,8,mixedType,1
6,4,0,10,mixedType,1
7,3,0,10,mixedType,1
7,2,0,9,mixedType,1
5,3,0,8,mixedType,1
7,3,0,10,mixedType,1
6,2,0,8,mixedType,1
8,1,0,9,mixedType,1
9,4,0,13,mixedType,1
5,3,0,8,mixedType,1
8,2,0,10,mixedType,1
4,2,0,6,mixedType,0
12,4,0,16,mixedType,2
6,2,0,8,mixedType,1
7,2,0,9,mixedType,1
9,3,0,12,mixedType,1
5,0,0,5,sameType,0
12,1,0,13,mixedType,1
1,9,0,10,mixedType,1
5,3,0,8,mixedType,1
7,3,0,10,mixedType,1
9,2,0,11,mixedType,1
6,1,0,7,mixedType,0
9,6,0,15,mixedType,2
7,3,0,10,mixedType,1
5,2,0,7,mixedType,0
14,2,0,16,mixedType,2
5,8,0,13,mixedType,1
5,4,0,9,mixedType,1
7,3,0,10,mixedType,1
7,3,0,10,mixedType,1
1,8,0,9,mixedType,1
9,1,0,10,mixedType,1
4,2,0,6,mixedType,0
13,3,0,16,mixedType,2
7,3,0,10,mixedType,1
3,3,0,6,mixedType,0
6,3,0,9,mixedType,1
7,1,0,8,mixedType,1
6,2,0,8,mixedType,1
10,3,0,13,mixedType,1
7,3,0,10,mixedType,1
6,4,0,10,mixedType,1
8,2,0,10,mixedType,1
6,4,0,10,mixedType,1
7,2,0,9,mixedType,1
6,4,0,10,mixedType,1
7,2,0,9,mixedType,1
7,2,0,9,mixedType,1
4,2,0,6,mixedType,0
4,6,0,10,mixedType,1
4,2,0,6,mixedType,0
5,2,0,7,mixedType,0
5,8,0,13,mixedType,1
5,3,0,8,mixedType,1
4,4,0,8,mixedType,1
2,8,0,10,mixedType,1
6,3,0,9,mixedType,1
6,4,0,10,mixedType,1
6,2,0,8,mixedType,1
4,8,0,12,mixedType,1
4,2,0,6,mixedType,0
5,2,0,7,mixedType,0
6,7,0,13,mixedType,1
5,2,0,7,mixedType,0
7,3,0,10,mixedType,1
7,2,0,9,mixedType,1
6,3,0,9,mixedType,1
4,2,0,6,mixedType,0
9,2,0,11,mixedType,1
5,3,0,8,mixedType,1
4,6,0,10,mixedType,1
15,1,0,16,mixedType,2
6,3,0,9,mixedType,1
7,3,0,10,mixedType,1
6,1,0,7,mixedType,0
7,3,0,10,mixedType,1
6,3,0,9,mixedType,1
3,6,0,9,mixedType,1
2,6,0,8,mixedType,1
3,3,0,6,mixedType,0
6,3,0,9,mixedType,1
7,3,0,10,mixedType,1
1,8,0,9,mixedType,1
8,1,0,9,mixedType,1
3,6,0,9,mixedType,1
3,6,0,9,mixedType,1
8,1,0,9,mixedType,1
8,3,0,11,mixedType,1
2,10,0,12,mixedType,1
4,4,0,8,mixedType,1
10,1,0,11,mixedType,1
14,2,0,16,mixedType,2
8,3,0,11,mixedType,1
7,4,0,11,mixedType,1
4,4,0,8,mixedType,1
4,6,0,10,mixedType,1
14,2,0,16,mixedType,2
12,4,0,16,mixedType,2
3,6,0,9,mixedType,1
6,3,0,9,mixedType,1
14,2,0,16,mixedType,2
12,4,0,16,mixedType,2
4,2,0,6,mixedType,0
8,2,0,10,mixedType,1
4,6,0,10,mixedType,1
8,3,0,11,mixedType,1
5,2,0,7,mixedType,0
8,2,0,10,mixedType,1
4,2,0,6,mixedType,0
8,1,0,9,mixedType,1
7,2,0,9,mixedType,1
6,3,0,9,mixedType,1
9,1,0,10,mixedType,1
7,2,0,9,mixedType,1
6,3,0,9,mixedType,1
6,2,0,8,mixedType,1
8,2,0,10,mixedType,1
3,6,0,9,mixedType,1
2,4,0,6,mixedType,0
6,2,0,8,mixedType,1
12,4,0,16,mixedType,2
5,1,0,6,mixedType,0
7,2,0,9,mixedType,1
9,1,0,10,mixedType,1
7,2,0,9,mixedType,1
13,3,0,16,mixedType,2
9,4,0,13,mixedType,1
3,6,0,9,mixedType,1
8,2,0,10,mixedType,1
5,2,0,7,mixedType,0
11,5,5,21,mixedType,2
6,3,0,9,mixedType,1
6,1,0,7,mixedType,0
6,7,0,13,mixedType,1
7,3,0,10,mixedType,1
8,2,0,10,mixedType,1
7,3,0,10,mixedType,1
8,1,0,9,mixedType,1
6,4,0,10,mixedType,1
5,1,0,6,mixedType,0
5,4,0,9,mixedType,1
3,10,0,13,mixedType,1
9,2,0,11,mixedType,1
6,6,0,12,mixedType,1
9,6,1,16,mixedType,2
5,3,0,8,mixedType,1
5,3,0,8,mixedType,1
12,1,0,13,mixedType,1
7,2,0,9,mixedType,1
15,1,0,16,mixedType,2
11,3,0,14,mixedType,2
4,6,0,10,mixedType,1
15,4,0,19,mixedType,2
6,3,0,9,mixedType,1
9,3,0,12,mixedType,1
6,4,0,10,mixedType,1
7,2,0,9,mixedType,1
7,3,0,10,mixedType,1
6,3,0,9,mixedType,1
4,4,0,8,mixedType,1
2,4,0,6,mixedType,0
7,1,0,8,mixedType,1
8,1,0,9,mixedType,1
5,2,0,7,mixedType,0
10,3,0,13,mixedType,1
7,3,0,10,mixedType,1
3,5,0,8,mixedType,1
6,1,0,7,mixedType,0
4,2,0,6,mixedType,0
6,3,0,9,mixedType,1
6,3,0,9,mixedType,1
8,1,0,9,mixedType,1
8,2,0,10,mixedType,1
9,1,0,10,mixedType,1
7,1,0,8,mixedType,1
9,1,0,10,mixedType,1
6,3,0,9,mixedType,1
5,1,0,6,mixedType,0
1,8,0,9,mixedType,1
4,4,0,8,mixedType,1
3,9,0,12,mixedType,1
12,3,0,15,mixedType,2
2,7,0,9,mixedType,1
4,4,0,8,mixedType,1
1,8,0,9,mixedType,1
7,4,0,11,mixedType,1
6,4,0,10,mixedType,1
7,3,0,10,mixedType,1
2,8,0,10,mixedType,1
1,9,0,10,mixedType,1
4,2,0,6,mixedType,0
5,1,0,6,mixedType,0
6,2,0,8,mixedType,1
5,2,0,7,mixedType,0
6,4,0,10,mixedType,1
7,4,0,11,mixedType,1
4,2,0,6,mixedType,0
7,2,0,9,mixedType,1
5,2,0,7,mixedType,0
6,1,0,7,mixedType,0
3,6,0,9,mixedType,1
7,1,0,8,mixedType,1
8,2,0,10,mixedType,1
6,3,0,9,mixedType,1
10,2,0,12,mixedType,1
9,4,0,13,mixedType,1
3,7,0,10,mixedType,1
5,3,0,8,mixedType,1
6,2,0,8,mixedType,1
6,1,0,7,mixedType,0
11,1,0,12,mixedType,1
4,4,0,8,mixedType,1
5,3,0,8,mixedType,1
6,3,0,9,mixedType,1
6,6,0,12,mixedType,1
8,1,0,9,mixedType,1
14,2,0,16,mixedType,2
6,3,0,9,mixedType,1
9,3,0,12,mixedType,1
1,9,0,10,mixedType,1
9,1,0,10,mixedType,1
5,2,0,7,mixedType,0
6,4,0,10,mixedType,1
5,2,0,7,mixedType,0
2,6,0,8,mixedType,1
1,5,0,6,mixedType,0
9,1,0,10,mixedType,1
6,3,0,9,mixedType,1
5,2,0,7,mixedType,0
13,3,0,16,mixedType,2
7,2,0,9,mixedType,1
12,3,0,15,mixedType,2
8,1,0,9,mixedType,1
9,3,0,12,mixedType,1
9,2,0,11,mixedType,1
8,2,0,10,mixedType,1
7,2,0,9,mixedType,1
5,3,0,8,mixedType,1
8,1,0,9,mixedType,1
12,4,0,16,mixedType,2
8,1,0,9,mixedType,1
5,3,0,8,mixedType,1
6,1,0,7,mixedType,0
7,2,0,9,mixedType,1
4,4,0,8,mixedType,1
4,8,0,12,mixedType,1
8,3,0,11,mixedType,1
7,3,0,10,mixedType,1
6,1,0,7,mixedType,0
8,2,0,10,mixedType,1
1,10,0,11,mixedType,1
8,2,0,10,mixedType,1
7,3,0,10,mixedType,1
6,1,0,7,mixedType,0
9,3,0,12,mixedType,1
9,1,0,10,mixedType,1
4,6,0,10,mixedType,1
12,3,0,15,mixedType,2
9,3,0,12,mixedType,1
4,6,0,10,mixedType,1
8,1,0,9,mixedType,1
5,2,0,7,mixedType,0
6,2,0,8,mixedType,1
5,3,0,8,mixedType,1
10,6,0,16,mixedType,2
11,3,0,14,mixedType,2
3,5,0,8,mixedType,1
9,4,0,13,mixedType,1
1,10,0,11,mixedType,1
9,1,0,10,mixedType,1
15,1,0,16,mixedType,2
8,2,0,10,mixedType,1
8,3,0,11,mixedType,1
3,6,0,9,mixedType,1
12,4,0,16,mixedType,2
10,2,0,12,mixedType,1
7,2,0,9,mixedType,1
7,3,0,10,mixedType,1
5,1,0,6,mixedType,0
5,4,0,9,mixedType,1
8,3,0,11,mixedType,1
6,1,0,7,mixedType,0
8,2,0,10,mixedType,1
5,4,0,9,mixedType,1
9,3,0,12,mixedType,1
6,4,0,10,mixedType,1
9,1,0,10,mixedType,1
4,6,0,10,mixedType,1
5,4,0,9,mixedType,1
5,4,0,9,mixedType,1
9,1,0,10,mixedType,1
7,2,0,9,mixedType,1
10,1,0,11,mixedType,1
9,2,0,11,mixedType,1
4,4,0,8,mixedType,1
9,1,0,10,mixedType,1
8,1,0,9,mixedType,1
7,3,0,10,mixedType,1
5,4,0,9,mixedType,1
13,3,0,16,mixedType,2
8,5,0,13,mixedType,1
4,4,0,8,mixedType,1
9,1,0,10,mixedType,1
7,2,0,9,mixedType,1
9,3,0,12,mixedType,1
6,3,0,9,mixedType,1
3,5,0,8,mixedType,1
4,4,0,8,mixedType,1
1,8,0,9,mixedType,1
33,12,0,45,mixedType,2
7,3,0,10,mixedType,1
12,4,0,16,mixedType,2
4,4,0,8,mixedType,1
6,3,0,9,mixedType,1
3,8,0,11,mixedType,1
7,1,0,8,mixedType,1
9,1,0,10,mixedType,1
6,4,0,10,mixedType,1
6,2,0,8,mixedType,1
3,5,0,8,mixedType,1
6,2,0,8,mixedType,1
6,3,0,9,mixedType,1
8,3,0,11,mixedType,1
5,3,0,8,mixedType,1
6,4,0,10,mixedType,1
5,3,0,8,mixedType,1
7,4,0,11,mixedType,1
6,2,0,8,mixedType,1
5,5,0,10,mixedType,1
6,3,0,9,mixedType,1
5,3,0,8,mixedType,1
4,4,0,8,mixedType,1
7,1,0,8,mixedType,1
5,2,0,7,mixedType,0
3,6,0,9,mixedType,1
4,2,0,6,mixedType,0
2,7,0,9,mixedType,1
8,3,0,11,mixedType,1
4,2,0,6,mixedType,0
9,3,0,12,mixedType,1
5,3,0,8,mixedType,1
13,3,0,16,mixedType,2
6,4,0,10,mixedType,1
5,2,0,7,mixedType,0
6,3,0,9,mixedType,1
1,9,0,10,mixedType,1
8,2,0,10,mixedType,1
3,6,0,9,mixedType,1
1,7,0,8,mixedType,1
3,6,0,9,mixedType,1
4,10,0,14,mixedType,2
6,2,0,8,mixedType,1
4,4,0,8,mixedType,1
9,1,0,10,mixedType,1
4,4,0,8,mixedType,1
7,3,0,10,mixedType,1
7,2,0,9,mixedType,1
8,1,0,9,mixedType,1
8,1,0,9,mixedType,1
8,4,0,12,mixedType,1
7,3,0,10,mixedType,1
12,4,0,16,mixedType,2
7,3,0,10,mixedType,1
14,2,0,16,mixedType,2
6,2,0,8,mixedType,1
3,6,0,9,mixedType,1
9,2,0,11,mixedType,1
6,3,0,9,mixedType,1
4,6,0,10,mixedType,1
6,4,0,10,mixedType,1
4,5,0,9,mixedType,1
8,1,0,9,mixedType,1
8,2,0,10,mixedType,1
8,2,0,10,mixedType,1
7,7,0,14,mixedType,2
7,3,0,10,mixedType,1
8,1,0,9,mixedType,1
6,1,0,7,mixedType,0
8,1,0,9,mixedType,1
13,3,0,16,mixedType,2
15,1,0,16,mixedType,2
1,7,0,8,mixedType,1
7,3,0,10,mixedType,1
6,3,0,9,mixedType,1
3,10,0,13,mixedType,1
4,4,0,8,mixedType,1
9,3,0,12,mixedType,1
5,6,0,11,mixedType,1
12,3,0,15,mixedType,2
9,4,3,16,mixedType,2
6,2,0,8,mixedType,1
6,2,0,8,mixedType,1
9,2,0,11,mixedType,1
10,0,1,11,mixedType,1
14,2,0,16,mixedType,2
13,3,0,16,mixedType,2
7,1,0,8,mixedType,1
7,3,0,10,mixedType,1
13,3,0,16,mixedType,2
7,2,0,9,mixedType,1
12,4,0,16,mixedType,2
14,2,0,16,mixedType,2
4,4,0,8,mixedType,1
6,2,0,8,mixedType,1
7,2,0,9,mixedType,1
7,2,0,9,mixedType,1
6,3,0,9,mixedType,1
6,1,0,7,mixedType,0
8,1,0,9,mixedType,1
6,5,5,16,mixedType,2
5,2,0,7,mixedType,0
4,2,0,6,mixedType,0
7,3,0,10,mixedType,1
14,2,0,16,mixedType,2
9,2,0,11,mixedType,1
5,4,0,9,mixedType,1
9,4,0,13,mixedType,1
4,2,0,6,mixedType,0
4,11,0,15,mixedType,2
5,6,0,11,mixedType,1
8,2,0,10,mixedType,1
7,3,0,10,mixedType,1
7,3,0,10,mixedType,1
3,6,0,9,mixedType,1
5,1,0,6,mixedType,0
8,2,0,10,mixedType,1
6,4,0,10,mixedType,1
6,3,0,9,mixedType,1
5,4,0,9,mixedType,1
3,6,0,9,mixedType,1
8,4,0,12,mixedType,1
12,3,0,15,mixedType,2
3,6,0,9,mixedType,1
8,3,0,11,mixedType,1
14,2,0,16,mixedType,2
23,2,0,25,mixedType,2
8,6,2,16,mixedType,2
7,3,0,10,mixedType,1
4,2,0,6,mixedType,0
6,3,0,9,mixedType,1
5,6,0,11,mixedType,1
6,1,0,7,mixedType,0
5,4,0,9,mixedType,1
8,1,0,9,mixedType,1
8,1,0,9,mixedType,1
4,2,0,6,mixedType,0
1,7,0,8,mixedType,1
5,3,0,8,mixedType,1
7,2,0,9,mixedType,1
8,2,0,10,mixedType,1
5,3,0,8,mixedType,1
4,2,0,6,mixedType,0
8,2,0,10,mixedType,1
5,2,0,7,mixedType,0
9,1,0,10,mixedType,1
9,1,0,10,mixedType,1
4,2,0,6,mixedType,0
7,2,0,9,mixedType,1
7,6,0,13,mixedType,1
5,3,0,8,mixedType,1
6,2,0,8,mixedType,1
4,8,0,12,mixedType,1
6,1,0,7,mixedType,0
1,7,0,8,mixedType,1
6,3,0,9,mixedType,1
7,1,0,8,mixedType,1
5,9,0,14,mixedType,2
5,2,0,7,mixedType,0
8,2,0,10,mixedType,1
9,3,0,12,mixedType,1
7,4,0,11,mixedType,1
8,1,0,9,mixedType,1
7,3,0,10,mixedType,1
5,4,0,9,mixedType,1
7,2,0,9,mixedType,1
8,3,0,11,mixedType,1
9,1,0,10,mixedType,1
5,6,0,11,mixedType,1
9,2,0,11,mixedType,1
1,7,0,8,mixedType,1
5,9,0,14,mixedType,2
7,3,0,10,mixedType,1
7,3,0,10,mixedType,1
10,2,2,14,mixedType,2
9,3,0,12,mixedType,1
2,8,0,10,mixedType,1
8,2,0,10,mixedType,1
9,1,0,10,mixedType,1
7,1,0,8,mixedType,1
2,8,0,10,mixedType,1
5,1,0,6,mixedType,0
6,3,0,9,mixedType,1
6,3,0,9,mixedType,1
6,2,0,8,mixedType,1
6,4,0,10,mixedType,1
13,3,0,16,mixedType,2
8,2,0,10,mixedType,1
8,2,0,10,mixedType,1
11,3,0,14,mixedType,2
6,3,0,9,mixedType,1
8,2,0,10,mixedType,1
6,4,0,10,mixedType,1
9,2,0,11,mixedType,1
6,6,0,12,mixedType,1
6,3,0,9,mixedType,1
2,6,0,8,mixedType,1
4,2,0,6,mixedType,0
7,3,0,10,mixedType,1
13,3,0,16,mixedType,2
3,5,0,8,mixedType,1
2,7,0,9,mixedType,1
8,2,0,10,mixedType,1
4,6,0,10,mixedType,1
3,5,0,8,mixedType,1
5,4,0,9,mixedType,1
5,2,0,7,mixedType,0
15,1,0,16,mixedType,2
7,3,0,10,mixedType,1
10,1,0,11,mixedType,1
1,9,0,10,mixedType,1
8,1,0,9,mixedType,1
8,1,0,9,mixedType,1
8,1,0,9,mixedType,1
6,3,0,9,mixedType,1
2,8,0,10,mixedType,1
8,1,0,9,mixedType,1
3,5,0,8,mixedType,1
6,3,0,9,mixedType,1
5,3,0,8,mixedType,1
4,4,0,8,mixedType,1
11,5,0,16,mixedType,2
5,1,0,6,mixedType,0
7,1,0,8,mixedType,1
14,2,0,16,mixedType,2
6,1,0,7,mixedType,0
4,2,0,6,mixedType,0
8,3,0,11,mixedType,1
3,7,0,10,mixedType,1
5,2,0,7,mixedType,0
3,3,0,6,mixedType,0
9,1,0,10,mixedType,1
9,1,0,10,mixedType,1
7,1,0,8,mixedType,1
2,7,0,9,mixedType,1
2,4,0,6,mixedType,0
7,1,0,8,mixedType,1
11,5,0,16,mixedType,2
9,4,0,13,mixedType,1
1,9,0,10,mixedType,1
15,1,0,16,mixedType,2
9,4,0,13,mixedType,1
1,10,0,11,mixedType,1
6,3,0,9,mixedType,1
8,1,0,9,mixedType,1
8,1,0,9,mixedType,1
5,2,0,7,mixedType,0
8,1,0,9,mixedType,1
4,2,0,6,mixedType,0
4,9,0,13,mixedType,1
14,2,0,16,mixedType,2
15,1,0,16,mixedType,2
4,4,0,8,mixedType,1
8,2,0,10,mixedType,1
3,8,0,11,mixedType,1
12,3,0,15,mixedType,2
5,3,0,8,mixedType,1
5,8,0,13,mixedType,1
1,8,0,9,mixedType,1
7,4,0,11,mixedType,1
7,2,0,9,mixedType,1
4,2,0,6,mixedType,0
9,1,0,10,mixedType,1
4,6,0,10,mixedType,1
5,3,0,8,mixedType,1
4,4,0,8,mixedType,1
9,3,0,12,mixedType,1
4,8,0,12,mixedType,1
9,1,0,10,mixedType,1
8,1,0,9,mixedType,1
5,3,0,8,mixedType,1
9,1,0,10,mixedType,1
6,1,0,7,mixedType,0
4,4,0,8,mixedType,1
5,1,0,6,mixedType,0
7,5,0,12,mixedType,1
6,5,0,11,mixedType,1
5,3,0,8,mixedType,1
6,2,0,8,mixedType,1
4,4,0,8,mixedType,1
5,2,0,7,mixedType,0
4,2,0,6,mixedType,0
5,3,0,8,mixedType,1
11,3,0,14,mixedType,2
8,1,0,9,mixedType,1
10,3,0,13,mixedType,1
7,3,0,10,mixedType,1
9,4,0,13,mixedType,1
5,5,0,10,mixedType,1
6,1,0,7,mixedType,0
14,2,0,16,mixedType,2
12,3,0,15,mixedType,2
8,2,0,10,mixedType,1
6,2,0,8,mixedType,1
13,3,0,16,mixedType,2
7,2,0,9,mixedType,1
5,2,0,7,mixedType,0
4,4,0,8,mixedType,1
5,4,0,9,mixedType,1
4,8,0,12,mixedType,1
4,2,0,6,mixedType,0
6,2,0,8,mixedType,1
9,1,0,10,mixedType,1
3,10,2,15,mixedType,2
5,5,0,10,mixedType,1
14,2,0,16,mixedType,2
7,3,0,10,mixedType,1
4,2,0,6,mixedType,0
14,2,0,16,mixedType,2
10,2,0,12,mixedType,1
6,2,0,8,mixedType,1
6,2,0,8,mixedType,1
5,2,0,7,mixedType,0
5,3,0,8,mixedType,1
14,2,0,16,mixedType,2
7,3,0,10,mixedType,1
5,3,0,8,mixedType,1
7,1,0,8,mixedType,1
5,3,0,8,mixedType,1
5,2,0,7,mixedType,0
8,2,0,10,mixedType,1
2,9,0,11,mixedType,1
5,3,0,8,mixedType,1
5,2,0,7,mixedType,0
9,1,0,10,mixedType,1
5,3,0,8,mixedType,1
9,3,0,12,mixedType,1
7,1,0,8,mixedType,1
2,6,0,8,mixedType,1
8,2,0,10,mixedType,1
6,2,0,8,mixedType,1
0,6,2,8,mixedType,1
5,1,0,6,mixedType,0
5,3,0,8,mixedType,1
5,3,0,8,mixedType,1
7,3,0,10,mixedType,1
7,6,0,13,mixedType,1
12,3,0,15,mixedType,2
7,1,0,8,mixedType,1
7,3,0,10,mixedType,1
7,2,0,9,mixedType,1
7,1,0,8,mixedType,1
7,2,0,9,mixedType,1
3,6,0,9,mixedType,1
9,8,1,18,mixedType,2
7,3,0,10,mixedType,1
6,2,0,8,mixedType,1
6,3,0,9,mixedType,1
7,3,0,10,mixedType,1
9,1,0,10,mixedType,1
6,1,0,7,mixedType,0
8,1,0,9,mixedType,1
5,5,0,10,mixedType,1
6,3,0,9,mixedType,1
2,6,0,8,mixedType,1
7,0,3,10,mixedType,1
9,1,0,10,mixedType,1
6,6,0,12,mixedType,1
5,4,0,9,mixedType,1
7,2,0,9,mixedType,1
8,1,0,9,mixedType,1
11,2,0,13,mixedType,1
7,3,0,10,mixedType,1
7,2,0,9,mixedType,1
3,6,0,9,mixedType,1
2,4,0,6,mixedType,0
5,2,0,7,mixedType,0
5,2,0,7,mixedType,0
14,2,0,16,mixedType,2
6,3,0,9,mixedType,1
5,3,0,8,mixedType,1
10,4,0,14,mixedType,2
8,1,0,9,mixedType,1
7,2,0,9,mixedType,1
4,4,0,8,mixedType,1
6,4,0,10,mixedType,1
1,6,0,7,mixedType,0
4,4,0,8,mixedType,1
12,3,0,15,mixedType,2
5,2,0,7,mixedType,0
15,1,0,16,mixedType,2
14,2,0,16,mixedType,2
6,2,0,8,mixedType,1
5,4,0,9,mixedType,1
6,2,0,8,mixedType,1
5,2,0,7,mixedType,0
7,2,0,9,mixedType,1
5,2,0,7,mixedType,0
5,3,0,8,mixedType,1
8,2,0,10,mixedType,1
6,3,0,9,mixedType,1
1,8,0,9,mixedType,1
6,4,0,10,mixedType,1
5,5,0,10,mixedType,1
6,2,0,8,mixedType,1
6,1,0,7,mixedType,0
9,1,0,10,mixedType,1
4,2,0,6,mixedType,0
5,1,0,6,mixedType,0
7,1,0,8,mixedType,1
3,6,0,9,mixedType,1
1,8,0,9,mixedType,1
6,1,0,7,mixedType,0
15,1,0,16,mixedType,2
6,2,0,8,mixedType,1
6,3,0,9,mixedType,1
8,2,0,10,mixedType,1
4,2,0,6,mixedType,0
5,6,0,11,mixedType,1
6,4,0,10,mixedType,1
5,3,0,8,mixedType,1
8,6,0,14,mixedType,2
2,8,0,10,mixedType,1
8,3,0,11,mixedType,1
5,1,0,6,mixedType,0
4,2,0,6,mixedType,0
9,1,0,10,mixedType,1
6,3,0,9,mixedType,1
5,3,0,8,mixedType,1
5,3,0,8,mixedType,1
9,3,0,12,mixedType,1
9,2,0,11,mixedType,1
9,4,0,13,mixedType,1
3,3,0,6,mixedType,0
5,3,0,8,mixedType,1
5,3,0,8,mixedType,1
3,6,0,9,mixedType,1
5,3,0,8,mixedType,1
3,4,0,7,mixedType,0
4,4,0,8,mixedType,1
6,2,0,8,mixedType,1
5,3,0,8,mixedType,1
14,2,0,16,mixedType,2
6,1,0,7,mixedType,0
7,4,0,11,mixedType,1
7,2,0,9,mixedType,1
5,1,0,6,mixedType,0
9,2,0,11,mixedType,1
4,4,0,8,mixedType,1
4,6,0,10,mixedType,1
11,5,0,16,mixedType,2
6,4,0,10,mixedType,1
6,1,0,7,mixedType,0
9,2,0,11,mixedType,1
4,2,0,6,mixedType,0
5,3,0,8,mixedType,1
8,3,0,11,mixedType,1
7,2,0,9,mixedType,1
5,1,0,6,mixedType,0
5,3,0,8,mixedType,1
1,5,0,6,mixedType,0
2,4,0,6,mixedType,0
2,7,0,9,mixedType,1
6,1,0,7,mixedType,0
12,4,0,16,mixedType,2
2,4,0,6,mixedType,0
6,3,0,9,mixedType,1
8,2,0,10,mixedType,1
5,4,0,9,mixedType,1
7,1,0,8,mixedType,1
8,1,0,9,mixedType,1
11,3,0,14,mixedType,2
8,3,0,11,mixedType,1
7,3,0,10,mixedType,1
6,4,0,10,mixedType,1
6,4,0,10,mixedType,1
7,3,0,10,mixedType,1
8,2,0,10,mixedType,1
11,1,3,15,mixedType,2
8,2,0,10,mixedType,1
6,4,0,10,mixedType,1
4,6,0,10,mixedType,1
0,10,1,11,mixedType,1
6,3,0,9,mixedType,1
8,3,0,11,mixedType,1
7,2,0,9,mixedType,1
13,3,0,16,mixedType,2
6,3,0,9,mixedType,1
6,2,0,8,mixedType,1
12,3,0,15,mixedType,2
7,2,0,9,mixedType,1
6,2,0,8,mixedType,1
14,2,0,16,mixedType,2
5,4,0,9,mixedType,1
13,3,0,16,mixedType,2
6,4,0,10,mixedType,1
7,2,0,9,mixedType,1
2,8,0,10,mixedType,1
6,3,0,9,mixedType,1
14,2,0,16,mixedType,2
2,4,0,6,mixedType,0
13,3,0,16,mixedType,2
3,5,0,8,mixedType,1
9,1,0,10,mixedType,1
6,2,0,8,mixedType,1
8,4,0,12,mixedType,1
5,2,0,7,mixedType,0
5,2,0,7,mixedType,0
7,2,0,9,mixedType,1
12,3,0,15,mixedType,2
12,6,0,18,mixedType,2
7,2,0,9,mixedType,1
6,3,0,9,mixedType,1
2,8,0,10,mixedType,1
1,8,0,9,mixedType,1
6,2,0,8,mixedType,1
4,6,0,10,mixedType,1
9,2,0,11,mixedType,1
5,0,1,6,mixedType,0
12,4,0,16,mixedType,2
8,2,0,10,mixedType,1
10,2,0,12,mixedType,1
6,4,0,10,mixedType,1
6,5,0,11,mixedType,1
11,3,0,14,mixedType,2
2,6,0,8,mixedType,1
8,1,0,9,mixedType,1
5,1,0,6,mixedType,0
3,3,0,6,mixedType,0
15,1,0,16,mixedType,2
7,3,0,10,mixedType,1
8,3,0,11,mixedType,1
9,3,0,12,mixedType,1
9,1,0,10,mixedType,1
4,4,0,8,mixedType,1
4,4,0,8,mixedType,1
3,6,0,9,mixedType,1
5,1,0,6,mixedType,0
8,3,0,11,mixedType,1
7,2,0,9,mixedType,1
6,1,0,7,mixedType,0
5,3,0,8,mixedType,1
7,3,0,10,mixedType,1
5,4,0,9,mixedType,1
6,2,0,8,mixedType,1
14,2,0,16,mixedType,2
6,1,0,7,mixedType,0
13,3,0,16,mixedType,2
5,4,0,9,mixedType,1
14,2,0,16,mixedType,2
3,5,0,8,mixedType,1
7,3,0,10,mixedType,1
7,2,0,9,mixedType,1
5,3,0,8,mixedType,1
10,2,0,12,mixedType,1
4,6,0,10,mixedType,1
5,4,0,9,mixedType,1
6,1,0,7,mixedType,0
7,2,0,9,mixedType,1
7,2,0,9,mixedType,1
6,2,0,8,mixedType,1
4,6,0,10,mixedType,1
5,2,0,7,mixedType,0
4,4,0,8,mixedType,1
1,10,0,11,mixedType,1
7,2,0,9,mixedType,1
5,3,0,8,mixedType,1
7,4,0,11,mixedType,1
5,3,0,8,mixedType,1
9,3,0,12,mixedType,1
8,1,0,9,mixedType,1
7,6,0,13,mixedType,1
7,2,0,9,mixedType,1
1,11,0,12,mixedType,1
6,3,0,9,mixedType,1
6,3,0,9,mixedType,1
5,4,0,9,mixedType,1
6,1,0,7,mixedType,0
1,9,0,10,mixedType,1
8,2,0,10,mixedType,1
7,3,0,10,mixedType,1
7,2,0,9,mixedType,1
6,4,0,10,mixedType,1
5,4,0,9,mixedType,1
9,3,0,12,mixedType,1
7,3,0,10,mixedType,1
4,2,0,6,mixedType,0
6,3,0,9,mixedType,1
7,2,0,9,mixedType,1
8,2,0,10,mixedType,1
8,4,0,12,mixedType,1
1,7,0,8,mixedType,1
8,3,0,11,mixedType,1
12,4,0,16,mixedType,2
6,1,0,7,mixedType,0
4,2,0,6,mixedType,0
7,3,0,10,mixedType,1
8,6,1,15,mixedType,2
7,3,0,10,mixedType,1
11,1,0,12,mixedType,1
7,2,0,9,mixedType,1
5,3,0,8,mixedType,1
6,3,0,9,mixedType,1
16,1,0,17,mixedType,2
3,5,0,8,mixedType,1
7,2,0,9,mixedType,1
7,4,0,11,mixedType,1
7,3,0,10,mixedType,1
4,2,0,6,mixedType,0
6,3,0,9,mixedType,1
7,3,0,10,mixedType,1
5,2,0,7,mixedType,0
8,1,0,9,mixedType,1
7,1,0,8,mixedType,1
7,3,0,10,mixedType,1
7,1,0,8,mixedType,1
8,1,0,9,mixedType,1
6,2,0,8,mixedType,1
5,4,0,9,mixedType,1
5,3,0,8,mixedType,1
7,3,0,10,mixedType,1
5,3,0,8,mixedType,1
8,2,0,10,mixedType,1
8,2,0,10,mixedType,1
6,7,0,13,mixedType,1
3,3,0,6,mixedType,0
5,4,0,9,mixedType,1
7,1,0,8,mixedType,1
6,5,0,11,mixedType,1
8,1,0,9,mixedType,1
5,2,0,7,mixedType,0
5,3,0,8,mixedType,1
4,2,0,6,mixedType,0
7,3,0,10,mixedType,1
12,4,0,16,mixedType,2
2,6,0,8,mixedType,1
5,2,0,7,mixedType,0
13,3,0,16,mixedType,2
13,2,0,15,mixedType,2
8,1,0,9,mixedType,1
4,7,0,11,mixedType,1
5,2,0,7,mixedType,0
5,5,0,10,mixedType,1
5,3,0,8,mixedType,1
6,3,0,9,mixedType,1
15,1,0,16,mixedType,2
8,2,0,10,mixedType,1
10,1,0,11,mixedType,1
6,4,0,10,mixedType,1
8,1,0,9,mixedType,1
7,3,0,10,mixedType,1
8,3,0,11,mixedType,1
5,2,0,7,mixedType,0
4,4,0,8,mixedType,1
6,3,0,9,mixedType,1
5,2,0,7,mixedType,0
5,3,0,8,mixedType,1
8,1,0,9,mixedType,1
5,3,0,8,mixedType,1
11,1,0,12,mixedType,1
8,2,0,10,mixedType,1
8,4,0,12,mixedType,1
7,2,0,9,mixedType,1
6,3,0,9,mixedType,1
6,3,0,9,mixedType,1
6,4,0,10,mixedType,1
9,1,0,10,mixedType,1
3,8,0,11,mixedType,1
5,2,0,7,mixedType,0
4,2,0,6,mixedType,0
5,2,0,7,mixedType,0
9,2,0,11,mixedType,1
6,3,0,9,mixedType,1
7,3,0,10,mixedType,1
7,3,0,10,mixedType,1
7,1,0,8,mixedType,1
4,2,0,6,mixedType,0
9,3,0,12,mixedType,1
6,4,0,10,mixedType,1
12,3,0,15,mixedType,2
5,3,0,8,mixedType,1
6,1,0,7,mixedType,0
6,2,0,8,mixedType,1
4,7,0,11,mixedType,1
5,6,0,11,mixedType,1
5,3,0,8,mixedType,1
3,10,0,13,mixedType,1
8,1,0,9,mixedType,1
8,1,0,9,mixedType,1
14,2,0,16,mixedType,2
6,4,0,10,mixedType,1
4,4,0,8,mixedType,1
9,3,0,12,mixedType,1
12,4,0,16,mixedType,2
12,4,0,16,mixedType,2
7,1,0,8,mixedType,1
4,6,0,10,mixedType,1
5,4,0,9,mixedType,1
3,6,0,9,mixedType,1
5,3,0,8,mixedType,1
8,1,0,9,mixedType,1
6,1,0,7,mixedType,0
5,1,0,6,mixedType,0
9,1,0,10,mixedType,1
5,3,0,8,mixedType,1
9,4,0,13,mixedType,1
5,6,0,11,mixedType,1
5,8,0,13,mixedType,1
5,1,0,6,mixedType,0
14,2,0,16,mixedType,2
5,2,0,7,mixedType,0
6,1,0,7,mixedType,0
9,2,0,11,mixedType,1
7,2,0,9,mixedType,1
8,2,0,10,mixedType,1
3,5,0,8,mixedType,1
1,7,0,8,mixedType,1
2,4,0,6,mixedType,0
6,2,0,8,mixedType,1
9,1,0,10,mixedType,1
5,4,0,9,mixedType,1
6,3,0,9,mixedType,1
15,1,0,16,mixedType,2
6,4,0,10,mixedType,1
5,1,0,6,mixedType,0
5,3,0,8,mixedType,1
9,1,0,10,mixedType,1
8,4,0,12,mixedType,1
6,3,0,9,mixedType,1
13,3,0,16,mixedType,2
13,3,0,16,mixedType,2
9,2,0,11,mixedType,1
6,4,0,10,mixedType,1
7,3,0,10,mixedType,1
7,2,0,9,mixedType,1
6,1,0,7,mixedType,0
6,4,0,10,mixedType,1
10,2,0,12,mixedType,1
6,3,0,9,mixedType,1
3,11,0,14,mixedType,2
1,8,0,9,mixedType,1
1,8,0,9,mixedType,1
7,4,0,11,mixedType,1
14,2,0,16,mixedType,2
9,1,0,10,mixedType,1
7,3,0,10,mixedType,1
7,2,0,9,mixedType,1
7,5,0,12,mixedType,1
9,2,0,11,mixedType,1
5,4,0,9,mixedType,1
3,5,0,8,mixedType,1
8,2,0,10,mixedType,1
6,1,0,7,mixedType,0
6,1,0,7,mixedType,0
6,1,0,7,mixedType,0
6,3,0,9,mixedType,1
6,4,0,10,mixedType,1
6,3,0,9,mixedType,1
7,2,0,9,mixedType,1
10,2,0,12,mixedType,1
8,2,0,10,mixedType,1
5,2,0,7,mixedType,0
8,2,0,10,mixedType,1
4,4,0,8,mixedType,1
7,3,0,10,mixedType,1
5,2,0,7,mixedType,0
6,3,0,9,mixedType,1
7,3,0,10,mixedType,1
8,3,0,11,mixedType,1
2,6,0,8,mixedType,1
3,6,0,9,mixedType,1
6,3,0,9,mixedType,1
1,7,0,8,mixedType,1
6,3,0,9,mixedType,1
6,4,0,10,mixedType,1
5,7,0,12,mixedType,1
5,2,0,7,mixedType,0
6,3,0,9,mixedType,1
7,5,0,12,mixedType,1
9,3,0,12,mixedType,1
5,2,0,7,mixedType,0
8,3,0,11,mixedType,1
4,2,0,6,mixedType,0
7,4,0,11,mixedType,1
5,4,0,9,mixedType,1
5,1,0,6,mixedType,0
7,1,0,8,mixedType,1
5,3,0,8,mixedType,1
1,11,0,12,mixedType,1
6,4,0,10,mixedType,1
5,3,0,8,mixedType,1
5,7,0,12,mixedType,1
9,1,0,10,mixedType,1
4,5,0,9,mixedType,1
6,3,0,9,mixedType,1
14,2,0,16,mixedType,2
4,4,0,8,mixedType,1
2,7,0,9,mixedType,1
9,2,0,11,mixedType,1
6,6,0,12,mixedType,1
5,2,0,7,mixedType,0
5,3,0,8,mixedType,1
9,1,0,10,mixedType,1
8,4,0,12,mixedType,1
4,5,0,9,mixedType,1
3,6,0,9,mixedType,1
4,4,0,8,mixedType,1
6,3,0,9,mixedType,1
7,3,0,10,mixedType,1
9,2,0,11,mixedType,1
13,3,0,16,mixedType,2
6,2,0,8,mixedType,1
6,4,0,10,mixedType,1
6,2,0,8,mixedType,1
6,2,0,8,mixedType,1
8,3,0,11,mixedType,1
6,1,0,7,mixedType,0
8,5,0,13,mixedType,1
2,6,0,8,mixedType,1
12,3,0,15,mixedType,2
6,1,0,7,mixedType,0
7,1,0,8,mixedType,1
9,2,0,11,mixedType,1
5,3,0,8,mixedType,1
5,2,0,7,mixedType,0
6,2,0,8,mixedType,1
7,1,0,8,mixedType,1
9,1,0,10,mixedType,1
5,4,0,9,mixedType,1
6,3,0,9,mixedType,1
6,3,0,9,mixedType,1
12,4,0,16,mixedType,2
14,2,0,16,mixedType,2
8,1,0,9,mixedType,1
1,6,0,7,mixedType,0
1,10,0,11,mixedType,1
4,6,0,10,mixedType,1
8,2,0,10,mixedType,1
12,3,0,15,mixedType,2
6,3,0,9,mixedType,1
7,2,0,9,mixedType,1
16,3,0,19,mixedType,2
8,3,0,11,mixedType,1
8,6,0,14,mixedType,2
5,6,0,11,mixedType,1
5,2,0,7,mixedType,0
9,1,0,10,mixedType,1
9,1,0,10,mixedType,1
5,4,0,9,mixedType,1
7,1,0,8,mixedType,1
10,2,0,12,mixedType,1
7,3,0,10,mixedType,1
11,2,0,13,mixedType,1
9,1,0,10,mixedType,1
10,5,0,15,mixedType,2
4,4,0,8,mixedType,1
4,5,0,9,mixedType,1
12,3,0,15,mixedType,2
1,9,0,10,mixedType,1
7,2,0,9,mixedType,1
7,3,0,10,mixedType,1
10,3,0,13,mixedType,1
9,3,0,12,mixedType,1
2,6,0,8,mixedType,1
5,3,0,8,mixedType,1
6,4,0,10,mixedType,1
8,1,0,9,mixedType,1
7,6,0,13,mixedType,1
7,3,0,10,mixedType,1
15,1,0,16,mixedType,2
9,2,0,11,mixedType,1
12,3,0,15,mixedType,2
6,3,0,9,mixedType,1
8,2,0,10,mixedType,1
4,4,0,8,mixedType,1
15,1,0,16,mixedType,2
6,4,0,10,mixedType,1
6,4,0,10,mixedType,1
6,4,0,10,mixedType,1
13,3,0,16,mixedType,2
5,3,0,8,mixedType,1
5,3,0,8,mixedType,1
5,4,0,9,mixedType,1
9,1,0,10,mixedType,1
10,3,0,13,mixedType,1
8,1,0,9,mixedType,1
5,4,0,9,mixedType,1
8,1,0,9,mixedType,1
1,7,0,8,mixedType,1
6,2,0,8,mixedType,1
14,2,0,16,mixedType,2
6,4,0,10,mixedType,1
6,6,0,12,mixedType,1
8,2,0,10,mixedType,1
8,3,0,11,mixedType,1
8,1,0,9,mixedType,1
7,1,0,8,mixedType,1
11,0,1,12,mixedType,1
6,2,0,8,mixedType,1
14,2,0,16,mixedType,2
5,4,0,9,mixedType,1
14,2,0,16,mixedType,2
7,3,0,10,mixedType,1
6,4,0,10,mixedType,1
6,3,0,9,mixedType,1
15,1,0,16,mixedType,2
4,6,0,10,mixedType,1
5,3,0,8,mixedType,1
10,3,0,13,mixedType,1
3,5,0,8,mixedType,1
3,5,0,8,mixedType,1
8,1,0,9,mixedType,1
5,2,0,7,mixedType,0
6,2,0,8,mixedType,1
6,2,0,8,mixedType,1
5,4,0,9,mixedType,1
10,2,0,12,mixedType,1
15,1,0,16,mixedType,2
14,2,0,16,mixedType,2
7,2,0,9,mixedType,1
8,2,0,10,mixedType,1
7,3,0,10,mixedType,1
9,1,0,10,mixedType,1
6,3,0,9,mixedType,1
1,7,0,8,mixedType,1
7,1,0,8,mixedType,1
6,2,0,8,mixedType,1
6,2,0,8,mixedType,1
2,7,0,9,mixedType,1
6,3,0,9,mixedType,1
2,9,0,11,mixedType,1
7,2,0,9,mixedType,1
9,2,0,11,mixedType,1
9,4,0,13,mixedType,1
4,5,0,9,mixedType,1
6,2,0,8,mixedType,1
5,2,0,7,mixedType,0
4,8,0,12,mixedType,1
5,2,0,7,mixedType,0
7,2,0,9,mixedType,1
6,4,0,10,mixedType,1
15,1,0,16,mixedType,2
5,3,0,8,mixedType,1
6,3,0,9,mixedType,1
7,4,0,11,mixedType,1
13,3,0,16,mixedType,2
1,8,0,9,mixedType,1
7,2,0,9,mixedType,1
7,3,0,10,mixedType,1
6,1,0,7,mixedType,0
7,2,0,9,mixedType,1
8,4,0,12,mixedType,1
8,2,0,10,mixedType,1
8,2,0,10,mixedType,1
4,4,0,8,mixedType,1
5,2,0,7,mixedType,0
7,2,0,9,mixedType,1
7,3,0,10,mixedType,1
8,1,0,9,mixedType,1
5,3,0,8,mixedType,1
4,2,0,6,mixedType,0
8,3,0,11,mixedType,1
6,6,0,12,mixedType,1
7,3,0,10,mixedType,1
9,1,0,10,mixedType,1
11,2,2,15,mixedType,2
7,3,0,10,mixedType,1
5,4,0,9,mixedType,1
7,4,0,11,mixedType,1
7,3,0,10,mixedType,1
5,3,0,8,mixedType,1
5,1,0,6,mixedType,0
13,3,0,16,mixedType,2
2,4,0,6,mixedType,0
6,4,0,10,mixedType,1
8,1,0,9,mixedType,1
4,2,0,6,mixedType,0
8,2,0,10,mixedType,1
8,2,0,10,mixedType,1
5,3,0,8,mixedType,1
6,4,0,10,mixedType,1
4,4,0,8,mixedType,1
3,5,0,8,mixedType,1
4,8,0,12,mixedType,1
9,2,0,11,mixedType,1
14,2,0,16,mixedType,2
7,3,0,10,mixedType,1
10,2,0,12,mixedType,1
0,8,2,10,mixedType,1
9,1,0,10,mixedType,1
7,5,0,12,mixedType,1
15,1,0,16,mixedType,2
6,10,0,16,mixedType,2
5,2,0,7,mixedType,0
7,2,0,9,mixedType,1
12,4,0,16,mixedType,2
1,7,0,8,mixedType,1
15,1,0,16,mixedType,2
5,2,0,7,mixedType,0
12,3,0,15,mixedType,2
6,3,0,9,mixedType,1
4,2,0,6,mixedType,0
7,2,0,9,mixedType,1
9,1,0,10,mixedType,1
1,8,0,9,mixedType,1
5,3,0,8,mixedType,1
7,2,0,9,mixedType,1
8,2,0,10,mixedType,1
1,9,0,10,mixedType,1
2,8,0,10,mixedType,1
7,1,0,8,mixedType,1
14,2,0,16,mixedType,2
4,4,0,8,mixedType,1
14,2,0,16,mixedType,2
7,2,0,9,mixedType,1
15,1,0,16,mixedType,2
6,3,0,9,mixedType,1
4,5,0,9,mixedType,1
6,3,0,9,mixedType,1
3,5,0,8,mixedType,1
6,1,0,7,mixedType,0
8,2,0,10,mixedType,1
6,4,0,10,mixedType,1
3,8,0,11,mixedType,1
7,3,0,10,mixedType,1
8,2,0,10,mixedType,1
6,2,0,8,mixedType,1
14,2,1,17,mixedType,2
6,2,0,8,mixedType,1
2,4,0,6,mixedType,0
10,2,0,12,mixedType,1
7,2,0,9,mixedType,1
1,8,0,9,mixedType,1
9,1,0,10,mixedType,1
5,4,0,9,mixedType,1
7,1,0,8,mixedType,1
4,2,0,6,mixedType,0
5,1,0,6,mixedType,0
6,3,0,9,mixedType,1
10,2,0,12,mixedType,1
7,2,0,9,mixedType,1
7,2,0,9,mixedType,1
6,1,0,7,mixedType,0
7,2,0,9,mixedType,1
6,2,0,8,mixedType,1
7,1,0,8,mixedType,1
9,5,0,14,mixedType,2
4,4,0,8,mixedType,1
1,8,0,9,mixedType,1
8,3,3,14,mixedType,2
5,8,0,13,mixedType,1
6,3,0,9,mixedType,1
6,4,0,10,mixedType,1
8,2,0,10,mixedType,1
5,4,0,9,mixedType,1
5,3,0,8,mixedType,1
7,3,0,10,mixedType,1
4,5,0,9,mixedType,1
8,2,0,10,mixedType,1
4,2,0,6,mixedType,0
8,1,0,9,mixedType,1
9,2,0,11,mixedType,1
5,3,0,8,mixedType,1
13,1,1,15,mixedType,2
6,3,0,9,mixedType,1
4,4,0,8,mixedType,1
7,2,0,9,mixedType,1
6,4,0,10,mixedType,1
13,3,0,16,mixedType,2
6,3,0,9,mixedType,1
3,5,0,8,mixedType,1
5,5,0,10,mixedType,1
5,4,0,9,mixedType,1
9,2,0,11,mixedType,1
5,5,0,10,mixedType,1
10,1,0,11,mixedType,1
8,1,0,9,mixedType,1
5,2,0,7,mixedType,0
6,4,0,10,mixedType,1
9,2,0,11,mixedType,1
2,6,0,8,mixedType,1
2,8,0,10,mixedType,1
7,4,0,11,mixedType,1
3,3,0,6,mixedType,0
5,4,0,9,mixedType,1
4,4,0,8,mixedType,1
9,3,0,12,mixedType,1
8,1,0,9,mixedType,1
6,2,0,8,mixedType,1
3,5,0,8,mixedType,1
9,2,0,11,mixedType,1
6,2,0,8,mixedType,1
4,2,0,6,mixedType,0
6,2,0,8,mixedType,1
8,1,0,9,mixedType,1
0,7,1,8,mixedType,1
8,2,0,10,mixedType,1
4,2,0,6,mixedType,0
6,2,0,8,mixedType,1
5,4,0,9,mixedType,1
7,0,1,8,mixedType,1
1,5,0,6,mixedType,0
7,3,0,10,mixedType,1
5,3,0,8,mixedType,1
5,3,0,8,mixedType,1
14,2,0,16,mixedType,2
5,2,0,7,mixedType,0
8,1,0,9,mixedType,1
7,1,0,8,mixedType,1
14,2,0,16,mixedType,2
7,4,0,11,mixedType,1
13,3,0,16,mixedType,2
5,3,0,8,mixedType,1
6,3,0,9,mixedType,1
5,2,0,7,mixedType,0
5,4,0,9,mixedType,1
3,7,0,10,mixedType,1
2,8,0,10,mixedType,1
3,8,0,11,mixedType,1
3,6,0,9,mixedType,1
9,1,0,10,mixedType,1
9,4,0,13,mixedType,1
7,2,0,9,mixedType,1
4,2,0,6,mixedType,0
7,4,0,11,mixedType,1
7,3,0,10,mixedType,1
9,1,0,10,mixedType,1
3,5,0,8,mixedType,1
7,3,0,10,mixedType,1
6,1,0,7,mixedType,0
5,3,0,8,mixedType,1
9,2,0,11,mixedType,1
7,3,0,10,mixedType,1
7,3,0,10,mixedType,1
6,3,0,9,mixedType,1
5,2,0,7,mixedType,0
7,3,0,10,mixedType,1
5,1,0,6,mixedType,0
6,3,0,9,mixedType,1
5,2,0,7,mixedType,0
5,4,0,9,mixedType,1
5,2,0,7,mixedType,0
5,3,0,8,mixedType,1
2,8,0,10,mixedType,1
15,1,0,16,mixedType,2
5,3,0,8,mixedType,1
5,3,0,8,mixedType,1
5,4,0,9,mixedType,1
15,1,0,16,mixedType,2
9,1,0,10,mixedType,1
7,3,0,10,mixedType,1
6,2,0,8,mixedType,1
5,2,0,7,mixedType,0
4,2,0,6,mixedType,0
6,3,0,9,mixedType,1
1,10,0,11,mixedType,1
7,3,0,10,mixedType,1
11,1,0,12,mixedType,1
8,1,0,9,mixedType,1
8,2,0,10,mixedType,1
3,6,0,9,mixedType,1
8,2,0,10,mixedType,1
6,3,0,9,mixedType,1
6,1,0,7,mixedType,0
9,1,0,10,mixedType,1
6,3,0,9,mixedType,1
3,5,0,8,mixedType,1
2,6,0,8,mixedType,1
11,1,0,12,mixedType,1
7,3,0,10,mixedType,1
4,4,0,8,mixedType,1
2,6,0,8,mixedType,1
7,2,0,9,mixedType,1
6,3,0,9,mixedType,1
7,4,0,11,mixedType,1
2,7,0,9,mixedType,1
6,1,0,7,mixedType,0
1,8,0,9,mixedType,1
6,6,0,12,mixedType,1
5,1,0,6,mixedType,0
8,1,0,9,mixedType,1
7,1,0,8,mixedType,1
6,3,0,9,mixedType,1
6,1,0,7,mixedType,0
15,1,0,16,mixedType,2
5,4,0,9,mixedType,1
11,1,0,12,mixedType,1
4,4,0,8,mixedType,1
6,3,0,9,mixedType,1
7,4,0,11,mixedType,1
6,2,0,8,mixedType,1
2,6,0,8,mixedType,1
7,2,0,9,mixedType,1
5,2,0,7,mixedType,0
6,1,0,7,mixedType,0
5,2,0,7,mixedType,0
8,1,0,9,mixedType,1
7,3,0,10,mixedType,1
5,5,0,10,mixedType,1
4,6,0,10,mixedType,1
1,7,0,8,mixedType,1
2,6,0,8,mixedType,1
5,2,0,7,mixedType,0
4,4,0,8,mixedType,1
6,1,0,7,mixedType,0
4,8,0,12,mixedType,1
1,8,0,9,mixedType,1
4,8,0,12,mixedType,1
4,4,0,8,mixedType,1
5,2,0,7,mixedType,0
5,2,0,7,mixedType,0
2,6,0,8,mixedType,1
5,4,0,9,mixedType,1
9,0,1,10,mixedType,1
14,2,0,16,mixedType,2
8,3,0,11,mixedType,1
7,4,0,11,mixedType,1
7,3,0,10,mixedType,1
8,4,0,12,mixedType,1
4,6,0,10,mixedType,1
6,3,0,9,mixedType,1
8,2,0,10,mixedType,1
7,3,0,10,mixedType,1
6,1,0,7,mixedType,0
5,5,0,10,mixedType,1
11,3,0,14,mixedType,2
11,2,0,13,mixedType,1
6,4,0,10,mixedType,1
11,5,0,16,mixedType,2
7,2,0,9,mixedType,1
11,3,0,14,mixedType,2
4,6,0,10,mixedType,1
7,8,2,17,mixedType,2
8,4,0,12,mixedType,1
3,6,0,9,mixedType,1
8,1,0,9,mixedType,1
8,2,0,10,mixedType,1
5,2,0,7,mixedType,0
8,7,0,15,mixedType,2
8,2,0,10,mixedType,1
6,2,0,8,mixedType,1
4,2,0,6,mixedType,0
8,1,0,9,mixedType,1
6,2,0,8,mixedType,1
12,4,0,16,mixedType,2
18,4,0,22,mixedType,2
8,3,0,11,mixedType,1
5,1,0,6,mixedType,0
15,1,0,16,mixedType,2
8,1,0,9,mixedType,1
4,4,0,8,mixedType,1
6,2,0,8,mixedType,1
5,2,0,7,mixedType,0
7,3,0,10,mixedType,1
3,8,0,11,mixedType,1
7,3,0,10,mixedType,1
8,1,0,9,mixedType,1
6,4,0,10,mixedType,1
5,3,0,8,mixedType,1
7,1,0,8,mixedType,1
3,8,0,11,mixedType,1
14,2,0,16,mixedType,2
5,2,0,7,mixedType,0
15,1,0,16,mixedType,2
7,1,0,8,mixedType,1
7,1,0,8,mixedType,1
3,6,0,9,mixedType,1
14,2,0,16,mixedType,2
8,2,0,10,mixedType,1
9,1,0,10,mixedType,1
5,2,0,7,mixedType,0
7,3,0,10,mixedType,1
10,1,0,11,mixedType,1
3,6,0,9,mixedType,1
2,7,0,9,mixedType,1
4,2,0,6,mixedType,0
8,1,0,9,mixedType,1
5,3,0,8,mixedType,1
14,2,0,16,mixedType,2
1,8,0,9,mixedType,1
7,3,0,10,mixedType,1
5,4,0,9,mixedType,1
6,3,0,9,mixedType,1
2,6,0,8,mixedType,1
12,4,0,16,mixedType,2
7,3,0,10,mixedType,1
14,2,0,16,mixedType,2
7,3,0,10,mixedType,1
14,2,0,16,mixedType,2
5,2,0,7,mixedType,0
10,2,0,12,mixedType,1
5,4,0,9,mixedType,1
2,8,0,10,mixedType,1
5,1,0,6,mixedType,0
9,1,0,10,mixedType,1
7,2,0,9,mixedType,1
6,4,0,10,mixedType,1
9,1,0,10,mixedType,1
11,4,0,15,mixedType,2
7,3,0,10,mixedType,1
7,1,0,8,mixedType,1
8,2,0,10,mixedType,1
6,4,0,10,mixedType,1
14,2,0,16,mixedType,2
10,6,0,16,mixedType,2
15,1,0,16,mixedType,2
5,2,0,7,mixedType,0
7,3,0,10,mixedType,1
6,2,0,8,mixedType,1
1,8,0,9,mixedType,1
3,9,0,12,mixedType,1
5,2,0,7,mixedType,0
2,8,0,10,mixedType,1
4,4,0,8,mixedType,1
7,3,0,10,mixedType,1
7,1,0,8,mixedType,1
8,2,0,10,mixedType,1
5,3,0,8,mixedType,1
8,2,0,10,mixedType,1
6,2,0,8,mixedType,1
9,1,0,10,mixedType,1
11,2,0,13,mixedType,1
7,3,0,10,mixedType,1
7,3,0,10,mixedType,1
8,3,0,11,mixedType,1
4,5,0,9,mixedType,1
2,4,0,6,mixedType,0
11,2,0,13,mixedType,1
7,1,0,8,mixedType,1
13,3,0,16,mixedType,2
5,4,0,9,mixedType,1
12,4,0,16,mixedType,2
2,8,0,10,mixedType,1
8,4,0,12,mixedType,1
7,2,0,9,mixedType,1
7,1,0,8,mixedType,1
15,1,0,16,mixedType,2
10,3,0,13,mixedType,1
4,4,0,8,mixedType,1
4,2,0,6,mixedType,0
3,5,0,8,mixedType,1
8,2,0,10,mixedType,1
5,2,0,7,mixedType,0
7,1,0,8,mixedType,1
14,2,0,16,mixedType,2
6,1,0,7,mixedType,0
6,3,0,9,mixedType,1
15,1,0,16,mixedType,2
8,3,0,11,mixedType,1
7,3,0,10,mixedType,1
9,2,0,11,mixedType,1
7,2,0,9,mixedType,1
6,1,0,7,mixedType,0
13,3,0,16,mixedType,2
6,6,0,12,mixedType,1
3,3,0,6,mixedType,0
9,4,0,13,mixedType,1
13,3,0,16,mixedType,2
5,4,0,9,mixedType,1
6,4,0,10,mixedType,1
6,1,0,7,mixedType,0
7,3,0,10,mixedType,1
3,6,0,9,mixedType,1
8,1,0,9,mixedType,1
6,4,0,10,mixedType,1
5,3,0,8,mixedType,1
1,9,0,10,mixedType,1
7,1,0,8,mixedType,1
5,2,0,7,mixedType,0
6,2,0,8,mixedType,1
8,2,0,10,mixedType,1
8,3,0,11,mixedType,1
4,8,0,12,mixedType,1
8,2,0,10,mixedType,1
2,6,0,8,mixedType,1
11,3,0,14,mixedType,2
6,4,0,10,mixedType,1
6,2,0,8,mixedType,1
4,2,0,6,mixedType,0
5,2,0,7,mixedType,0
8,3,0,11,mixedType,1
7,3,0,10,mixedType,1
14,2,0,16,mixedType,2
7,3,0,10,mixedType,1
5,2,0,7,mixedType,0
14,2,0,16,mixedType,2
6,3,0,9,mixedType,1
7,2,0,9,mixedType,1
6,1,0,7,mixedType,0
12,0,1,13,mixedType,1
6,3,0,9,mixedType,1
5,3,0,8,mixedType,1
14,2,0,16,mixedType,2
9,1,0,10,mixedType,1
2,6,0,8,mixedType,1
2,6,0,8,mixedType,1
13,3,0,16,mixedType,2
6,2,0,8,mixedType,1
6,2,0,8,mixedType,1
5,3,0,8,mixedType,1
5,3,0,8,mixedType,1
3,7,0,10,mixedType,1
7,3,0,10,mixedType,1
11,3,0,14,mixedType,2
4,4,0,8,mixedType,1
14,2,0,16,mixedType,2
7,3,0,10,mixedType,1
8,3,0,11,mixedType,1
4,2,0,6,mixedType,0
8,2,0,10,mixedType,1
5,2,0,7,mixedType,0
4,4,0,8,mixedType,1
5,1,0,6,mixedType,0
8,2,0,10,mixedType,1
8,1,0,9,mixedType,1
9,1,1,11,mixedType,1
6,1,0,7,mixedType,0
25,5,0,30,mixedType,2
7,3,0,10,mixedType,1
6,1,0,7,mixedType,0
6,1,0,7,mixedType,0
6,3,0,9,mixedType,1
3,5,0,8,mixedType,1
7,2,0,9,mixedType,1
4,8,0,12,mixedType,1
12,4,0,16,mixedType,2
4,2,0,6,mixedType,0
6,2,0,8,mixedType,1
11,3,0,14,mixedType,2
7,2,0,9,mixedType,1
9,2,0,11,mixedType,1
5,3,0,8,mixedType,1
1,8,0,9,mixedType,1
3,5,0,8,mixedType,1
6,1,0,7,mixedType,0
2,7,0,9,mixedType,1
8,2,0,10,mixedType,1
5,4,0,9,mixedType,1
5,6,0,11,mixedType,1
6,4,0,10,mixedType,1
4,2,0,6,mixedType,0
6,3,0,9,mixedType,1
5,2,0,7,mixedType,0
15,1,1,17,mixedType,2
8,4,0,12,mixedType,1
2,6,0,8,mixedType,1
7,2,0,9,mixedType,1
5,4,0,9,mixedType,1
6,1,0,7,mixedType,0
12,4,0,16,mixedType,2
17,8,0,25,mixedType,2
7,2,0,9,mixedType,1
7,3,0,10,mixedType,1
12,4,0,16,mixedType,2
4,4,0,8,mixedType,1
8,4,0,12,mixedType,1
6,4,0,10,mixedType,1
6,2,0,8,mixedType,1
3,6,0,9,mixedType,1
13,3,0,16,mixedType,2
7,3,0,10,mixedType,1
11,5,0,16,mixedType,2
8,2,0,10,mixedType,1
11,3,0,14,mixedType,2
6,1,0,7,mixedType,0
4,2,0,6,mixedType,0
4,6,0,10,mixedType,1
7,3,0,10,mixedType,1
6,1,0,7,mixedType,0
9,2,0,11,mixedType,1
5,3,0,8,mixedType,1
5,3,0,8,mixedType,1
14,2,0,16,mixedType,2
5,3,0,8,mixedType,1
1,7,0,8,mixedType,1
13,3,0,16,mixedType,2
7,1,0,8,mixedType,1
5,2,0,7,mixedType,0
6,2,0,8,mixedType,1
8,2,0,10,mixedType,1
9,1,0,10,mixedType,1
9,4,0,13,mixedType,1
7,3,0,10,mixedType,1
6,4,0,10,mixedType,1
4,8,0,12,mixedType,1
7,5,0,12,mixedType,1
7,5,0,12,mixedType,1
8,2,0,10,mixedType,1
8,1,0,9,mixedType,1
4,8,0,12,mixedType,1
6,2,0,8,mixedType,1
3,10,0,13,mixedType,1
9,1,0,10,mixedType,1
4,2,0,6,mixedType,0
1,8,0,9,mixedType,1
6,4,0,10,mixedType,1
1,8,0,9,mixedType,1
5,3,0,8,mixedType,1
8,2,0,10,mixedType,1
10,2,0,12,mixedType,1
15,1,0,16,mixedType,2
7,1,0,8,mixedType,1
6,2,0,8,mixedType,1
9,4,0,13,mixedType,1
4,4,0,8,mixedType,1
6,1,0,7,mixedType,0
7,3,0,10,mixedType,1
9,1,0,10,mixedType,1
15,1,0,16,mixedType,2
5,3,0,8,mixedType,1
6,3,0,9,mixedType,1
7,3,0,10,mixedType,1
6,3,0,9,mixedType,1
3,7,0,10,mixedType,1
9,2,0,11,mixedType,1
6,5,0,11,mixedType,1
10,1,0,11,mixedType,1
7,1,0,8,mixedType,1
8,1,0,9,mixedType,1
7,2,0,9,mixedType,1
6,1,0,7,mixedType,0
5,1,0,6,mixedType,0
7,3,0,10,mixedType,1
6,3,0,9,mixedType,1
7,3,0,10,mixedType,1
3,6,0,9,mixedType,1
15,1,0,16,mixedType,2
10,2,0,12,mixedType,1
17,3,2,22,mixedType,2
5,4,0,9,mixedType,1
2,6,0,8,mixedType,1
4,8,0,12,mixedType,1
7,1,0,8,mixedType,1
6,2,0,8,mixedType,1
2,10,0,12,mixedType,1
6,1,0,7,mixedType,0
5,4,0,9,mixedType,1
6,1,0,7,mixedType,0
8,1,0,9,mixedType,1
5,4,0,9,mixedType,1
6,3,0,9,mixedType,1
5,2,0,7,mixedType,0
8,2,0,10,mixedType,1
13,3,0,16,mixedType,2
6,1,0,7,mixedType,0
4,4,0,8,mixedType,1
4,4,0,8,mixedType,1
7,3,0,10,mixedType,1
7,1,0,8,mixedType,1
6,2,0,8,mixedType,1
5,3,0,8,mixedType,1
6,2,0,8,mixedType,1
6,6,0,12,mixedType,1
8,4,0,12,mixedType,1
6,6,0,12,mixedType,1
6,3,0,9,mixedType,1
6,3,0,9,mixedType,1
6,3,0,9,mixedType,1
8,6,1,15,mixedType,2
12,3,0,15,mixedType,2
4,4,0,8,mixedType,1
6,2,0,8,mixedType,1
6,3,0,9,mixedType,1
6,6,0,12,mixedType,1
15,1,0,16,mixedType,2
11,1,0,12,mixedType,1
6,1,0,7,mixedType,0
2,6,0,8,mixedType,1
5,2,0,7,mixedType,0
7,3,0,10,mixedType,1
7,0,1,8,mixedType,1
3,6,0,9,mixedType,1
8,1,0,9,mixedType,1
4,6,0,10,mixedType,1
8,1,0,9,mixedType,1
6,3,0,9,mixedType,1
8,1,0,9,mixedType,1
7,3,0,10,mixedType,1
5,6,0,11,mixedType,1
1,8,0,9,mixedType,1
6,4,0,10,mixedType,1
4,2,0,6,mixedType,0
6,2,0,8,mixedType,1
9,1,0,10,mixedType,1
4,8,0,12,mixedType,1
7,3,0,10,mixedType,1
3,7,0,10,mixedType,1
3,6,0,9,mixedType,1
1,8,0,9,mixedType,1
6,3,0,9,mixedType,1
6,4,0,10,mixedType,1
15,1,0,16,mixedType,2
5,3,0,8,mixedType,1
13,3,0,16,mixedType,2
8,2,0,10,mixedType,1
10,3,0,13,mixedType,1
2,7,0,9,mixedType,1
4,4,0,8,mixedType,1
8,2,0,10,mixedType,1
14,2,0,16,mixedType,2
15,1,0,16,mixedType,2
9,2,0,11,mixedType,1
2,8,0,10,mixedType,1
7,2,0,9,mixedType,1
5,2,0,7,mixedType,0
7,4,0,11,mixedType,1
6,1,0,7,mixedType,0
5,1,0,6,mixedType,0
2,8,0,10,mixedType,1
8,1,0,9,mixedType,1
15,1,0,16,mixedType,2
7,4,0,11,mixedType,1
6,3,0,9,mixedType,1
4,6,0,10,mixedType,1
8,1,0,9,mixedType,1
6,4,0,10,mixedType,1
6,2,0,8,mixedType,1
6,3,0,9,mixedType,1
6,1,0,7,mixedType,0
7,4,0,11,mixedType,1
8,1,0,9,mixedType,1
5,4,0,9,mixedType,1
5,2,0,7,mixedType,0
7,3,0,10,mixedType,1
4,2,0,6,mixedType,0
5,1,0,6,mixedType,0
6,3,0,9,mixedType,1
6,3,0,9,mixedType,1
6,2,0,8,mixedType,1
10,6,0,16,mixedType,2
7,3,0,10,mixedType,1
13,3,0,16,mixedType,2
7,2,0,9,mixedType,1
10,2,0,12,mixedType,1
7,1,0,8,mixedType,1
6,1,0,7,mixedType,0
3,6,0,9,mixedType,1
7,5,0,12,mixedType,1
6,3,0,9,mixedType,1
1,10,0,11,mixedType,1
3,6,0,9,mixedType,1
9,3,0,12,mixedType,1
6,2,0,8,mixedType,1
8,2,0,10,mixedType,1
7,3,0,10,mixedType,1
6,2,0,8,mixedType,1
6,3,0,9,mixedType,1
6,1,0,7,mixedType,0
12,3,0,15,mixedType,2
2,8,0,10,mixedType,1
6,2,0,8,mixedType,1
7,4,0,11,mixedType,1
5,4,0,9,mixedType,1
8,2,0,10,mixedType,1
6,2,0,8,mixedType,1
4,4,0,8,mixedType,1
5,3,0,8,mixedType,1
14,2,0,16,mixedType,2
7,4,0,11,mixedType,1
6,4,0,10,mixedType,1
8,2,0,10,mixedType,1
2,7,0,9,mixedType,1
9,3,0,12,mixedType,1
7,3,0,10,mixedType,1
8,2,0,10,mixedType,1
9,2,0,11,mixedType,1
10,2,0,12,mixedType,1
1,8,0,9,mixedType,1
7,2,0,9,mixedType,1
7,3,0,10,mixedType,1
5,7,0,12,mixedType,1
6,2,0,8,mixedType,1
5,1,0,6,mixedType,0
4,2,0,6,mixedType,0
8,3,0,11,mixedType,1
4,4,0,8,mixedType,1
6,4,0,10,mixedType,1
3,7,0,10,mixedType,1
7,6,0,13,mixedType,1
7,3,0,10,mixedType,1
7,3,0,10,mixedType,1
13,3,0,16,mixedType,2
6,4,0,10,mixedType,1
7,3,0,10,mixedType,1
8,1,0,9,mixedType,1
8,2,0,10,mixedType,1
3,6,0,9,mixedType,1
9,2,0,11,mixedType,1
8,2,0,10,mixedType,1
8,6,0,14,mixedType,2
6,3,0,9,mixedType,1
5,2,0,7,mixedType,0
6,3,0,9,mixedType,1
3,7,0,10,mixedType,1
8,3,0,11,mixedType,1
7,3,0,10,mixedType,1
6,4,0,10,mixedType,1
9,2,0,11,mixedType,1
5,1,0,6,mixedType,0
6,1,0,7,mixedType,0
14,2,0,16,mixedType,2
11,1,0,12,mixedType,1
9,2,0,11,mixedType,1
9,3,0,12,mixedType,1
13,3,0,16,mixedType,2
3,11,1,15,mixedType,2
3,10,0,13,mixedType,1
8,1,0,9,mixedType,1
6,3,0,9,mixedType,1
7,3,0,10,mixedType,1
6,4,0,10,mixedType,1
6,3,0,9,mixedType,1
5,2,0,7,mixedType,0
6,3,0,9,mixedType,1
10,1,0,11,mixedType,1
5,4,0,9,mixedType,1
3,6,0,9,mixedType,1
6,2,0,8,mixedType,1
6,3,0,9,mixedType,1
4,4,0,8,mixedType,1
6,2,0,8,mixedType,1
6,5,0,11,mixedType,1
8,2,0,10,mixedType,1
4,4,0,8,mixedType,1
9,2,0,11,mixedType,1
6,4,0,10,mixedType,1
9,1,0,10,mixedType,1
1,7,0,8,mixedType,1
8,1,0,9,mixedType,1
6,4,0,10,mixedType,1
7,3,0,10,mixedType,1
2,4,0,6,mixedType,0
4,4,0,8,mixedType,1
3,6,0,9,mixedType,1
7,4,0,11,mixedType,1
15,1,0,16,mixedType,2
5,4,0,9,mixedType,1
5,8,2,15,mixedType,2
6,2,0,8,mixedType,1
14,2,0,16,mixedType,2
13,2,0,15,mixedType,2
7,2,0,9,mixedType,1
8,3,0,11,mixedType,1
5,2,0,7,mixedType,0
5,2,0,7,mixedType,0
4,2,0,6,mixedType,0
7,1,0,8,mixedType,1
11,1,0,12,mixedType,1
3,5,0,8,mixedType,1
2,9,0,11,mixedType,1
8,1,0,9,mixedType,1
7,1,0,8,mixedType,1
5,7,0,12,mixedType,1
5,3,0,8,mixedType,1
10,1,0,11,mixedType,1
6,3,0,9,mixedType,1
5,1,0,6,mixedType,0
7,3,0,10,mixedType,1
0,6,0,6,sameType,0
5,1,0,6,mixedType,0
7,1,0,8,mixedType,1
9,3,0,12,mixedType,1
13,3,0,16,mixedType,2
8,1,0,9,mixedType,1
9,2,0,11,mixedType,1
4,2,0,6,mixedType,0
6,3,0,9,mixedType,1
8,2,0,10,mixedType,1
1,11,0,12,mixedType,1
6,4,0,10,mixedType,1
6,2,0,8,mixedType,1
4,2,0,6,mixedType,0
4,2,0,6,mixedType,0
5,3,0,8,mixedType,1
9,3,0,12,mixedType,1
13,4,0,17,mixedType,2
9,1,0,10,mixedType,1
2,6,0,8,mixedType,1
5,2,0,7,mixedType,0
10,3,0,13,mixedType,1
6,3,0,9,mixedType,1
6,1,0,7,mixedType,0
4,2,0,6,mixedType,0
9,3,0,12,mixedType,1
3,7,0,10,mixedType,1
4,8,0,12,mixedType,1
8,3,0,11,mixedType,1
5,5,0,10,mixedType,1
5,3,0,8,mixedType,1
5,3,0,8,mixedType,1
11,5,0,16,mixedType,2
4,6,0,10,mixedType,1
7,6,0,13,mixedType,1
6,3,0,9,mixedType,1
4,4,0,8,mixedType,1
5,6,0,11,mixedType,1
4,4,0,8,mixedType,1
8,4,0,12,mixedType,1
3,5,0,8,mixedType,1
3,6,0,9,mixedType,1
8,2,0,10,mixedType,1
7,2,0,9,mixedType,1
11,5,0,16,mixedType,2
3,3,0,6,mixedType,0
11,2,0,13,mixedType,1
2,10,0,12,mixedType,1
6,1,0,7,mixedType,0
7,3,0,10,mixedType,1
6,3,0,9,mixedType,1
5,1,0,6,mixedType,0
13,3,0,16,mixedType,2
7,2,0,9,mixedType,1
7,2,0,9,mixedType,1
5,2,0,7,mixedType,0
15,1,0,16,mixedType,2
11,5,0,16,mixedType,2
11,5,0,16,mixedType,2
1,8,0,9,mixedType,1
2,9,0,11,mixedType,1
14,2,0,16,mixedType,2
9,3,0,12,mixedType,1
15,1,0,16,mixedType,2
15,1,0,16,mixedType,2
6,2,0,8,mixedType,1
1,7,0,8,mixedType,1
12,3,0,15,mixedType,2
7,3,0,10,mixedType,1
8,3,0,11,mixedType,1
7,1,0,8,mixedType,1
12,1,0,13,mixedType,1
14,2,0,16,mixedType,2
7,2,0,9,mixedType,1
3,5,0,8,mixedType,1
13,1,1,15,mixedType,2
7,2,0,9,mixedType,1
5,2,0,7,mixedType,0
8,1,0,9,mixedType,1
10,2,0,12,mixedType,1
4,4,0,8,mixedType,1
6,1,0,7,mixedType,0
13,3,0,16,mixedType,2
8,2,0,10,mixedType,1
8,1,0,9,mixedType,1
7,3,0,10,mixedType,1
7,2,0,9,mixedType,1
6,2,0,8,mixedType,1
4,4,0,8,mixedType,1
8,2,0,10,mixedType,1
7,2,0,9,mixedType,1
7,3,0,10,mixedType,1
0,8,2,10,mixedType,1
2,6,0,8,mixedType,1
4,6,0,10,mixedType,1
5,4,0,9,mixedType,1
10,2,0,12,mixedType,1
6,3,0,9,mixedType,1
6,3,0,9,mixedType,1
5,2,0,7,mixedType,0
6,3,0,9,mixedType,1
6,2,0,8,mixedType,1
7,3,0,10,mixedType,1
13,3,0,16,mixedType,2
2,4,0,6,mixedType,0
6,3,0,9,mixedType,1
4,8,0,12,mixedType,1
6,4,0,10,mixedType,1
6,3,0,9,mixedType,1
8,1,0,9,mixedType,1
5,6,0,11,mixedType,1
6,4,0,10,mixedType,1
8,2,0,10,mixedType,1
7,3,0,10,mixedType,1
6,0,1,7,mixedType,0
6,3,0,9,mixedType,1
1,8,0,9,mixedType,1
5,2,0,7,mixedType,0
1,9,0,10,mixedType,1
8,3,0,11,mixedType,1
9,3,0,12,mixedType,1
7,2,0,9,mixedType,1
7,3,0,10,mixedType,1
6,3,0,9,mixedType,1
5,4,0,9,mixedType,1
5,4,0,9,mixedType,1
4,2,0,6,mixedType,0
5,7,0,12,mixedType,1
4,4,0,8,mixedType,1
6,3,0,9,mixedType,1
6,4,0,10,mixedType,1
5,4,0,9,mixedType,1
6,1,0,7,mixedType,0
4,5,0,9,mixedType,1
13,3,0,16,mixedType,2
8,1,0,9,mixedType,1
6,1,0,7,mixedType,0
7,1,0,8,mixedType,1
6,4,0,10,mixedType,1
2,6,0,8,mixedType,1
11,5,0,16,mixedType,2
4,9,0,13,mixedType,1
6,3,0,9,mixedType,1
6,2,0,8,mixedType,1
8,4,0,12,mixedType,1
5,4,0,9,mixedType,1
6,1,0,7,mixedType,0
5,3,0,8,mixedType,1
6,4,0,10,mixedType,1
6,4,0,10,mixedType,1
14,2,0,16,mixedType,2
7,1,0,8,mixedType,1
8,3,0,11,mixedType,1
7,3,0,10,mixedType,1
5,3,0,8,mixedType,1
2,6,0,8,mixedType,1
13,3,0,16,mixedType,2
3,5,0,8,mixedType,1
11,5,0,16,mixedType,2
5,1,0,6,mixedType,0
14,1,0,15,mixedType,2
7,2,0,9,mixedType,1
7,4,0,11,mixedType,1
6,3,0,9,mixedType,1
1,7,0,8,mixedType,1
2,7,0,9,mixedType,1
6,1,0,7,mixedType,0
7,2,0,9,mixedType,1
4,4,0,8,mixedType,1
8,4,0,12,mixedType,1
5,3,0,8,mixedType,1
7,3,0,10,mixedType,1
6,2,0,8,mixedType,1
5,1,0,6,mixedType,0
9,3,0,12,mixedType,1
5,3,0,8,mixedType,1
6,4,0,10,mixedType,1
14,2,0,16,mixedType,2
7,3,0,10,mixedType,1
5,3,0,8,mixedType,1
8,2,0,10,mixedType,1
11,3,0,14,mixedType,2
4,2,0,6,mixedType,0
4,2,0,6,mixedType,0
6,2,0,8,mixedType,1
14,2,0,16,mixedType,2
12,3,0,15,mixedType,2
5,4,0,9,mixedType,1
8,4,0,12,mixedType,1
8,4,0,12,mixedType,1
1,7,0,8,mixedType,1
15,1,0,16,mixedType,2
3,5,0,8,mixedType,1
14,2,0,16,mixedType,2
1,11,0,12,mixedType,1
6,2,0,8,mixedType,1
2,4,0,6,mixedType,0
9,2,0,11,mixedType,1
8,1,0,9,mixedType,1
13,3,0,16,mixedType,2
6,1,0,7,mixedType,0
2,6,0,8,mixedType,1
7,5,0,12,mixedType,1
4,6,0,10,mixedType,1
3,5,0,8,mixedType,1
9,1,0,10,mixedType,1
5,4,0,9,mixedType,1
5,3,0,8,mixedType,1
7,1,0,8,mixedType,1
6,1,0,7,mixedType,0
6,4,0,10,mixedType,1
5,9,1,15,mixedType,2
2,6,0,8,mixedType,1
7,5,0,12,mixedType,1
9,4,0,13,mixedType,1
7,3,0,10,mixedType,1
13,3,0,16,mixedType,2
2,4,0,6,mixedType,0
12,4,0,16,mixedType,2
6,4,0,10,mixedType,1
5,1,0,6,mixedType,0
4,8,0,12,mixedType,1
3,6,0,9,mixedType,1
6,4,0,10,mixedType,1
6,2,0,8,mixedType,1
6,6,0,12,mixedType,1
1,8,0,9,mixedType,1
6,1,0,7,mixedType,0
5,2,0,7,mixedType,0
7,3,0,10,mixedType,1
3,5,0,8,mixedType,1
8,5,0,13,mixedType,1
8,4,0,12,mixedType,1
4,6,0,10,mixedType,1
5,4,0,9,mixedType,1
6,2,0,8,mixedType,1
6,5,0,11,mixedType,1
3,6,0,9,mixedType,1
4,6,0,10,mixedType,1
5,3,0,8,mixedType,1
6,1,0,7,mixedType,0
5,2,0,7,mixedType,0
1,8,0,9,mixedType,1
4,6,0,10,mixedType,1
8,2,0,10,mixedType,1
9,3,0,12,mixedType,1
3,8,0,11,mixedType,1
6,2,0,8,mixedType,1
5,6,0,11,mixedType,1
12,4,0,16,mixedType,2
13,3,0,16,mixedType,2
1,8,0,9,mixedType,1
8,1,0,9,mixedType,1
5,2,0,7,mixedType,0
6,3,0,9,mixedType,1
6,3,0,9,mixedType,1
8,3,0,11,mixedType,1
3,8,0,11,mixedType,1
8,2,0,10,mixedType,1
7,3,0,10,mixedType,1
4,4,0,8,mixedType,1
7,6,0,13,mixedType,1
8,1,0,9,mixedType,1
8,3,0,11,mixedType,1
5,1,0,6,mixedType,0
9,1,0,10,mixedType,1
8,0,1,9,mixedType,1
4,4,0,8,mixedType,1
8,3,0,11,mixedType,1
5,6,0,11,mixedType,1
7,3,0,10,mixedType,1
3,6,0,9,mixedType,1
4,6,0,10,mixedType,1
5,3,0,8,mixedType,1
11,5,0,16,mixedType,2
5,4,0,9,mixedType,1
5,3,0,8,mixedType,1
12,4,0,16,mixedType,2
7,3,0,10,mixedType,1
6,3,0,9,mixedType,1
7,3,0,10,mixedType,1
6,3,0,9,mixedType,1
12,4,0,16,mixedType,2
5,4,0,9,mixedType,1
12,2,1,15,mixedType,2
6,4,0,10,mixedType,1
7,2,0,9,mixedType,1
7,3,0,10,mixedType,1
11,2,0,13,mixedType,1
9,3,0,12,mixedType,1
6,4,0,10,mixedType,1
3,3,0,6,mixedType,0
5,1,0,6,mixedType,0
7,3,0,10,mixedType,1
5,4,0,9,mixedType,1
5,4,0,9,mixedType,1
5,2,0,7,mixedType,0
5,4,0,9,mixedType,1
12,3,0,15,mixedType,2
7,3,0,10,mixedType,1
1,6,0,7,mixedType,0
11,8,1,20,mixedType,2
7,3,0,10,mixedType,1
15,1,0,16,mixedType,2
10,1,0,11,mixedType,1
4,4,0,8,mixedType,1
5,2,0,7,mixedType,0
4,4,0,8,mixedType,1
8,2,0,10,mixedType,1
6,6,0,12,mixedType,1
12,0,1,13,mixedType,1
8,2,0,10,mixedType,1
6,4,0,10,mixedType,1
8,1,0,9,mixedType,1
5,1,0,6,mixedType,0
7,3,0,10,mixedType,1
1,8,0,9,mixedType,1
9,2,0,11,mixedType,1
7,4,0,11,mixedType,1
5,2,0,7,mixedType,0
6,2,0,8,mixedType,1
3,5,0,8,mixedType,1
7,6,0,13,mixedType,1
11,5,0,16,mixedType,2
3,7,0,10,mixedType,1
6,4,0,10,mixedType,1
7,3,0,10,mixedType,1
3,5,0,8,mixedType,1
4,6,0,10,mixedType,1
5,3,0,8,mixedType,1
5,3,0,8,mixedType,1
5,1,0,6,mixedType,0
4,6,0,10,mixedType,1
9,4,0,13,mixedType,1
7,3,0,10,mixedType,1
15,1,0,16,mixedType,2
5,4,0,9,mixedType,1
5,3,0,8,mixedType,1
7,3,0,10,mixedType,1
6,4,0,10,mixedType,1
5,3,0,8,mixedType,1
11,3,0,14,mixedType,2
15,1,0,16,mixedType,2
8,1,0,9,mixedType,1
1,5,0,6,mixedType,0
3,6,0,9,mixedType,1
4,4,0,8,mixedType,1
13,3,0,16,mixedType,2
2,9,0,11,mixedType,1
5,3,0,8,mixedType,1
15,1,0,16,mixedType,2
8,2,0,10,mixedType,1
7,4,0,11,mixedType,1
5,3,0,8,mixedType,1
5,3,0,8,mixedType,1
6,1,0,7,mixedType,0
5,3,0,8,mixedType,1
7,4,0,11,mixedType,1
6,3,0,9,mixedType,1
9,4,0,13,mixedType,1
7,1,0,8,mixedType,1
2,4,0,6,mixedType,0
5,2,0,7,mixedType,0
5,2,0,7,mixedType,0
6,2,0,8,mixedType,1
5,2,0,7,mixedType,0
6,3,0,9,mixedType,1
6,1,0,7,mixedType,0
9,3,0,12,mixedType,1
7,1,0,8,mixedType,1
6,2,0,8,mixedType,1
5,1,0,6,mixedType,0
2,6,0,8,mixedType,1
7,1,0,8,mixedType,1
7,3,0,10,mixedType,1
15,1,0,16,mixedType,2
5,5,0,10,mixedType,1
8,3,0,11,mixedType,1
7,3,0,10,mixedType,1
15,1,0,16,mixedType,2
8,1,0,9,mixedType,1
5,3,0,8,mixedType,1
5,3,0,8,mixedType,1
5,2,0,7,mixedType,0
3,6,0,9,mixedType,1
4,2,0,6,mixedType,0
7,2,0,9,mixedType,1
6,2,0,8,mixedType,1
5,1,0,6,mixedType,0
8,2,0,10,mixedType,1
4,4,0,8,mixedType,1
5,8,0,13,mixedType,1
6,3,0,9,mixedType,1
4,4,0,8,mixedType,1
6,1,0,7,mixedType,0
7,2,0,9,mixedType,1
8,2,0,10,mixedType,1
6,3,0,9,mixedType,1
7,3,0,10,mixedType,1
9,1,0,10,mixedType,1
5,2,0,7,mixedType,0
1,8,0,9,mixedType,1
5,1,0,6,mixedType,0
8,1,0,9,mixedType,1
9,2,0,11,mixedType,1
5,2,0,7,mixedType,0
7,2,0,9,mixedType,1
6,3,0,9,mixedType,1
3,7,0,10,mixedType,1
5,2,0,7,mixedType,0
9,1,0,10,mixedType,1
5,4,0,9,mixedType,1
6,1,0,7,mixedType,0
9,3,0,12,mixedType,1
8,1,0,9,mixedType,1
4,10,1,15,mixedType,2
1,8,0,9,mixedType,1
6,2,0,8,mixedType,1
7,1,0,8,mixedType,1
7,4,0,11,mixedType,1
4,4,0,8,mixedType,1
13,3,0,16,mixedType,2
5,3,0,8,mixedType,1
6,3,0,9,mixedType,1
6,4,0,10,mixedType,1
8,3,0,11,mixedType,1
9,1,0,10,mixedType,1
6,4,0,10,mixedType,1
5,3,0,8,mixedType,1
7,2,0,9,mixedType,1
7,3,0,10,mixedType,1
6,3,0,9,mixedType,1
8,2,0,10,mixedType,1
15,1,0,16,mixedType,2
2,4,0,6,mixedType,0
2,6,0,8,mixedType,1
8,1,0,9,mixedType,1
9,2,0,11,mixedType,1
3,6,0,9,mixedType,1
8,4,0,12,mixedType,1
4,6,0,10,mixedType,1
8,4,0,12,mixedType,1
9,1,0,10,mixedType,1
10,2,0,12,mixedType,1
6,1,0,7,mixedType,0
7,2,0,9,mixedType,1
10,3,0,13,mixedType,1
1,8,0,9,mixedType,1
7,4,0,11,mixedType,1
7,2,0,9,mixedType,1
5,5,0,10,mixedType,1
8,3,0,11,mixedType,1
1,9,0,10,mixedType,1
12,4,0,16,mixedType,2
4,5,0,9,mixedType,1
8,2,0,10,mixedType,1
2,4,0,6,mixedType,0
9,4,1,14,mixedType,2
2,6,0,8,mixedType,1
12,1,0,13,mixedType,1
1,9,0,10,mixedType,1
6,4,0,10,mixedType,1
4,2,0,6,mixedType,0
7,3,0,10,mixedType,1
7,3,0,10,mixedType,1
7,3,0,10,mixedType,1
6,1,0,7,mixedType,0
5,3,0,8,mixedType,1
3,7,0,10,mixedType,1
5,3,0,8,mixedType,1
9,1,0,10,mixedType,1
4,8,0,12,mixedType,1
6,4,0,10,mixedType,1
9,4,0,13,mixedType,1
5,2,0,7,mixedType,0
2,11,0,13,mixedType,1
7,3,0,10,mixedType,1
3,6,0,9,mixedType,1
7,3,0,10,mixedType,1
8,1,0,9,mixedType,1
6,3,0,9,mixedType,1
6,1,0,7,mixedType,0
6,4,0,10,mixedType,1
5,3,0,8,mixedType,1
1,8,0,9,mixedType,1
11,3,0,14,mixedType,2
8,2,0,10,mixedType,1
5,3,0,8,mixedType,1
6,6,0,12,mixedType,1
6,4,0,10,mixedType,1
11,5,0,16,mixedType,2
4,2,0,6,mixedType,0
4,4,0,8,mixedType,1
11,4,1,16,mixedType,2
8,2,0,10,mixedType,1
7,2,0,9,mixedType,1
7,3,0,10,mixedType,1
4,4,0,8,mixedType,1
5,2,0,7,mixedType,0
6,4,0,10,mixedType,1
9,0,1,10,mixedType,1
6,2,0,8,mixedType,1
2,6,0,8,mixedType,1
7,3,0,10,mixedType,1
6,2,0,8,mixedType,1
8,1,0,9,mixedType,1
7,2,0,9,mixedType,1
1,7,0,8,mixedType,1
6,4,0,10,mixedType,1
6,1,1,8,mixedType,1
10,1,0,11,mixedType,1
8,1,0,9,mixedType,1
8,4,0,12,mixedType,1
6,3,0,9,mixedType,1
5,1,0,6,mixedType,0
3,5,0,8,mixedType,1
7,1,0,8,mixedType,1
7,2,0,9,mixedType,1
9,1,0,10,mixedType,1
3,6,0,9,mixedType,1
7,3,0,10,mixedType,1
4,9,0,13,mixedType,1
9,1,0,10,mixedType,1
6,4,0,10,mixedType,1
1,9,0,10,mixedType,1
5,4,0,9,mixedType,1
7,3,0,10,mixedType,1
2,10,0,12,mixedType,1
7,2,0,9,mixedType,1
12,3,0,15,mixedType,2
11,5,0,16,mixedType,2
4,2,0,6,mixedType,0
2,6,0,8,mixedType,1
7,2,0,9,mixedType,1
6,4,0,10,mixedType,1
14,2,0,16,mixedType,2
13,3,0,16,mixedType,2
6,3,0,9,mixedType,1
3,9,0,12,mixedType,1
4,2,0,6,mixedType,0
7,3,0,10,mixedType,1
9,3,0,12,mixedType,1
6,2,0,8,mixedType,1
1,8,0,9,mixedType,1
8,3,0,11,mixedType,1
9,1,0,10,mixedType,1
4,7,0,11,mixedType,1
7,4,0,11,mixedType,1
7,3,0,10,mixedType,1
6,3,0,9,mixedType,1
4,8,0,12,mixedType,1
12,2,1,15,mixedType,2
5,6,0,11,mixedType,1
16,3,0,19,mixedType,2
4,4,0,8,mixedType,1
12,4,0,16,mixedType,2
5,1,0,6,mixedType,0
4,2,0,6,mixedType,0
8,2,0,10,mixedType,1
14,2,0,16,mixedType,2
10,0,1,11,mixedType,1
7,2,0,9,mixedType,1
2,8,0,10,mixedType,1
2,9,0,11,mixedType,1
6,3,0,9,mixedType,1
14,2,0,16,mixedType,2
1,8,0,9,mixedType,1
7,1,0,8,mixedType,1
2,6,0,8,mixedType,1
6,1,0,7,mixedType,0
1,8,0,9,mixedType,1
2,4,0,6,mixedType,0
7,4,0,11,mixedType,1
7,3,0,10,mixedType,1
3,8,0,11,mixedType,1
7,3,0,10,mixedType,1
8,1,0,9,mixedType,1
1,8,0,9,mixedType,1
7,3,0,10,mixedType,1
14,2,0,16,mixedType,2
6,1,0,7,mixedType,0
5,2,0,7,mixedType,0
9,5,0,14,mixedType,2
5,2,0,7,mixedType,0
5,3,0,8,mixedType,1
7,3,0,10,mixedType,1
6,4,0,10,mixedType,1
5,2,0,7,mixedType,0
13,3,0,16,mixedType,2
3,6,0,9,mixedType,1
4,2,0,6,mixedType,0
11,1,0,12,mixedType,1
13,3,0,16,mixedType,2
5,4,0,9,mixedType,1
6,3,0,9,mixedType,1
7,3,0,10,mixedType,1
4,2,0,6,mixedType,0
9,2,0,11,mixedType,1
7,2,0,9,mixedType,1
9,2,0,11,mixedType,1
5,2,0,7,mixedType,0
4,4,0,8,mixedType,1
5,4,0,9,mixedType,1
9,3,0,12,mixedType,1
12,3,0,15,mixedType,2
8,4,0,12,mixedType,1
13,3,0,16,mixedType,2
7,1,0,8,mixedType,1
7,2,0,9,mixedType,1
5,4,0,9,mixedType,1
7,3,0,10,mixedType,1
6,3,0,9,mixedType,1
11,1,0,12,mixedType,1
6,2,0,8,mixedType,1
6,5,0,11,mixedType,1
5,3,0,8,mixedType,1
10,0,1,11,mixedType,1
9,2,0,11,mixedType,1
4,6,0,10,mixedType,1
2,8,0,10,mixedType,1
6,1,0,7,mixedType,0
5,3,0,8,mixedType,1
8,2,0,10,mixedType,1
3,8,0,11,mixedType,1
13,2,0,15,mixedType,2
5,3,0,8,mixedType,1
9,1,0,10,mixedType,1
8,2,0,10,mixedType,1
7,4,0,11,mixedType,1
6,3,0,9,mixedType,1
6,1,0,7,mixedType,0
5,2,0,7,mixedType,0
4,6,0,10,mixedType,1
8,4,0,12,mixedType,1
6,3,0,9,mixedType,1
1,8,0,9,mixedType,1
8,1,0,9,mixedType,1
5,4,0,9,mixedType,1
15,1,0,16,mixedType,2
8,1,0,9,mixedType,1
2,8,0,10,mixedType,1
0,8,1,9,mixedType,1
9,1,0,10,mixedType,1
8,2,0,10,mixedType,1
4,4,0,8,mixedType,1
4,6,0,10,mixedType,1
12,4,0,16,mixedType,2
7,3,0,10,mixedType,1
6,3,0,9,mixedType,1
5,2,0,7,mixedType,0
7,1,0,8,mixedType,1
8,6,0,14,mixedType,2
11,5,0,16,mixedType,2
4,4,0,8,mixedType,1
3,3,0,6,mixedType,0
8,1,0,9,mixedType,1
6,2,0,8,mixedType,1
19,1,0,20,mixedType,2
4,5,0,9,mixedType,1
13,3,0,16,mixedType,2
14,2,0,16,mixedType,2
2,8,0,10,mixedType,1
3,6,0,9,mixedType,1
7,1,0,8,mixedType,1
9,2,0,11,mixedType,1
6,3,0,9,mixedType,1
6,0,1,7,mixedType,0
5,3,0,8,mixedType,1
12,1,0,13,mixedType,1
9,4,0,13,mixedType,1
8,1,0,9,mixedType,1
7,2,0,9,mixedType,1
12,3,0,15,mixedType,2
4,4,0,8,mixedType,1
7,2,0,9,mixedType,1
5,4,0,9,mixedType,1
8,1,0,9,mixedType,1
7,1,0,8,mixedType,1
5,2,0,7,mixedType,0
1,8,0,9,mixedType,1
5,2,0,7,mixedType,0
14,2,0,16,mixedType,2
5,2,0,7,mixedType,0
6,4,0,10,mixedType,1
6,2,0,8,mixedType,1
8,3,0,11,mixedType,1
14,2,0,16,mixedType,2
8,1,0,9,mixedType,1
6,2,0,8,mixedType,1
14,2,0,16,mixedType,2
4,2,0,6,mixedType,0
1,8,0,9,mixedType,1
8,1,0,9,mixedType,1
7,2,0,9,mixedType,1
5,4,0,9,mixedType,1
7,2,0,9,mixedType,1
7,1,0,8,mixedType,1
8,1,0,9,mixedType,1
12,4,0,16,mixedType,2
8,1,0,9,mixedType,1
6,1,0,7,mixedType,0
8,2,0,10,mixedType,1
14,2,0,16,mixedType,2
5,3,0,8,mixedType,1
5,3,0,8,mixedType,1
6,1,0,7,mixedType,0
6,4,0,10,mixedType,1
6,4,0,10,mixedType,1
7,2,0,9,mixedType,1
6,4,0,10,mixedType,1
6,3,0,9,mixedType,1
10,2,0,12,mixedType,1
2,6,0,8,mixedType,1
3,3,0,6,mixedType,0
6,2,0,8,mixedType,1
5,3,0,8,mixedType,1
10,2,0,12,mixedType,1
4,2,0,6,mixedType,0
2,6,0,8,mixedType,1
5,4,0,9,mixedType,1
2,6,0,8,mixedType,1
5,2,0,7,mixedType,0
15,1,0,16,mixedType,2
4,5,0,9,mixedType,1
8,4,0,12,mixedType,1
9,1,0,10,mixedType,1
3,5,0,8,mixedType,1
7,3,0,10,mixedType,1
3,6,0,9,mixedType,1
5,2,0,7,mixedType,0
7,1,0,8,mixedType,1
4,2,0,6,mixedType,0
1,8,0,9,mixedType,1
6,4,0,10,mixedType,1
12,1,0,13,mixedType,1
3,7,0,10,mixedType,1
7,1,0,8,mixedType,1
6,4,0,10,mixedType,1
6,1,0,7,mixedType,0
5,4,0,9,mixedType,1
2,6,0,8,mixedType,1
6,0,2,8,mixedType,1
2,8,0,10,mixedType,1
6,4,0,10,mixedType,1
7,1,0,8,mixedType,1
6,2,0,8,mixedType,1
4,4,0,8,mixedType,1
4,2,0,6,mixedType,0
4,4,0,8,mixedType,1
15,1,0,16,mixedType,2
4,8,0,12,mixedType,1
2,6,0,8,mixedType,1
9,4,0,13,mixedType,1
15,1,0,16,mixedType,2
6,6,0,12,mixedType,1
5,4,0,9,mixedType,1
6,3,0,9,mixedType,1
7,0,0,7,sameType,0
4,2,0,6,mixedType,0
6,3,0,9,mixedType,1
6,1,0,7,mixedType,0
6,6,0,12,mixedType,1
12,3,0,15,mixedType,2
9,1,0,10,mixedType,1
3,5,0,8,mixedType,1
5,3,0,8,mixedType,1
9,2,0,11,mixedType,1
7,3,0,10,mixedType,1
5,4,0,9,mixedType,1
8,2,0,10,mixedType,1
8,2,0,10,mixedType,1
15,1,0,16,mixedType,2
9,4,0,13,mixedType,1
8,1,0,9,mixedType,1
1,8,0,9,mixedType,1
5,3,0,8,mixedType,1
7,3,0,10,mixedType,1
1,9,0,10,mixedType,1
5,1,0,6,mixedType,0
6,2,0,8,mixedType,1
8,1,0,9,mixedType,1
10,1,0,11,mixedType,1
4,2,0,6,mixedType,0
2,8,0,10,mixedType,1
13,3,0,16,mixedType,2
15,1,0,16,mixedType,2
7,4,0,11,mixedType,1
8,4,0,12,mixedType,1
8,3,0,11,mixedType,1
6,4,0,10,mixedType,1
2,4,0,6,mixedType,0
9,3,0,12,mixedType,1
6,2,0,8,mixedType,1
5,6,0,11,mixedType,1
9,3,0,12,mixedType,1
12,4,0,16,mixedType,2
6,1,0,7,mixedType,0
3,5,0,8,mixedType,1
5,1,0,6,mixedType,0
8,2,0,10,mixedType,1
7,3,0,10,mixedType,1
11,3,0,14,mixedType,2
5,3,0,8,mixedType,1
2,7,0,9,mixedType,1
9,3,0,12,mixedType,1
8,4,0,12,mixedType,1
8,1,0,9,mixedType,1
7,2,0,9,mixedType,1
5,2,0,7,mixedType,0
11,1,0,12,mixedType,1
10,2,0,12,mixedType,1
7,2,0,9,mixedType,1
15,1,0,16,mixedType,2
4,4,0,8,mixedType,1
7,4,0,11,mixedType,1
3,7,0,10,mixedType,1
4,2,0,6,mixedType,0
7,2,0,9,mixedType,1
3,3,0,6,mixedType,0
8,4,0,12,mixedType,1
5,3,0,8,mixedType,1
6,8,0,14,mixedType,2
2,6,0,8,mixedType,1
1,7,0,8,mixedType,1
12,4,0,16,mixedType,2
5,6,0,11,mixedType,1
5,6,0,11,mixedType,1
7,2,0,9,mixedType,1
2,6,0,8,mixedType,1
6,3,0,9,mixedType,1
7,2,0,9,mixedType,1
1,5,0,6,mixedType,0
6,3,0,9,mixedType,1
8,2,0,10,mixedType,1
7,3,0,10,mixedType,1
14,1,0,15,mixedType,2
11,5,0,16,mixedType,2
9,1,0,10,mixedType,1
7,2,0,9,mixedType,1
6,4,0,10,mixedType,1
8,1,0,9,mixedType,1
15,1,0,16,mixedType,2
2,8,0,10,mixedType,1
4,4,0,8,mixedType,1
4,5,0,9,mixedType,1
2,9,0,11,mixedType,1
6,4,0,10,mixedType,1
8,4,0,12,mixedType,1
7,1,0,8,mixedType,1
7,2,0,9,mixedType,1
11,1,0,12,mixedType,1
8,4,0,12,mixedType,1
7,3,0,10,mixedType,1
10,1,0,11,mixedType,1
4,4,0,8,mixedType,1
15,1,0,16,mixedType,2
4,2,0,6,mixedType,0
7,3,0,10,mixedType,1
5,1,0,6,mixedType,0
2,7,0,9,mixedType,1
6,3,0,9,mixedType,1
4,4,0,8,mixedType,1
1,8,0,9,mixedType,1
5,3,0,8,mixedType,1
9,1,0,10,mixedType,1
2,6,0,8,mixedType,1
12,3,0,15,mixedType,2
2,8,0,10,mixedType,1
2,7,0,9,mixedType,1
6,4,0,10,mixedType,1
7,1,0,8,mixedType,1
15,1,0,16,mixedType,2
4,4,0,8,mixedType,1
7,1,0,8,mixedType,1
3,5,0,8,mixedType,1
5,2,0,7,mixedType,0
14,2,0,16,mixedType,2
7,5,0,12,mixedType,1
3,7,0,10,mixedType,1
3,8,0,11,mixedType,1
8,2,0,10,mixedType,1
9,3,0,12,mixedType,1
9,3,0,12,mixedType,1
5,3,0,8,mixedType,1
7,1,0,8,mixedType,1
14,2,0,16,mixedType,2
4,6,0,10,mixedType,1
13,3,0,16,mixedType,2
7,3,0,10,mixedType,1
4,4,0,8,mixedType,1
2,9,0,11,mixedType,1
1,8,0,9,mixedType,1
9,2,0,11,mixedType,1
5,4,0,9,mixedType,1
8,3,0,11,mixedType,1
6,2,0,8,mixedType,1
12,3,0,15,mixedType,2
6,1,0,7,mixedType,0
8,4,2,14,mixedType,2
6,2,0,8,mixedType,1
4,2,0,6,mixedType,0
7,2,0,9,mixedType,1
8,3,0,11,mixedType,1
5,4,0,9,mixedType,1
4,2,0,6,mixedType,0
6,3,0,9,mixedType,1
9,2,0,11,mixedType,1
9,1,0,10,mixedType,1
11,3,0,14,mixedType,2
8,9,0,17,mixedType,2
9,2,0,11,mixedType,1
8,1,0,9,mixedType,1
6,2,0,8,mixedType,1
4,2,0,6,mixedType,0
7,3,0,10,mixedType,1
7,6,0,13,mixedType,1
5,1,0,6,mixedType,0
4,4,0,8,mixedType,1
5,1,0,6,mixedType,0
5,4,0,9,mixedType,1
7,2,0,9,mixedType,1
9,2,0,11,mixedType,1
6,6,0,12,mixedType,1
7,2,0,9,mixedType,1
6,1,0,7,mixedType,0
9,1,0,10,mixedType,1
4,2,0,6,mixedType,0
4,5,0,9,mixedType,1
4,2,0,6,mixedType,0
5,2,0,7,mixedType,0
8,2,0,10,mixedType,1
8,3,0,11,mixedType,1
7,2,0,9,mixedType,1
8,2,0,10,mixedType,1
4,4,0,8,mixedType,1
7,3,0,10,mixedType,1
10,4,0,14,mixedType,2
7,3,0,10,mixedType,1
5,1,0,6,mixedType,0
7,1,0,8,mixedType,1
5,4,0,9,mixedType,1
8,3,0,11,mixedType,1
10,1,0,11,mixedType,1
3,6,0,9,mixedType,1
3,5,0,8,mixedType,1
6,3,0,9,mixedType,1
6,2,0,8,mixedType,1
5,2,0,7,mixedType,0
5,3,0,8,mixedType,1
12,3,0,15,mixedType,2
5,9,0,14,mixedType,2
6,4,0,10,mixedType,1
5,2,0,7,mixedType,0
6,3,0,9,mixedType,1
15,1,0,16,mixedType,2
7,4,0,11,mixedType,1
6,4,0,10,mixedType,1
6,3,0,9,mixedType,1
7,3,0,10,mixedType,1
5,2,0,7,mixedType,0
15,1,0,16,mixedType,2
15,1,0,16,mixedType,2
7,1,0,8,mixedType,1
5,4,0,9,mixedType,1
4,4,0,8,mixedType,1
7,1,0,8,mixedType,1
13,3,0,16,mixedType,2
9,1,0,10,mixedType,1
9,2,0,11,mixedType,1
5,6,0,11,mixedType,1
12,3,0,15,mixedType,2
15,1,0,16,mixedType,2
5,3,0,8,mixedType,1
8,1,0,9,mixedType,1
5,2,0,7,mixedType,0
5,4,0,9,mixedType,1
8,2,0,10,mixedType,1
7,2,0,9,mixedType,1
6,2,0,8,mixedType,1
14,2,0,16,mixedType,2
8,1,0,9,mixedType,1
12,4,0,16,mixedType,2
6,1,0,7,mixedType,0
6,3,0,9,mixedType,1
5,3,0,8,mixedType,1
10,2,0,12,mixedType,1
6,2,0,8,mixedType,1
7,3,0,10,mixedType,1
6,4,0,10,mixedType,1
7,2,0,9,mixedType,1
8,1,0,9,mixedType,1
8,1,0,9,mixedType,1
5,4,0,9,mixedType,1
4,4,0,8,mixedType,1
10,2,0,12,mixedType,1
7,3,0,10,mixedType,1
12,4,0,16,mixedType,2
6,3,0,9,mixedType,1
5,3,0,8,mixedType,1
8,2,0,10,mixedType,1
7,3,0,10,mixedType,1
9,3,0,12,mixedType,1
15,1,0,16,mixedType,2
10,1,0,11,mixedType,1
7,3,0,10,mixedType,1
5,7,0,12,mixedType,1
4,2,0,6,mixedType,0
3,5,0,8,mixedType,1
4,6,0,10,mixedType,1
7,2,0,9,mixedType,1
8,2,0,10,mixedType,1
6,3,0,9,mixedType,1
5,4,0,9,mixedType,1
5,3,0,8,mixedType,1
10,3,0,13,mixedType,1
7,3,0,10,mixedType,1
2,6,0,8,mixedType,1
12,4,0,16,mixedType,2
5,3,0,8,mixedType,1
8,3,0,11,mixedType,1
6,1,0,7,mixedType,0
6,2,0,8,mixedType,1
6,3,0,9,mixedType,1
1,8,0,9,mixedType,1
9,2,0,11,mixedType,1
8,4,0,12,mixedType,1
6,2,0,8,mixedType,1
8,3,0,11,mixedType,1
6,3,0,9,mixedType,1
13,3,0,16,mixedType,2
6,1,0,7,mixedType,0
6,2,0,8,mixedType,1
9,2,0,11,mixedType,1
5,1,0,6,mixedType,0
6,14,0,20,mixedType,2
7,3,0,10,mixedType,1
13,3,0,16,mixedType,2
7,2,0,9,mixedType,1
5,2,0,7,mixedType,0
5,3,0,8,mixedType,1
13,3,0,16,mixedType,2
6,4,0,10,mixedType,1
5,1,0,6,mixedType,0
6,1,0,7,mixedType,0
9,1,0,10,mixedType,1
9,6,1,16,mixedType,2
11,3,0,14,mixedType,2
5,5,0,10,mixedType,1
7,1,0,8,mixedType,1
4,2,0,6,mixedType,0
6,1,0,7,mixedType,0
5,2,0,7,mixedType,0
14,2,0,16,mixedType,2
4,4,0,8,mixedType,1
6,2,0,8,mixedType,1
12,3,0,15,mixedType,2
2,8,0,10,mixedType,1
5,6,0,11,mixedType,1
3,6,0,9,mixedType,1
5,4,0,9,mixedType,1
6,4,0,10,mixedType,1
14,2,0,16,mixedType,2
7,6,0,13,mixedType,1
5,3,0,8,mixedType,1
9,2,4,15,mixedType,2
0,10,0,10,sameType,1
8,1,0,9,mixedType,1
6,3,0,9,mixedType,1
9,1,0,10,mixedType,1
7,4,0,11,mixedType,1
3,6,0,9,mixedType,1
2,6,0,8,mixedType,1
6,2,0,8,mixedType,1
5,4,0,9,mixedType,1
5,3,0,8,mixedType,1
1,8,0,9,mixedType,1
7,2,0,9,mixedType,1
1,8,0,9,mixedType,1
6,3,0,9,mixedType,1
6,3,0,9,mixedType,1
5,2,0,7,mixedType,0
7,2,0,9,mixedType,1
4,2,0,6,mixedType,0
7,1,0,8,mixedType,1
2,5,0,7,mixedType,0
2,7,0,9,mixedType,1
5,1,0,6,mixedType,0
8,1,0,9,mixedType,1
15,1,0,16,mixedType,2
4,4,0,8,mixedType,1
4,2,0,6,mixedType,0
5,2,0,7,mixedType,0
9,3,0,12,mixedType,1
9,1,0,10,mixedType,1
1,8,0,9,mixedType,1
5,3,0,8,mixedType,1
6,3,0,9,mixedType,1
4,4,0,8,mixedType,1
6,3,0,9,mixedType,1
4,4,0,8,mixedType,1
7,3,0,10,mixedType,1
5,4,0,9,mixedType,1
6,2,0,8,mixedType,1
11,3,0,14,mixedType,2
8,2,0,10,mixedType,1
8,1,0,9,mixedType,1
13,3,0,16,mixedType,2
7,2,0,9,mixedType,1
3,7,0,10,mixedType,1
6,4,0,10,mixedType,1
10,3,0,13,mixedType,1
10,2,0,12,mixedType,1
9,1,0,10,mixedType,1
1,8,0,9,mixedType,1
5,3,0,8,mixedType,1
10,1,0,11,mixedType,1
6,1,0,7,mixedType,0
7,3,0,10,mixedType,1
5,4,0,9,mixedType,1
3,0,6,9,mixedType,0
6,2,0,8,mixedType,1
2,7,0,9,mixedType,1
5,3,0,8,mixedType,1
6,3,0,9,mixedType,1
3,8,0,11,mixedType,1
8,2,0,10,mixedType,1
8,2,0,10,mixedType,1
7,3,0,10,mixedType,1
6,6,0,12,mixedType,1
9,1,0,10,mixedType,1
8,2,0,10,mixedType,1
0,10,2,12,mixedType,1
14,2,0,16,mixedType,2
5,2,0,7,mixedType,0
6,4,0,10,mixedType,1
6,4,0,10,mixedType,1
7,2,0,9,mixedType,1
5,3,0,8,mixedType,1
8,1,0,9,mixedType,1
4,5,0,9,mixedType,1
5,2,0,7,mixedType,0
8,2,0,10,mixedType,1
5,3,0,8,mixedType,1
6,3,0,9,mixedType,1
5,2,0,7,mixedType,0
6,4,0,10,mixedType,1
8,2,0,10,mixedType,1
13,6,0,19,mixedType,2
15,1,0,16,mixedType,2
6,3,0,9,mixedType,1
5,4,0,9,mixedType,1
5,2,0,7,mixedType,0
13,1,1,15,mixedType,2
5,6,0,11,mixedType,1
6,3,0,9,mixedType,1
8,1,0,9,mixedType,1
12,4,0,16,mixedType,2
5,3,0,8,mixedType,1
6,4,0,10,mixedType,1
4,2,0,6,mixedType,0
13,3,0,16,mixedType,2
6,3,0,9,mixedType,1
15,1,0,16,mixedType,2
5,4,0,9,mixedType,1
11,1,0,12,mixedType,1
1,8,0,9,mixedType,1
6,4,0,10,mixedType,1
7,2,0,9,mixedType,1
7,3,0,10,mixedType,1
5,2,0,7,mixedType,0
6,1,0,7,mixedType,0
5,2,0,7,mixedType,0
4,2,0,6,mixedType,0
6,3,0,9,mixedType,1
5,3,0,8,mixedType,1
6,2,0,8,mixedType,1
5,7,0,12,mixedType,1
8,1,0,9,mixedType,1
8,4,0,12,mixedType,1
2,6,0,8,mixedType,1
2,4,0,6,mixedType,0
6,1,0,7,mixedType,0
6,3,0,9,mixedType,1
5,2,0,7,mixedType,0
9,1,0,10,mixedType,1
15,1,0,16,mixedType,2
8,1,0,9,mixedType,1
5,3,0,8,mixedType,1
6,3,0,9,mixedType,1
6,2,0,8,mixedType,1
12,1,0,13,mixedType,1
14,2,0,16,mixedType,2
6,4,0,10,mixedType,1
14,2,0,16,mixedType,2
7,2,0,9,mixedType,1
6,2,0,8,mixedType,1
8,2,0,10,mixedType,1
4,4,0,8,mixedType,1
7,2,0,9,mixedType,1
7,3,0,10,mixedType,1
4,2,0,6,mixedType,0
5,4,0,9,mixedType,1
5,4,0,9,mixedType,1
10,2,0,12,mixedType,1
4,2,0,6,mixedType,0
9,2,0,11,mixedType,1
2,6,0,8,mixedType,1
7,1,0,8,mixedType,1
8,2,0,10,mixedType,1
10,2,0,12,mixedType,1
1,8,0,9,mixedType,1
9,1,0,10,mixedType,1
14,2,0,16,mixedType,2
14,2,0,16,mixedType,2
6,3,0,9,mixedType,1
6,3,0,9,mixedType,1
14,2,0,16,mixedType,2
8,2,0,10,mixedType,1
5,4,0,9,mixedType,1
5,4,0,9,mixedType,1
5,1,0,6,mixedType,0
6,7,0,13,mixedType,1
12,4,0,16,mixedType,2
2,8,0,10,mixedType,1
12,4,0,16,mixedType,2
4,2,0,6,mixedType,0
6,4,0,10,mixedType,1
7,2,0,9,mixedType,1
7,3,0,10,mixedType,1
13,3,0,16,mixedType,2
8,4,0,12,mixedType,1
4,4,0,8,mixedType,1
8,2,0,10,mixedType,1
7,2,0,9,mixedType,1
6,1,0,7,mixedType,0
4,4,0,8,mixedType,1
6,3,0,9,mixedType,1
7,3,0,10,mixedType,1
5,2,0,7,mixedType,0
9,4,0,13,mixedType,1
6,3,0,9,mixedType,1
5,1,0,6,mixedType,0
8,1,0,9,mixedType,1
11,4,0,15,mixedType,2
8,2,0,10,mixedType,1
5,3,0,8,mixedType,1
5,6,0,11,mixedType,1
4,4,0,8,mixedType,1
6,3,0,9,mixedType,1
5,6,0,11,mixedType,1
10,4,1,15,mixedType,2
5,2,0,7,mixedType,0
7,2,0,9,mixedType,1
14,2,0,16,mixedType,2
4,4,0,8,mixedType,1
8,1,0,9,mixedType,1
8,1,0,9,mixedType,1
8,5,0,13,mixedType,1
5,6,0,11,mixedType,1
9,3,0,12,mixedType,1
9,3,0,12,mixedType,1
7,3,0,10,mixedType,1
3,7,0,10,mixedType,1
7,3,0,10,mixedType,1
5,1,0,6,mixedType,0
7,4,0,11,mixedType,1
2,4,0,6,mixedType,0
8,1,0,9,mixedType,1
6,6,0,12,mixedType,1
17,3,0,20,mixedType,2
5,4,0,9,mixedType,1
8,4,0,12,mixedType,1
5,2,0,7,mixedType,0
8,4,0,12,mixedType,1
8,4,0,12,mixedType,1
7,3,0,10,mixedType,1
7,2,0,9,mixedType,1
3,9,0,12,mixedType,1
14,2,0,16,mixedType,2
5,3,0,8,mixedType,1
6,3,0,9,mixedType,1
6,1,0,7,mixedType,0
6,4,0,10,mixedType,1
3,3,0,6,mixedType,0
6,3,0,9,mixedType,1
4,2,0,6,mixedType,0
5,4,0,9,mixedType,1
14,2,0,16,mixedType,2
5,2,0,7,mixedType,0
7,3,0,10,mixedType,1
5,2,0,7,mixedType,0
15,1,0,16,mixedType,2
8,2,0,10,mixedType,1
5,4,0,9,mixedType,1
7,6,0,13,mixedType,1
7,1,0,8,mixedType,1
7,2,0,9,mixedType,1
6,4,0,10,mixedType,1
4,2,0,6,mixedType,0
3,7,0,10,mixedType,1
6,3,0,9,mixedType,1
7,1,0,8,mixedType,1
8,2,0,10,mixedType,1
3,5,0,8,mixedType,1
9,4,2,15,mixedType,2
6,4,0,10,mixedType,1
12,4,0,16,mixedType,2
10,4,2,16,mixedType,2
6,4,0,10,mixedType,1
6,3,0,9,mixedType,1
6,2,0,8,mixedType,1
5,4,0,9,mixedType,1
5,3,0,8,mixedType,1
8,2,0,10,mixedType,1
7,4,0,11,mixedType,1
5,2,0,7,mixedType,0
8,2,0,10,mixedType,1
5,3,0,8,mixedType,1
7,1,0,8,mixedType,1
7,4,0,11,mixedType,1
3,5,0,8,mixedType,1
14,2,0,16,mixedType,2
6,4,0,10,mixedType,1
4,4,0,8,mixedType,1
15,1,0,16,mixedType,2
10,2,0,12,mixedType,1
4,2,0,6,mixedType,0
9,2,0,11,mixedType,1
4,4,0,8,mixedType,1
7,3,0,10,mixedType,1
9,1,0,10,mixedType,1
9,2,0,11,mixedType,1
7,2,0,9,mixedType,1
8,4,0,12,mixedType,1
8,1,0,9,mixedType,1
6,2,0,8,mixedType,1
6,3,0,9,mixedType,1
10,3,0,13,mixedType,1
9,3,0,12,mixedType,1
7,2,0,9,mixedType,1
7,2,0,9,mixedType,1
1,10,0,11,mixedType,1
6,2,0,8,mixedType,1
15,1,0,16,mixedType,2
14,2,0,16,mixedType,2
4,2,0,6,mixedType,0
7,2,0,9,mixedType,1
4,4,0,8,mixedType,1
7,3,0,10,mixedType,1
11,1,0,12,mixedType,1
7,1,0,8,mixedType,1
6,3,0,9,mixedType,1
10,6,0,16,mixedType,2
5,4,0,9,mixedType,1
5,4,0,9,mixedType,1
11,4,0,15,mixedType,2
2,6,0,8,mixedType,1
5,1,0,6,mixedType,0
8,1,0,9,mixedType,1
9,1,0,10,mixedType,1
5,2,0,7,mixedType,0
7,3,0,10,mixedType,1
8,4,0,12,mixedType,1
9,1,0,10,mixedType,1
8,1,0,9,mixedType,1
4,4,0,8,mixedType,1
6,3,0,9,mixedType,1
8,1,0,9,mixedType,1
10,3,0,13,mixedType,1
3,7,0,10,mixedType,1
15,1,0,16,mixedType,2
6,1,0,7,mixedType,0
8,2,0,10,mixedType,1
6,3,0,9,mixedType,1
9,4,0,13,mixedType,1
6,1,0,7,mixedType,0
8,4,0,12,mixedType,1
6,4,0,10,mixedType,1
9,3,0,12,mixedType,1
3,3,0,6,mixedType,0
5,4,0,9,mixedType,1
6,4,0,10,mixedType,1
5,2,0,7,mixedType,0
2,8,0,10,mixedType,1
7,3,0,10,mixedType,1
6,4,0,10,mixedType,1
6,1,0,7,mixedType,0
12,4,0,16,mixedType,2
7,3,0,10,mixedType,1
6,3,0,9,mixedType,1
6,2,0,8,mixedType,1
6,2,0,8,mixedType,1
9,4,0,13,mixedType,1
6,3,0,9,mixedType,1
8,2,0,10,mixedType,1
7,2,0,9,mixedType,1
8,1,0,9,mixedType,1
6,3,0,9,mixedType,1
8,2,0,10,mixedType,1
5,3,0,8,mixedType,1
7,3,0,10,mixedType,1
3,7,0,10,mixedType,1
2,7,0,9,mixedType,1
5,1,0,6,mixedType,0
5,4,0,9,mixedType,1
14,2,0,16,mixedType,2
7,1,0,8,mixedType,1
5,2,0,7,mixedType,0
5,2,0,7,mixedType,0
8,4,0,12,mixedType,1
4,2,0,6,mixedType,0
7,2,0,9,mixedType,1
6,4,0,10,mixedType,1
9,3,0,12,mixedType,1
6,4,0,10,mixedType,1
13,3,0,16,mixedType,2
8,2,0,10,mixedType,1
13,3,0,16,mixedType,2
5,8,0,13,mixedType,1
1,6,0,7,mixedType,0
13,3,0,16,mixedType,2
12,4,0,16,mixedType,2
13,3,0,16,mixedType,2
6,3,0,9,mixedType,1
4,4,0,8,mixedType,1
6,3,0,9,mixedType,1
14,2,0,16,mixedType,2
8,1,0,9,mixedType,1
13,3,0,16,mixedType,2
15,1,0,16,mixedType,2
10,3,0,13,mixedType,1
9,1,0,10,mixedType,1
3,3,0,6,mixedType,0
5,2,0,7,mixedType,0
13,3,0,16,mixedType,2
9,4,0,13,mixedType,1
10,1,0,11,mixedType,1
6,2,0,8,mixedType,1
14,2,0,16,mixedType,2
2,4,0,6,mixedType,0
9,2,0,11,mixedType,1
4,6,0,10,mixedType,1
9,3,0,12,mixedType,1
6,4,0,10,mixedType,1
1,8,0,9,mixedType,1
6,2,0,8,mixedType,1
4,5,0,9,mixedType,1
15,1,0,16,mixedType,2
6,3,0,9,mixedType,1
7,1,0,8,mixedType,1
6,2,0,8,mixedType,1
7,3,0,10,mixedType,1
5,2,0,7,mixedType,0
7,2,0,9,mixedType,1
4,4,0,8,mixedType,1
6,3,0,9,mixedType,1
8,6,0,14,mixedType,2
3,6,0,9,mixedType,1
7,5,0,12,mixedType,1
6,3,0,9,mixedType,1
7,2,0,9,mixedType,1
7,3,0,10,mixedType,1
8,3,0,11,mixedType,1
4,4,0,8,mixedType,1
13,3,0,16,mixedType,2
7,2,0,9,mixedType,1
9,2,0,11,mixedType,1
11,6,0,17,mixedType,2
4,4,0,8,mixedType,1
11,1,0,12,mixedType,1
6,4,0,10,mixedType,1
7,3,0,10,mixedType,1
9,2,0,11,mixedType,1
8,3,0,11,mixedType,1
5,4,0,9,mixedType,1
6,1,0,7,mixedType,0
1,7,0,8,mixedType,1
6,2,0,8,mixedType,1
6,9,0,15,mixedType,2
4,6,0,10,mixedType,1
1,7,0,8,mixedType,1
8,3,0,11,mixedType,1
7,1,0,8,mixedType,1
9,8,0,17,mixedType,2
7,2,0,9,mixedType,1
6,3,0,9,mixedType,1
4,6,0,10,mixedType,1
1,10,0,11,mixedType,1
1,5,0,6,mixedType,0
1,10,0,11,mixedType,1
6,3,0,9,mixedType,1
6,4,0,10,mixedType,1
7,3,0,10,mixedType,1
4,4,0,8,mixedType,1
5,4,0,9,mixedType,1
5,4,0,9,mixedType,1
5,3,0,8,mixedType,1
7,2,0,9,mixedType,1
11,1,0,12,mixedType,1
5,2,0,7,mixedType,0
2,6,0,8,mixedType,1
4,2,0,6,mixedType,0
6,2,0,8,mixedType,1
9,1,0,10,mixedType,1
8,3,0,11,mixedType,1
5,3,0,8,mixedType,1
9,2,0,11,mixedType,1
6,3,0,9,mixedType,1
5,3,0,8,mixedType,1
9,2,0,11,mixedType,1
7,3,0,10,mixedType,1
7,2,0,9,mixedType,1
14,2,0,16,mixedType,2
5,3,0,8,mixedType,1
8,1,0,9,mixedType,1
6,2,0,8,mixedType,1
2,8,0,10,mixedType,1
8,2,0,10,mixedType,1
6,1,0,7,mixedType,0
9,1,0,10,mixedType,1
14,2,0,16,mixedType,2
5,2,0,7,mixedType,0
6,1,0,7,mixedType,0
7,2,0,9,mixedType,1
11,10,0,21,mixedType,2
5,2,0,7,mixedType,0
7,2,0,9,mixedType,1
6,4,0,10,mixedType,1
7,6,0,13,mixedType,1
5,1,0,6,mixedType,0
16,2,0,18,mixedType,2
9,1,0,10,mixedType,1
4,4,0,8,mixedType,1
5,4,0,9,mixedType,1
9,3,0,12,mixedType,1
6,4,0,10,mixedType,1
15,1,0,16,mixedType,2
6,2,0,8,mixedType,1
5,2,0,7,mixedType,0
7,2,0,9,mixedType,1
3,6,0,9,mixedType,1
6,3,0,9,mixedType,1
7,2,0,9,mixedType,1
9,2,0,11,mixedType,1
6,3,0,9,mixedType,1
5,2,0,7,mixedType,0
7,2,0,9,mixedType,1
8,1,0,9,mixedType,1
6,1,0,7,mixedType,0
1,8,0,9,mixedType,1
7,3,0,10,mixedType,1
15,1,0,16,mixedType,2
1,8,0,9,mixedType,1
5,1,0,6,mixedType,0
3,8,0,11,mixedType,1
6,2,0,8,mixedType,1
6,4,0,10,mixedType,1
6,3,0,9,mixedType,1
9,1,0,10,mixedType,1
8,2,0,10,mixedType,1
8,1,0,9,mixedType,1
3,6,0,9,mixedType,1
10,2,0,12,mixedType,1
2,6,0,8,mixedType,1
12,4,0,16,mixedType,2
7,3,0,10,mixedType,1
7,2,0,9,mixedType,1
3,6,0,9,mixedType,1
9,1,0,10,mixedType,1
14,2,0,16,mixedType,2
12,4,0,16,mixedType,2
5,4,0,9,mixedType,1
7,3,0,10,mixedType,1
8,3,0,11,mixedType,1
6,2,0,8,mixedType,1
7,1,0,8,mixedType,1
13,3,0,16,mixedType,2
4,4,0,8,mixedType,1
3,17,0,20,mixedType,2
5,1,0,6,mixedType,0
3,6,0,9,mixedType,1
4,4,0,8,mixedType,1
10,2,0,12,mixedType,1
9,1,0,10,mixedType,1
14,2,0,16,mixedType,2
10,1,0,11,mixedType,1
6,1,0,7,mixedType,0
3,6,0,9,mixedType,1
6,2,0,8,mixedType,1
6,4,0,10,mixedType,1
10,2,0,12,mixedType,1
2,6,0,8,mixedType,1
3,3,4,10,mixedType,1
7,3,0,10,mixedType,1
3,6,0,9,mixedType,1
2,6,0,8,mixedType,1
8,6,0,14,mixedType,2
5,2,0,7,mixedType,0
5,2,0,7,mixedType,0
6,4,0,10,mixedType,1
7,3,0,10,mixedType,1
9,3,0,12,mixedType,1
6,2,0,8,mixedType,1
9,2,0,11,mixedType,1
15,1,0,16,mixedType,2
7,3,0,10,mixedType,1
5,2,0,7,mixedType,0
5,2,0,7,mixedType,0
6,3,0,9,mixedType,1
6,3,0,9,mixedType,1
8,1,0,9,mixedType,1
3,3,0,6,mixedType,0
7,3,0,10,mixedType,1
4,6,0,10,mixedType,1
3,9,0,12,mixedType,1
8,1,0,9,mixedType,1
7,2,0,9,mixedType,1
3,6,0,9,mixedType,1
2,8,0,10,mixedType,1
6,3,0,9,mixedType,1
6,3,0,9,mixedType,1
4,8,0,12,mixedType,1
9,1,0,10,mixedType,1
5,2,0,7,mixedType,0
12,4,0,16,mixedType,2
8,2,0,10,mixedType,1
5,6,0,11,mixedType,1
12,4,0,16,mixedType,2
7,2,0,9,mixedType,1
8,1,0,9,mixedType,1
2,4,0,6,mixedType,0
3,6,0,9,mixedType,1
5,6,0,11,mixedType,1
3,6,0,9,mixedType,1
1,8,0,9,mixedType,1
7,2,0,9,mixedType,1
6,2,0,8,mixedType,1
15,1,0,16,mixedType,2
9,3,0,12,mixedType,1
7,3,0,10,mixedType,1
6,3,0,9,mixedType,1
6,4,0,10,mixedType,1
5,2,0,7,mixedType,0
4,2,0,6,mixedType,0
6,3,0,9,mixedType,1
6,8,0,14,mixedType,2
9,1,0,10,mixedType,1
8,2,0,10,mixedType,1
8,2,0,10,mixedType,1
7,3,0,10,mixedType,1
6,1,0,7,mixedType,0
8,2,0,10,mixedType,1
6,4,0,10,mixedType,1
7,3,0,10,mixedType,1
8,2,0,10,mixedType,1
4,6,0,10,mixedType,1
6,2,0,8,mixedType,1
7,2,0,9,mixedType,1
7,3,0,10,mixedType,1
7,16,0,23,mixedType,2
6,3,0,9,mixedType,1
5,4,0,9,mixedType,1
6,4,0,10,mixedType,1
7,3,0,10,mixedType,1
5,3,0,8,mixedType,1
10,2,0,12,mixedType,1
9,1,0,10,mixedType,1
4,4,0,8,mixedType,1
14,2,0,16,mixedType,2
7,5,0,12,mixedType,1
8,1,0,9,mixedType,1
9,2,0,11,mixedType,1
9,1,0,10,mixedType,1
5,5,0,10,mixedType,1
7,3,0,10,mixedType,1
5,8,0,13,mixedType,1
12,4,0,16,mixedType,2
4,2,0,6,mixedType,0
3,8,0,11,mixedType,1
8,2,0,10,mixedType,1
8,2,0,10,mixedType,1
7,3,0,10,mixedType,1
7,2,0,9,mixedType,1
5,3,0,8,mixedType,1
7,2,0,9,mixedType,1
9,4,0,13,mixedType,1
8,2,0,10,mixedType,1
5,4,0,9,mixedType,1
7,5,0,12,mixedType,1
9,1,0,10,mixedType,1
8,2,0,10,mixedType,1
4,2,0,6,mixedType,0
4,5,0,9,mixedType,1
4,2,0,6,mixedType,0
7,5,0,12,mixedType,1
9,1,0,10,mixedType,1
13,3,0,16,mixedType,2
4,4,0,8,mixedType,1
8,1,0,9,mixedType,1
1,8,0,9,mixedType,1
2,11,0,13,mixedType,1
6,3,0,9,mixedType,1
1,8,0,9,mixedType,1
3,7,0,10,mixedType,1
7,3,0,10,mixedType,1
7,3,0,10,mixedType,1
9,1,0,10,mixedType,1
8,2,0,10,mixedType,1
5,8,1,14,mixedType,2
6,4,0,10,mixedType,1
6,2,0,8,mixedType,1
7,1,0,8,mixedType,1
9,1,0,10,mixedType,1
8,1,0,9,mixedType,1
6,2,0,8,mixedType,1
13,3,0,16,mixedType,2
5,1,0,6,mixedType,0
5,6,0,11,mixedType,1
9,1,0,10,mixedType,1
7,2,0,9,mixedType,1
4,2,0,6,mixedType,0
6,3,0,9,mixedType,1
8,3,0,11,mixedType,1
6,2,0,8,mixedType,1
6,3,0,9,mixedType,1
6,1,0,7,mixedType,0
8,2,0,10,mixedType,1
12,4,0,16,mixedType,2
7,3,0,10,mixedType,1
5,2,0,7,mixedType,0
14,2,0,16,mixedType,2
6,1,0,7,mixedType,0
5,3,0,8,mixedType,1
6,3,0,9,mixedType,1
9,3,0,12,mixedType,1
6,3,0,9,mixedType,1
4,2,0,6,mixedType,0
7,3,0,10,mixedType,1
8,2,0,10,mixedType,1
3,6,0,9,mixedType,1
2,8,0,10,mixedType,1
2,4,0,6,mixedType,0
6,4,0,10,mixedType,1
7,3,0,10,mixedType,1
6,2,0,8,mixedType,1
6,4,0,10,mixedType,1
5,3,0,8,mixedType,1
6,4,0,10,mixedType,1
5,3,0,8,mixedType,1
9,4,1,14,mixedType,2
9,3,0,12,mixedType,1
13,3,0,16,mixedType,2
8,2,0,10,mixedType,1
8,2,0,10,mixedType,1
3,6,0,9,mixedType,1
7,1,0,8,mixedType,1
7,3,0,10,mixedType,1
7,3,0,10,mixedType,1
5,2,0,7,mixedType,0
4,2,0,6,mixedType,0
9,2,0,11,mixedType,1
5,3,0,8,mixedType,1
11,1,0,12,mixedType,1
8,2,0,10,mixedType,1
14,2,0,16,mixedType,2
7,3,0,10,mixedType,1
4,4,0,8,mixedType,1
12,4,0,16,mixedType,2
7,3,0,10,mixedType,1
4,2,0,6,mixedType,0
8,2,0,10,mixedType,1
4,4,0,8,mixedType,1
9,1,0,10,mixedType,1
7,3,0,10,mixedType,1
9,1,0,10,mixedType,1
6,4,0,10,mixedType,1
6,1,0,7,mixedType,0
6,3,0,9,mixedType,1
6,3,0,9,mixedType,1
9,1,0,10,mixedType,1
8,4,0,12,mixedType,1
13,3,0,16,mixedType,2
10,2,0,12,mixedType,1
7,3,0,10,mixedType,1
5,8,0,13,mixedType,1
7,4,0,11,mixedType,1
6,1,0,7,mixedType,0
4,6,0,10,mixedType,1
6,3,0,9,mixedType,1
7,2,0,9,mixedType,1
4,2,0,6,mixedType,0
6,2,0,8,mixedType,1
5,2,0,7,mixedType,0
3,6,0,9,mixedType,1
6,3,0,9,mixedType,1
13,3,0,16,mixedType,2
13,3,0,16,mixedType,2
13,3,0,16,mixedType,2
5,3,0,8,mixedType,1
8,4,0,12,mixedType,1
10,3,0,13,mixedType,1
4,6,0,10,mixedType,1
7,3,0,10,mixedType,1
2,7,0,9,mixedType,1
9,1,0,10,mixedType,1
10,2,0,12,mixedType,1
3,6,0,9,mixedType,1
2,9,0,11,mixedType,1
8,1,0,9,mixedType,1
15,1,0,16,mixedType,2
1,8,0,9,mixedType,1
9,4,0,13,mixedType,1
8,1,0,9,mixedType,1
8,4,0,12,mixedType,1
5,4,0,9,mixedType,1
4,6,0,10,mixedType,1
6,3,0,9,mixedType,1
9,3,0,12,mixedType,1
3,7,0,10,mixedType,1
12,1,0,13,mixedType,1
6,4,0,10,mixedType,1
6,3,0,9,mixedType,1
5,3,0,8,mixedType,1
2,7,0,9,mixedType,1
8,6,1,15,mixedType,2
5,2,0,7,mixedType,0
11,2,0,13,mixedType,1
8,2,0,10,mixedType,1
6,1,0,7,mixedType,0
9,2,0,11,mixedType,1
3,9,0,12,mixedType,1
9,2,0,11,mixedType,1
7,3,0,10,mixedType,1
3,6,0,9,mixedType,1
14,2,0,16,mixedType,2
2,11,0,13,mixedType,1
5,6,0,11,mixedType,1
7,3,0,10,mixedType,1
3,7,0,10,mixedType,1
9,1,0,10,mixedType,1
3,7,0,10,mixedType,1
5,2,0,7,mixedType,0
7,1,0,8,mixedType,1
7,7,0,14,mixedType,2
9,4,0,13,mixedType,1
7,3,0,10,mixedType,1
11,3,0,14,mixedType,2
8,2,0,10,mixedType,1
3,10,0,13,mixedType,1
8,1,0,9,mixedType,1
6,1,0,7,mixedType,0
6,4,0,10,mixedType,1
4,4,0,8,mixedType,1
4,2,0,6,mixedType,0
6,4,0,10,mixedType,1
6,2,0,8,mixedType,1
7,1,0,8,mixedType,1
1,8,0,9,mixedType,1
5,5,0,10,mixedType,1
15,1,0,16,mixedType,2
8,1,0,9,mixedType,1
6,3,0,9,mixedType,1
8,3,0,11,mixedType,1
8,2,0,10,mixedType,1
5,4,0,9,mixedType,1
7,1,0,8,mixedType,1
5,5,0,10,mixedType,1
6,4,0,10,mixedType,1
6,3,0,9,mixedType,1
2,7,0,9,mixedType,1
7,1,0,8,mixedType,1
6,2,0,8,mixedType,1
10,1,0,11,mixedType,1
8,1,0,9,mixedType,1
11,5,0,16,mixedType,2
6,1,0,7,mixedType,0
7,2,0,9,mixedType,1
12,4,0,16,mixedType,2
1,7,0,8,mixedType,1
3,8,0,11,mixedType,1
8,2,0,10,mixedType,1
6,1,0,7,mixedType,0
7,3,0,10,mixedType,1
9,2,0,11,mixedType,1
1,8,0,9,mixedType,1
7,2,0,9,mixedType,1
6,1,0,7,mixedType,0
8,2,0,10,mixedType,1
8,2,0,10,mixedType,1
6,1,0,7,mixedType,0
10,3,0,13,mixedType,1
7,1,0,8,mixedType,1
15,1,0,16,mixedType,2
12,3,0,15,mixedType,2
5,2,0,7,mixedType,0
13,3,0,16,mixedType,2
7,1,0,8,mixedType,1
9,1,0,10,mixedType,1
9,1,0,10,mixedType,1
7,4,0,11,mixedType,1
3,6,0,9,mixedType,1
10,3,0,13,mixedType,1
13,3,0,16,mixedType,2
2,10,0,12,mixedType,1
5,3,0,8,mixedType,1
9,3,0,12,mixedType,1
8,1,0,9,mixedType,1
7,3,0,10,mixedType,1
9,1,0,10,mixedType,1
4,4,0,8,mixedType,1
4,7,0,11,mixedType,1
3,5,0,8,mixedType,1
7,2,0,9,mixedType,1
1,7,0,8,mixedType,1
7,3,0,10,mixedType,1
6,3,0,9,mixedType,1
4,2,0,6,mixedType,0
6,3,0,9,mixedType,1
9,1,0,10,mixedType,1
15,1,0,16,mixedType,2
6,2,0,8,mixedType,1
4,7,0,11,mixedType,1
5,2,0,7,mixedType,0
4,4,0,8,mixedType,1
7,3,0,10,mixedType,1
7,1,0,8,mixedType,1
8,1,0,9,mixedType,1
11,3,0,14,mixedType,2
15,1,0,16,mixedType,2
9,3,0,12,mixedType,1
2,10,0,12,mixedType,1
5,2,0,7,mixedType,0
15,1,0,16,mixedType,2
6,3,0,9,mixedType,1
9,4,0,13,mixedType,1
6,4,0,10,mixedType,1
7,4,0,11,mixedType,1
1,8,0,9,mixedType,1
9,1,0,10,mixedType,1
7,1,0,8,mixedType,1
7,2,0,9,mixedType,1
2,6,0,8,mixedType,1
5,4,0,9,mixedType,1
2,9,0,11,mixedType,1
1,8,0,9,mixedType,1
16,1,1,18,mixedType,2
11,3,0,14,mixedType,2
7,3,0,10,mixedType,1
2,6,0,8,mixedType,1
8,2,0,10,mixedType,1
5,2,0,7,mixedType,0
5,3,0,8,mixedType,1
14,2,0,16,mixedType,2
7,1,0,8,mixedType,1
6,3,0,9,mixedType,1
11,3,0,14,mixedType,2
4,2,0,6,mixedType,0
13,3,0,16,mixedType,2
6,3,0,9,mixedType,1
6,3,0,9,mixedType,1
6,4,0,10,mixedType,1
7,3,0,10,mixedType,1
5,3,0,8,mixedType,1
1,8,0,9,mixedType,1
4,6,0,10,mixedType,1
8,4,0,12,mixedType,1
6,0,2,8,mixedType,0
15,5,0,20,mixedType,2
7,3,0,10,mixedType,1
5,2,0,7,mixedType,0
13,3,0,16,mixedType,2
5,2,0,7,mixedType,0
14,2,0,16,mixedType,2
9,1,0,10,mixedType,1
6,2,0,8,mixedType,1
7,2,0,9,mixedType,1
6,3,0,9,mixedType,1
6,3,0,9,mixedType,1
8,3,0,11,mixedType,1
6,6,0,12,mixedType,1
2,8,0,10,mixedType,1
6,1,0,7,mixedType,0
6,4,0,10,mixedType,1
6,3,0,9,mixedType,1
6,1,0,7,mixedType,0
1,9,0,10,mixedType,1
6,2,0,8,mixedType,1
3,3,0,6,mixedType,0
3,8,0,11,mixedType,1
14,2,0,16,mixedType,2
8,2,0,10,mixedType,1
7,1,0,8,mixedType,1
6,3,0,9,mixedType,1
6,3,0,9,mixedType,1
3,3,0,6,mixedType,0
9,4,0,13,mixedType,1
15,1,0,16,mixedType,2
4,2,0,6,mixedType,0
8,2,0,10,mixedType,1
5,2,0,7,mixedType,0
7,1,0,8,mixedType,1
14,2,0,16,mixedType,2
5,3,0,8,mixedType,1
8,1,0,9,mixedType,1
6,3,0,9,mixedType,1
10,2,0,12,mixedType,1
9,4,0,13,mixedType,1
4,2,0,6,mixedType,0
7,2,0,9,mixedType,1
6,3,0,9,mixedType,1
7,2,0,9,mixedType,1
8,4,0,12,mixedType,1
6,3,0,9,mixedType,1
5,4,0,9,mixedType,1
13,3,0,16,mixedType,2
8,2,0,10,mixedType,1
4,2,0,6,mixedType,0
3,10,0,13,mixedType,1
11,3,0,14,mixedType,2
7,3,0,10,mixedType,1
3,6,0,9,mixedType,1
5,5,0,10,mixedType,1
8,1,0,9,mixedType,1
6,1,0,7,mixedType,0
6,3,0,9,mixedType,1
8,2,0,10,mixedType,1
5,2,0,7,mixedType,0
6,3,0,9,mixedType,1
5,1,0,6,mixedType,0
1,10,0,11,mixedType,1
2,7,0,9,mixedType,1
4,5,0,9,mixedType,1
8,2,0,10,mixedType,1
7,3,0,10,mixedType,1
5,4,0,9,mixedType,1
3,6,0,9,mixedType,1
9,1,0,10,mixedType,1
6,4,0,10,mixedType,1
5,4,0,9,mixedType,1
8,1,0,9,mixedType,1
12,4,0,16,mixedType,2
6,8,0,14,mixedType,2
6,4,0,10,mixedType,1
5,2,0,7,mixedType,0
6,5,0,11,mixedType,1
3,6,0,9,mixedType,1
7,3,0,10,mixedType,1
15,1,0,16,mixedType,2
13,3,0,16,mixedType,2
8,1,0,9,mixedType,1
6,3,0,9,mixedType,1
8,4,0,12,mixedType,1
7,4,0,11,mixedType,1
10,3,0,13,mixedType,1
9,1,0,10,mixedType,1
8,2,0,10,mixedType,1
3,6,0,9,mixedType,1
7,1,0,8,mixedType,1
7,2,0,9,mixedType,1
8,1,0,9,mixedType,1
6,4,0,10,mixedType,1
5,2,0,7,mixedType,0
9,3,0,12,mixedType,1
5,1,0,6,mixedType,0
6,3,0,9,mixedType,1
7,3,0,10,mixedType,1
3,5,0,8,mixedType,1
7,4,0,11,mixedType,1
6,1,0,7,mixedType,0
5,4,0,9,mixedType,1
5,3,0,8,mixedType,1
3,6,0,9,mixedType,1
5,3,0,8,mixedType,1
1,8,0,9,mixedType,1
11,3,0,14,mixedType,2
6,3,0,9,mixedType,1
9,1,0,10,mixedType,1
5,3,0,8,mixedType,1
8,4,0,12,mixedType,1
8,8,0,16,mixedType,2
4,4,0,8,mixedType,1
4,6,0,10,mixedType,1
7,4,0,11,mixedType,1
8,4,0,12,mixedType,1
4,4,0,8,mixedType,1
6,4,0,10,mixedType,1
13,3,0,16,mixedType,2
4,6,0,10,mixedType,1
5,3,0,8,mixedType,1
7,3,0,10,mixedType,1
5,1,0,6,mixedType,0
8,2,0,10,mixedType,1
14,2,0,16,mixedType,2
7,1,0,8,mixedType,1
6,3,0,9,mixedType,1
7,4,0,11,mixedType,1
7,3,0,10,mixedType,1
7,1,0,8,mixedType,1
8,3,0,11,mixedType,1
7,3,0,10,mixedType,1
7,1,0,8,mixedType,1
7,3,0,10,mixedType,1
7,2,0,9,mixedType,1
8,2,0,10,mixedType,1
3,6,0,9,mixedType,1
5,1,0,6,mixedType,0
11,3,0,14,mixedType,2
4,5,0,9,mixedType,1
7,4,0,11,mixedType,1
8,1,0,9,mixedType,1
9,2,0,11,mixedType,1
8,1,0,9,mixedType,1
4,4,0,8,mixedType,1
2,6,0,8,mixedType,1
7,6,0,13,mixedType,1
8,1,0,9,mixedType,1
6,2,0,8,mixedType,1
6,3,0,9,mixedType,1
6,1,0,7,mixedType,0
7,3,0,10,mixedType,1
5,6,0,11,mixedType,1
7,1,0,8,mixedType,1
5,3,0,8,mixedType,1
7,1,0,8,mixedType,1
3,6,0,9,mixedType,1
6,3,0,9,mixedType,1
4,4,0,8,mixedType,1
5,2,0,7,mixedType,0
14,2,0,16,mixedType,2
6,1,0,7,mixedType,0
5,3,0,8,mixedType,1
9,3,0,12,mixedType,1
5,3,0,8,mixedType,1
11,3,0,14,mixedType,2
5,3,0,8,mixedType,1
6,4,0,10,mixedType,1
8,3,0,11,mixedType,1
5,1,0,6,mixedType,0
4,4,0,8,mixedType,1
4,2,0,6,mixedType,0
7,2,0,9,mixedType,1
7,1,0,8,mixedType,1
1,8,0,9,mixedType,1
11,3,0,14,mixedType,2
6,2,0,8,mixedType,1
2,6,0,8,mixedType,1
8,1,0,9,mixedType,1
5,1,0,6,mixedType,0
7,4,0,11,mixedType,1
6,3,0,9,mixedType,1
2,6,0,8,mixedType,1
7,2,0,9,mixedType,1
5,2,0,7,mixedType,0
8,1,0,9,mixedType,1
7,3,0,10,mixedType,1
5,2,0,7,mixedType,0
3,5,0,8,mixedType,1
1,10,0,11,mixedType,1
8,3,0,11,mixedType,1
8,2,0,10,mixedType,1
6,3,0,9,mixedType,1
8,2,0,10,mixedType,1
8,1,0,9,mixedType,1
6,3,0,9,mixedType,1
9,1,0,10,mixedType,1
8,1,0,9,mixedType,1
7,2,0,9,mixedType,1
8,1,0,9,mixedType,1
1,9,0,10,mixedType,1
14,2,0,16,mixedType,2
7,1,0,8,mixedType,1
5,3,0,8,mixedType,1
7,3,0,10,mixedType,1
4,4,0,8,mixedType,1
11,5,0,16,mixedType,2
7,3,0,10,mixedType,1
6,3,0,9,mixedType,1
3,5,0,8,mixedType,1
7,2,0,9,mixedType,1
6,2,0,8,mixedType,1
12,4,0,16,mixedType,2
14,2,0,16,mixedType,2
8,2,0,10,mixedType,1
7,3,0,10,mixedType,1
4,2,0,6,mixedType,0
7,1,0,8,mixedType,1
6,2,0,8,mixedType,1
4,4,0,8,mixedType,1
5,4,0,9,mixedType,1
5,4,0,9,mixedType,1
9,2,0,11,mixedType,1
7,2,0,9,mixedType,1
5,4,0,9,mixedType,1
6,4,0,10,mixedType,1
7,1,0,8,mixedType,1
11,2,0,13,mixedType,1
5,4,0,9,mixedType,1
5,2,0,7,mixedType,0
7,3,0,10,mixedType,1
13,3,0,16,mixedType,2
6,8,0,14,mixedType,2
5,1,0,6,mixedType,0
6,4,0,10,mixedType,1
5,5,0,10,mixedType,1
7,2,0,9,mixedType,1
7,4,0,11,mixedType,1
8,3,0,11,mixedType,1
8,1,0,9,mixedType,1
4,4,0,8,mixedType,1
8,4,0,12,mixedType,1
3,5,0,8,mixedType,1
3,6,0,9,mixedType,1
7,3,0,10,mixedType,1
8,3,0,11,mixedType,1
13,3,0,16,mixedType,2
10,3,2,15,mixedType,2
8,2,0,10,mixedType,1
3,6,0,9,mixedType,1
5,2,0,7,mixedType,0
6,3,0,9,mixedType,1
8,2,0,10,mixedType,1
6,3,0,9,mixedType,1
14,2,0,16,mixedType,2
9,3,0,12,mixedType,1
8,2,0,10,mixedType,1
5,3,0,8,mixedType,1
7,2,0,9,mixedType,1
14,2,0,16,mixedType,2
10,2,0,12,mixedType,1
12,4,0,16,mixedType,2
1,8,0,9,mixedType,1
5,4,0,9,mixedType,1
7,3,0,10,mixedType,1
14,1,0,15,mixedType,2
4,6,0,10,mixedType,1
9,3,0,12,mixedType,1
11,0,2,13,mixedType,1
6,4,0,10,mixedType,1
5,2,0,7,mixedType,0
6,3,0,9,mixedType,1
5,3,0,8,mixedType,1
6,7,0,13,mixedType,1
5,0,1,6,mixedType,0
8,1,0,9,mixedType,1
6,2,0,8,mixedType,1
6,4,0,10,mixedType,1
7,3,0,10,mixedType,1
12,3,0,15,mixedType,2
3,6,0,9,mixedType,1
12,4,0,16,mixedType,2
5,3,0,8,mixedType,1
5,2,0,7,mixedType,0
8,1,0,9,mixedType,1
7,2,0,9,mixedType,1
4,2,0,6,mixedType,0
5,3,0,8,mixedType,1
3,5,0,8,mixedType,1
5,3,0,8,mixedType,1
4,5,0,9,mixedType,1
6,4,0,10,mixedType,1
6,3,0,9,mixedType,1
6,2,0,8,mixedType,1
2,6,0,8,mixedType,1
6,1,0,7,mixedType,0
3,8,0,11,mixedType,1
5,4,0,9,mixedType,1
6,2,0,8,mixedType,1
9,1,0,10,mixedType,1
6,4,0,10,mixedType,1
5,3,0,8,mixedType,1
4,4,0,8,mixedType,1
6,3,0,9,mixedType,1
5,3,0,8,mixedType,1
7,2,0,9,mixedType,1
8,2,0,10,mixedType,1
4,4,0,8,mixedType,1
8,2,0,10,mixedType,1
6,2,0,8,mixedType,1
8,3,0,11,mixedType,1
5,2,0,7,mixedType,0
4,2,0,6,mixedType,0
8,3,0,11,mixedType,1
6,2,0,8,mixedType,1
6,4,0,10,mixedType,1
7,3,0,10,mixedType,1
6,7,0,13,mixedType,1
13,3,0,16,mixedType,2
3,5,0,8,mixedType,1
9,2,0,11,mixedType,1
6,1,0,7,mixedType,0
9,2,0,11,mixedType,1
5,4,0,9,mixedType,1
14,2,0,16,mixedType,2
15,1,0,16,mixedType,2
6,2,0,8,mixedType,1
6,1,0,7,mixedType,0
6,6,0,12,mixedType,1
7,3,0,10,mixedType,1
4,8,0,12,mixedType,1
2,7,0,9,mixedType,1
4,2,0,6,mixedType,0
3,6,0,9,mixedType,1
5,1,0,6,mixedType,0
5,1,0,6,mixedType,0
5,2,0,7,mixedType,0
8,3,0,11,mixedType,1
8,2,0,10,mixedType,1
7,5,0,12,mixedType,1
7,2,0,9,mixedType,1
8,1,0,9,mixedType,1
3,8,0,11,mixedType,1
3,7,0,10,mixedType,1
8,2,0,10,mixedType,1
8,0,1,9,mixedType,1
6,2,0,8,mixedType,1
5,3,0,8,mixedType,1
5,3,0,8,mixedType,1
6,3,0,9,mixedType,1
3,6,0,9,mixedType,1
14,2,0,16,mixedType,2
8,2,0,10,mixedType,1
1,8,0,9,mixedType,1
5,1,0,6,mixedType,0
5,2,0,7,mixedType,0
12,3,1,16,mixedType,2
6,3,0,9,mixedType,1
11,2,0,13,mixedType,1
6,4,0,10,mixedType,1
5,0,6,11,mixedType,1
8,2,0,10,mixedType,1
6,1,0,7,mixedType,0
8,2,0,10,mixedType,1
3,3,0,6,mixedType,0
3,6,0,9,mixedType,1
8,2,0,10,mixedType,1
6,3,0,9,mixedType,1
2,6,0,8,mixedType,1
5,1,0,6,mixedType,0
5,4,0,9,mixedType,1
2,8,0,10,mixedType,1
11,3,0,14,mixedType,2
8,2,0,10,mixedType,1
4,5,0,9,mixedType,1
14,2,0,16,mixedType,2
4,4,0,8,mixedType,1
7,3,0,10,mixedType,1
6,2,0,8,mixedType,1
7,1,0,8,mixedType,1
5,2,0,7,mixedType,0
5,3,0,8,mixedType,1
8,4,0,12,mixedType,1
7,3,0,10,mixedType,1
3,7,0,10,mixedType,1
12,4,0,16,mixedType,2
3,8,0,11,mixedType,1
5,1,0,6,mixedType,0
10,3,0,13,mixedType,1
1,8,0,9,mixedType,1
5,4,0,9,mixedType,1
6,3,0,9,mixedType,1
4,6,0,10,mixedType,1
6,4,0,10,mixedType,1
6,4,0,10,mixedType,1
10,1,0,11,mixedType,1
7,3,0,10,mixedType,1
6,2,0,8,mixedType,1
12,3,0,15,mixedType,2
8,1,0,9,mixedType,1
13,3,0,16,mixedType,2
8,2,0,10,mixedType,1
7,3,0,10,mixedType,1
5,3,0,8,mixedType,1
5,5,0,10,mixedType,1
6,1,0,7,mixedType,0
6,1,0,7,mixedType,0
5,4,0,9,mixedType,1
6,4,0,10,mixedType,1
8,3,0,11,mixedType,1
7,2,0,9,mixedType,1
8,3,0,11,mixedType,1
2,6,0,8,mixedType,1
8,4,0,12,mixedType,1
4,2,0,6,mixedType,0
6,2,0,8,mixedType,1
6,3,0,9,mixedType,1
7,1,0,8,mixedType,1
7,1,0,8,mixedType,1
12,1,0,13,mixedType,1
6,4,0,10,mixedType,1
5,3,0,8,mixedType,1
8,0,1,9,mixedType,1
2,4,0,6,mixedType,0
10,6,0,16,mixedType,2
7,2,0,9,mixedType,1
3,6,0,9,mixedType,1
4,2,0,6,mixedType,0
4,2,0,6,mixedType,0
5,5,0,10,mixedType,1
8,1,0,9,mixedType,1
5,6,0,11,mixedType,1
4,2,0,6,mixedType,0
0,8,1,9,mixedType,1
8,2,0,10,mixedType,1
9,3,0,12,mixedType,1
6,3,0,9,mixedType,1
6,1,0,7,mixedType,0
5,2,0,7,mixedType,0
8,1,0,9,mixedType,1
2,7,0,9,mixedType,1
7,3,0,10,mixedType,1
8,1,0,9,mixedType,1
5,2,0,7,mixedType,0
4,2,0,6,mixedType,0
8,2,0,10,mixedType,1
1,7,0,8,mixedType,1
5,4,0,9,mixedType,1
2,4,0,6,mixedType,0
4,2,0,6,mixedType,0
10,2,0,12,mixedType,1
7,2,0,9,mixedType,1
6,2,0,8,mixedType,1
6,1,0,7,mixedType,0
9,2,0,11,mixedType,1
7,2,0,9,mixedType,1
4,6,0,10,mixedType,1
5,1,0,6,mixedType,0
9,3,0,12,mixedType,1
11,4,0,15,mixedType,2
6,4,0,10,mixedType,1
8,1,0,9,mixedType,1
6,3,0,9,mixedType,1
5,4,0,9,mixedType,1
9,3,0,12,mixedType,1
13,3,0,16,mixedType,2
6,4,0,10,mixedType,1
8,2,0,10,mixedType,1
6,2,0,8,mixedType,1
11,3,0,14,mixedType,2
5,3,0,8,mixedType,1
9,1,0,10,mixedType,1
6,5,0,11,mixedType,1
6,3,0,9,mixedType,1
14,2,0,16,mixedType,2
5,6,0,11,mixedType,1
9,3,0,12,mixedType,1
5,3,0,8,mixedType,1
4,4,0,8,mixedType,1
6,1,0,7,mixedType,0
6,4,0,10,mixedType,1
1,5,0,6,mixedType,0
6,1,0,7,mixedType,0
8,2,0,10,mixedType,1
3,3,0,6,mixedType,0
4,2,0,6,mixedType,0
4,4,0,8,mixedType,1
13,3,0,16,mixedType,2
8,1,0,9,mixedType,1
5,8,0,13,mixedType,1
5,2,0,7,mixedType,0
9,3,0,12,mixedType,1
5,5,0,10,mixedType,1
5,1,0,6,mixedType,0
9,1,0,10,mixedType,1
5,3,0,8,mixedType,1
7,6,0,13,mixedType,1
9,1,0,10,mixedType,1
4,4,7,15,mixedType,2
8,4,0,12,mixedType,1
1,7,0,8,mixedType,1
7,1,0,8,mixedType,1
6,2,0,8,mixedType,1
5,4,0,9,mixedType,1
7,4,0,11,mixedType,1
8,4,0,12,mixedType,1
1,9,0,10,mixedType,1
8,2,0,10,mixedType,1
8,1,0,9,mixedType,1
10,1,0,11,mixedType,1
6,1,0,7,mixedType,0
6,1,0,7,mixedType,0
6,3,0,9,mixedType,1
8,1,0,9,mixedType,1
3,5,0,8,mixedType,1
5,5,0,10,mixedType,1
8,2,0,10,mixedType,1
6,3,0,9,mixedType,1
10,6,0,16,mixedType,2
5,3,0,8,mixedType,1
5,1,0,6,mixedType,0
1,8,0,9,mixedType,1
7,3,0,10,mixedType,1
4,4,0,8,mixedType,1
6,3,0,9,mixedType,1
6,2,0,8,mixedType,1
6,2,0,8,mixedType,1
3,6,0,9,mixedType,1
12,3,0,15,mixedType,2
6,1,0,7,mixedType,0
7,3,0,10,mixedType,1
15,1,0,16,mixedType,2
6,4,0,10,mixedType,1
6,3,0,9,mixedType,1
3,7,0,10,mixedType,1
5,3,0,8,mixedType,1
5,1,0,6,mixedType,0
9,3,0,12,mixedType,1
6,3,0,9,mixedType,1
7,2,0,9,mixedType,1
9,4,0,13,mixedType,1
6,4,0,10,mixedType,1
4,4,0,8,mixedType,1
8,2,0,10,mixedType,1
5,4,0,9,mixedType,1
8,2,0,10,mixedType,1
14,2,0,16,mixedType,2
11,1,0,12,mixedType,1
7,3,0,10,mixedType,1
1,8,0,9,mixedType,1
6,8,1,15,mixedType,2
2,4,0,6,mixedType,0
6,4,0,10,mixedType,1
10,2,0,12,mixedType,1
9,1,0,10,mixedType,1
5,3,0,8,mixedType,1
5,3,0,8,mixedType,1
4,6,0,10,mixedType,1
4,4,0,8,mixedType,1
11,5,0,16,mixedType,2
15,1,0,16,mixedType,2
4,5,0,9,mixedType,1
1,8,0,9,mixedType,1
5,3,0,8,mixedType,1
4,7,0,11,mixedType,1
8,4,0,12,mixedType,1
15,1,0,16,mixedType,2
6,3,0,9,mixedType,1
7,3,0,10,mixedType,1
11,2,0,13,mixedType,1
7,3,0,10,mixedType,1
4,6,0,10,mixedType,1
4,4,0,8,mixedType,1
6,2,0,8,mixedType,1
13,3,0,16,mixedType,2
6,2,0,8,mixedType,1
7,2,0,9,mixedType,1
8,4,0,12,mixedType,1
4,2,0,6,mixedType,0
5,5,4,14,mixedType,2
6,3,0,9,mixedType,1
5,4,0,9,mixedType,1
13,3,0,16,mixedType,2
6,2,0,8,mixedType,1
6,1,0,7,mixedType,0
1,8,0,9,mixedType,1
6,3,0,9,mixedType,1
5,5,0,10,mixedType,1
13,3,0,16,mixedType,2
8,10,0,18,mixedType,2
5,3,0,8,mixedType,1
7,2,0,9,mixedType,1
5,5,0,10,mixedType,1
6,1,0,7,mixedType,0
9,3,0,12,mixedType,1
3,6,0,9,mixedType,1
7,3,0,10,mixedType,1
7,3,0,10,mixedType,1
3,6,0,9,mixedType,1
8,4,0,12,mixedType,1
3,7,0,10,mixedType,1
14,2,0,16,mixedType,2
14,2,0,16,mixedType,2
5,2,0,7,mixedType,0
7,6,0,13,mixedType,1
6,3,0,9,mixedType,1
9,3,0,12,mixedType,1
7,3,0,10,mixedType,1
6,1,0,7,mixedType,0
5,1,0,6,mixedType,0
3,6,0,9,mixedType,1
9,1,0,10,mixedType,1
7,3,0,10,mixedType,1
4,4,0,8,mixedType,1
11,2,0,13,mixedType,1
6,1,0,7,mixedType,0
4,4,0,8,mixedType,1
10,1,0,11,mixedType,1
4,9,2,15,mixedType,2
7,2,0,9,mixedType,1
9,2,0,11,mixedType,1
11,3,0,14,mixedType,2
12,1,0,13,mixedType,1
5,2,0,7,mixedType,0
6,2,0,8,mixedType,1
7,3,0,10,mixedType,1
9,2,0,11,mixedType,1
7,2,0,9,mixedType,1
6,4,0,10,mixedType,1
7,1,0,8,mixedType,1
9,2,0,11,mixedType,1
5,3,0,8,mixedType,1
6,2,0,8,mixedType,1
7,1,0,8,mixedType,1
7,3,0,10,mixedType,1
8,3,0,11,mixedType,1
6,2,0,8,mixedType,1
6,3,0,9,mixedType,1
9,2,0,11,mixedType,1
6,4,0,10,mixedType,1
5,3,0,8,mixedType,1
2,9,0,11,mixedType,1
7,3,0,10,mixedType,1
6,4,0,10,mixedType,1
8,2,0,10,mixedType,1
3,5,0,8,mixedType,1
5,4,0,9,mixedType,1
5,4,0,9,mixedType,1
10,2,0,12,mixedType,1
12,0,4,16,mixedType,2
6,3,0,9,mixedType,1
6,1,0,7,mixedType,0
5,2,0,7,mixedType,0
4,4,0,8,mixedType,1
4,4,0,8,mixedType,1
7,3,0,10,mixedType,1
5,1,0,6,mixedType,0
6,2,0,8,mixedType,1
13,3,0,16,mixedType,2
5,2,0,7,mixedType,0
13,3,0,16,mixedType,2
3,6,0,9,mixedType,1
5,3,0,8,mixedType,1
1,8,0,9,mixedType,1
6,3,0,9,mixedType,1
7,3,0,10,mixedType,1
6,3,0,9,mixedType,1
7,3,0,10,mixedType,1
1,10,0,11,mixedType,1
4,7,0,11,mixedType,1
9,0,1,10,mixedType,1
6,1,0,7,mixedType,0
6,1,0,7,mixedType,0
5,4,0,9,mixedType,1
7,3,0,10,mixedType,1
7,2,0,9,mixedType,1
8,3,0,11,mixedType,1
6,2,0,8,mixedType,1
7,3,0,10,mixedType,1
14,2,0,16,mixedType,2
8,4,0,12,mixedType,1
5,3,0,8,mixedType,1
14,2,0,16,mixedType,2
9,1,0,10,mixedType,1
5,2,0,7,mixedType,0
15,1,0,16,mixedType,2
3,6,0,9,mixedType,1
6,6,0,12,mixedType,1
7,3,0,10,mixedType,1
5,3,0,8,mixedType,1
6,1,0,7,mixedType,0
7,6,0,13,mixedType,1
5,3,0,8,mixedType,1
8,2,0,10,mixedType,1
5,4,0,9,mixedType,1
7,3,0,10,mixedType,1
5,3,0,8,mixedType,1
2,10,0,12,mixedType,1
7,1,0,8,mixedType,1
6,1,0,7,mixedType,0
9,2,0,11,mixedType,1
7,1,0,8,mixedType,1
7,3,0,10,mixedType,1
1,8,0,9,mixedType,1
15,1,0,16,mixedType,2
9,4,0,13,mixedType,1
12,3,0,15,mixedType,2
8,4,0,12,mixedType,1
7,5,0,12,mixedType,1
6,1,0,7,mixedType,0
3,5,0,8,mixedType,1
8,1,0,9,mixedType,1
6,1,0,7,mixedType,0
4,4,0,8,mixedType,1
8,1,0,9,mixedType,1
5,1,0,6,mixedType,0
4,4,0,8,mixedType,1
13,3,0,16,mixedType,2
12,3,0,15,mixedType,2
7,2,0,9,mixedType,1
7,2,0,9,mixedType,1
5,3,0,8,mixedType,1
7,1,0,8,mixedType,1
2,6,0,8,mixedType,1
4,6,0,10,mixedType,1
8,4,0,12,mixedType,1
11,4,4,19,mixedType,2
6,3,0,9,mixedType,1
3,6,0,9,mixedType,1
6,2,0,8,mixedType,1
5,3,0,8,mixedType,1
5,6,0,11,mixedType,1
6,3,0,9,mixedType,1
1,8,0,9,mixedType,1
8,2,0,10,mixedType,1
6,1,0,7,mixedType,0
7,3,0,10,mixedType,1
7,2,0,9,mixedType,1
4,4,0,8,mixedType,1
7,2,0,9,mixedType,1
8,1,0,9,mixedType,1
5,2,0,7,mixedType,0
7,2,0,9,mixedType,1
3,5,0,8,mixedType,1
8,2,0,10,mixedType,1
10,1,0,11,mixedType,1
8,1,0,9,mixedType,1
13,3,0,16,mixedType,2
1,8,0,9,mixedType,1
9,3,0,12,mixedType,1
9,1,0,10,mixedType,1
8,1,0,9,mixedType,1
6,2,0,8,mixedType,1
4,9,0,13,mixedType,1
4,4,0,8,mixedType,1
8,1,0,9,mixedType,1
12,4,0,16,mixedType,2
8,2,0,10,mixedType,1
1,8,0,9,mixedType,1
9,1,0,10,mixedType,1
6,3,0,9,mixedType,1
7,2,0,9,mixedType,1
8,4,0,12,mixedType,1
7,3,0,10,mixedType,1
6,7,0,13,mixedType,1
5,8,0,13,mixedType,1
3,6,0,9,mixedType,1
6,1,0,7,mixedType,0
6,4,0,10,mixedType,1
13,3,0,16,mixedType,2
5,3,0,8,mixedType,1
7,4,0,11,mixedType,1
4,4,0,8,mixedType,1
7,2,0,9,mixedType,1
4,4,0,8,mixedType,1
7,4,0,11,mixedType,1
5,3,0,8,mixedType,1
8,3,0,11,mixedType,1
5,2,0,7,mixedType,0
10,1,0,11,mixedType,1
6,6,0,12,mixedType,1
8,1,0,9,mixedType,1
6,6,0,12,mixedType,1
9,7,0,16,mixedType,2
5,3,0,8,mixedType,1
6,4,0,10,mixedType,1
9,1,0,10,mixedType,1
3,8,0,11,mixedType,1
4,2,0,6,mixedType,0
9,4,0,13,mixedType,1
5,4,0,9,mixedType,1
7,1,0,8,mixedType,1
7,3,0,10,mixedType,1
6,3,0,9,mixedType,1
7,1,0,8,mixedType,1
15,1,0,16,mixedType,2
2,6,0,8,mixedType,1
6,2,0,8,mixedType,1
7,3,0,10,mixedType,1
6,4,0,10,mixedType,1
11,5,0,16,mixedType,2
3,6,0,9,mixedType,1
7,3,0,10,mixedType,1
6,2,0,8,mixedType,1
3,6,0,9,mixedType,1
8,1,0,9,mixedType,1
8,1,0,9,mixedType,1
6,5,0,11,mixedType,1
8,2,0,10,mixedType,1
7,1,0,8,mixedType,1
6,3,0,9,mixedType,1
5,4,0,9,mixedType,1
7,3,0,10,mixedType,1
2,6,0,8,mixedType,1
7,4,0,11,mixedType,1
2,10,0,12,mixedType,1
6,1,0,7,mixedType,0
11,5,0,16,mixedType,2
5,2,0,7,mixedType,0
7,2,0,9,mixedType,1
6,1,0,7,mixedType,0
10,1,0,11,mixedType,1
4,4,0,8,mixedType,1
6,3,0,9,mixedType,1
6,3,0,9,mixedType,1
13,3,0,16,mixedType,2
13,3,0,16,mixedType,2
9,2,0,11,mixedType,1
8,2,0,10,mixedType,1
7,3,0,10,mixedType,1
6,3,0,9,mixedType,1
6,6,0,12,mixedType,1
12,1,0,13,mixedType,1
15,1,0,16,mixedType,2
7,3,0,10,mixedType,1
13,3,0,16,mixedType,2
7,2,0,9,mixedType,1
7,2,0,9,mixedType,1
6,2,0,8,mixedType,1
1,8,0,9,mixedType,1
6,1,0,7,mixedType,0
5,2,0,7,mixedType,0
5,6,0,11,mixedType,1
2,4,0,6,mixedType,0
5,4,0,9,mixedType,1
6,3,0,9,mixedType,1
6,3,0,9,mixedType,1
6,3,0,9,mixedType,1
2,6,0,8,mixedType,1
4,5,0,9,mixedType,1
1,7,0,8,mixedType,1
8,6,2,16,mixedType,2
1,8,0,9,mixedType,1
2,7,0,9,mixedType,1
5,2,0,7,mixedType,0
9,3,0,12,mixedType,1
6,3,0,9,mixedType,1
3,10,0,13,mixedType,1
9,2,0,11,mixedType,1
6,3,0,9,mixedType,1
7,3,0,10,mixedType,1
4,4,0,8,mixedType,1
11,3,0,14,mixedType,2
5,1,0,6,mixedType,0
6,3,0,9,mixedType,1
6,3,0,9,mixedType,1
7,3,0,10,mixedType,1
7,3,0,10,mixedType,1
5,3,0,8,mixedType,1
1,8,0,9,mixedType,1
8,3,0,11,mixedType,1
4,4,0,8,mixedType,1
5,2,0,7,mixedType,0
8,2,0,10,mixedType,1
9,1,0,10,mixedType,1
13,6,1,20,mixedType,2
7,1,0,8,mixedType,1
7,3,0,10,mixedType,1
15,1,0,16,mixedType,2
1,9,0,10,mixedType,1
6,1,0,7,mixedType,0
5,8,0,13,mixedType,1
6,4,0,10,mixedType,1
3,6,0,9,mixedType,1
10,2,0,12,mixedType,1
7,3,0,10,mixedType,1
5,3,0,8,mixedType,1
4,4,0,8,mixedType,1
9,2,0,11,mixedType,1
5,2,0,7,mixedType,0
1,9,0,10,mixedType,1
5,6,0,11,mixedType,1
8,3,0,11,mixedType,1
1,8,0,9,mixedType,1
9,1,0,10,mixedType,1
5,4,0,9,mixedType,1
6,2,0,8,mixedType,1
6,4,0,10,mixedType,1
6,1,0,7,mixedType,0
5,3,0,8,mixedType,1
5,3,0,8,mixedType,1
4,4,0,8,mixedType,1
11,1,0,12,mixedType,1
4,2,0,6,mixedType,0
7,1,0,8,mixedType,1
14,2,0,16,mixedType,2
6,2,0,8,mixedType,1
12,1,0,13,mixedType,1
7,3,0,10,mixedType,1
0,8,1,9,mixedType,1
10,2,0,12,mixedType,1
4,4,0,8,mixedType,1
5,4,0,9,mixedType,1
7,2,0,9,mixedType,1
9,1,0,10,mixedType,1
6,1,0,7,mixedType,0
6,2,0,8,mixedType,1
8,2,0,10,mixedType,1
6,3,0,9,mixedType,1
3,7,0,10,mixedType,1
4,2,0,6,mixedType,0
9,3,0,12,mixedType,1
6,3,0,9,mixedType,1
4,4,0,8,mixedType,1
9,1,0,10,mixedType,1
6,2,0,8,mixedType,1
5,8,0,13,mixedType,1
11,2,0,13,mixedType,1
5,3,0,8,mixedType,1
11,3,0,14,mixedType,2
9,1,0,10,mixedType,1
4,2,0,6,mixedType,0
6,4,0,10,mixedType,1
6,3,0,9,mixedType,1
6,3,0,9,mixedType,1
6,1,0,7,mixedType,0
13,3,0,16,mixedType,2
8,2,0,10,mixedType,1
7,2,0,9,mixedType,1
4,4,0,8,mixedType,1
5,4,0,9,mixedType,1
8,3,0,11,mixedType,1
6,3,0,9,mixedType,1
8,2,0,10,mixedType,1
9,1,0,10,mixedType,1
4,2,0,6,mixedType,0
14,2,0,16,mixedType,2
3,5,0,8,mixedType,1
6,3,0,9,mixedType,1
3,0,0,3,sameType,0
6,3,0,9,mixedType,1
9,2,0,11,mixedType,1
5,3,0,8,mixedType,1
14,2,0,16,mixedType,2
6,3,0,9,mixedType,1
12,4,0,16,mixedType,2
5,2,0,7,mixedType,0
5,3,0,8,mixedType,1
7,1,0,8,mixedType,1
5,3,0,8,mixedType,1
5,3,0,8,mixedType,1
8,1,0,9,mixedType,1
5,7,0,12,mixedType,1
7,3,0,10,mixedType,1
11,0,1,12,mixedType,1
7,1,0,8,mixedType,1
5,4,0,9,mixedType,1
6,1,0,7,mixedType,0
2,9,0,11,mixedType,1
6,2,0,8,mixedType,1
7,3,0,10,mixedType,1
5,1,0,6,mixedType,0
5,2,0,7,mixedType,0
9,1,0,10,mixedType,1
5,3,0,8,mixedType,1
11,1,0,12,mixedType,1
7,4,0,11,mixedType,1
2,8,0,10,mixedType,1
5,3,0,8,mixedType,1
6,3,0,9,mixedType,1
13,3,0,16,mixedType,2
9,2,0,11,mixedType,1
8,2,0,10,mixedType,1
5,2,0,7,mixedType,0
14,2,0,16,mixedType,2
5,2,0,7,mixedType,0
6,1,0,7,mixedType,0
9,1,0,10,mixedType,1
7,3,0,10,mixedType,1
9,3,0,12,mixedType,1
6,1,0,7,mixedType,0
8,2,0,10,mixedType,1
9,1,0,10,mixedType,1
1,11,0,12,mixedType,1
4,4,0,8,mixedType,1
7,3,0,10,mixedType,1
13,3,0,16,mixedType,2
3,6,0,9,mixedType,1
7,3,0,10,mixedType,1
6,3,0,9,mixedType,1
12,3,0,15,mixedType,2
7,2,0,9,mixedType,1
10,3,0,13,mixedType,1
7,3,0,10,mixedType,1
6,0,1,7,mixedType,0
8,1,0,9,mixedType,1
6,3,0,9,mixedType,1
8,2,0,10,mixedType,1
8,2,0,10,mixedType,1
15,1,0,16,mixedType,2
6,1,0,7,mixedType,0
6,4,0,10,mixedType,1
8,3,0,11,mixedType,1
6,4,0,10,mixedType,1
3,3,0,6,mixedType,0
11,1,0,12,mixedType,1
4,4,0,8,mixedType,1
7,2,0,9,mixedType,1
7,2,0,9,mixedType,1
4,4,0,8,mixedType,1
6,6,0,12,mixedType,1
11,3,0,14,mixedType,2
7,4,0,11,mixedType,1
13,1,1,15,mixedType,2
7,3,0,10,mixedType,1
6,0,2,8,mixedType,0
6,1,0,7,mixedType,0
8,1,0,9,mixedType,1
14,2,0,16,mixedType,2
4,2,0,6,mixedType,0
5,3,0,8,mixedType,1
8,1,0,9,mixedType,1
5,4,0,9,mixedType,1
9,2,0,11,mixedType,1
5,4,0,9,mixedType,1
4,8,0,12,mixedType,1
12,4,0,16,mixedType,2
10,1,0,11,mixedType,1
2,7,0,9,mixedType,1
7,2,0,9,mixedType,1
3,3,0,6,mixedType,0
6,4,0,10,mixedType,1
6,2,0,8,mixedType,1
3,6,0,9,mixedType,1
1,9,0,10,mixedType,1
5,2,0,7,mixedType,0
3,6,0,9,mixedType,1
2,8,0,10,mixedType,1
7,4,0,11,mixedType,1
14,2,0,16,mixedType,2
9,3,0,12,mixedType,1
6,1,0,7,mixedType,0
6,1,0,7,mixedType,0
8,3,0,11,mixedType,1
8,2,0,10,mixedType,1
8,1,0,9,mixedType,1
8,4,0,12,mixedType,1
7,2,0,9,mixedType,1
6,3,0,9,mixedType,1
10,2,0,12,mixedType,1
5,2,0,7,mixedType,0
7,3,0,10,mixedType,1
8,2,0,10,mixedType,1
7,2,0,9,mixedType,1
8,2,0,10,mixedType,1
5,2,0,7,mixedType,0
15,1,0,16,mixedType,2
6,2,0,8,mixedType,1
4,4,0,8,mixedType,1
8,1,0,9,mixedType,1
7,1,0,8,mixedType,1
11,1,0,12,mixedType,1
12,1,0,13,mixedType,1
7,1,0,8,mixedType,1
6,3,0,9,mixedType,1
6,3,0,9,mixedType,1
6,2,0,8,mixedType,1
7,2,0,9,mixedType,1
6,2,0,8,mixedType,1
7,4,0,11,mixedType,1
6,4,0,10,mixedType,1
6,2,0,8,mixedType,1
9,1,0,10,mixedType,1
11,1,0,12,mixedType,1
6,2,0,8,mixedType,1
6,2,0,8,mixedType,1
6,1,0,7,mixedType,0
6,4,0,10,mixedType,1
8,2,0,10,mixedType,1
5,2,0,7,mixedType,0
6,4,0,10,mixedType,1
2,6,0,8,mixedType,1
7,2,0,9,mixedType,1
15,1,1,17,mixedType,2
4,2,0,6,mixedType,0
8,4,0,12,mixedType,1
5,2,0,7,mixedType,0
15,1,0,16,mixedType,2
5,4,0,9,mixedType,1
6,4,1,11,mixedType,1
7,2,0,9,mixedType,1
5,4,0,9,mixedType,1
8,1,0,9,mixedType,1
7,3,0,10,mixedType,1
5,3,0,8,mixedType,1
5,3,0,8,mixedType,1
8,4,0,12,mixedType,1
14,2,0,16,mixedType,2
9,1,0,10,mixedType,1
5,4,0,9,mixedType,1
6,3,0,9,mixedType,1
5,2,0,7,mixedType,0
6,1,0,7,mixedType,0
6,3,0,9,mixedType,1
6,3,0,9,mixedType,1
1,8,0,9,mixedType,1
6,2,0,8,mixedType,1
8,2,0,10,mixedType,1
2,6,0,8,mixedType,1
7,3,0,10,mixedType,1
10,1,0,11,mixedType,1
7,2,0,9,mixedType,1
8,2,0,10,mixedType,1
4,4,0,8,mixedType,1
6,2,0,8,mixedType,1
6,2,0,8,mixedType,1
7,2,0,9,mixedType,1
5,3,0,8,mixedType,1
12,3,0,15,mixedType,2
8,1,0,9,mixedType,1
5,2,0,7,mixedType,0
7,0,2,9,mixedType,1
7,2,0,9,mixedType,1
9,4,0,13,mixedType,1
5,3,0,8,mixedType,1
13,3,0,16,mixedType,2
9,3,0,12,mixedType,1
9,4,0,13,mixedType,1
3,3,0,6,mixedType,0
4,4,0,8,mixedType,1
8,2,0,10,mixedType,1
4,4,0,8,mixedType,1
8,4,0,12,mixedType,1
9,1,0,10,mixedType,1
7,2,0,9,mixedType,1
2,4,0,6,mixedType,0
13,4,0,17,mixedType,2
6,2,0,8,mixedType,1
5,7,0,12,mixedType,1
5,3,0,8,mixedType,1
6,3,0,9,mixedType,1
7,3,0,10,mixedType,1
7,1,0,8,mixedType,1
6,7,0,13,mixedType,1
6,3,0,9,mixedType,1
11,1,0,12,mixedType,1
10,3,0,13,mixedType,1
7,1,0,8,mixedType,1
6,3,0,9,mixedType,1
8,2,0,10,mixedType,1
8,4,0,12,mixedType,1
4,2,0,6,mixedType,0
7,2,0,9,mixedType,1
7,3,0,10,mixedType,1
6,4,0,10,mixedType,1
5,8,0,13,mixedType,1
4,4,0,8,mixedType,1
7,3,0,10,mixedType,1
7,3,0,10,mixedType,1
5,3,0,8,mixedType,1
5,3,0,8,mixedType,1
7,2,0,9,mixedType,1
7,2,0,9,mixedType,1
7,4,0,11,mixedType,1
9,1,0,10,mixedType,1
7,1,0,8,mixedType,1
7,3,0,10,mixedType,1
5,1,0,6,mixedType,0
13,3,0,16,mixedType,2
7,3,0,10,mixedType,1
5,3,0,8,mixedType,1
5,3,0,8,mixedType,1
6,4,0,10,mixedType,1
8,2,0,10,mixedType,1
5,4,0,9,mixedType,1
7,2,0,9,mixedType,1
5,1,0,6,mixedType,0
6,3,0,9,mixedType,1
13,2,0,15,mixedType,2
6,3,0,9,mixedType,1
8,1,0,9,mixedType,1
7,2,0,9,mixedType,1
4,6,0,10,mixedType,1
6,3,0,9,mixedType,1
5,5,0,10,mixedType,1
9,3,0,12,mixedType,1
6,1,0,7,mixedType,0
4,8,0,12,mixedType,1
7,3,0,10,mixedType,1
8,4,0,12,mixedType,1
8,2,0,10,mixedType,1
2,6,0,8,mixedType,1
7,2,0,9,mixedType,1
7,1,0,8,mixedType,1
6,1,0,7,mixedType,0
7,3,0,10,mixedType,1
4,6,0,10,mixedType,1
6,3,0,9,mixedType,1
8,1,0,9,mixedType,1
8,1,0,9,mixedType,1
14,2,0,16,mixedType,2
2,8,0,10,mixedType,1
7,1,0,8,mixedType,1
5,2,0,7,mixedType,0
1,8,0,9,mixedType,1
7,1,0,8,mixedType,1
9,5,0,14,mixedType,2
5,3,0,8,mixedType,1
6,4,0,10,mixedType,1
7,1,0,8,mixedType,1
8,1,0,9,mixedType,1
9,1,0,10,mixedType,1
7,4,0,11,mixedType,1
15,1,0,16,mixedType,2
6,6,0,12,mixedType,1
9,2,0,11,mixedType,1
12,1,0,13,mixedType,1
7,3,0,10,mixedType,1
6,3,0,9,mixedType,1
5,3,0,8,mixedType,1
5,4,0,9,mixedType,1
16,4,0,20,mixedType,2
6,4,0,10,mixedType,1
14,2,0,16,mixedType,2
7,3,0,10,mixedType,1
5,2,0,7,mixedType,0
7,4,0,11,mixedType,1
12,3,0,15,mixedType,2
7,3,0,10,mixedType,1
8,3,0,11,mixedType,1
9,3,0,12,mixedType,1
7,6,0,13,mixedType,1
6,1,0,7,mixedType,0
5,3,0,8,mixedType,1
5,3,0,8,mixedType,1
5,3,0,8,mixedType,1
9,1,0,10,mixedType,1
7,1,0,8,mixedType,1
11,1,1,13,mixedType,1
5,2,0,7,mixedType,0
2,8,0,10,mixedType,1
7,3,0,10,mixedType,1
2,6,0,8,mixedType,1
0,7,1,8,mixedType,1
4,2,0,6,mixedType,0
6,1,0,7,mixedType,0
15,1,0,16,mixedType,2
8,2,0,10,mixedType,1
6,1,0,7,mixedType,0
6,1,0,7,mixedType,0
8,2,0,10,mixedType,1
3,6,0,9,mixedType,1
15,1,0,16,mixedType,2
7,2,0,9,mixedType,1
9,3,0,12,mixedType,1
6,2,0,8,mixedType,1
3,6,0,9,mixedType,1
8,1,0,9,mixedType,1
3,8,0,11,mixedType,1
5,5,0,10,mixedType,1
5,2,0,7,mixedType,0
2,6,0,8,mixedType,1
5,3,0,8,mixedType,1
8,1,0,9,mixedType,1
3,6,0,9,mixedType,1
5,2,0,7,mixedType,0
12,3,0,15,mixedType,2
5,2,0,7,mixedType,0
15,1,0,16,mixedType,2
9,1,0,10,mixedType,1
9,2,0,11,mixedType,1
9,2,0,11,mixedType,1
9,1,0,10,mixedType,1
8,2,0,10,mixedType,1
8,1,0,9,mixedType,1
7,5,0,12,mixedType,1
7,2,0,9,mixedType,1
14,2,0,16,mixedType,2
8,2,0,10,mixedType,1
12,3,0,15,mixedType,2
2,6,0,8,mixedType,1
4,4,0,8,mixedType,1
6,3,0,9,mixedType,1
8,4,0,12,mixedType,1
7,2,0,9,mixedType,1
5,4,0,9,mixedType,1
14,2,0,16,mixedType,2
7,2,0,9,mixedType,1
12,4,0,16,mixedType,2
6,2,0,8,mixedType,1
7,3,0,10,mixedType,1
8,6,0,14,mixedType,2
14,2,0,16,mixedType,2
5,4,0,9,mixedType,1
3,6,0,9,mixedType,1
8,1,0,9,mixedType,1
2,4,0,6,mixedType,0
1,8,0,9,mixedType,1
9,2,0,11,mixedType,1
2,6,0,8,mixedType,1
6,4,0,10,mixedType,1
8,2,0,10,mixedType,1
6,1,0,7,mixedType,0
7,2,0,9,mixedType,1
8,1,0,9,mixedType,1
13,3,0,16,mixedType,2
9,1,0,10,mixedType,1
7,3,0,10,mixedType,1
1,7,0,8,mixedType,1
7,2,0,9,mixedType,1
6,6,0,12,mixedType,1
10,1,0,11,mixedType,1
9,2,0,11,mixedType,1
4,8,0,12,mixedType,1
5,1,0,6,mixedType,0
14,2,0,16,mixedType,2
11,1,0,12,mixedType,1
7,3,0,10,mixedType,1
9,1,0,10,mixedType,1
7,1,0,8,mixedType,1
1,8,0,9,mixedType,1
14,2,0,16,mixedType,2
5,3,0,8,mixedType,1
8,2,0,10,mixedType,1
2,7,0,9,mixedType,1
12,3,0,15,mixedType,2
10,1,0,11,mixedType,1
6,2,0,8,mixedType,1
8,8,0,16,mixedType,2
2,8,0,10,mixedType,1
6,4,0,10,mixedType,1
9,2,0,11,mixedType,1
5,3,0,8,mixedType,1
4,8,0,12,mixedType,1
7,3,0,10,mixedType,1
9,1,0,10,mixedType,1
8,1,0,9,mixedType,1
6,3,0,9,mixedType,1
7,2,0,9,mixedType,1
15,1,0,16,mixedType,2
11,2,0,13,mixedType,1
1,9,0,10,mixedType,1
6,1,0,7,mixedType,0
5,2,0,7,mixedType,0
5,4,0,9,mixedType,1
7,4,0,11,mixedType,1
7,2,0,9,mixedType,1
1,10,0,11,mixedType,1
3,6,0,9,mixedType,1
7,3,0,10,mixedType,1
9,1,0,10,mixedType,1
6,3,0,9,mixedType,1
15,1,0,16,mixedType,2
8,1,0,9,mixedType,1
6,3,0,9,mixedType,1
1,8,0,9,mixedType,1
5,2,0,7,mixedType,0
13,3,0,16,mixedType,2
6,2,0,8,mixedType,1
4,5,0,9,mixedType,1
13,3,0,16,mixedType,2
9,3,0,12,mixedType,1
3,7,0,10,mixedType,1
11,5,0,16,mixedType,2
5,3,0,8,mixedType,1
13,3,0,16,mixedType,2
14,2,0,16,mixedType,2
7,2,0,9,mixedType,1
7,3,0,10,mixedType,1
7,3,0,10,mixedType,1
6,2,0,8,mixedType,1
6,3,0,9,mixedType,1
6,2,0,8,mixedType,1
6,1,0,7,mixedType,0
7,3,0,10,mixedType,1
9,2,0,11,mixedType,1
1,8,0,9,mixedType,1
6,3,0,9,mixedType,1
6,4,0,10,mixedType,1
7,3,0,10,mixedType,1
14,1,0,15,mixedType,2
9,2,0,11,mixedType,1
14,2,0,16,mixedType,2
8,2,0,10,mixedType,1
8,4,0,12,mixedType,1
11,3,0,14,mixedType,2
4,6,0,10,mixedType,1
4,2,0,6,mixedType,0
5,3,0,8,mixedType,1
6,1,0,7,mixedType,0
15,1,0,16,mixedType,2
8,2,0,10,mixedType,1
5,3,0,8,mixedType,1
6,4,0,10,mixedType,1
5,2,0,7,mixedType,0
5,3,0,8,mixedType,1
6,3,0,9,mixedType,1
6,3,0,9,mixedType,1
7,2,0,9,mixedType,1
6,1,0,7,mixedType,0
1,11,0,12,mixedType,1
6,3,0,9,mixedType,1
3,3,0,6,mixedType,0
6,4,0,10,mixedType,1
4,2,0,6,mixedType,0
9,3,0,12,mixedType,1
8,2,0,10,mixedType,1
1,8,0,9,mixedType,1
6,4,0,10,mixedType,1
7,2,0,9,mixedType,1
5,3,0,8,mixedType,1
8,4,0,12,mixedType,1
4,6,0,10,mixedType,1
7,3,0,10,mixedType,1
7,3,0,10,mixedType,1
5,3,0,8,mixedType,1
11,3,0,14,mixedType,2
4,8,0,12,mixedType,1
2,8,0,10,mixedType,1
5,2,0,7,mixedType,0
6,3,0,9,mixedType,1
5,5,0,10,mixedType,1
4,6,0,10,mixedType,1
4,2,0,6,mixedType,0
7,1,0,8,mixedType,1
5,8,0,13,mixedType,1
7,5,0,12,mixedType,1
8,2,0,10,mixedType,1
14,2,0,16,mixedType,2
5,2,0,7,mixedType,0
8,1,0,9,mixedType,1
1,9,0,10,mixedType,1
4,4,0,8,mixedType,1
8,3,0,11,mixedType,1
6,1,0,7,mixedType,0
14,2,0,16,mixedType,2
9,2,0,11,mixedType,1
5,4,0,9,mixedType,1
6,3,0,9,mixedType,1
15,1,0,16,mixedType,2
3,6,0,9,mixedType,1
9,9,0,18,mixedType,2
4,4,0,8,mixedType,1
6,1,0,7,mixedType,0
6,2,0,8,mixedType,1
6,2,0,8,mixedType,1
6,8,0,14,mixedType,2
2,4,0,6,mixedType,0
6,3,0,9,mixedType,1
8,4,0,12,mixedType,1
6,1,0,7,mixedType,0
9,3,0,12,mixedType,1
7,2,0,9,mixedType,1
9,2,0,11,mixedType,1
7,3,0,10,mixedType,1
1,7,0,8,mixedType,1
5,2,0,7,mixedType,0
14,2,0,16,mixedType,2
13,3,0,16,mixedType,2
9,3,0,12,mixedType,1
13,3,0,16,mixedType,2
9,2,0,11,mixedType,1
5,2,0,7,mixedType,0
5,6,0,11,mixedType,1
7,2,0,9,mixedType,1
2,4,0,6,mixedType,0
9,1,0,10,mixedType,1
2,4,0,6,mixedType,0
3,7,0,10,mixedType,1
5,2,0,7,mixedType,0
5,2,0,7,mixedType,0
7,2,0,9,mixedType,1
5,1,0,6,mixedType,0
5,3,0,8,mixedType,1
9,3,0,12,mixedType,1
3,8,0,11,mixedType,1
7,1,0,8,mixedType,1
3,6,0,9,mixedType,1
8,4,0,12,mixedType,1
4,4,0,8,mixedType,1
6,3,0,9,mixedType,1
9,4,0,13,mixedType,1
5,2,0,7,mixedType,0
5,7,0,12,mixedType,1
6,4,0,10,mixedType,1
2,7,0,9,mixedType,1
11,3,0,14,mixedType,2
6,3,0,9,mixedType,1
15,1,0,16,mixedType,2
10,4,0,14,mixedType,2
8,2,0,10,mixedType,1
5,2,0,7,mixedType,0
4,4,0,8,mixedType,1
8,1,0,9,mixedType,1
9,2,0,11,mixedType,1
7,3,0,10,mixedType,1
7,2,0,9,mixedType,1
4,2,0,6,mixedType,0
13,3,0,16,mixedType,2
6,2,0,8,mixedType,1
4,4,0,8,mixedType,1
9,1,0,10,mixedType,1
2,9,0,11,mixedType,1
3,8,0,11,mixedType,1
7,5,0,12,mixedType,1
4,6,0,10,mixedType,1
2,6,0,8,mixedType,1
8,2,0,10,mixedType,1
7,1,0,8,mixedType,1
5,3,0,8,mixedType,1
10,2,0,12,mixedType,1
6,2,0,8,mixedType,1
8,2,0,10,mixedType,1
10,2,0,12,mixedType,1
10,3,0,13,mixedType,1
2,4,0,6,mixedType,0
4,4,0,8,mixedType,1
4,4,0,8,mixedType,1
4,4,0,8,mixedType,1
5,3,0,8,mixedType,1
6,2,0,8,mixedType,1
7,4,0,11,mixedType,1
12,4,0,16,mixedType,2
8,4,0,12,mixedType,1
7,2,0,9,mixedType,1
8,3,0,11,mixedType,1
7,3,0,10,mixedType,1
7,3,0,10,mixedType,1
3,3,0,6,mixedType,0
6,2,0,8,mixedType,1
6,3,0,9,mixedType,1
6,3,0,9,mixedType,1
7,2,0,9,mixedType,1
14,2,0,16,mixedType,2
4,6,0,10,mixedType,1
6,3,0,9,mixedType,1
14,2,0,16,mixedType,2
12,3,0,15,mixedType,2
5,1,0,6,mixedType,0
7,6,0,13,mixedType,1
11,3,0,14,mixedType,2
7,1,0,8,mixedType,1
10,10,0,20,mixedType,2
6,3,0,9,mixedType,1
1,9,0,10,mixedType,1
5,2,0,7,mixedType,0
7,3,0,10,mixedType,1
5,2,0,7,mixedType,0
6,3,0,9,mixedType,1
13,3,0,16,mixedType,2
9,3,0,12,mixedType,1
16,1,1,18,mixedType,2
14,2,0,16,mixedType,2
5,4,0,9,mixedType,1
9,3,0,12,mixedType,1
9,1,0,10,mixedType,1
12,4,0,16,mixedType,2
14,2,0,16,mixedType,2
7,2,0,9,mixedType,1
5,8,0,13,mixedType,1
8,2,0,10,mixedType,1
6,1,0,7,mixedType,0
13,3,0,16,mixedType,2
5,5,0,10,mixedType,1
7,2,0,9,mixedType,1
9,4,0,13,mixedType,1
6,1,0,7,mixedType,0
7,2,0,9,mixedType,1
6,2,0,8,mixedType,1
6,1,0,7,mixedType,0
7,3,0,10,mixedType,1
7,2,0,9,mixedType,1
9,4,0,13,mixedType,1
5,4,0,9,mixedType,1
7,1,0,8,mixedType,1
7,5,0,12,mixedType,1
5,3,0,8,mixedType,1
5,4,0,9,mixedType,1
5,4,0,9,mixedType,1
12,3,0,15,mixedType,2
3,3,0,6,mixedType,0
6,1,0,7,mixedType,0
7,3,0,10,mixedType,1
10,1,0,11,mixedType,1
6,3,0,9,mixedType,1
8,3,0,11,mixedType,1
6,1,0,7,mixedType,0
11,3,0,14,mixedType,2
5,3,0,8,mixedType,1
1,8,0,9,mixedType,1
6,1,0,7,mixedType,0
8,2,0,10,mixedType,1
7,3,0,10,mixedType,1
8,2,0,10,mixedType,1
4,2,0,6,mixedType,0
2,4,0,6,mixedType,0
6,3,0,9,mixedType,1
4,4,0,8,mixedType,1
7,1,0,8,mixedType,1
5,4,0,9,mixedType,1
7,2,0,9,mixedType,1
7,3,0,10,mixedType,1
7,1,0,8,mixedType,1
3,3,0,6,mixedType,0
5,4,0,9,mixedType,1
6,1,0,7,mixedType,0
6,2,0,8,mixedType,1
8,4,0,12,mixedType,1
7,3,0,10,mixedType,1
5,1,0,6,mixedType,0
11,2,0,13,mixedType,1
14,2,0,16,mixedType,2
8,1,0,9,mixedType,1
8,2,0,10,mixedType,1
7,3,0,10,mixedType,1
5,6,0,11,mixedType,1
6,3,0,9,mixedType,1
5,4,0,9,mixedType,1
8,3,0,11,mixedType,1
8,3,0,11,mixedType,1
4,4,0,8,mixedType,1
8,4,0,12,mixedType,1
10,4,0,14,mixedType,2
9,1,0,10,mixedType,1
10,6,0,16,mixedType,2
9,3,0,12,mixedType,1
4,5,0,9,mixedType,1
4,4,0,8,mixedType,1
4,2,0,6,mixedType,0
5,1,0,6,mixedType,0
7,3,0,10,mixedType,1
8,2,0,10,mixedType,1
6,3,0,9,mixedType,1
7,2,0,9,mixedType,1
10,2,0,12,mixedType,1
4,4,0,8,mixedType,1
6,1,0,7,mixedType,0
4,2,0,6,mixedType,0
7,2,0,9,mixedType,1
5,8,0,13,mixedType,1
9,1,0,10,mixedType,1
7,2,0,9,mixedType,1
14,2,0,16,mixedType,2
8,1,0,9,mixedType,1
9,1,0,10,mixedType,1
3,6,0,9,mixedType,1
6,3,0,9,mixedType,1
8,3,0,11,mixedType,1
6,1,0,7,mixedType,0
6,3,0,9,mixedType,1
7,2,0,9,mixedType,1
9,1,0,10,mixedType,1
5,1,0,6,mixedType,0
8,3,0,11,mixedType,1
1,7,0,8,mixedType,1
6,3,0,9,mixedType,1
9,1,0,10,mixedType,1
6,3,0,9,mixedType,1
9,0,1,10,mixedType,1
6,4,0,10,mixedType,1
7,5,0,12,mixedType,1
8,2,0,10,mixedType,1
8,2,0,10,mixedType,1
6,6,0,12,mixedType,1
4,6,0,10,mixedType,1
4,5,0,9,mixedType,1
4,2,0,6,mixedType,0
6,5,0,11,mixedType,1
1,5,0,6,mixedType,0
5,3,0,8,mixedType,1
6,4,0,10,mixedType,1
5,4,0,9,mixedType,1
6,3,0,9,mixedType,1
9,2,0,11,mixedType,1
7,3,0,10,mixedType,1
7,3,0,10,mixedType,1
8,3,0,11,mixedType,1
6,2,0,8,mixedType,1
6,1,0,7,mixedType,0
21,1,2,24,mixedType,2
6,3,0,9,mixedType,1
2,6,0,8,mixedType,1
5,5,0,10,mixedType,1
4,5,0,9,mixedType,1
3,5,0,8,mixedType,1
5,5,0,10,mixedType,1
2,6,0,8,mixedType,1
9,2,0,11,mixedType,1
5,3,0,8,mixedType,1
4,4,0,8,mixedType,1
4,8,0,12,mixedType,1
2,7,0,9,mixedType,1
6,3,0,9,mixedType,1
7,3,0,10,mixedType,1
5,2,0,7,mixedType,0
5,2,0,7,mixedType,0
5,2,0,7,mixedType,0
9,4,0,13,mixedType,1
7,3,0,10,mixedType,1
7,3,0,10,mixedType,1
5,2,0,7,mixedType,0
6,4,0,10,mixedType,1
7,1,0,8,mixedType,1
6,3,0,9,mixedType,1
6,4,0,10,mixedType,1
10,3,0,13,mixedType,1
13,2,0,15,mixedType,2
9,1,0,10,mixedType,1
6,4,0,10,mixedType,1
7,3,0,10,mixedType,1
12,3,0,15,mixedType,2
7,3,0,10,mixedType,1
5,1,0,6,mixedType,0
5,3,0,8,mixedType,1
6,1,0,7,mixedType,0
8,6,0,14,mixedType,2
1,8,0,9,mixedType,1
5,6,0,11,mixedType,1
5,3,0,8,mixedType,1
6,4,0,10,mixedType,1
8,2,0,10,mixedType,1
6,4,0,10,mixedType,1
3,6,0,9,mixedType,1
7,6,0,13,mixedType,1
6,3,0,9,mixedType,1
5,3,0,8,mixedType,1
6,4,0,10,mixedType,1
7,2,0,9,mixedType,1
10,3,0,13,mixedType,1
5,2,0,7,mixedType,0
6,3,0,9,mixedType,1
7,1,0,8,mixedType,1
5,3,0,8,mixedType,1
6,4,0,10,mixedType,1
3,5,0,8,mixedType,1
6,4,0,10,mixedType,1
7,1,0,8,mixedType,1
3,6,0,9,mixedType,1
4,5,0,9,mixedType,1
4,4,0,8,mixedType,1
3,10,0,13,mixedType,1
7,3,0,10,mixedType,1
13,3,0,16,mixedType,2
4,4,0,8,mixedType,1
7,1,0,8,mixedType,1
6,3,0,9,mixedType,1
6,1,0,7,mixedType,0
7,3,0,10,mixedType,1
1,7,0,8,mixedType,1
2,8,0,10,mixedType,1
5,3,0,8,mixedType,1
7,3,0,10,mixedType,1
6,6,0,12,mixedType,1
6,6,0,12,mixedType,1
10,4,0,14,mixedType,2
7,3,0,10,mixedType,1
2,9,0,11,mixedType,1
8,1,0,9,mixedType,1
6,4,0,10,mixedType,1
7,2,0,9,mixedType,1
1,7,0,8,mixedType,1
1,7,0,8,mixedType,1
8,2,0,10,mixedType,1
5,3,0,8,mixedType,1
10,2,0,12,mixedType,1
5,3,0,8,mixedType,1
6,3,0,9,mixedType,1
6,1,0,7,mixedType,0
5,2,0,7,mixedType,0
1,9,0,10,mixedType,1
4,2,0,6,mixedType,0
4,5,0,9,mixedType,1
6,1,0,7,mixedType,0
7,4,0,11,mixedType,1
5,2,0,7,mixedType,0
1,8,0,9,mixedType,1
8,1,0,9,mixedType,1
6,5,0,11,mixedType,1
15,1,0,16,mixedType,2
11,2,0,13,mixedType,1
6,3,0,9,mixedType,1
9,1,0,10,mixedType,1
6,3,0,9,mixedType,1
8,2,0,10,mixedType,1
9,0,1,10,mixedType,1
7,3,0,10,mixedType,1
4,5,0,9,mixedType,1
7,2,0,9,mixedType,1
5,3,0,8,mixedType,1
6,6,0,12,mixedType,1
7,3,0,10,mixedType,1
9,2,0,11,mixedType,1
6,1,0,7,mixedType,0
7,1,0,8,mixedType,1
7,2,0,9,mixedType,1
6,6,0,12,mixedType,1
7,2,0,9,mixedType,1
4,6,0,10,mixedType,1
6,2,0,8,mixedType,1
6,3,0,9,mixedType,1
5,4,0,9,mixedType,1
10,2,0,12,mixedType,1
8,3,0,11,mixedType,1
7,3,0,10,mixedType,1
5,1,0,6,mixedType,0
5,3,0,8,mixedType,1
8,2,0,10,mixedType,1
8,2,0,10,mixedType,1
8,1,0,9,mixedType,1
8,3,0,11,mixedType,1
4,4,0,8,mixedType,1
7,2,0,9,mixedType,1
13,3,0,16,mixedType,2
6,2,0,8,mixedType,1
18,2,0,20,mixedType,2
9,1,0,10,mixedType,1
7,3,0,10,mixedType,1
6,4,0,10,mixedType,1
5,1,0,6,mixedType,0
5,3,0,8,mixedType,1
1,8,0,9,mixedType,1
7,1,0,8,mixedType,1
6,3,0,9,mixedType,1
5,3,0,8,mixedType,1
5,2,0,7,mixedType,0
10,2,0,12,mixedType,1
11,5,0,16,mixedType,2
5,3,0,8,mixedType,1
15,1,0,16,mixedType,2
2,6,0,8,mixedType,1
7,2,0,9,mixedType,1
4,2,0,6,mixedType,0
7,1,0,8,mixedType,1
7,3,0,10,mixedType,1
8,2,0,10,mixedType,1
7,2,0,9,mixedType,1
4,4,0,8,mixedType,1
6,1,0,7,mixedType,0
10,2,0,12,mixedType,1
4,6,0,10,mixedType,1
5,2,0,7,mixedType,0
4,4,0,8,mixedType,1
6,4,0,10,mixedType,1
7,4,0,11,mixedType,1
5,3,0,8,mixedType,1
7,6,0,13,mixedType,1
6,2,0,8,mixedType,1
8,1,0,9,mixedType,1
6,3,0,9,mixedType,1
9,2,0,11,mixedType,1
7,2,0,9,mixedType,1
5,1,0,6,mixedType,0
6,4,0,10,mixedType,1
13,3,0,16,mixedType,2
7,2,0,9,mixedType,1
7,2,0,9,mixedType,1
12,3,0,15,mixedType,2
5,1,0,6,mixedType,0
6,3,0,9,mixedType,1
15,1,0,16,mixedType,2
8,2,0,10,mixedType,1
4,8,0,12,mixedType,1
7,1,0,8,mixedType,1
8,2,0,10,mixedType,1
2,6,0,8,mixedType,1
4,4,0,8,mixedType,1
14,2,0,16,mixedType,2
13,3,0,16,mixedType,2
6,3,0,9,mixedType,1
3,5,0,8,mixedType,1
7,3,0,10,mixedType,1
8,4,0,12,mixedType,1
6,3,0,9,mixedType,1
6,3,0,9,mixedType,1
4,9,0,13,mixedType,1
7,1,0,8,mixedType,1
3,5,0,8,mixedType,1
9,4,0,13,mixedType,1
8,2,0,10,mixedType,1
4,8,0,12,mixedType,1
9,1,0,10,mixedType,1
8,1,0,9,mixedType,1
6,4,0,10,mixedType,1
7,2,0,9,mixedType,1
3,5,0,8,mixedType,1
6,3,0,9,mixedType,1
7,3,0,10,mixedType,1
14,2,0,16,mixedType,2
14,2,0,16,mixedType,2
5,3,0,8,mixedType,1
4,4,0,8,mixedType,1
6,2,0,8,mixedType,1
9,1,0,10,mixedType,1
5,4,0,9,mixedType,1
5,2,0,7,mixedType,0
11,1,0,12,mixedType,1
5,4,0,9,mixedType,1
6,1,0,7,mixedType,0
5,3,0,8,mixedType,1
7,2,0,9,mixedType,1
9,3,0,12,mixedType,1
4,7,0,11,mixedType,1
1,6,0,7,mixedType,0
8,1,0,9,mixedType,1
4,2,0,6,mixedType,0
6,3,0,9,mixedType,1
6,2,0,8,mixedType,1
4,7,0,11,mixedType,1
3,10,0,13,mixedType,1
6,2,0,8,mixedType,1
6,1,0,7,mixedType,0
14,2,0,16,mixedType,2
9,4,0,13,mixedType,1
6,1,0,7,mixedType,0
10,2,0,12,mixedType,1
4,6,0,10,mixedType,1
9,3,0,12,mixedType,1
7,3,0,10,mixedType,1
4,6,0,10,mixedType,1
10,0,1,11,mixedType,1
8,6,0,14,mixedType,2
3,6,0,9,mixedType,1
8,2,0,10,mixedType,1
7,1,0,8,mixedType,1
6,4,0,10,mixedType,1
4,4,0,8,mixedType,1
3,6,0,9,mixedType,1
6,2,0,8,mixedType,1
2,4,0,6,mixedType,0
5,1,0,6,mixedType,0
7,4,0,11,mixedType,1
2,7,0,9,mixedType,1
4,7,0,11,mixedType,1
5,3,0,8,mixedType,1
0,3,3,6,mixedType,0
7,4,0,11,mixedType,1
12,1,0,13,mixedType,1
5,2,0,7,mixedType,0
0,8,1,9,mixedType,1
4,4,0,8,mixedType,1
7,3,0,10,mixedType,1
6,3,0,9,mixedType,1
7,5,0,12,mixedType,1
7,3,0,10,mixedType,1
9,2,0,11,mixedType,1
14,2,0,16,mixedType,2
14,2,0,16,mixedType,2
8,3,0,11,mixedType,1
7,3,0,10,mixedType,1
9,2,0,11,mixedType,1
1,7,0,8,mixedType,1
5,2,0,7,mixedType,0
5,4,0,9,mixedType,1
8,1,0,9,mixedType,1
5,6,0,11,mixedType,1
9,1,0,10,mixedType,1
8,2,0,10,mixedType,1
6,4,0,10,mixedType,1
6,4,0,10,mixedType,1
3,10,0,13,mixedType,1
13,3,0,16,mixedType,2
5,2,0,7,mixedType,0
6,1,0,7,mixedType,0
8,1,0,9,mixedType,1
5,2,0,7,mixedType,0
5,4,0,9,mixedType,1
9,3,0,12,mixedType,1
5,2,0,7,mixedType,0
14,2,0,16,mixedType,2
4,4,0,8,mixedType,1
6,4,0,10,mixedType,1
6,1,0,7,mixedType,0
8,2,0,10,mixedType,1
7,4,0,11,mixedType,1
10,4,0,14,mixedType,2
6,3,0,9,mixedType,1
5,4,0,9,mixedType,1
7,3,0,10,mixedType,1
5,3,0,8,mixedType,1
6,4,0,10,mixedType,1
7,3,0,10,mixedType,1
3,7,0,10,mixedType,1
4,4,0,8,mixedType,1
6,2,0,8,mixedType,1
7,1,0,8,mixedType,1
6,3,0,9,mixedType,1
6,3,0,9,mixedType,1
8,1,0,9,mixedType,1
6,2,0,8,mixedType,1
14,2,0,16,mixedType,2
13,3,0,16,mixedType,2
5,3,0,8,mixedType,1
15,1,0,16,mixedType,2
7,3,0,10,mixedType,1
6,3,0,9,mixedType,1
4,6,0,10,mixedType,1
9,1,0,10,mixedType,1
7,3,0,10,mixedType,1
7,3,0,10,mixedType,1
5,4,0,9,mixedType,1
6,1,0,7,mixedType,0
2,9,0,11,mixedType,1
10,3,0,13,mixedType,1
16,1,0,17,mixedType,2
11,1,0,12,mixedType,1
9,4,0,13,mixedType,1
13,3,0,16,mixedType,2
7,1,0,8,mixedType,1
5,4,0,9,mixedType,1
10,3,0,13,mixedType,1
7,3,0,10,mixedType,1
13,3,0,16,mixedType,2
2,6,0,8,mixedType,1
7,3,0,10,mixedType,1
1,5,0,6,mixedType,0
7,2,0,9,mixedType,1
6,1,0,7,mixedType,0
5,3,0,8,mixedType,1
14,2,0,16,mixedType,2
8,2,0,10,mixedType,1
7,3,0,10,mixedType,1
7,3,0,10,mixedType,1
1,8,0,9,mixedType,1
9,2,0,11,mixedType,1
5,1,0,6,mixedType,0
7,2,0,9,mixedType,1
4,4,0,8,mixedType,1
5,0,2,7,mixedType,0
3,6,0,9,mixedType,1
3,6,0,9,mixedType,1
1,10,0,11,mixedType,1
9,3,0,12,mixedType,1
5,4,0,9,mixedType,1
7,3,0,10,mixedType,1
6,2,0,8,mixedType,1
7,4,0,11,mixedType,1
4,5,0,9,mixedType,1
14,2,0,16,mixedType,2
4,6,0,10,mixedType,1
2,6,0,8,mixedType,1
6,2,0,8,mixedType,1
6,2,0,8,mixedType,1
9,3,0,12,mixedType,1
6,1,0,7,mixedType,0
9,2,0,11,mixedType,1
8,2,0,10,mixedType,1
6,2,0,8,mixedType,1
7,3,0,10,mixedType,1
8,2,0,10,mixedType,1
5,3,0,8,mixedType,1
7,3,0,10,mixedType,1
15,1,0,16,mixedType,2
8,2,0,10,mixedType,1
7,1,0,8,mixedType,1
3,6,0,9,mixedType,1
10,1,0,11,mixedType,1
9,2,0,11,mixedType,1
5,2,0,7,mixedType,0
14,2,0,16,mixedType,2
11,5,0,16,mixedType,2
8,4,0,12,mixedType,1
6,3,0,9,mixedType,1
6,3,0,9,mixedType,1
6,3,0,9,mixedType,1
4,6,0,10,mixedType,1
8,1,0,9,mixedType,1
5,4,0,9,mixedType,1
5,2,0,7,mixedType,0
11,3,0,14,mixedType,2
6,4,0,10,mixedType,1
6,2,0,8,mixedType,1
6,6,0,12,mixedType,1
8,2,0,10,mixedType,1
4,4,0,8,mixedType,1
8,1,0,9,mixedType,1
7,3,0,10,mixedType,1
7,1,0,8,mixedType,1
4,4,0,8,mixedType,1
11,3,0,14,mixedType,2
5,8,0,13,mixedType,1
4,2,0,6,mixedType,0
6,1,0,7,mixedType,0
8,1,0,9,mixedType,1
3,6,0,9,mixedType,1
8,1,0,9,mixedType,1
7,1,0,8,mixedType,1
14,2,0,16,mixedType,2
4,4,0,8,mixedType,1
8,2,0,10,mixedType,1
6,1,0,7,mixedType,0
5,1,0,6,mixedType,0
8,4,0,12,mixedType,1
6,3,0,9,mixedType,1
6,3,0,9,mixedType,1
7,6,0,13,mixedType,1
7,2,0,9,mixedType,1
6,2,0,8,mixedType,1
4,8,0,12,mixedType,1
15,1,0,16,mixedType,2
6,0,0,6,sameType,0
7,1,0,8,mixedType,1
8,1,0,9,mixedType,1
7,1,0,8,mixedType,1
7,1,0,8,mixedType,1
7,2,0,9,mixedType,1
11,2,0,13,mixedType,1
14,2,0,16,mixedType,2
4,5,0,9,mixedType,1
6,6,0,12,mixedType,1
6,4,0,10,mixedType,1
6,4,0,10,mixedType,1
6,3,0,9,mixedType,1
4,6,0,10,mixedType,1
8,2,0,10,mixedType,1
2,8,0,10,mixedType,1
5,4,0,9,mixedType,1
5,4,0,9,mixedType,1
6,4,0,10,mixedType,1
5,3,0,8,mixedType,1
4,6,0,10,mixedType,1
6,3,0,9,mixedType,1
7,6,0,13,mixedType,1
7,2,0,9,mixedType,1
11,5,0,16,mixedType,2
6,2,0,8,mixedType,1
7,2,0,9,mixedType,1
10,6,0,16,mixedType,2
6,1,0,7,mixedType,0
11,9,1,21,mixedType,2
7,2,0,9,mixedType,1
7,3,0,10,mixedType,1
4,4,0,8,mixedType,1
5,3,0,8,mixedType,1
6,7,0,13,mixedType,1
3,8,0,11,mixedType,1
13,3,0,16,mixedType,2
12,6,0,18,mixedType,2
7,3,0,10,mixedType,1
8,1,0,9,mixedType,1
12,4,0,16,mixedType,2
8,1,0,9,mixedType,1
12,3,0,15,mixedType,2
6,1,0,7,mixedType,0
9,2,0,11,mixedType,1
13,3,0,16,mixedType,2
18,4,2,24,mixedType,2
6,3,0,9,mixedType,1
4,4,0,8,mixedType,1
8,1,0,9,mixedType,1
8,1,0,9,mixedType,1
2,6,0,8,mixedType,1
5,2,0,7,mixedType,0
5,6,0,11,mixedType,1
1,8,0,9,mixedType,1
8,2,0,10,mixedType,1
4,2,0,6,mixedType,0
7,3,0,10,mixedType,1
9,1,0,10,mixedType,1
7,2,0,9,mixedType,1
10,2,0,12,mixedType,1
12,4,0,16,mixedType,2
6,1,0,7,mixedType,0
7,3,0,10,mixedType,1
6,2,0,8,mixedType,1
4,2,0,6,mixedType,0
11,1,0,12,mixedType,1
8,1,0,9,mixedType,1
9,1,0,10,mixedType,1
7,2,0,9,mixedType,1
6,1,0,7,mixedType,0
5,1,0,6,mixedType,0
6,4,0,10,mixedType,1
4,8,0,12,mixedType,1
3,6,0,9,mixedType,1
8,1,0,9,mixedType,1
5,4,0,9,mixedType,1
7,2,0,9,mixedType,1
5,3,0,8,mixedType,1
8,1,0,9,mixedType,1
2,9,0,11,mixedType,1
6,1,0,7,mixedType,0
1,10,0,11,mixedType,1
9,1,0,10,mixedType,1
5,5,0,10,mixedType,1
5,8,0,13,mixedType,1
6,3,0,9,mixedType,1
5,3,0,8,mixedType,1
1,9,0,10,mixedType,1
7,2,0,9,mixedType,1
5,2,0,7,mixedType,0
1,9,0,10,mixedType,1
5,4,0,9,mixedType,1
12,3,0,15,mixedType,2
4,4,0,8,mixedType,1
6,4,0,10,mixedType,1
7,2,0,9,mixedType,1
3,7,0,10,mixedType,1
2,4,0,6,mixedType,0
8,2,0,10,mixedType,1
6,2,0,8,mixedType,1
5,2,0,7,mixedType,0
5,4,0,9,mixedType,1
14,2,0,16,mixedType,2
1,9,0,10,mixedType,1
8,3,0,11,mixedType,1
1,5,0,6,mixedType,0
6,2,0,8,mixedType,1
2,10,0,12,mixedType,1
6,4,0,10,mixedType,1
2,6,0,8,mixedType,1
8,1,0,9,mixedType,1
3,6,0,9,mixedType,1
7,2,0,9,mixedType,1
7,6,0,13,mixedType,1
8,1,0,9,mixedType,1
7,4,0,11,mixedType,1
4,4,0,8,mixedType,1
7,12,0,19,mixedType,2
8,1,0,9,mixedType,1
6,2,0,8,mixedType,1
7,4,0,11,mixedType,1
6,4,0,10,mixedType,1
8,2,0,10,mixedType,1
5,2,0,7,mixedType,0
14,2,0,16,mixedType,2
4,5,0,9,mixedType,1
5,2,0,7,mixedType,0
10,2,0,12,mixedType,1
3,9,0,12,mixedType,1
4,2,0,6,mixedType,0
3,5,0,8,mixedType,1
12,3,0,15,mixedType,2
8,1,0,9,mixedType,1
8,0,1,9,mixedType,1
8,2,0,10,mixedType,1
8,2,0,10,mixedType,1
5,1,0,6,mixedType,0
13,3,0,16,mixedType,2
7,3,0,10,mixedType,1
6,1,0,7,mixedType,0
8,2,0,10,mixedType,1
14,2,0,16,mixedType,2
14,2,0,16,mixedType,2
6,3,0,9,mixedType,1
4,6,0,10,mixedType,1
6,5,0,11,mixedType,1
9,1,0,10,mixedType,1
7,3,0,10,mixedType,1
2,6,0,8,mixedType,1
5,3,0,8,mixedType,1
6,1,0,7,mixedType,0
3,3,0,6,mixedType,0
5,3,0,8,mixedType,1
8,2,0,10,mixedType,1
2,8,0,10,mixedType,1
7,2,0,9,mixedType,1
15,1,0,16,mixedType,2
5,6,0,11,mixedType,1
6,4,0,10,mixedType,1
6,1,0,7,mixedType,0
1,7,0,8,mixedType,1
5,2,0,7,mixedType,0
5,6,0,11,mixedType,1
5,2,0,7,mixedType,0
11,4,2,17,mixedType,2
3,6,0,9,mixedType,1
4,4,0,8,mixedType,1
6,2,0,8,mixedType,1
9,2,0,11,mixedType,1
7,1,0,8,mixedType,1
4,6,0,10,mixedType,1
3,6,0,9,mixedType,1
4,6,0,10,mixedType,1
6,2,0,8,mixedType,1
11,1,0,12,mixedType,1
4,4,0,8,mixedType,1
8,1,0,9,mixedType,1
10,1,0,11,mixedType,1
3,3,0,6,mixedType,0
8,4,0,12,mixedType,1
2,7,0,9,mixedType,1
6,3,0,9,mixedType,1
6,1,0,7,mixedType,0
6,3,0,9,mixedType,1
8,2,0,10,mixedType,1
5,4,0,9,mixedType,1
6,2,0,8,mixedType,1
10,2,0,12,mixedType,1
6,4,0,10,mixedType,1
6,4,0,10,mixedType,1
4,2,0,6,mixedType,0
7,1,0,8,mixedType,1
4,2,0,6,mixedType,0
5,4,0,9,mixedType,1
9,2,0,11,mixedType,1
6,2,0,8,mixedType,1
6,2,0,8,mixedType,1
3,8,0,11,mixedType,1
3,5,0,8,mixedType,1
5,4,0,9,mixedType,1
14,2,0,16,mixedType,2
6,2,0,8,mixedType,1
9,1,0,10,mixedType,1
12,1,0,13,mixedType,1
5,3,0,8,mixedType,1
15,1,0,16,mixedType,2
5,3,0,8,mixedType,1
5,4,0,9,mixedType,1
6,2,0,8,mixedType,1
12,3,0,15,mixedType,2
6,1,0,7,mixedType,0
3,6,0,9,mixedType,1
11,3,0,14,mixedType,2
6,3,0,9,mixedType,1
13,3,0,16,mixedType,2
5,4,0,9,mixedType,1
7,2,0,9,mixedType,1
5,2,0,7,mixedType,0
6,1,0,7,mixedType,0
7,2,0,9,mixedType,1
3,5,0,8,mixedType,1
7,2,0,9,mixedType,1
8,2,0,10,mixedType,1
9,1,0,10,mixedType,1
3,7,0,10,mixedType,1
7,2,0,9,mixedType,1
9,1,0,10,mixedType,1
7,2,0,9,mixedType,1
6,4,0,10,mixedType,1
13,3,0,16,mixedType,2
11,3,0,14,mixedType,2
4,4,0,8,mixedType,1
7,2,0,9,mixedType,1
6,2,0,8,mixedType,1
3,5,0,8,mixedType,1
5,3,0,8,mixedType,1
12,3,0,15,mixedType,2
6,3,0,9,mixedType,1
7,2,0,9,mixedType,1
7,3,0,10,mixedType,1
7,1,0,8,mixedType,1
6,2,0,8,mixedType,1
4,4,0,8,mixedType,1
6,1,0,7,mixedType,0
8,2,0,10,mixedType,1
5,3,0,8,mixedType,1
5,4,0,9,mixedType,1
9,1,0,10,mixedType,1
5,5,0,10,mixedType,1
3,6,0,9,mixedType,1
0,8,0,8,sameType,1
13,3,0,16,mixedType,2
4,2,0,6,mixedType,0
7,3,0,10,mixedType,1
6,4,0,10,mixedType,1
8,1,0,9,mixedType,1
8,1,0,9,mixedType,1
7,3,0,10,mixedType,1
6,2,0,8,mixedType,1
10,2,0,12,mixedType,1
12,4,0,16,mixedType,2
9,1,0,10,mixedType,1
8,2,0,10,mixedType,1
5,2,0,7,mixedType,0
8,2,0,10,mixedType,1
3,3,0,6,mixedType,0
11,1,0,12,mixedType,1
2,7,0,9,mixedType,1
1,9,0,10,mixedType,1
14,2,0,16,mixedType,2
7,7,0,14,mixedType,2
12,3,0,15,mixedType,2
8,1,0,9,mixedType,1
4,5,0,9,mixedType,1
9,2,0,11,mixedType,1
5,4,0,9,mixedType,1
7,4,0,11,mixedType,1
4,2,0,6,mixedType,0
4,7,0,11,mixedType,1
6,2,0,8,mixedType,1
7,2,0,9,mixedType,1
6,4,0,10,mixedType,1
5,3,0,8,mixedType,1
5,2,0,7,mixedType,0
1,8,0,9,mixedType,1
5,7,0,12,mixedType,1
9,0,1,10,mixedType,1
3,3,0,6,mixedType,0
8,8,2,18,mixedType,2
7,3,0,10,mixedType,1
4,2,0,6,mixedType,0
15,1,0,16,mixedType,2
15,1,0,16,mixedType,2
5,3,0,8,mixedType,1
7,1,0,8,mixedType,1
5,2,0,7,mixedType,0
8,2,0,10,mixedType,1
7,3,0,10,mixedType,1
2,8,0,10,mixedType,1
6,1,0,7,mixedType,0
6,3,0,9,mixedType,1
2,7,0,9,mixedType,1
8,2,0,10,mixedType,1
5,3,0,8,mixedType,1
5,3,0,8,mixedType,1
7,1,0,8,mixedType,1
9,2,0,11,mixedType,1
8,2,0,10,mixedType,1
15,1,0,16,mixedType,2
5,5,0,10,mixedType,1
9,1,0,10,mixedType,1
6,2,0,8,mixedType,1
8,4,0,12,mixedType,1
3,5,0,8,mixedType,1
6,4,0,10,mixedType,1
7,1,0,8,mixedType,1
9,0,1,10,mixedType,1
2,6,0,8,mixedType,1
4,2,0,6,mixedType,0
5,3,0,8,mixedType,1
5,1,0,6,mixedType,0
8,2,0,10,mixedType,1
7,4,0,11,mixedType,1
4,9,0,13,mixedType,1
11,4,1,16,mixedType,2
7,2,0,9,mixedType,1
12,3,0,15,mixedType,2
2,6,0,8,mixedType,1
6,4,0,10,mixedType,1
6,4,0,10,mixedType,1
5,3,0,8,mixedType,1
5,3,0,8,mixedType,1
6,2,0,8,mixedType,1
7,3,0,10,mixedType,1
11,3,0,14,mixedType,2
13,3,0,16,mixedType,2
6,1,0,7,mixedType,0
7,1,0,8,mixedType,1
5,1,0,6,mixedType,0
5,2,0,7,mixedType,0
4,4,0,8,mixedType,1
6,5,0,11,mixedType,1
6,3,0,9,mixedType,1
14,2,0,16,mixedType,2
6,2,0,8,mixedType,1
9,4,0,13,mixedType,1
8,2,0,10,mixedType,1
7,4,0,11,mixedType,1
4,4,0,8,mixedType,1
3,6,0,9,mixedType,1
5,2,0,7,mixedType,0
6,1,0,7,mixedType,0
8,1,0,9,mixedType,1
1,8,0,9,mixedType,1
6,4,0,10,mixedType,1
10,5,0,15,mixedType,2
2,8,0,10,mixedType,1
3,3,0,6,mixedType,0
9,1,0,10,mixedType,1
7,3,0,10,mixedType,1
5,1,0,6,mixedType,0
6,4,0,10,mixedType,1
7,3,0,10,mixedType,1
4,4,0,8,mixedType,1
4,6,0,10,mixedType,1
7,3,0,10,mixedType,1
3,10,0,13,mixedType,1
9,4,0,13,mixedType,1
4,3,0,7,mixedType,0
2,7,0,9,mixedType,1
6,3,0,9,mixedType,1
6,1,0,7,mixedType,0
14,2,0,16,mixedType,2
7,3,0,10,mixedType,1
5,2,0,7,mixedType,0
10,3,0,13,mixedType,1
5,3,0,8,mixedType,1
3,3,0,6,mixedType,0
5,4,0,9,mixedType,1
5,4,0,9,mixedType,1
8,2,0,10,mixedType,1
10,4,0,14,mixedType,2
4,4,0,8,mixedType,1
5,8,0,13,mixedType,1
6,2,0,8,mixedType,1
3,6,0,9,mixedType,1
14,2,0,16,mixedType,2
6,3,0,9,mixedType,1
6,3,0,9,mixedType,1
7,3,0,10,mixedType,1
7,3,0,10,mixedType,1
4,2,0,6,mixedType,0
5,6,0,11,mixedType,1
6,1,0,7,mixedType,0
13,3,0,16,mixedType,2
7,3,0,10,mixedType,1
6,1,0,7,mixedType,0
3,5,0,8,mixedType,1
5,1,0,6,mixedType,0
6,3,0,9,mixedType,1
10,5,0,15,mixedType,2
5,3,0,8,mixedType,1
9,2,0,11,mixedType,1
13,3,0,16,mixedType,2
5,2,0,7,mixedType,0
5,3,0,8,mixedType,1
15,1,0,16,mixedType,2
8,1,0,9,mixedType,1
6,4,0,10,mixedType,1
3,6,0,9,mixedType,1
7,1,0,8,mixedType,1
6,2,0,8,mixedType,1
5,2,0,7,mixedType,0
14,2,0,16,mixedType,2
4,5,0,9,mixedType,1
9,1,0,10,mixedType,1
7,1,0,8,mixedType,1
9,1,0,10,mixedType,1
4,4,0,8,mixedType,1
9,2,0,11,mixedType,1
3,8,0,11,mixedType,1
4,6,0,10,mixedType,1
10,6,0,16,mixedType,2
5,4,0,9,mixedType,1
5,4,0,9,mixedType,1
6,3,0,9,mixedType,1
7,3,0,10,mixedType,1
5,2,0,7,mixedType,0
9,3,0,12,mixedType,1
5,3,0,8,mixedType,1
5,4,0,9,mixedType,1
0,8,2,10,mixedType,1
5,2,0,7,mixedType,0
8,1,0,9,mixedType,1
6,6,0,12,mixedType,1
4,2,0,6,mixedType,0
8,2,0,10,mixedType,1
13,3,0,16,mixedType,2
2,7,0,9,mixedType,1
8,1,0,9,mixedType,1
6,1,0,7,mixedType,0
5,3,0,8,mixedType,1
5,3,0,8,mixedType,1
4,5,0,9,mixedType,1
6,1,0,7,mixedType,0
6,3,0,9,mixedType,1
7,2,0,9,mixedType,1
5,1,0,6,mixedType,0
12,4,0,16,mixedType,2
8,2,0,10,mixedType,1
6,1,0,7,mixedType,0
5,3,0,8,mixedType,1
6,3,0,9,mixedType,1
1,8,0,9,mixedType,1
8,2,0,10,mixedType,1
4,4,0,8,mixedType,1
3,7,0,10,mixedType,1
10,1,0,11,mixedType,1
15,1,0,16,mixedType,2
4,6,0,10,mixedType,1
7,2,0,9,mixedType,1
1,11,0,12,mixedType,1
6,1,0,7,mixedType,0
6,3,0,9,mixedType,1
13,3,0,16,mixedType,2
11,5,0,16,mixedType,2
8,4,0,12,mixedType,1
5,2,0,7,mixedType,0
7,6,0,13,mixedType,1
3,3,0,6,mixedType,0
9,1,0,10,mixedType,1
9,1,0,10,mixedType,1
3,6,0,9,mixedType,1
7,3,0,10,mixedType,1
8,2,0,10,mixedType,1
7,2,0,9,mixedType,1
6,3,0,9,mixedType,1
9,3,0,12,mixedType,1
6,1,0,7,mixedType,0
8,1,0,9,mixedType,1
6,1,0,7,mixedType,0
7,3,0,10,mixedType,1
6,6,0,12,mixedType,1
6,4,0,10,mixedType,1
5,2,0,7,mixedType,0
9,1,0,10,mixedType,1
10,3,0,13,mixedType,1
14,2,0,16,mixedType,2
6,3,0,9,mixedType,1
5,2,0,7,mixedType,0
14,2,0,16,mixedType,2
14,2,0,16,mixedType,2
5,1,0,6,mixedType,0
6,3,0,9,mixedType,1
7,2,0,9,mixedType,1
6,3,0,9,mixedType,1
3,6,0,9,mixedType,1
4,2,0,6,mixedType,0
8,1,0,9,mixedType,1
7,1,0,8,mixedType,1
6,3,0,9,mixedType,1
7,1,0,8,mixedType,1
5,1,0,6,mixedType,0
7,1,0,8,mixedType,1
5,2,0,7,mixedType,0
6,4,0,10,mixedType,1
6,3,0,9,mixedType,1
6,1,0,7,mixedType,0
10,1,0,11,mixedType,1
5,1,0,6,mixedType,0
6,4,0,10,mixedType,1
15,1,0,16,mixedType,2
5,4,0,9,mixedType,1
6,3,0,9,mixedType,1
5,2,0,7,mixedType,0
9,1,0,10,mixedType,1
11,3,0,14,mixedType,2
7,3,0,10,mixedType,1
11,5,0,16,mixedType,2
6,2,0,8,mixedType,1
5,2,0,7,mixedType,0
5,4,0,9,mixedType,1
6,2,0,8,mixedType,1
8,1,0,9,mixedType,1
6,3,0,9,mixedType,1
7,3,0,10,mixedType,1
5,3,0,8,mixedType,1
5,5,0,10,mixedType,1
7,3,0,10,mixedType,1
7,3,0,10,mixedType,1
9,3,0,12,mixedType,1
5,5,0,10,mixedType,1
5,8,0,13,mixedType,1
6,2,0,8,mixedType,1
6,2,0,8,mixedType,1
13,2,0,15,mixedType,2
3,10,0,13,mixedType,1
3,3,0,6,mixedType,0
4,4,0,8,mixedType,1
6,3,0,9,mixedType,1
4,2,0,6,mixedType,0
5,2,0,7,mixedType,0
5,4,0,9,mixedType,1
6,3,0,9,mixedType,1
11,4,0,15,mixedType,2
11,3,0,14,mixedType,2
7,2,0,9,mixedType,1
6,4,0,10,mixedType,1
6,1,0,7,mixedType,0
8,2,0,10,mixedType,1
8,3,0,11,mixedType,1
5,2,0,7,mixedType,0
15,1,0,16,mixedType,2
7,2,0,9,mixedType,1
4,5,0,9,mixedType,1
15,1,0,16,mixedType,2
4,4,0,8,mixedType,1
11,5,0,16,mixedType,2
6,2,0,8,mixedType,1
10,4,0,14,mixedType,2
15,1,0,16,mixedType,2
4,2,0,6,mixedType,0
5,2,0,7,mixedType,0
6,8,0,14,mixedType,2
6,4,0,10,mixedType,1
4,8,0,12,mixedType,1
5,3,0,8,mixedType,1
1,9,0,10,mixedType,1
3,6,0,9,mixedType,1
14,2,0,16,mixedType,2
8,3,0,11,mixedType,1
6,2,0,8,mixedType,1
7,1,0,8,mixedType,1
7,3,0,10,mixedType,1
1,9,0,10,mixedType,1
7,3,0,10,mixedType,1
14,2,0,16,mixedType,2
14,2,0,16,mixedType,2
6,1,0,7,mixedType,0
7,2,0,9,mixedType,1
12,0,1,13,mixedType,1
2,7,0,9,mixedType,1
9,1,0,10,mixedType,1
7,3,0,10,mixedType,1
6,2,0,8,mixedType,1
6,3,0,9,mixedType,1
4,2,0,6,mixedType,0
5,8,0,13,mixedType,1
10,1,0,11,mixedType,1
2,6,0,8,mixedType,1
6,4,0,10,mixedType,1
7,2,0,9,mixedType,1
5,1,0,6,mixedType,0
5,2,0,7,mixedType,0
4,7,0,11,mixedType,1
1,8,0,9,mixedType,1
8,2,0,10,mixedType,1
4,2,0,6,mixedType,0
2,8,0,10,mixedType,1
7,2,0,9,mixedType,1
4,2,0,6,mixedType,0
6,6,0,12,mixedType,1
8,2,0,10,mixedType,1
7,3,0,10,mixedType,1
7,2,0,9,mixedType,1
3,8,0,11,mixedType,1
5,1,0,6,mixedType,0
6,1,0,7,mixedType,0
3,5,0,8,mixedType,1
6,3,0,9,mixedType,1
6,3,0,9,mixedType,1
8,3,0,11,mixedType,1
9,2,0,11,mixedType,1
13,3,0,16,mixedType,2
7,1,0,8,mixedType,1
3,7,0,10,mixedType,1
5,3,0,8,mixedType,1
6,2,0,8,mixedType,1
13,2,1,16,mixedType,2
6,4,0,10,mixedType,1
5,3,0,8,mixedType,1
13,3,0,16,mixedType,2
6,2,0,8,mixedType,1
6,3,0,9,mixedType,1
6,3,0,9,mixedType,1
6,4,0,10,mixedType,1
7,1,0,8,mixedType,1
7,2,0,9,mixedType,1
7,1,0,8,mixedType,1
6,3,0,9,mixedType,1
5,3,0,8,mixedType,1
7,3,0,10,mixedType,1
8,1,0,9,mixedType,1
8,1,0,9,mixedType,1
6,3,0,9,mixedType,1
14,2,0,16,mixedType,2
6,3,0,9,mixedType,1
7,1,0,8,mixedType,1
6,2,0,8,mixedType,1
9,4,0,13,mixedType,1
7,3,0,10,mixedType,1
14,2,0,16,mixedType,2
6,4,0,10,mixedType,1
6,1,0,7,mixedType,0
8,1,0,9,mixedType,1
14,2,0,16,mixedType,2
5,3,0,8,mixedType,1
15,1,1,17,mixedType,2
2,4,0,6,mixedType,0
15,1,0,16,mixedType,2
7,4,0,11,mixedType,1
7,2,0,9,mixedType,1
6,4,0,10,mixedType,1
4,2,0,6,mixedType,0
6,1,0,7,mixedType,0
10,3,0,13,mixedType,1
7,3,0,10,mixedType,1
11,1,0,12,mixedType,1
7,2,0,9,mixedType,1
6,2,0,8,mixedType,1
10,1,0,11,mixedType,1
6,1,0,7,mixedType,0
5,6,0,11,mixedType,1
8,1,0,9,mixedType,1
5,2,0,7,mixedType,0
11,3,2,16,mixedType,2
13,3,0,16,mixedType,2
5,4,0,9,mixedType,1
6,3,0,9,mixedType,1
4,2,0,6,mixedType,0
10,4,0,14,mixedType,2
7,3,0,10,mixedType,1
8,2,0,10,mixedType,1
12,3,0,15,mixedType,2
3,5,0,8,mixedType,1
6,3,0,9,mixedType,1
5,4,0,9,mixedType,1
2,6,0,8,mixedType,1
2,6,0,8,mixedType,1
5,4,0,9,mixedType,1
6,4,0,10,mixedType,1
6,3,0,9,mixedType,1
7,1,0,8,mixedType,1
8,1,0,9,mixedType,1
9,2,0,11,mixedType,1
2,6,0,8,mixedType,1
5,1,0,6,mixedType,0
6,4,0,10,mixedType,1
6,3,0,9,mixedType,1
6,1,0,7,mixedType,0
15,1,1,17,mixedType,2
8,2,0,10,mixedType,1
15,1,0,16,mixedType,2
5,4,0,9,mixedType,1
6,4,0,10,mixedType,1
5,3,0,8,mixedType,1
6,1,0,7,mixedType,0
4,4,0,8,mixedType,1
5,3,0,8,mixedType,1
7,2,0,9,mixedType,1
5,2,0,7,mixedType,0
7,1,0,8,mixedType,1
5,3,0,8,mixedType,1
8,2,0,10,mixedType,1
5,5,0,10,mixedType,1
5,3,0,8,mixedType,1
4,5,0,9,mixedType,1
2,6,0,8,mixedType,1
6,2,0,8,mixedType,1
7,7,0,14,mixedType,2
2,6,0,8,mixedType,1
3,5,0,8,mixedType,1
8,2,0,10,mixedType,1
5,3,0,8,mixedType,1
11,1,0,12,mixedType,1
5,5,0,10,mixedType,1
5,2,0,7,mixedType,0
11,1,0,12,mixedType,1
6,3,0,9,mixedType,1
5,3,0,8,mixedType,1
4,2,0,6,mixedType,0
5,3,0,8,mixedType,1
8,1,0,9,mixedType,1
8,2,0,10,mixedType,1
3,7,0,10,mixedType,1
4,4,0,8,mixedType,1
8,1,0,9,mixedType,1
7,3,0,10,mixedType,1
7,3,0,10,mixedType,1
5,4,0,9,mixedType,1
4,2,0,6,mixedType,0
3,6,0,9,mixedType,1
2,8,0,10,mixedType,1
5,2,0,7,mixedType,0
19,1,2,22,mixedType,2
5,1,0,6,mixedType,0
5,3,0,8,mixedType,1
7,2,0,9,mixedType,1
9,3,0,12,mixedType,1
8,3,0,11,mixedType,1
7,3,0,10,mixedType,1
9,1,0,10,mixedType,1
7,4,0,11,mixedType,1
8,1,0,9,mixedType,1
5,3,0,8,mixedType,1
5,2,0,7,mixedType,0
4,4,0,8,mixedType,1
5,1,0,6,mixedType,0
6,2,0,8,mixedType,1
9,2,0,11,mixedType,1
2,6,0,8,mixedType,1
3,5,0,8,mixedType,1
13,3,0,16,mixedType,2
6,3,0,9,mixedType,1
7,3,0,10,mixedType,1
6,3,0,9,mixedType,1
6,3,0,9,mixedType,1
5,3,0,8,mixedType,1
9,5,0,14,mixedType,2
1,8,0,9,mixedType,1
15,2,0,17,mixedType,2
1,8,0,9,mixedType,1
4,2,0,6,mixedType,0
7,2,0,9,mixedType,1
2,6,0,8,mixedType,1
12,3,0,15,mixedType,2
4,0,0,4,sameType,0
6,6,0,12,mixedType,1
7,2,0,9,mixedType,1
7,2,0,9,mixedType,1
7,1,0,8,mixedType,1
13,3,0,16,mixedType,2
3,9,3,15,mixedType,2
11,5,0,16,mixedType,2
5,7,0,12,mixedType,1
7,3,0,10,mixedType,1
7,3,0,10,mixedType,1
6,1,0,7,mixedType,0
8,3,0,11,mixedType,1
6,2,0,8,mixedType,1
6,1,0,7,mixedType,0
9,2,0,11,mixedType,1
8,4,0,12,mixedType,1
9,1,0,10,mixedType,1
9,2,0,11,mixedType,1
4,6,0,10,mixedType,1
2,8,0,10,mixedType,1
5,5,0,10,mixedType,1
6,3,0,9,mixedType,1
2,6,0,8,mixedType,1
7,3,0,10,mixedType,1
8,5,0,13,mixedType,1
8,0,1,9,mixedType,1
7,1,0,8,mixedType,1
4,4,0,8,mixedType,1
2,8,0,10,mixedType,1
7,3,0,10,mixedType,1
7,4,0,11,mixedType,1
4,2,0,6,mixedType,0
10,6,0,16,mixedType,2
8,4,0,12,mixedType,1
7,6,0,13,mixedType,1
9,2,0,11,mixedType,1
5,2,0,7,mixedType,0
5,6,0,11,mixedType,1
5,3,0,8,mixedType,1
10,3,0,13,mixedType,1
11,5,0,16,mixedType,2
1,8,0,9,mixedType,1
16,1,0,17,mixedType,2
7,3,0,10,mixedType,1
3,6,0,9,mixedType,1
9,1,0,10,mixedType,1
14,2,0,16,mixedType,2
3,10,0,13,mixedType,1
8,2,0,10,mixedType,1
7,3,0,10,mixedType,1
7,3,0,10,mixedType,1
8,2,0,10,mixedType,1
8,2,0,10,mixedType,1
6,3,0,9,mixedType,1
1,11,0,12,mixedType,1
9,2,0,11,mixedType,1
15,1,0,16,mixedType,2
7,3,0,10,mixedType,1
8,1,0,9,mixedType,1
1,7,0,8,mixedType,1
5,3,0,8,mixedType,1
6,6,0,12,mixedType,1
7,5,0,12,mixedType,1
6,1,0,7,mixedType,0
5,1,0,6,mixedType,0
14,2,0,16,mixedType,2
5,3,0,8,mixedType,1
3,7,0,10,mixedType,1
8,3,0,11,mixedType,1
9,1,0,10,mixedType,1
8,3,0,11,mixedType,1
8,2,0,10,mixedType,1
7,3,0,10,mixedType,1
14,2,0,16,mixedType,2
6,1,0,7,mixedType,0
5,4,0,9,mixedType,1
4,2,0,6,mixedType,0
13,3,0,16,mixedType,2
4,6,0,10,mixedType,1
4,5,0,9,mixedType,1
2,8,0,10,mixedType,1
6,3,0,9,mixedType,1
4,2,0,6,mixedType,0
6,1,0,7,mixedType,0
6,4,0,10,mixedType,1
2,6,0,8,mixedType,1
10,2,0,12,mixedType,1
7,3,0,10,mixedType,1
4,2,0,6,mixedType,0
7,2,0,9,mixedType,1
6,2,0,8,mixedType,1
7,0,0,7,sameType,0
11,4,1,16,mixedType,2
15,1,0,16,mixedType,2
8,2,0,10,mixedType,1
9,4,0,13,mixedType,1
4,2,0,6,mixedType,0
2,8,0,10,mixedType,1
7,3,0,10,mixedType,1
5,5,0,10,mixedType,1
5,4,0,9,mixedType,1
7,1,0,8,mixedType,1
3,8,0,11,mixedType,1
15,1,0,16,mixedType,2
8,1,0,9,mixedType,1
8,2,0,10,mixedType,1
4,4,0,8,mixedType,1
8,3,0,11,mixedType,1
6,4,0,10,mixedType,1
3,6,0,9,mixedType,1
4,4,0,8,mixedType,1
5,4,0,9,mixedType,1
4,8,0,12,mixedType,1
6,2,0,8,mixedType,1
5,2,0,7,mixedType,0
1,8,0,9,mixedType,1
13,3,0,16,mixedType,2
7,3,0,10,mixedType,1
4,5,0,9,mixedType,1
9,1,0,10,mixedType,1
6,4,0,10,mixedType,1
6,4,0,10,mixedType,1
5,5,0,10,mixedType,1
6,3,0,9,mixedType,1
7,2,0,9,mixedType,1
4,4,0,8,mixedType,1
3,5,0,8,mixedType,1
5,1,0,6,mixedType,0
8,2,0,10,mixedType,1
14,2,0,16,mixedType,2
9,2,0,11,mixedType,1
8,3,0,11,mixedType,1
6,3,0,9,mixedType,1
10,2,0,12,mixedType,1
7,2,0,9,mixedType,1
10,1,0,11,mixedType,1
11,3,0,14,mixedType,2
13,3,0,16,mixedType,2
13,3,0,16,mixedType,2
14,2,0,16,mixedType,2
7,1,0,8,mixedType,1
3,6,0,9,mixedType,1
5,3,0,8,mixedType,1
6,3,0,9,mixedType,1
3,3,0,6,mixedType,0
12,4,0,16,mixedType,2
5,2,0,7,mixedType,0
13,3,0,16,mixedType,2
5,2,0,7,mixedType,0
10,1,0,11,mixedType,1
7,4,0,11,mixedType,1
8,1,0,9,mixedType,1
6,3,0,9,mixedType,1
7,3,0,10,mixedType,1
6,2,0,8,mixedType,1
13,3,0,16,mixedType,2
1,9,0,10,mixedType,1
6,3,0,9,mixedType,1
5,2,0,7,mixedType,0
6,1,0,7,mixedType,0
4,4,0,8,mixedType,1
5,4,0,9,mixedType,1
4,4,0,8,mixedType,1
3,3,0,6,mixedType,0
7,3,0,10,mixedType,1
14,2,0,16,mixedType,2
7,4,0,11,mixedType,1
6,3,0,9,mixedType,1
7,2,0,9,mixedType,1
2,7,0,9,mixedType,1
7,1,0,8,mixedType,1
5,2,0,7,mixedType,0
14,2,0,16,mixedType,2
9,1,0,10,mixedType,1
5,10,0,15,mixedType,2
8,1,0,9,mixedType,1
1,8,0,9,mixedType,1
2,7,0,9,mixedType,1
6,1,0,7,mixedType,0
7,3,0,10,mixedType,1
6,3,0,9,mixedType,1
10,2,0,12,mixedType,1
5,3,0,8,mixedType,1
3,9,0,12,mixedType,1
5,3,0,8,mixedType,1
10,2,0,12,mixedType,1
5,3,0,8,mixedType,1
8,2,0,10,mixedType,1
14,2,0,16,mixedType,2
5,3,0,8,mixedType,1
4,4,0,8,mixedType,1
12,4,0,16,mixedType,2
6,2,0,8,mixedType,1
3,10,0,13,mixedType,1
5,2,0,7,mixedType,0
7,2,0,9,mixedType,1
2,8,0,10,mixedType,1
15,1,0,16,mixedType,2
6,2,0,8,mixedType,1
5,7,0,12,mixedType,1
6,4,0,10,mixedType,1
7,2,0,9,mixedType,1
8,2,0,10,mixedType,1
6,1,0,7,mixedType,0
5,3,0,8,mixedType,1
11,3,0,14,mixedType,2
4,4,0,8,mixedType,1
8,4,0,12,mixedType,1
3,3,0,6,mixedType,0
9,2,0,11,mixedType,1
6,3,0,9,mixedType,1
6,5,0,11,mixedType,1
13,2,1,16,mixedType,2
6,4,0,10,mixedType,1
8,2,0,10,mixedType,1
8,2,0,10,mixedType,1
6,0,1,7,mixedType,0
7,5,0,12,mixedType,1
6,2,0,8,mixedType,1
9,4,0,13,mixedType,1
7,3,0,10,mixedType,1
2,6,0,8,mixedType,1
4,4,0,8,mixedType,1
7,4,0,11,mixedType,1
7,2,0,9,mixedType,1
12,1,0,13,mixedType,1
5,4,0,9,mixedType,1
8,4,0,12,mixedType,1
10,2,0,12,mixedType,1
13,3,0,16,mixedType,2
7,1,0,8,mixedType,1
5,2,0,7,mixedType,0
6,2,0,8,mixedType,1
9,4,1,14,mixedType,2
7,3,0,10,mixedType,1
5,3,0,8,mixedType,1
4,8,0,12,mixedType,1
5,3,0,8,mixedType,1
8,1,0,9,mixedType,1
5,2,0,7,mixedType,0
5,4,0,9,mixedType,1
6,2,0,8,mixedType,1
11,2,1,14,mixedType,2
7,4,0,11,mixedType,1
11,5,0,16,mixedType,2
9,1,0,10,mixedType,1
6,4,0,10,mixedType,1
13,4,0,17,mixedType,2
7,3,0,10,mixedType,1
3,6,0,9,mixedType,1
8,3,0,11,mixedType,1
7,3,0,10,mixedType,1
11,2,0,13,mixedType,1
1,7,0,8,mixedType,1
1,7,0,8,mixedType,1
7,1,0,8,mixedType,1
2,6,0,8,mixedType,1
5,1,0,6,mixedType,0
5,4,0,9,mixedType,1
2,4,0,6,mixedType,0
9,1,0,10,mixedType,1
6,3,0,9,mixedType,1
6,2,0,8,mixedType,1
6,3,0,9,mixedType,1
3,6,0,9,mixedType,1
4,2,0,6,mixedType,0
5,4,0,9,mixedType,1
8,2,0,10,mixedType,1
9,3,0,12,mixedType,1
0,6,2,8,mixedType,1
3,7,0,10,mixedType,1
6,3,0,9,mixedType,1
9,2,0,11,mixedType,1
7,2,0,9,mixedType,1
8,1,0,9,mixedType,1
4,6,0,10,mixedType,1
3,5,0,8,mixedType,1
5,1,0,6,mixedType,0
8,1,0,9,mixedType,1
8,1,0,9,mixedType,1
6,3,0,9,mixedType,1
13,3,0,16,mixedType,2
7,6,0,13,mixedType,1
4,2,0,6,mixedType,0
7,2,0,9,mixedType,1
4,6,0,10,mixedType,1
11,3,0,14,mixedType,2
4,2,0,6,mixedType,0
5,4,0,9,mixedType,1
7,2,0,9,mixedType,1
1,8,0,9,mixedType,1
5,3,0,8,mixedType,1
10,2,0,12,mixedType,1
7,3,0,10,mixedType,1
7,2,0,9,mixedType,1
7,3,0,10,mixedType,1
12,4,0,16,mixedType,2
13,3,0,16,mixedType,2
8,3,0,11,mixedType,1
8,2,0,10,mixedType,1
6,2,0,8,mixedType,1
11,3,0,14,mixedType,2
6,2,0,8,mixedType,1
4,2,0,6,mixedType,0
12,4,0,16,mixedType,2
6,1,0,7,mixedType,0
6,2,0,8,mixedType,1
5,2,0,7,mixedType,0
6,2,0,8,mixedType,1
8,1,0,9,mixedType,1
6,2,0,8,mixedType,1
15,1,0,16,mixedType,2
6,4,0,10,mixedType,1
7,3,0,10,mixedType,1
8,3,0,11,mixedType,1
4,2,0,6,mixedType,0
1,5,0,6,mixedType,0
12,4,0,16,mixedType,2
8,1,0,9,mixedType,1
15,1,0,16,mixedType,2
6,2,0,8,mixedType,1
12,4,0,16,mixedType,2
8,2,0,10,mixedType,1
14,2,0,16,mixedType,2
13,3,1,17,mixedType,2
6,4,0,10,mixedType,1
6,4,0,10,mixedType,1
1,11,0,12,mixedType,1
7,2,0,9,mixedType,1
0,5,2,7,mixedType,0
8,1,0,9,mixedType,1
7,3,0,10,mixedType,1
11,5,0,16,mixedType,2
6,1,0,7,mixedType,0
15,1,0,16,mixedType,2
5,4,0,9,mixedType,1
5,1,0,6,mixedType,0
1,11,0,12,mixedType,1
13,3,0,16,mixedType,2
9,1,0,10,mixedType,1
12,4,0,16,mixedType,2
6,3,0,9,mixedType,1
7,2,0,9,mixedType,1
6,4,0,10,mixedType,1
8,4,0,12,mixedType,1
5,3,0,8,mixedType,1
7,3,0,10,mixedType,1
6,3,0,9,mixedType,1
8,1,0,9,mixedType,1
3,6,0,9,mixedType,1
8,1,0,9,mixedType,1
6,4,0,10,mixedType,1
4,5,0,9,mixedType,1
8,1,0,9,mixedType,1
6,3,0,9,mixedType,1
4,4,0,8,mixedType,1
1,7,0,8,mixedType,1
5,2,0,7,mixedType,0
8,1,0,9,mixedType,1
15,1,0,16,mixedType,2
5,2,0,7,mixedType,0
4,2,0,6,mixedType,0
5,3,0,8,mixedType,1
5,8,0,13,mixedType,1
6,1,0,7,mixedType,0
6,3,0,9,mixedType,1
7,2,0,9,mixedType,1
2,7,0,9,mixedType,1
5,3,0,8,mixedType,1
7,4,0,11,mixedType,1
10,2,0,12,mixedType,1
5,0,3,8,mixedType,1
4,6,0,10,mixedType,1
8,3,0,11,mixedType,1
7,1,0,8,mixedType,1
5,8,1,14,mixedType,2
15,1,0,16,mixedType,2
12,4,0,16,mixedType,2
6,2,0,8,mixedType,1
15,1,0,16,mixedType,2
7,2,0,9,mixedType,1
6,4,0,10,mixedType,1
4,7,0,11,mixedType,1
6,6,0,12,mixedType,1
8,1,0,9,mixedType,1
7,1,0,8,mixedType,1
11,2,0,13,mixedType,1
8,4,0,12,mixedType,1
4,4,0,8,mixedType,1
5,1,0,6,mixedType,0
6,1,0,7,mixedType,0
12,3,0,15,mixedType,2
7,2,0,9,mixedType,1
8,1,0,9,mixedType,1
15,1,0,16,mixedType,2
4,4,0,8,mixedType,1
5,2,0,7,mixedType,0
6,1,0,7,mixedType,0
5,4,0,9,mixedType,1
6,3,0,9,mixedType,1
14,2,0,16,mixedType,2
5,3,0,8,mixedType,1
3,3,0,6,mixedType,0
12,3,0,15,mixedType,2
8,2,0,10,mixedType,1
0,9,0,9,sameType,1
5,1,0,6,mixedType,0
6,2,0,8,mixedType,1
5,3,0,8,mixedType,1
6,3,0,9,mixedType,1
14,2,0,16,mixedType,2
12,4,0,16,mixedType,2
6,3,0,9,mixedType,1
6,3,0,9,mixedType,1
7,3,0,10,mixedType,1
5,3,0,8,mixedType,1
4,2,0,6,mixedType,0
7,3,0,10,mixedType,1
4,2,0,6,mixedType,0
4,4,0,8,mixedType,1
6,2,0,8,mixedType,1
3,8,0,11,mixedType,1
5,4,0,9,mixedType,1
6,3,0,9,mixedType,1
7,2,0,9,mixedType,1
7,4,0,11,mixedType,1
12,3,0,15,mixedType,2
6,4,0,10,mixedType,1
9,1,0,10,mixedType,1
9,1,0,10,mixedType,1
7,3,0,10,mixedType,1
6,2,0,8,mixedType,1
4,2,0,6,mixedType,0
3,8,0,11,mixedType,1
3,6,0,9,mixedType,1
8,1,0,9,mixedType,1
5,1,0,6,mixedType,0
8,2,0,10,mixedType,1
6,1,0,7,mixedType,0
15,1,0,16,mixedType,2
7,3,0,10,mixedType,1
7,3,0,10,mixedType,1
12,4,0,16,mixedType,2
9,3,0,12,mixedType,1
14,2,0,16,mixedType,2
4,5,0,9,mixedType,1
13,3,0,16,mixedType,2
4,2,0,6,mixedType,0
7,2,0,9,mixedType,1
6,4,0,10,mixedType,1
5,2,0,7,mixedType,0
2,6,0,8,mixedType,1
11,5,0,16,mixedType,2
7,1,0,8,mixedType,1
3,8,0,11,mixedType,1
5,4,0,9,mixedType,1
6,7,0,13,mixedType,1
8,4,0,12,mixedType,1
7,3,0,10,mixedType,1
6,3,0,9,mixedType,1
9,3,0,12,mixedType,1
8,2,0,10,mixedType,1
3,3,0,6,mixedType,0
5,4,0,9,mixedType,1
7,3,0,10,mixedType,1
6,3,0,9,mixedType,1
4,2,0,6,mixedType,0
14,2,0,16,mixedType,2
8,4,0,12,mixedType,1
5,3,0,8,mixedType,1
11,2,1,14,mixedType,2
7,3,0,10,mixedType,1
6,1,0,7,mixedType,0
9,4,1,14,mixedType,2
6,3,0,9,mixedType,1
4,4,0,8,mixedType,1
8,2,0,10,mixedType,1
13,3,0,16,mixedType,2
14,2,0,16,mixedType,2
13,3,0,16,mixedType,2
5,4,0,9,mixedType,1
6,3,0,9,mixedType,1
5,4,0,9,mixedType,1
10,1,0,11,mixedType,1
8,1,0,9,mixedType,1
6,5,0,11,mixedType,1
7,2,0,9,mixedType,1
6,4,0,10,mixedType,1
9,3,0,12,mixedType,1
6,3,0,9,mixedType,1
0,4,1,5,mixedType,0
4,8,0,12,mixedType,1
5,8,0,13,mixedType,1
6,4,0,10,mixedType,1
9,2,0,11,mixedType,1
7,2,0,9,mixedType,1
7,2,0,9,mixedType,1
4,4,0,8,mixedType,1
4,6,0,10,mixedType,1
8,3,0,11,mixedType,1
7,3,0,10,mixedType,1
7,2,0,9,mixedType,1
8,2,0,10,mixedType,1
11,3,0,14,mixedType,2
7,2,0,9,mixedType,1
3,6,0,9,mixedType,1
6,4,0,10,mixedType,1
2,4,0,6,mixedType,0
7,1,0,8,mixedType,1
10,2,0,12,mixedType,1
8,2,0,10,mixedType,1
6,1,0,7,mixedType,0
6,3,0,9,mixedType,1
9,1,0,10,mixedType,1
5,6,0,11,mixedType,1
6,2,0,8,mixedType,1
3,5,0,8,mixedType,1
6,10,2,18,mixedType,2
5,9,0,14,mixedType,2
7,2,0,9,mixedType,1
7,3,0,10,mixedType,1
7,2,0,9,mixedType,1
8,2,0,10,mixedType,1
6,1,0,7,mixedType,0
5,3,0,8,mixedType,1
7,5,0,12,mixedType,1
7,3,0,10,mixedType,1
5,2,0,7,mixedType,0
2,8,0,10,mixedType,1
5,8,0,13,mixedType,1
9,1,0,10,mixedType,1
6,4,0,10,mixedType,1
8,2,0,10,mixedType,1
6,1,0,7,mixedType,0
7,1,0,8,mixedType,1
6,3,0,9,mixedType,1
12,4,0,16,mixedType,2
11,3,0,14,mixedType,2
6,3,0,9,mixedType,1
5,4,0,9,mixedType,1
3,6,0,9,mixedType,1
6,3,0,9,mixedType,1
6,4,0,10,mixedType,1
6,4,0,10,mixedType,1
15,1,0,16,mixedType,2
2,8,0,10,mixedType,1
6,5,0,11,mixedType,1
5,8,0,13,mixedType,1
8,1,0,9,mixedType,1
9,1,0,10,mixedType,1
6,2,0,8,mixedType,1
6,2,0,8,mixedType,1
4,2,0,6,mixedType,0
4,4,0,8,mixedType,1
5,4,0,9,mixedType,1
6,4,0,10,mixedType,1
10,1,0,11,mixedType,1
5,8,0,13,mixedType,1
1,9,0,10,mixedType,1
5,4,0,9,mixedType,1
4,6,0,10,mixedType,1
9,1,0,10,mixedType,1
9,4,0,13,mixedType,1
8,3,0,11,mixedType,1
8,2,0,10,mixedType,1
3,5,0,8,mixedType,1
7,3,0,10,mixedType,1
4,4,0,8,mixedType,1
7,2,0,9,mixedType,1
12,4,0,16,mixedType,2
9,8,0,17,mixedType,2
10,2,0,12,mixedType,1
8,4,0,12,mixedType,1
6,3,0,9,mixedType,1
11,2,0,13,mixedType,1
1,8,0,9,mixedType,1
13,3,0,16,mixedType,2
7,3,0,10,mixedType,1
4,4,0,8,mixedType,1
4,2,0,6,mixedType,0
8,2,0,10,mixedType,1
8,2,0,10,mixedType,1
1,7,0,8,mixedType,1
10,3,2,15,mixedType,2
5,2,0,7,mixedType,0
6,3,0,9,mixedType,1
6,2,0,8,mixedType,1
3,3,0,6,mixedType,0
7,3,0,10,mixedType,1
10,2,0,12,mixedType,1
8,2,0,10,mixedType,1
5,4,0,9,mixedType,1
11,5,0,16,mixedType,2
6,6,0,12,mixedType,1
5,2,0,7,mixedType,0
1,8,0,9,mixedType,1
7,2,0,9,mixedType,1
8,3,0,11,mixedType,1
6,0,1,7,mixedType,0
15,1,0,16,mixedType,2
6,8,0,14,mixedType,2
7,2,0,9,mixedType,1
6,4,0,10,mixedType,1
9,2,0,11,mixedType,1
3,6,0,9,mixedType,1
5,1,0,6,mixedType,0
7,2,0,9,mixedType,1
3,6,0,9,mixedType,1
15,3,0,18,mixedType,2
10,2,0,12,mixedType,1
6,4,0,10,mixedType,1
1,7,0,8,mixedType,1
6,6,0,12,mixedType,1
8,2,0,10,mixedType,1
12,3,0,15,mixedType,2
6,4,0,10,mixedType,1
5,6,0,11,mixedType,1
7,3,0,10,mixedType,1
14,2,0,16,mixedType,2
4,6,0,10,mixedType,1
5,4,0,9,mixedType,1
11,3,0,14,mixedType,2
7,3,0,10,mixedType,1
7,3,0,10,mixedType,1
6,2,0,8,mixedType,1
6,1,0,7,mixedType,0
6,4,0,10,mixedType,1
7,4,0,11,mixedType,1
5,3,0,8,mixedType,1
5,2,0,7,mixedType,0
6,4,0,10,mixedType,1
7,2,0,9,mixedType,1
13,3,0,16,mixedType,2
7,2,0,9,mixedType,1
6,3,0,9,mixedType,1
6,3,0,9,mixedType,1
6,4,0,10,mixedType,1
7,7,0,14,mixedType,2
14,2,0,16,mixedType,2
9,3,0,12,mixedType,1
3,6,0,9,mixedType,1
6,3,0,9,mixedType,1
15,1,0,16,mixedType,2
4,4,0,8,mixedType,1
7,2,0,9,mixedType,1
7,3,0,10,mixedType,1
5,9,0,14,mixedType,2
8,1,0,9,mixedType,1
2,6,0,8,mixedType,1
6,4,0,10,mixedType,1
8,1,0,9,mixedType,1
3,6,0,9,mixedType,1
4,2,0,6,mixedType,0
4,2,0,6,mixedType,0
8,1,0,9,mixedType,1
9,4,0,13,mixedType,1
6,3,0,9,mixedType,1
2,6,0,8,mixedType,1
12,3,0,15,mixedType,2
8,3,0,11,mixedType,1
5,8,0,13,mixedType,1
12,1,0,13,mixedType,1
5,3,0,8,mixedType,1
7,3,0,10,mixedType,1
5,4,0,9,mixedType,1
7,3,0,10,mixedType,1
8,2,0,10,mixedType,1
6,4,0,10,mixedType,1
11,3,0,14,mixedType,2
1,8,0,9,mixedType,1
6,2,0,8,mixedType,1
4,4,0,8,mixedType,1
6,3,0,9,mixedType,1
7,1,0,8,mixedType,1
7,3,0,10,mixedType,1
9,1,0,10,mixedType,1
7,3,0,10,mixedType,1
7,3,0,10,mixedType,1
8,1,0,9,mixedType,1
6,2,0,8,mixedType,1
4,2,0,6,mixedType,0
14,2,0,16,mixedType,2
1,8,0,9,mixedType,1
9,3,0,12,mixedType,1
1,9,0,10,mixedType,1
4,2,0,6,mixedType,0
9,1,0,10,mixedType,1
7,2,0,9,mixedType,1
8,2,0,10,mixedType,1
5,3,0,8,mixedType,1
6,4,0,10,mixedType,1
7,3,0,10,mixedType,1
6,3,0,9,mixedType,1
14,2,0,16,mixedType,2
8,2,0,10,mixedType,1
11,1,0,12,mixedType,1
7,2,0,9,mixedType,1
11,1,0,12,mixedType,1
5,4,0,9,mixedType,1
4,7,0,11,mixedType,1
9,1,0,10,mixedType,1
9,2,0,11,mixedType,1
7,3,0,10,mixedType,1
6,2,0,8,mixedType,1
12,4,0,16,mixedType,2
9,2,0,11,mixedType,1
9,4,0,13,mixedType,1
5,4,0,9,mixedType,1
9,1,0,10,mixedType,1
7,3,0,10,mixedType,1
2,6,0,8,mixedType,1
5,3,0,8,mixedType,1
5,3,0,8,mixedType,1
6,1,0,7,mixedType,0
9,3,0,12,mixedType,1
1,5,0,6,mixedType,0
9,4,0,13,mixedType,1
4,4,0,8,mixedType,1
5,2,0,7,mixedType,0
9,1,0,10,mixedType,1
7,1,0,8,mixedType,1
5,1,0,6,mixedType,0
4,6,0,10,mixedType,1
12,3,0,15,mixedType,2
6,4,0,10,mixedType,1
1,7,0,8,mixedType,1
9,1,0,10,mixedType,1
7,1,0,8,mixedType,1
7,0,2,9,mixedType,1
1,10,0,11,mixedType,1
7,2,0,9,mixedType,1
8,2,0,10,mixedType,1
8,1,0,9,mixedType,1
5,1,0,6,mixedType,0
6,2,0,8,mixedType,1
7,3,0,10,mixedType,1
11,3,0,14,mixedType,2
9,1,0,10,mixedType,1
4,4,0,8,mixedType,1
5,2,0,7,mixedType,0
6,4,0,10,mixedType,1
6,4,0,10,mixedType,1
5,3,0,8,mixedType,1
7,3,0,10,mixedType,1
15,1,0,16,mixedType,2
13,3,0,16,mixedType,2
7,3,0,10,mixedType,1
9,3,0,12,mixedType,1
8,2,0,10,mixedType,1
6,1,0,7,mixedType,0
9,1,0,10,mixedType,1
1,8,0,9,mixedType,1
6,4,0,10,mixedType,1
10,2,0,12,mixedType,1
6,2,0,8,mixedType,1
3,5,0,8,mixedType,1
7,2,0,9,mixedType,1
10,1,0,11,mixedType,1
6,2,0,8,mixedType,1
4,5,0,9,mixedType,1
7,1,0,8,mixedType,1
9,8,0,17,mixedType,2
3,5,0,8,mixedType,1
2,6,0,8,mixedType,1
3,8,0,11,mixedType,1
5,2,0,7,mixedType,0
2,10,2,14,mixedType,2
6,3,0,9,mixedType,1
8,4,0,12,mixedType,1
2,8,0,10,mixedType,1
4,4,0,8,mixedType,1
7,3,0,10,mixedType,1
12,3,0,15,mixedType,2
13,3,0,16,mixedType,2
4,6,0,10,mixedType,1
8,1,0,9,mixedType,1
6,1,0,7,mixedType,0
6,4,0,10,mixedType,1
13,3,0,16,mixedType,2
8,3,0,11,mixedType,1
5,3,0,8,mixedType,1
9,2,0,11,mixedType,1
13,3,0,16,mixedType,2
6,2,0,8,mixedType,1
5,2,0,7,mixedType,0
4,5,0,9,mixedType,1
8,1,0,9,mixedType,1
6,3,0,9,mixedType,1
4,8,0,12,mixedType,1
6,2,0,8,mixedType,1
6,3,0,9,mixedType,1
6,2,0,8,mixedType,1
7,3,0,10,mixedType,1
13,3,0,16,mixedType,2
14,2,0,16,mixedType,2
8,3,0,11,mixedType,1
7,2,0,9,mixedType,1
3,7,0,10,mixedType,1
5,4,0,9,mixedType,1
11,1,0,12,mixedType,1
10,1,0,11,mixedType,1
14,2,0,16,mixedType,2
12,4,0,16,mixedType,2
8,2,0,10,mixedType,1
18,1,1,20,mixedType,2
9,3,0,12,mixedType,1
4,2,0,6,mixedType,0
9,1,0,10,mixedType,1
4,2,0,6,mixedType,0
8,4,0,12,mixedType,1
6,4,0,10,mixedType,1
9,1,0,10,mixedType,1
4,4,0,8,mixedType,1
12,3,0,15,mixedType,2
7,2,0,9,mixedType,1
11,2,0,13,mixedType,1
3,6,0,9,mixedType,1
9,2,0,11,mixedType,1
8,2,0,10,mixedType,1
5,3,0,8,mixedType,1
5,3,0,8,mixedType,1
4,5,0,9,mixedType,1
2,4,0,6,mixedType,0
4,8,0,12,mixedType,1
6,1,0,7,mixedType,0
7,3,0,10,mixedType,1
5,5,0,10,mixedType,1
11,3,0,14,mixedType,2
6,3,0,9,mixedType,1
14,2,0,16,mixedType,2
5,2,0,7,mixedType,0
8,2,0,10,mixedType,1
8,4,0,12,mixedType,1
6,7,0,13,mixedType,1
6,1,0,7,mixedType,0
5,4,0,9,mixedType,1
7,2,0,9,mixedType,1
7,6,0,13,mixedType,1
8,4,0,12,mixedType,1
7,2,0,9,mixedType,1
5,3,0,8,mixedType,1
4,4,0,8,mixedType,1
7,3,0,10,mixedType,1
6,2,0,8,mixedType,1
1,6,0,7,mixedType,0
7,3,0,10,mixedType,1
5,3,0,8,mixedType,1
4,6,0,10,mixedType,1
3,7,0,10,mixedType,1
6,2,0,8,mixedType,1
7,2,0,9,mixedType,1
5,2,0,7,mixedType,0
7,3,0,10,mixedType,1
6,4,0,10,mixedType,1
7,2,0,9,mixedType,1
4,2,0,6,mixedType,0
11,2,0,13,mixedType,1
7,3,0,10,mixedType,1
6,3,0,9,mixedType,1
8,2,0,10,mixedType,1
4,4,0,8,mixedType,1
5,1,0,6,mixedType,0
8,3,0,11,mixedType,1
6,2,0,8,mixedType,1
8,4,0,12,mixedType,1
6,3,0,9,mixedType,1
10,0,1,11,mixedType,1
8,1,0,9,mixedType,1
6,3,0,9,mixedType,1
3,5,0,8,mixedType,1
8,1,0,9,mixedType,1
6,4,0,10,mixedType,1
9,3,0,12,mixedType,1
7,2,0,9,mixedType,1
7,3,0,10,mixedType,1
11,1,0,12,mixedType,1
8,1,0,9,mixedType,1
10,3,0,13,mixedType,1
3,6,0,9,mixedType,1
3,6,0,9,mixedType,1
7,2,0,9,mixedType,1
8,4,0,12,mixedType,1
5,2,0,7,mixedType,0
10,4,0,14,mixedType,2
9,4,0,13,mixedType,1
5,4,0,9,mixedType,1
1,10,0,11,mixedType,1
5,3,0,8,mixedType,1
9,1,0,10,mixedType,1
14,2,0,16,mixedType,2
14,2,0,16,mixedType,2
5,10,3,18,mixedType,2
1,8,0,9,mixedType,1
3,3,0,6,mixedType,0
3,7,0,10,mixedType,1
1,8,0,9,mixedType,1
9,2,0,11,mixedType,1
6,3,0,9,mixedType,1
7,2,0,9,mixedType,1
6,1,0,7,mixedType,0
7,3,0,10,mixedType,1
4,2,0,6,mixedType,0
14,2,0,16,mixedType,2
5,1,0,6,mixedType,0
6,4,0,10,mixedType,1
12,4,0,16,mixedType,2
10,1,0,11,mixedType,1
6,3,0,9,mixedType,1
7,1,0,8,mixedType,1
5,1,0,6,mixedType,0
6,4,0,10,mixedType,1
5,6,0,11,mixedType,1
7,3,0,10,mixedType,1
5,3,0,8,mixedType,1
2,7,0,9,mixedType,1
7,2,0,9,mixedType,1
4,4,0,8,mixedType,1
7,3,0,10,mixedType,1
7,1,0,8,mixedType,1
14,2,0,16,mixedType,2
8,1,0,9,mixedType,1
8,3,0,11,mixedType,1
5,2,0,7,mixedType,0
6,3,0,9,mixedType,1
8,2,0,10,mixedType,1
9,2,0,11,mixedType,1
8,1,0,9,mixedType,1
13,3,1,17,mixedType,2
6,1,0,7,mixedType,0
4,8,0,12,mixedType,1
3,11,1,15,mixedType,2
5,2,0,7,mixedType,0
1,7,0,8,mixedType,1
4,2,0,6,mixedType,0
6,2,0,8,mixedType,1
5,3,0,8,mixedType,1
7,3,0,10,mixedType,1
7,3,0,10,mixedType,1
10,3,0,13,mixedType,1
6,1,0,7,mixedType,0
8,2,0,10,mixedType,1
1,8,0,9,mixedType,1
5,4,0,9,mixedType,1
6,3,0,9,mixedType,1
9,2,0,11,mixedType,1
5,2,0,7,mixedType,0
7,2,0,9,mixedType,1
5,2,0,7,mixedType,0
5,4,0,9,mixedType,1
8,2,0,10,mixedType,1
3,7,0,10,mixedType,1
7,1,0,8,mixedType,1
5,3,0,8,mixedType,1
7,6,0,13,mixedType,1
8,3,0,11,mixedType,1
13,3,0,16,mixedType,2
5,3,0,8,mixedType,1
11,1,0,12,mixedType,1
2,8,0,10,mixedType,1
7,3,0,10,mixedType,1
11,1,0,12,mixedType,1
6,2,0,8,mixedType,1
5,3,0,8,mixedType,1
9,2,0,11,mixedType,1
10,1,0,11,mixedType,1
9,1,0,10,mixedType,1
9,3,0,12,mixedType,1
5,3,0,8,mixedType,1
6,4,0,10,mixedType,1
5,4,0,9,mixedType,1
7,3,0,10,mixedType,1
10,2,0,12,mixedType,1
13,3,0,16,mixedType,2
6,3,0,9,mixedType,1
7,3,0,10,mixedType,1
8,2,0,10,mixedType,1
8,2,0,10,mixedType,1
6,3,0,9,mixedType,1
7,2,0,9,mixedType,1
5,3,0,8,mixedType,1
1,8,0,9,mixedType,1
4,9,0,13,mixedType,1
8,2,0,10,mixedType,1
3,7,0,10,mixedType,1
10,1,0,11,mixedType,1
6,2,0,8,mixedType,1
6,3,0,9,mixedType,1
4,4,0,8,mixedType,1
5,2,0,7,mixedType,0
6,3,0,9,mixedType,1
6,5,0,11,mixedType,1
7,4,0,11,mixedType,1
13,3,0,16,mixedType,2
2,8,0,10,mixedType,1
4,2,0,6,mixedType,0
2,6,0,8,mixedType,1
6,4,0,10,mixedType,1
4,2,0,6,mixedType,0
6,2,0,8,mixedType,1
6,4,0,10,mixedType,1
8,2,0,10,mixedType,1
8,3,0,11,mixedType,1
12,6,0,18,mixedType,2
6,1,0,7,mixedType,0
10,2,0,12,mixedType,1
6,3,0,9,mixedType,1
7,3,0,10,mixedType,1
4,6,0,10,mixedType,1
8,2,0,10,mixedType,1
1,10,0,11,mixedType,1
7,2,0,9,mixedType,1
8,4,0,12,mixedType,1
6,1,0,7,mixedType,0
8,1,0,9,mixedType,1
11,3,0,14,mixedType,2
7,1,0,8,mixedType,1
6,3,0,9,mixedType,1
9,2,0,11,mixedType,1
5,6,0,11,mixedType,1
7,1,0,8,mixedType,1
8,3,0,11,mixedType,1
5,7,0,12,mixedType,1
9,1,0,10,mixedType,1
7,4,0,11,mixedType,1
5,1,0,6,mixedType,0
7,2,0,9,mixedType,1
5,2,0,7,mixedType,0
5,1,0,6,mixedType,0
3,3,0,6,mixedType,0
5,3,0,8,mixedType,1
2,6,0,8,mixedType,1
8,1,0,9,mixedType,1
2,8,0,10,mixedType,1
9,3,0,12,mixedType,1
6,1,0,7,mixedType,0
14,2,0,16,mixedType,2
7,1,0,8,mixedType,1
12,3,0,15,mixedType,2
7,3,0,10,mixedType,1
1,10,0,11,mixedType,1
5,4,0,9,mixedType,1
6,4,0,10,mixedType,1
5,3,0,8,mixedType,1
8,1,0,9,mixedType,1
5,2,0,7,mixedType,0
4,2,0,6,mixedType,0
5,2,0,7,mixedType,0
4,6,0,10,mixedType,1
7,4,0,11,mixedType,1
4,2,0,6,mixedType,0
6,3,0,9,mixedType,1
9,1,0,10,mixedType,1
5,3,0,8,mixedType,1
7,1,0,8,mixedType,1
15,1,0,16,mixedType,2
3,5,0,8,mixedType,1
8,4,0,12,mixedType,1
6,4,0,10,mixedType,1
5,4,0,9,mixedType,1
3,8,0,11,mixedType,1
6,2,0,8,mixedType,1
3,7,0,10,mixedType,1
8,1,0,9,mixedType,1
7,3,0,10,mixedType,1
12,4,0,16,mixedType,2
14,2,0,16,mixedType,2
2,4,0,6,mixedType,0
7,3,0,10,mixedType,1
5,2,0,7,mixedType,0
13,3,0,16,mixedType,2
6,4,0,10,mixedType,1
8,0,1,9,mixedType,1
7,1,0,8,mixedType,1
6,3,0,9,mixedType,1
1,8,0,9,mixedType,1
2,4,0,6,mixedType,0
6,1,0,7,mixedType,0
8,2,0,10,mixedType,1
3,6,0,9,mixedType,1
8,4,0,12,mixedType,1
7,3,0,10,mixedType,1
12,3,0,15,mixedType,2
5,2,0,7,mixedType,0
6,1,0,7,mixedType,0
5,1,0,6,mixedType,0
5,2,0,7,mixedType,0
1,9,0,10,mixedType,1
8,2,0,10,mixedType,1
11,3,0,14,mixedType,2
1,8,0,9,mixedType,1
8,1,0,9,mixedType,1
5,3,0,8,mixedType,1
13,3,0,16,mixedType,2
5,3,0,8,mixedType,1
14,2,0,16,mixedType,2
4,2,0,6,mixedType,0
8,2,0,10,mixedType,1
9,2,0,11,mixedType,1
4,2,0,6,mixedType,0
4,2,0,6,mixedType,0
8,1,0,9,mixedType,1
5,3,0,8,mixedType,1
6,3,0,9,mixedType,1
2,8,0,10,mixedType,1
8,1,0,9,mixedType,1
4,6,0,10,mixedType,1
10,1,0,11,mixedType,1
14,2,0,16,mixedType,2
5,1,0,6,mixedType,0
7,3,0,10,mixedType,1
7,3,0,10,mixedType,1
7,3,0,10,mixedType,1
6,4,0,10,mixedType,1
9,3,0,12,mixedType,1
9,2,0,11,mixedType,1
6,4,0,10,mixedType,1
5,4,0,9,mixedType,1
7,2,0,9,mixedType,1
7,2,0,9,mixedType,1
1,8,0,9,mixedType,1
5,8,0,13,mixedType,1
5,3,0,8,mixedType,1
6,1,0,7,mixedType,0
6,2,0,8,mixedType,1
4,4,0,8,mixedType,1
3,6,0,9,mixedType,1
4,5,0,9,mixedType,1
2,6,0,8,mixedType,1
5,2,0,7,mixedType,0
6,1,0,7,mixedType,0
2,8,0,10,mixedType,1
2,10,0,12,mixedType,1
9,1,0,10,mixedType,1
2,7,0,9,mixedType,1
6,4,0,10,mixedType,1
0,5,1,6,mixedType,0
7,3,0,10,mixedType,1
7,3,0,10,mixedType,1
7,1,0,8,mixedType,1
7,3,0,10,mixedType,1
4,2,0,6,mixedType,0
14,2,0,16,mixedType,2
9,2,0,11,mixedType,1
9,3,0,12,mixedType,1
8,2,0,10,mixedType,1
7,1,0,8,mixedType,1
7,3,0,10,mixedType,1
8,2,0,10,mixedType,1
6,3,0,9,mixedType,1
8,1,0,9,mixedType,1
8,2,0,10,mixedType,1
5,8,0,13,mixedType,1
6,1,0,7,mixedType,0
6,2,0,8,mixedType,1
7,0,2,9,mixedType,1
7,2,0,9,mixedType,1
5,3,0,8,mixedType,1
6,1,0,7,mixedType,0
8,1,0,9,mixedType,1
6,2,0,8,mixedType,1
5,4,0,9,mixedType,1
6,3,0,9,mixedType,1
10,6,0,16,mixedType,2
8,4,0,12,mixedType,1
6,1,0,7,mixedType,0
6,2,0,8,mixedType,1
7,3,0,10,mixedType,1
2,8,0,10,mixedType,1
7,3,0,10,mixedType,1
5,6,0,11,mixedType,1
2,6,0,8,mixedType,1
6,3,0,9,mixedType,1
6,1,0,7,mixedType,0
6,2,0,8,mixedType,1
4,2,0,6,mixedType,0
6,3,0,9,mixedType,1
6,1,0,7,mixedType,0
7,1,0,8,mixedType,1
19,1,1,21,mixedType,2
12,3,0,15,mixedType,2
5,5,0,10,mixedType,1
7,2,0,9,mixedType,1
8,4,0,12,mixedType,1
13,3,0,16,mixedType,2
6,4,0,10,mixedType,1
8,2,0,10,mixedType,1
5,1,0,6,mixedType,0
5,2,0,7,mixedType,0
12,4,0,16,mixedType,2
7,2,0,9,mixedType,1
5,1,0,6,mixedType,0
5,2,0,7,mixedType,0
8,2,0,10,mixedType,1
9,2,0,11,mixedType,1
5,3,0,8,mixedType,1
14,2,0,16,mixedType,2
4,6,0,10,mixedType,1
5,2,0,7,mixedType,0
2,6,0,8,mixedType,1
12,4,0,16,mixedType,2
6,2,0,8,mixedType,1
7,3,0,10,mixedType,1
10,1,0,11,mixedType,1
3,3,0,6,mixedType,0
7,3,0,10,mixedType,1
8,2,0,10,mixedType,1
6,2,0,8,mixedType,1
7,3,0,10,mixedType,1
14,2,0,16,mixedType,2
5,1,0,6,mixedType,0
8,2,0,10,mixedType,1
4,2,0,6,mixedType,0
6,2,0,8,mixedType,1
14,2,0,16,mixedType,2
5,2,0,7,mixedType,0
3,7,0,10,mixedType,1
12,1,0,13,mixedType,1
7,3,0,10,mixedType,1
6,3,0,9,mixedType,1
5,2,0,7,mixedType,0
11,2,0,13,mixedType,1
3,3,0,6,mixedType,0
2,8,0,10,mixedType,1
10,4,0,14,mixedType,2
1,9,0,10,mixedType,1
8,2,0,10,mixedType,1
7,3,0,10,mixedType,1
4,4,0,8,mixedType,1
9,1,0,10,mixedType,1
6,1,0,7,mixedType,0
9,1,0,10,mixedType,1
6,3,0,9,mixedType,1
4,5,0,9,mixedType,1
10,2,0,12,mixedType,1
14,2,0,16,mixedType,2
6,3,0,9,mixedType,1
5,2,0,7,mixedType,0
10,2,0,12,mixedType,1
7,3,0,10,mixedType,1
15,1,0,16,mixedType,2
13,3,0,16,mixedType,2
10,1,0,11,mixedType,1
9,1,0,10,mixedType,1
6,4,0,10,mixedType,1
6,3,0,9,mixedType,1
5,3,0,8,mixedType,1
4,4,0,8,mixedType,1
12,4,0,16,mixedType,2
12,4,0,16,mixedType,2
15,1,0,16,mixedType,2
4,8,2,14,mixedType,2
10,2,0,12,mixedType,1
4,6,0,10,mixedType,1
1,8,0,9,mixedType,1
4,4,0,8,mixedType,1
5,2,0,7,mixedType,0
7,4,0,11,mixedType,1
7,1,0,8,mixedType,1
9,1,0,10,mixedType,1
7,4,0,11,mixedType,1
7,3,0,10,mixedType,1
6,2,0,8,mixedType,1
2,6,0,8,mixedType,1
3,6,0,9,mixedType,1
6,1,0,7,mixedType,0
8,2,0,10,mixedType,1
8,3,0,11,mixedType,1
6,3,0,9,mixedType,1
8,2,0,10,mixedType,1
4,2,0,6,mixedType,0
8,3,0,11,mixedType,1
9,1,0,10,mixedType,1
6,2,0,8,mixedType,1
7,4,0,11,mixedType,1
9,1,0,10,mixedType,1
14,2,0,16,mixedType,2
7,2,0,9,mixedType,1
7,3,0,10,mixedType,1
10,4,1,15,mixedType,2
7,3,0,10,mixedType,1
8,2,0,10,mixedType,1
5,1,0,6,mixedType,0
8,1,0,9,mixedType,1
6,3,0,9,mixedType,1
7,3,0,10,mixedType,1
8,4,0,12,mixedType,1
6,4,0,10,mixedType,1
0,6,1,7,mixedType,0
6,2,0,8,mixedType,1
5,2,0,7,mixedType,0
7,1,0,8,mixedType,1
10,1,0,11,mixedType,1
5,3,0,8,mixedType,1
5,2,0,7,mixedType,0
4,2,0,6,mixedType,0
15,1,0,16,mixedType,2
8,1,0,9,mixedType,1
5,2,0,7,mixedType,0
8,1,0,9,mixedType,1
8,1,0,9,mixedType,1
6,4,0,10,mixedType,1
9,1,0,10,mixedType,1
3,11,0,14,mixedType,2
7,3,0,10,mixedType,1
4,8,0,12,mixedType,1
10,5,0,15,mixedType,2
7,2,0,9,mixedType,1
7,5,0,12,mixedType,1
6,3,0,9,mixedType,1
5,4,0,9,mixedType,1
5,4,0,9,mixedType,1
13,3,0,16,mixedType,2
7,2,0,9,mixedType,1
6,1,0,7,mixedType,0
7,4,0,11,mixedType,1
5,1,0,6,mixedType,0
7,3,0,10,mixedType,1
8,4,0,12,mixedType,1
7,3,0,10,mixedType,1
9,1,0,10,mixedType,1
6,3,0,9,mixedType,1
4,4,0,8,mixedType,1
6,4,0,10,mixedType,1
7,3,0,10,mixedType,1
6,2,0,8,mixedType,1
8,2,0,10,mixedType,1
9,1,0,10,mixedType,1
7,2,0,9,mixedType,1
7,2,0,9,mixedType,1
1,8,0,9,mixedType,1
3,9,0,12,mixedType,1
6,3,0,9,mixedType,1
7,3,0,10,mixedType,1
3,8,0,11,mixedType,1
4,2,0,6,mixedType,0
10,1,0,11,mixedType,1
8,2,0,10,mixedType,1
6,5,0,11,mixedType,1
6,1,0,7,mixedType,0
7,2,0,9,mixedType,1
6,1,0,7,mixedType,0
8,3,0,11,mixedType,1
6,3,0,9,mixedType,1
3,7,0,10,mixedType,1
5,3,0,8,mixedType,1
3,6,0,9,mixedType,1
5,4,0,9,mixedType,1
6,3,0,9,mixedType,1
8,2,0,10,mixedType,1
9,3,0,12,mixedType,1
6,3,0,9,mixedType,1
6,1,0,7,mixedType,0
4,4,0,8,mixedType,1
8,3,0,11,mixedType,1
5,3,0,8,mixedType,1
6,3,0,9,mixedType,1
6,4,0,10,mixedType,1
2,4,0,6,mixedType,0
4,4,0,8,mixedType,1
8,0,1,9,mixedType,1
4,4,0,8,mixedType,1
4,9,0,13,mixedType,1
8,1,0,9,mixedType,1
2,7,0,9,mixedType,1
5,3,0,8,mixedType,1
5,4,0,9,mixedType,1
6,3,0,9,mixedType,1
14,2,0,16,mixedType,2
8,0,2,10,mixedType,1
7,2,0,9,mixedType,1
5,1,0,6,mixedType,0
7,3,0,10,mixedType,1
7,4,0,11,mixedType,1
6,0,1,7,mixedType,0
5,4,0,9,mixedType,1
6,4,0,10,mixedType,1
5,3,0,8,mixedType,1
8,8,0,16,mixedType,2
7,1,0,8,mixedType,1
15,1,0,16,mixedType,2
5,2,0,7,mixedType,0
7,1,0,8,mixedType,1
6,3,0,9,mixedType,1
2,6,0,8,mixedType,1
5,2,0,7,mixedType,0
12,1,0,13,mixedType,1
5,1,0,6,mixedType,0
4,4,0,8,mixedType,1
9,1,0,10,mixedType,1
5,2,0,7,mixedType,0
6,1,0,7,mixedType,0
11,1,0,12,mixedType,1
5,1,0,6,mixedType,0
5,1,0,6,mixedType,0
6,3,0,9,mixedType,1
9,4,0,13,mixedType,1
7,1,0,8,mixedType,1
6,4,0,10,mixedType,1
6,3,0,9,mixedType,1
5,3,0,8,mixedType,1
13,3,0,16,mixedType,2
8,1,0,9,mixedType,1
6,3,0,9,mixedType,1
3,6,0,9,mixedType,1
6,1,0,7,mixedType,0
4,2,0,6,mixedType,0
4,2,0,6,mixedType,0
6,4,0,10,mixedType,1
5,3,0,8,mixedType,1
11,5,0,16,mixedType,2
2,8,0,10,mixedType,1
8,2,0,10,mixedType,1
12,1,0,13,mixedType,1
6,4,0,10,mixedType,1
3,3,0,6,mixedType,0
7,1,0,8,mixedType,1
11,2,0,13,mixedType,1
8,1,0,9,mixedType,1
6,5,0,11,mixedType,1
4,4,0,8,mixedType,1
7,2,0,9,mixedType,1
5,4,0,9,mixedType,1
9,2,0,11,mixedType,1
5,2,0,7,mixedType,0
12,3,0,15,mixedType,2
7,4,0,11,mixedType,1
3,6,0,9,mixedType,1
5,2,0,7,mixedType,0
5,3,0,8,mixedType,1
15,1,0,16,mixedType,2
5,4,0,9,mixedType,1
9,3,0,12,mixedType,1
5,2,0,7,mixedType,0
6,5,0,11,mixedType,1
5,3,0,8,mixedType,1
5,3,0,8,mixedType,1
8,2,0,10,mixedType,1
12,1,0,13,mixedType,1
2,6,0,8,mixedType,1
7,3,0,10,mixedType,1
5,2,0,7,mixedType,0
8,4,0,12,mixedType,1
6,1,0,7,mixedType,0
1,7,0,8,mixedType,1
5,2,0,7,mixedType,0
7,3,0,10,mixedType,1
6,3,0,9,mixedType,1
5,3,0,8,mixedType,1
7,2,0,9,mixedType,1
9,1,0,10,mixedType,1
6,1,0,7,mixedType,0
14,2,0,16,mixedType,2
15,1,0,16,mixedType,2
6,1,0,7,mixedType,0
8,3,0,11,mixedType,1
7,2,0,9,mixedType,1
6,6,0,12,mixedType,1
7,3,0,10,mixedType,1
8,1,0,9,mixedType,1
7,3,0,10,mixedType,1
7,3,0,10,mixedType,1
5,3,0,8,mixedType,1
12,3,0,15,mixedType,2
9,1,0,10,mixedType,1
7,3,0,10,mixedType,1
1,8,0,9,mixedType,1
6,1,0,7,mixedType,0
14,2,0,16,mixedType,2
5,2,0,7,mixedType,0
11,3,0,14,mixedType,2
4,2,0,6,mixedType,0
4,2,0,6,mixedType,0
14,2,0,16,mixedType,2
6,2,0,8,mixedType,1
2,8,0,10,mixedType,1
4,4,0,8,mixedType,1
6,2,0,8,mixedType,1
7,1,0,8,mixedType,1
7,3,0,10,mixedType,1
5,5,0,10,mixedType,1
6,6,0,12,mixedType,1
14,2,0,16,mixedType,2
13,3,0,16,mixedType,2
14,2,0,16,mixedType,2
5,2,0,7,mixedType,0
5,1,0,6,mixedType,0
3,6,0,9,mixedType,1
8,2,0,10,mixedType,1
6,3,0,9,mixedType,1
8,2,0,10,mixedType,1
6,3,0,9,mixedType,1
13,3,0,16,mixedType,2
7,3,0,10,mixedType,1
8,2,0,10,mixedType,1
8,3,0,11,mixedType,1
0,9,0,9,sameType,1
2,8,0,10,mixedType,1
4,2,0,6,mixedType,0
4,8,0,12,mixedType,1
4,6,0,10,mixedType,1
4,4,0,8,mixedType,1
4,6,0,10,mixedType,1
1,8,0,9,mixedType,1
6,2,0,8,mixedType,1
8,3,0,11,mixedType,1
7,3,0,10,mixedType,1
8,2,0,10,mixedType,1
13,3,0,16,mixedType,2
7,3,0,10,mixedType,1
14,2,0,16,mixedType,2
6,8,0,14,mixedType,2
6,1,0,7,mixedType,0
6,1,0,7,mixedType,0
5,7,0,12,mixedType,1
8,4,0,12,mixedType,1
1,8,0,9,mixedType,1
6,3,0,9,mixedType,1
2,8,0,10,mixedType,1
4,2,0,6,mixedType,0
2,7,0,9,mixedType,1
3,6,0,9,mixedType,1
4,5,0,9,mixedType,1
5,1,0,6,mixedType,0
7,3,0,10,mixedType,1
15,1,0,16,mixedType,2
12,3,0,15,mixedType,2
4,2,0,6,mixedType,0
9,1,0,10,mixedType,1
1,9,0,10,mixedType,1
6,3,0,9,mixedType,1
9,3,0,12,mixedType,1
10,1,0,11,mixedType,1
5,2,0,7,mixedType,0
5,4,0,9,mixedType,1
4,2,0,6,mixedType,0
14,2,0,16,mixedType,2
9,1,0,10,mixedType,1
12,4,0,16,mixedType,2
10,2,0,12,mixedType,1
12,4,0,16,mixedType,2
8,3,0,11,mixedType,1
5,2,0,7,mixedType,0
7,3,0,10,mixedType,1
6,4,0,10,mixedType,1
6,3,0,9,mixedType,1
8,1,0,9,mixedType,1
6,2,0,8,mixedType,1
5,2,0,7,mixedType,0
5,1,0,6,mixedType,0
6,3,0,9,mixedType,1
8,2,0,10,mixedType,1
7,2,0,9,mixedType,1
7,2,0,9,mixedType,1
7,2,0,9,mixedType,1
7,4,0,11,mixedType,1
6,3,0,9,mixedType,1
6,4,0,10,mixedType,1
6,4,0,10,mixedType,1
8,4,0,12,mixedType,1
8,2,0,10,mixedType,1
1,10,0,11,mixedType,1
8,1,0,9,mixedType,1
8,2,0,10,mixedType,1
1,8,0,9,mixedType,1
6,3,0,9,mixedType,1
7,2,0,9,mixedType,1
9,3,0,12,mixedType,1
6,1,0,7,mixedType,0
6,3,0,9,mixedType,1
12,4,0,16,mixedType,2
6,1,0,7,mixedType,0
4,2,0,6,mixedType,0
6,4,0,10,mixedType,1
8,2,0,10,mixedType,1
12,3,0,15,mixedType,2
8,2,0,10,mixedType,1
12,3,0,15,mixedType,2
7,3,0,10,mixedType,1
7,4,0,11,mixedType,1
12,3,0,15,mixedType,2
7,3,0,10,mixedType,1
13,3,0,16,mixedType,2
4,6,0,10,mixedType,1
7,2,0,9,mixedType,1
4,6,0,10,mixedType,1
4,4,0,8,mixedType,1
8,1,0,9,mixedType,1
15,1,0,16,mixedType,2
7,2,0,9,mixedType,1
3,8,0,11,mixedType,1
6,3,0,9,mixedType,1
5,3,0,8,mixedType,1
9,2,0,11,mixedType,1
2,8,0,10,mixedType,1
5,4,0,9,mixedType,1
6,3,0,9,mixedType,1
6,2,0,8,mixedType,1
5,4,0,9,mixedType,1
9,3,0,12,mixedType,1
6,4,0,10,mixedType,1
4,6,0,10,mixedType,1
15,1,0,16,mixedType,2
6,4,0,10,mixedType,1
2,8,0,10,mixedType,1
3,6,0,9,mixedType,1
5,3,0,8,mixedType,1
6,4,0,10,mixedType,1
6,3,0,9,mixedType,1
8,2,0,10,mixedType,1
7,1,0,8,mixedType,1
4,4,0,8,mixedType,1
4,2,0,6,mixedType,0
5,5,0,10,mixedType,1
7,2,0,9,mixedType,1
6,3,0,9,mixedType,1
6,1,0,7,mixedType,0
3,7,0,10,mixedType,1
7,3,0,10,mixedType,1
8,2,0,10,mixedType,1
4,4,0,8,mixedType,1
6,3,0,9,mixedType,1
5,3,0,8,mixedType,1
10,11,0,21,mixedType,2
6,1,0,7,mixedType,0
9,3,0,12,mixedType,1
2,6,0,8,mixedType,1
3,8,0,11,mixedType,1
5,3,0,8,mixedType,1
13,3,0,16,mixedType,2
4,7,0,11,mixedType,1
8,2,0,10,mixedType,1
6,4,0,10,mixedType,1
5,3,0,8,mixedType,1
5,1,0,6,mixedType,0
6,6,0,12,mixedType,1
5,3,0,8,mixedType,1
6,2,0,8,mixedType,1
7,5,0,12,mixedType,1
9,1,0,10,mixedType,1
6,3,0,9,mixedType,1
4,4,0,8,mixedType,1
6,5,0,11,mixedType,1
12,1,0,13,mixedType,1
13,3,0,16,mixedType,2
10,1,0,11,mixedType,1
3,3,0,6,mixedType,0
5,6,0,11,mixedType,1
5,2,0,7,mixedType,0
5,2,0,7,mixedType,0
6,2,0,8,mixedType,1
5,3,0,8,mixedType,1
7,8,0,15,mixedType,2
6,1,0,7,mixedType,0
2,7,0,9,mixedType,1
3,3,0,6,mixedType,0
5,4,0,9,mixedType,1
12,4,0,16,mixedType,2
2,7,0,9,mixedType,1
4,4,0,8,mixedType,1
7,2,0,9,mixedType,1
6,2,0,8,mixedType,1
4,2,0,6,mixedType,0
7,3,0,10,mixedType,1
4,4,0,8,mixedType,1
8,1,0,9,mixedType,1
6,2,0,8,mixedType,1
8,1,0,9,mixedType,1
8,2,0,10,mixedType,1
8,2,0,10,mixedType,1
5,3,0,8,mixedType,1
6,1,0,7,mixedType,0
4,2,0,6,mixedType,0
7,3,0,10,mixedType,1
5,3,0,8,mixedType,1
6,3,0,9,mixedType,1
11,3,0,14,mixedType,2
3,6,0,9,mixedType,1
1,10,0,11,mixedType,1
10,2,0,12,mixedType,1
6,2,0,8,mixedType,1
5,2,0,7,mixedType,0
8,4,0,12,mixedType,1
7,3,0,10,mixedType,1
8,1,0,9,mixedType,1
7,3,0,10,mixedType,1
3,6,0,9,mixedType,1
4,6,0,10,mixedType,1
8,1,0,9,mixedType,1
6,1,0,7,mixedType,0
14,2,0,16,mixedType,2
6,3,0,9,mixedType,1
7,3,0,10,mixedType,1
6,3,0,9,mixedType,1
8,1,0,9,mixedType,1
6,1,0,7,mixedType,0
9,1,0,10,mixedType,1
8,2,0,10,mixedType,1
6,2,0,8,mixedType,1
12,1,0,13,mixedType,1
3,5,0,8,mixedType,1
14,2,0,16,mixedType,2
12,3,0,15,mixedType,2
10,6,0,16,mixedType,2
6,2,0,8,mixedType,1
8,2,0,10,mixedType,1
7,3,0,10,mixedType,1
15,1,0,16,mixedType,2
6,1,0,7,mixedType,0
11,3,0,14,mixedType,2
10,2,0,12,mixedType,1
14,2,0,16,mixedType,2
6,3,0,9,mixedType,1
7,4,0,11,mixedType,1
8,2,0,10,mixedType,1
3,7,0,10,mixedType,1
5,3,0,8,mixedType,1
4,5,0,9,mixedType,1
11,2,0,13,mixedType,1
9,3,0,12,mixedType,1
6,4,0,10,mixedType,1
9,2,0,11,mixedType,1
13,3,0,16,mixedType,2
14,2,0,16,mixedType,2
6,3,0,9,mixedType,1
6,5,0,11,mixedType,1
10,2,0,12,mixedType,1
12,1,0,13,mixedType,1
8,2,0,10,mixedType,1
15,1,0,16,mixedType,2
1,8,0,9,mixedType,1
13,3,0,16,mixedType,2
7,4,0,11,mixedType,1
5,3,0,8,mixedType,1
5,3,0,8,mixedType,1
5,5,0,10,mixedType,1
7,4,0,11,mixedType,1
5,3,0,8,mixedType,1
7,2,0,9,mixedType,1
6,3,0,9,mixedType,1
7,3,0,10,mixedType,1
4,2,0,6,mixedType,0
4,6,0,10,mixedType,1
0,9,1,10,mixedType,1
5,2,0,7,mixedType,0
5,4,0,9,mixedType,1
8,3,0,11,mixedType,1
7,2,0,9,mixedType,1
12,4,0,16,mixedType,2
1,12,0,13,mixedType,1
2,10,0,12,mixedType,1
6,2,0,8,mixedType,1
7,3,0,10,mixedType,1
9,2,0,11,mixedType,1
8,2,0,10,mixedType,1
11,3,0,14,mixedType,2
4,8,0,12,mixedType,1
6,3,0,9,mixedType,1
8,1,0,9,mixedType,1
9,1,0,10,mixedType,1
4,4,0,8,mixedType,1
10,1,0,11,mixedType,1
6,2,0,8,mixedType,1
7,3,0,10,mixedType,1
4,8,0,12,mixedType,1
6,4,0,10,mixedType,1
6,3,0,9,mixedType,1
7,2,0,9,mixedType,1
6,3,0,9,mixedType,1
8,1,0,9,mixedType,1
6,3,0,9,mixedType,1
7,3,0,10,mixedType,1
7,1,0,8,mixedType,1
6,8,0,14,mixedType,2
4,4,0,8,mixedType,1
7,4,0,11,mixedType,1
6,1,0,7,mixedType,0
8,2,0,10,mixedType,1
7,3,0,10,mixedType,1
6,1,0,7,mixedType,0
2,4,0,6,mixedType,0
4,4,0,8,mixedType,1
6,1,0,7,mixedType,0
2,4,0,6,mixedType,0
6,4,0,10,mixedType,1
4,4,0,8,mixedType,1
6,3,0,9,mixedType,1
4,2,0,6,mixedType,0
7,3,0,10,mixedType,1
4,2,0,6,mixedType,0
7,1,0,8,mixedType,1
9,1,0,10,mixedType,1
15,1,0,16,mixedType,2
8,1,0,9,mixedType,1
6,2,0,8,mixedType,1
9,1,0,10,mixedType,1
8,3,0,11,mixedType,1
7,2,0,9,mixedType,1
5,3,0,8,mixedType,1
8,2,0,10,mixedType,1
4,4,0,8,mixedType,1
5,3,0,8,mixedType,1
14,2,0,16,mixedType,2
6,3,0,9,mixedType,1
12,4,0,16,mixedType,2
4,4,0,8,mixedType,1
7,3,0,10,mixedType,1
5,4,0,9,mixedType,1
2,6,0,8,mixedType,1
10,1,0,11,mixedType,1
10,3,0,13,mixedType,1
6,2,0,8,mixedType,1
10,1,0,11,mixedType,1
13,3,0,16,mixedType,2
14,2,0,16,mixedType,2
5,3,0,8,mixedType,1
6,3,0,9,mixedType,1
13,3,0,16,mixedType,2
11,3,0,14,mixedType,2
7,3,0,10,mixedType,1
18,1,1,20,mixedType,2
6,1,0,7,mixedType,0
14,2,0,16,mixedType,2
3,7,0,10,mixedType,1
8,2,0,10,mixedType,1
11,5,0,16,mixedType,2
5,6,0,11,mixedType,1
2,7,0,9,mixedType,1
14,2,0,16,mixedType,2
6,4,0,10,mixedType,1
7,3,0,10,mixedType,1
6,4,0,10,mixedType,1
8,2,0,10,mixedType,1
11,3,0,14,mixedType,2
3,3,0,6,mixedType,0
8,2,0,10,mixedType,1
5,3,0,8,mixedType,1
1,8,0,9,mixedType,1
6,2,0,8,mixedType,1
5,1,0,6,mixedType,0
9,1,0,10,mixedType,1
6,2,0,8,mixedType,1
5,3,0,8,mixedType,1
7,1,0,8,mixedType,1
5,1,0,6,mixedType,0
5,3,0,8,mixedType,1
2,6,0,8,mixedType,1
10,3,0,13,mixedType,1
5,1,0,6,mixedType,0
7,2,0,9,mixedType,1
7,2,0,9,mixedType,1
6,1,0,7,mixedType,0
4,4,0,8,mixedType,1
6,3,0,9,mixedType,1
6,2,0,8,mixedType,1
7,4,0,11,mixedType,1
6,0,1,7,mixedType,0
6,4,0,10,mixedType,1
12,4,0,16,mixedType,2
10,1,0,11,mixedType,1
7,4,3,14,mixedType,2
6,3,0,9,mixedType,1
5,2,0,7,mixedType,0
10,2,0,12,mixedType,1
6,1,0,7,mixedType,0
6,4,0,10,mixedType,1
7,2,0,9,mixedType,1
8,2,0,10,mixedType,1
9,1,0,10,mixedType,1
6,3,0,9,mixedType,1
6,3,0,9,mixedType,1
4,5,0,9,mixedType,1
4,2,0,6,mixedType,0
7,1,0,8,mixedType,1
8,4,0,12,mixedType,1
7,3,0,10,mixedType,1
6,2,0,8,mixedType,1
11,2,0,13,mixedType,1
7,3,0,10,mixedType,1
10,1,0,11,mixedType,1
7,3,0,10,mixedType,1
9,3,0,12,mixedType,1
1,9,0,10,mixedType,1
6,3,0,9,mixedType,1
7,1,0,8,mixedType,1
8,4,0,12,mixedType,1
6,2,0,8,mixedType,1
5,2,0,7,mixedType,0
5,2,0,7,mixedType,0
8,2,0,10,mixedType,1
8,4,0,12,mixedType,1
6,3,0,9,mixedType,1
8,2,0,10,mixedType,1
6,4,0,10,mixedType,1
9,4,0,13,mixedType,1
11,3,0,14,mixedType,2
6,3,0,9,mixedType,1
15,1,0,16,mixedType,2
8,5,0,13,mixedType,1
12,4,0,16,mixedType,2
7,4,0,11,mixedType,1
7,3,0,10,mixedType,1
7,1,0,8,mixedType,1
8,5,0,13,mixedType,1
9,1,0,10,mixedType,1
6,1,0,7,mixedType,0
6,2,0,8,mixedType,1
6,1,0,7,mixedType,0
12,3,0,15,mixedType,2
2,8,0,10,mixedType,1
5,1,0,6,mixedType,0
5,2,0,7,mixedType,0
5,4,0,9,mixedType,1
5,6,0,11,mixedType,1
8,1,0,9,mixedType,1
4,4,0,8,mixedType,1
7,2,0,9,mixedType,1
7,1,0,8,mixedType,1
8,2,0,10,mixedType,1
9,4,0,13,mixedType,1
0,6,1,7,mixedType,0
7,3,0,10,mixedType,1
8,2,0,10,mixedType,1
3,6,0,9,mixedType,1
6,2,0,8,mixedType,1
8,3,0,11,mixedType,1
5,2,0,7,mixedType,0
9,6,0,15,mixedType,2
7,3,0,10,mixedType,1
8,1,0,9,mixedType,1
7,3,0,10,mixedType,1
5,3,0,8,mixedType,1
2,6,0,8,mixedType,1
10,6,0,16,mixedType,2
7,3,0,10,mixedType,1
5,2,0,7,mixedType,0
7,3,0,10,mixedType,1
3,3,0,6,mixedType,0
5,3,0,8,mixedType,1
12,3,0,15,mixedType,2
9,1,0,10,mixedType,1
7,3,0,10,mixedType,1
6,1,0,7,mixedType,0
14,2,0,16,mixedType,2
7,1,0,8,mixedType,1
14,2,0,16,mixedType,2
6,4,0,10,mixedType,1
10,1,0,11,mixedType,1
6,1,0,7,mixedType,0
8,2,0,10,mixedType,1
15,1,0,16,mixedType,2
6,2,0,8,mixedType,1
11,3,0,14,mixedType,2
7,3,0,10,mixedType,1
5,2,0,7,mixedType,0
4,4,0,8,mixedType,1
8,2,0,10,mixedType,1
1,9,0,10,mixedType,1
6,4,0,10,mixedType,1
8,4,0,12,mixedType,1
7,1,0,8,mixedType,1
5,3,0,8,mixedType,1
9,1,0,10,mixedType,1
7,0,0,7,sameType,0
5,6,0,11,mixedType,1
6,2,0,8,mixedType,1
9,2,0,11,mixedType,1
7,2,0,9,mixedType,1
6,1,0,7,mixedType,0
15,1,0,16,mixedType,2
6,1,0,7,mixedType,0
5,4,0,9,mixedType,1
9,5,0,14,mixedType,2
5,8,0,13,mixedType,1
2,4,0,6,mixedType,0
14,2,0,16,mixedType,2
15,3,0,18,mixedType,2
6,3,0,9,mixedType,1
5,2,0,7,mixedType,0
7,2,0,9,mixedType,1
8,4,0,12,mixedType,1
9,1,0,10,mixedType,1
2,6,0,8,mixedType,1
14,2,0,16,mixedType,2
6,1,0,7,mixedType,0
3,6,0,9,mixedType,1
5,6,0,11,mixedType,1
9,1,0,10,mixedType,1
8,1,0,9,mixedType,1
13,1,1,15,mixedType,2
5,2,0,7,mixedType,0
6,4,0,10,mixedType,1
8,2,0,10,mixedType,1
8,1,0,9,mixedType,1
1,8,0,9,mixedType,1
6,1,0,7,mixedType,0
5,3,0,8,mixedType,1
8,4,0,12,mixedType,1
7,2,0,9,mixedType,1
2,6,0,8,mixedType,1
6,6,0,12,mixedType,1
6,4,0,10,mixedType,1
5,4,0,9,mixedType,1
8,2,0,10,mixedType,1
9,3,0,12,mixedType,1
8,1,0,9,mixedType,1
13,3,0,16,mixedType,2
2,4,0,6,mixedType,0
3,7,0,10,mixedType,1
3,6,0,9,mixedType,1
7,5,0,12,mixedType,1
6,3,0,9,mixedType,1
7,4,0,11,mixedType,1
9,1,0,10,mixedType,1
4,4,0,8,mixedType,1
7,3,0,10,mixedType,1
14,2,0,16,mixedType,2
8,3,0,11,mixedType,1
7,3,0,10,mixedType,1
6,4,0,10,mixedType,1
4,2,0,6,mixedType,0
7,2,0,9,mixedType,1
6,4,0,10,mixedType,1
7,4,0,11,mixedType,1
11,3,0,14,mixedType,2
6,3,0,9,mixedType,1
5,2,0,7,mixedType,0
3,3,0,6,mixedType,0
7,2,0,9,mixedType,1
0,8,1,9,mixedType,1
7,3,0,10,mixedType,1
6,3,0,9,mixedType,1
4,4,0,8,mixedType,1
2,4,0,6,mixedType,0
5,3,0,8,mixedType,1
8,4,0,12,mixedType,1
1,8,0,9,mixedType,1
7,2,0,9,mixedType,1
1,7,0,8,mixedType,1
6,0,1,7,mixedType,0
8,3,0,11,mixedType,1
4,5,0,9,mixedType,1
7,3,0,10,mixedType,1
5,2,0,7,mixedType,0
3,6,0,9,mixedType,1
7,2,0,9,mixedType,1
5,2,0,7,mixedType,0
5,3,0,8,mixedType,1
6,1,0,7,mixedType,0
6,6,0,12,mixedType,1
4,2,0,6,mixedType,0
5,3,0,8,mixedType,1
7,2,0,9,mixedType,1
4,6,0,10,mixedType,1
6,8,0,14,mixedType,2
13,3,0,16,mixedType,2
6,3,0,9,mixedType,1
3,5,0,8,mixedType,1
12,1,0,13,mixedType,1
7,1,0,8,mixedType,1
9,2,0,11,mixedType,1
7,2,0,9,mixedType,1
1,8,0,9,mixedType,1
8,1,0,9,mixedType,1
8,3,0,11,mixedType,1
5,2,0,7,mixedType,0
10,2,0,12,mixedType,1
5,2,0,7,mixedType,0
7,2,0,9,mixedType,1
5,3,0,8,mixedType,1
9,3,0,12,mixedType,1
7,3,0,10,mixedType,1
3,7,0,10,mixedType,1
7,2,0,9,mixedType,1
8,2,0,10,mixedType,1
5,4,0,9,mixedType,1
14,2,0,16,mixedType,2
13,3,0,16,mixedType,2
7,3,0,10,mixedType,1
7,3,0,10,mixedType,1
8,2,0,10,mixedType,1
8,4,0,12,mixedType,1
12,3,0,15,mixedType,2
13,2,0,15,mixedType,2
7,3,0,10,mixedType,1
8,1,0,9,mixedType,1
5,3,0,8,mixedType,1
4,6,0,10,mixedType,1
3,6,0,9,mixedType,1
6,5,0,11,mixedType,1
7,3,0,10,mixedType,1
4,4,0,8,mixedType,1
6,1,0,7,mixedType,0
7,1,0,8,mixedType,1
6,3,0,9,mixedType,1
9,3,0,12,mixedType,1
15,1,0,16,mixedType,2
5,2,0,7,mixedType,0
3,6,0,9,mixedType,1
8,8,0,16,mixedType,2
8,2,0,10,mixedType,1
5,3,0,8,mixedType,1
5,3,0,8,mixedType,1
7,2,0,9,mixedType,1
1,8,0,9,mixedType,1
5,1,0,6,mixedType,0
6,2,0,8,mixedType,1
1,8,0,9,mixedType,1
4,6,0,10,mixedType,1
6,2,0,8,mixedType,1
6,3,0,9,mixedType,1
7,6,0,13,mixedType,1
7,3,0,10,mixedType,1
15,1,0,16,mixedType,2
8,2,0,10,mixedType,1
5,2,0,7,mixedType,0
11,3,0,14,mixedType,2
4,4,0,8,mixedType,1
7,3,0,10,mixedType,1
4,2,0,6,mixedType,0
5,3,0,8,mixedType,1
8,1,0,9,mixedType,1
8,3,0,11,mixedType,1
7,3,0,10,mixedType,1
6,3,0,9,mixedType,1
6,1,0,7,mixedType,0
2,6,0,8,mixedType,1
15,1,0,16,mixedType,2
6,4,0,10,mixedType,1
8,2,0,10,mixedType,1
3,6,0,9,mixedType,1
8,1,0,9,mixedType,1
10,3,0,13,mixedType,1
3,3,0,6,mixedType,0
9,3,0,12,mixedType,1
7,3,0,10,mixedType,1
0,6,0,6,sameType,0
8,1,0,9,mixedType,1
6,2,0,8,mixedType,1
5,3,0,8,mixedType,1
7,3,0,10,mixedType,1
5,3,0,8,mixedType,1
5,3,0,8,mixedType,1
7,2,0,9,mixedType,1
5,4,0,9,mixedType,1
6,3,0,9,mixedType,1
7,2,0,9,mixedType,1
5,2,0,7,mixedType,0
7,6,0,13,mixedType,1
11,3,0,14,mixedType,2
1,7,0,8,mixedType,1
7,2,0,9,mixedType,1
7,2,0,9,mixedType,1
15,1,0,16,mixedType,2
9,2,0,11,mixedType,1
4,7,0,11,mixedType,1
8,1,0,9,mixedType,1
9,4,0,13,mixedType,1
6,1,0,7,mixedType,0
14,2,0,16,mixedType,2
6,3,0,9,mixedType,1
4,2,0,6,mixedType,0
6,4,0,10,mixedType,1
10,3,0,13,mixedType,1
4,2,0,6,mixedType,0
6,1,0,7,mixedType,0
5,5,0,10,mixedType,1
5,3,0,8,mixedType,1
6,4,0,10,mixedType,1
5,2,0,7,mixedType,0
7,1,0,8,mixedType,1
8,2,0,10,mixedType,1
6,2,0,8,mixedType,1
6,3,0,9,mixedType,1
7,2,0,9,mixedType,1
5,3,0,8,mixedType,1
6,3,0,9,mixedType,1
7,3,0,10,mixedType,1
3,5,0,8,mixedType,1
14,2,0,16,mixedType,2
7,2,0,9,mixedType,1
6,3,0,9,mixedType,1
7,3,0,10,mixedType,1
1,8,0,9,mixedType,1
5,3,0,8,mixedType,1
7,2,0,9,mixedType,1
9,2,0,11,mixedType,1
7,3,0,10,mixedType,1
15,1,0,16,mixedType,2
2,6,0,8,mixedType,1
6,3,0,9,mixedType,1
7,8,0,15,mixedType,2
7,3,0,10,mixedType,1
13,4,0,17,mixedType,2
13,3,0,16,mixedType,2
7,3,0,10,mixedType,1
6,8,0,14,mixedType,2
4,4,0,8,mixedType,1
3,6,0,9,mixedType,1
7,2,0,9,mixedType,1
2,7,0,9,mixedType,1
6,6,0,12,mixedType,1
14,2,0,16,mixedType,2
5,3,0,8,mixedType,1
8,1,0,9,mixedType,1
8,1,0,9,mixedType,1
7,2,0,9,mixedType,1
14,2,0,16,mixedType,2
9,2,0,11,mixedType,1
6,6,0,12,mixedType,1
7,3,0,10,mixedType,1
7,3,0,10,mixedType,1
7,2,0,9,mixedType,1
7,4,0,11,mixedType,1
4,2,0,6,mixedType,0
4,4,0,8,mixedType,1
3,3,0,6,mixedType,0
7,2,0,9,mixedType,1
1,8,0,9,mixedType,1
5,2,0,7,mixedType,0
8,2,0,10,mixedType,1
6,7,0,13,mixedType,1
6,2,0,8,mixedType,1
7,4,0,11,mixedType,1
15,1,0,16,mixedType,2
6,6,0,12,mixedType,1
5,7,0,12,mixedType,1
6,3,0,9,mixedType,1
3,7,0,10,mixedType,1
7,3,0,10,mixedType,1
4,7,0,11,mixedType,1
8,1,0,9,mixedType,1
2,6,0,8,mixedType,1
4,2,0,6,mixedType,0
1,7,0,8,mixedType,1
5,1,0,6,mixedType,0
6,2,0,8,mixedType,1
13,3,0,16,mixedType,2
2,4,0,6,mixedType,0
1,9,0,10,mixedType,1
5,3,0,8,mixedType,1
7,3,0,10,mixedType,1
9,3,0,12,mixedType,1
7,3,0,10,mixedType,1
2,8,0,10,mixedType,1
6,3,0,9,mixedType,1
10,1,0,11,mixedType,1
8,1,0,9,mixedType,1
5,3,0,8,mixedType,1
6,2,0,8,mixedType,1
7,1,0,8,mixedType,1
9,1,0,10,mixedType,1
12,4,0,16,mixedType,2
6,3,0,9,mixedType,1
5,1,0,6,mixedType,0
9,1,0,10,mixedType,1
6,1,0,7,mixedType,0
7,2,0,9,mixedType,1
6,1,0,7,mixedType,0
6,1,0,7,mixedType,0
7,3,0,10,mixedType,1
5,2,0,7,mixedType,0
7,1,0,8,mixedType,1
7,2,0,9,mixedType,1
0,11,1,12,mixedType,1
6,3,0,9,mixedType,1
16,1,1,18,mixedType,2
5,2,0,7,mixedType,0
4,4,0,8,mixedType,1
2,8,0,10,mixedType,1
3,7,0,10,mixedType,1
4,7,0,11,mixedType,1
6,2,0,8,mixedType,1
6,2,0,8,mixedType,1
7,1,0,8,mixedType,1
4,6,0,10,mixedType,1
6,1,0,7,mixedType,0
4,5,0,9,mixedType,1
7,1,0,8,mixedType,1
8,4,0,12,mixedType,1
15,1,0,16,mixedType,2
9,1,0,10,mixedType,1
4,4,0,8,mixedType,1
4,4,0,8,mixedType,1
11,1,0,12,mixedType,1
4,4,0,8,mixedType,1
3,8,0,11,mixedType,1
11,4,0,15,mixedType,2
4,4,0,8,mixedType,1
7,3,0,10,mixedType,1
10,3,0,13,mixedType,1
13,3,0,16,mixedType,2
8,2,0,10,mixedType,1
15,1,0,16,mixedType,2
5,1,0,6,mixedType,0
6,1,0,7,mixedType,0
6,4,0,10,mixedType,1
5,2,0,7,mixedType,0
3,6,0,9,mixedType,1
14,2,0,16,mixedType,2
8,3,0,11,mixedType,1
16,0,1,17,mixedType,2
7,1,0,8,mixedType,1
4,8,0,12,mixedType,1
6,2,0,8,mixedType,1
6,0,8,14,mixedType,2
6,1,0,7,mixedType,0
5,4,0,9,mixedType,1
3,6,0,9,mixedType,1
6,2,0,8,mixedType,1
6,3,0,9,mixedType,1
5,3,0,8,mixedType,1
8,4,0,12,mixedType,1
6,2,0,8,mixedType,1
6,8,0,14,mixedType,2
6,4,0,10,mixedType,1
6,4,0,10,mixedType,1
13,3,0,16,mixedType,2
8,1,0,9,mixedType,1
5,3,0,8,mixedType,1
11,3,0,14,mixedType,2
8,3,0,11,mixedType,1
12,4,0,16,mixedType,2
5,4,0,9,mixedType,1
14,2,0,16,mixedType,2
13,3,0,16,mixedType,2
1,8,0,9,mixedType,1
8,1,0,9,mixedType,1
8,2,0,10,mixedType,1
4,7,0,11,mixedType,1
7,3,0,10,mixedType,1
7,2,0,9,mixedType,1
9,1,0,10,mixedType,1
6,3,0,9,mixedType,1
8,2,0,10,mixedType,1
9,3,0,12,mixedType,1
6,3,0,9,mixedType,1
6,1,0,7,mixedType,0
9,3,0,12,mixedType,1
8,2,0,10,mixedType,1
11,3,0,14,mixedType,2
14,2,0,16,mixedType,2
7,1,0,8,mixedType,1
4,6,0,10,mixedType,1
4,2,0,6,mixedType,0
13,3,0,16,mixedType,2
5,2,0,7,mixedType,0
5,3,0,8,mixedType,1
3,5,0,8,mixedType,1
4,2,0,6,mixedType,0
6,1,0,7,mixedType,0
12,1,0,13,mixedType,1
10,3,0,13,mixedType,1
4,2,0,6,mixedType,0
3,5,0,8,mixedType,1
7,8,0,15,mixedType,2
7,2,0,9,mixedType,1
4,2,0,6,mixedType,0
8,2,0,10,mixedType,1
7,3,0,10,mixedType,1
5,1,0,6,mixedType,0
13,3,0,16,mixedType,2
4,4,0,8,mixedType,1
3,7,0,10,mixedType,1
6,3,0,9,mixedType,1
7,2,0,9,mixedType,1
6,4,0,10,mixedType,1
6,3,0,9,mixedType,1
8,2,0,10,mixedType,1
15,1,0,16,mixedType,2
7,3,0,10,mixedType,1
7,3,0,10,mixedType,1
14,2,0,16,mixedType,2
9,1,0,10,mixedType,1
7,4,0,11,mixedType,1
5,6,0,11,mixedType,1
12,4,0,16,mixedType,2
5,3,0,8,mixedType,1
6,2,0,8,mixedType,1
7,3,0,10,mixedType,1
6,0,3,9,mixedType,1
4,4,0,8,mixedType,1
2,6,0,8,mixedType,1
12,9,1,22,mixedType,2
13,2,0,15,mixedType,2
6,1,0,7,mixedType,0
7,2,0,9,mixedType,1
9,4,0,13,mixedType,1
6,4,0,10,mixedType,1
7,2,0,9,mixedType,1
9,3,0,12,mixedType,1
9,4,0,13,mixedType,1
15,1,0,16,mixedType,2
8,2,0,10,mixedType,1
8,2,0,10,mixedType,1
2,10,0,12,mixedType,1
10,3,0,13,mixedType,1
8,3,0,11,mixedType,1
7,2,0,9,mixedType,1
3,3,0,6,mixedType,0
3,5,0,8,mixedType,1
9,1,0,10,mixedType,1
8,3,0,11,mixedType,1
2,7,0,9,mixedType,1
15,1,0,16,mixedType,2
9,1,0,10,mixedType,1
4,4,0,8,mixedType,1
6,3,0,9,mixedType,1
10,2,0,12,mixedType,1
6,4,0,10,mixedType,1
4,8,0,12,mixedType,1
8,3,0,11,mixedType,1
8,5,0,13,mixedType,1
6,1,0,7,mixedType,0
8,1,0,9,mixedType,1
8,1,0,9,mixedType,1
6,2,0,8,mixedType,1
7,5,0,12,mixedType,1
8,1,0,9,mixedType,1
7,2,0,9,mixedType,1
8,1,0,9,mixedType,1
4,4,0,8,mixedType,1
15,1,0,16,mixedType,2
5,6,0,11,mixedType,1
6,3,0,9,mixedType,1
6,3,0,9,mixedType,1
3,8,0,11,mixedType,1
7,2,0,9,mixedType,1
1,7,0,8,mixedType,1
12,4,0,16,mixedType,2
5,4,0,9,mixedType,1
6,3,0,9,mixedType,1
6,2,0,8,mixedType,1
7,3,0,10,mixedType,1
5,4,0,9,mixedType,1
3,8,0,11,mixedType,1
6,4,0,10,mixedType,1
4,4,0,8,mixedType,1
6,4,0,10,mixedType,1
1,8,0,9,mixedType,1
3,6,0,9,mixedType,1
2,4,0,6,mixedType,0
4,4,0,8,mixedType,1
7,3,0,10,mixedType,1
7,3,0,10,mixedType,1
4,5,0,9,mixedType,1
8,2,0,10,mixedType,1
5,0,4,9,mixedType,1
8,2,0,10,mixedType,1
7,3,0,10,mixedType,1
6,2,0,8,mixedType,1
6,3,0,9,mixedType,1
12,4,0,16,mixedType,2
5,2,0,7,mixedType,0
8,1,0,9,mixedType,1
6,2,0,8,mixedType,1
4,8,0,12,mixedType,1
6,4,0,10,mixedType,1
13,3,0,16,mixedType,2
14,2,0,16,mixedType,2
5,1,0,6,mixedType,0
6,3,0,9,mixedType,1
8,1,0,9,mixedType,1
5,3,0,8,mixedType,1
3,3,0,6,mixedType,0
9,1,0,10,mixedType,1
15,1,0,16,mixedType,2
5,6,0,11,mixedType,1
3,10,0,13,mixedType,1
2,7,0,9,mixedType,1
8,2,0,10,mixedType,1
8,1,0,9,mixedType,1
7,2,0,9,mixedType,1
4,2,0,6,mixedType,0
8,2,0,10,mixedType,1
9,4,1,14,mixedType,2
5,2,0,7,mixedType,0
3,9,0,12,mixedType,1
1,10,0,11,mixedType,1
12,4,0,16,mixedType,2
15,1,0,16,mixedType,2
16,3,0,19,mixedType,2
6,3,0,9,mixedType,1
6,3,0,9,mixedType,1
2,9,0,11,mixedType,1
7,3,0,10,mixedType,1
4,4,0,8,mixedType,1
6,2,0,8,mixedType,1
9,1,0,10,mixedType,1
8,4,0,12,mixedType,1
8,2,0,10,mixedType,1
8,1,0,9,mixedType,1
5,2,0,7,mixedType,0
11,4,0,15,mixedType,2
7,3,0,10,mixedType,1
10,1,0,11,mixedType,1
3,6,0,9,mixedType,1
4,4,0,8,mixedType,1
8,4,0,12,mixedType,1
6,1,0,7,mixedType,0
11,5,0,16,mixedType,2
4,6,0,10,mixedType,1
6,3,0,9,mixedType,1
6,3,0,9,mixedType,1
3,7,0,10,mixedType,1
8,2,0,10,mixedType,1
5,4,0,9,mixedType,1
4,2,0,6,mixedType,0
15,1,0,16,mixedType,2
4,2,0,6,mixedType,0
2,4,0,6,mixedType,0
4,5,0,9,mixedType,1
4,6,0,10,mixedType,1
9,3,0,12,mixedType,1
6,2,0,8,mixedType,1
7,3,0,10,mixedType,1
12,3,0,15,mixedType,2
6,4,0,10,mixedType,1
3,6,0,9,mixedType,1
4,6,0,10,mixedType,1
8,3,0,11,mixedType,1
15,1,0,16,mixedType,2
7,2,0,9,mixedType,1
10,2,0,12,mixedType,1
5,3,0,8,mixedType,1
12,4,0,16,mixedType,2
7,3,0,10,mixedType,1
8,2,0,10,mixedType,1
6,2,0,8,mixedType,1
6,1,0,7,mixedType,0
7,3,0,10,mixedType,1
7,2,0,9,mixedType,1
7,2,0,9,mixedType,1
12,3,0,15,mixedType,2
5,3,0,8,mixedType,1
5,7,0,12,mixedType,1
6,4,0,10,mixedType,1
7,2,0,9,mixedType,1
8,4,0,12,mixedType,1
8,2,0,10,mixedType,1
3,5,0,8,mixedType,1
5,1,0,6,mixedType,0
8,1,0,9,mixedType,1
6,3,0,9,mixedType,1
5,4,0,9,mixedType,1
7,2,0,9,mixedType,1
10,2,0,12,mixedType,1
5,2,0,7,mixedType,0
7,3,0,10,mixedType,1
7,4,0,11,mixedType,1
8,4,0,12,mixedType,1
6,2,0,8,mixedType,1
11,1,0,12,mixedType,1
4,4,0,8,mixedType,1
9,2,0,11,mixedType,1
5,2,0,7,mixedType,0
6,2,0,8,mixedType,1
5,4,0,9,mixedType,1
15,1,0,16,mixedType,2
6,2,0,8,mixedType,1
13,3,0,16,mixedType,2
6,6,0,12,mixedType,1
9,3,0,12,mixedType,1
2,4,0,6,mixedType,0
5,4,0,9,mixedType,1
4,6,0,10,mixedType,1
7,3,0,10,mixedType,1
5,7,0,12,mixedType,1
6,10,0,16,mixedType,2
4,4,0,8,mixedType,1
6,4,0,10,mixedType,1
6,1,0,7,mixedType,0
6,4,0,10,mixedType,1
4,2,0,6,mixedType,0
5,3,0,8,mixedType,1
6,3,0,9,mixedType,1
8,3,0,11,mixedType,1
4,6,0,10,mixedType,1
5,4,0,9,mixedType,1
8,1,0,9,mixedType,1
8,2,0,10,mixedType,1
4,5,0,9,mixedType,1
7,2,0,9,mixedType,1
6,3,0,9,mixedType,1
6,4,0,10,mixedType,1
7,2,0,9,mixedType,1
5,6,0,11,mixedType,1
3,6,0,9,mixedType,1
6,3,0,9,mixedType,1
3,7,0,10,mixedType,1
5,2,0,7,mixedType,0
14,2,0,16,mixedType,2
12,4,0,16,mixedType,2
8,2,0,10,mixedType,1
1,12,0,13,mixedType,1
6,1,0,7,mixedType,0
2,6,0,8,mixedType,1
4,2,0,6,mixedType,0
6,3,0,9,mixedType,1
6,2,0,8,mixedType,1
6,7,0,13,mixedType,1
5,3,0,8,mixedType,1
3,3,0,6,mixedType,0
6,6,6,18,mixedType,2
1,8,0,9,mixedType,1
12,1,0,13,mixedType,1
13,3,0,16,mixedType,2
9,3,0,12,mixedType,1
14,2,0,16,mixedType,2
7,1,0,8,mixedType,1
8,3,0,11,mixedType,1
5,2,0,7,mixedType,0
15,1,0,16,mixedType,2
10,2,0,12,mixedType,1
7,3,0,10,mixedType,1
3,5,0,8,mixedType,1
6,1,0,7,mixedType,0
6,4,0,10,mixedType,1
8,2,0,10,mixedType,1
7,3,0,10,mixedType,1
4,2,0,6,mixedType,0
2,6,0,8,mixedType,1
3,5,0,8,mixedType,1
11,2,0,13,mixedType,1
6,2,0,8,mixedType,1
13,3,0,16,mixedType,2
15,1,0,16,mixedType,2
7,4,0,11,mixedType,1
8,1,0,9,mixedType,1
4,6,0,10,mixedType,1
15,1,0,16,mixedType,2
3,5,0,8,mixedType,1
6,4,0,10,mixedType,1
1,7,0,8,mixedType,1
8,1,0,9,mixedType,1
9,2,0,11,mixedType,1
6,3,0,9,mixedType,1
7,3,0,10,mixedType,1
14,2,0,16,mixedType,2
7,2,0,9,mixedType,1
6,3,0,9,mixedType,1
6,2,0,8,mixedType,1
5,4,0,9,mixedType,1
7,4,0,11,mixedType,1
8,1,0,9,mixedType,1
5,2,0,7,mixedType,0
8,1,0,9,mixedType,1
5,3,0,8,mixedType,1
6,4,0,10,mixedType,1
7,3,0,10,mixedType,1
5,4,0,9,mixedType,1
10,0,0,10,sameType,1
6,1,0,7,mixedType,0
7,2,0,9,mixedType,1
8,4,0,12,mixedType,1
14,2,0,16,mixedType,2
6,3,0,9,mixedType,1
6,3,0,9,mixedType,1
4,4,0,8,mixedType,1
9,3,3,15,mixedType,2
10,2,0,12,mixedType,1
8,1,0,9,mixedType,1
5,5,0,10,mixedType,1
12,3,0,15,mixedType,2
5,4,0,9,mixedType,1
7,2,0,9,mixedType,1
6,4,0,10,mixedType,1
6,3,0,9,mixedType,1
5,4,0,9,mixedType,1
6,4,0,10,mixedType,1
6,3,0,9,mixedType,1
5,4,0,9,mixedType,1
3,7,0,10,mixedType,1
7,3,0,10,mixedType,1
2,9,0,11,mixedType,1
5,2,0,7,mixedType,0
10,2,0,12,mixedType,1
8,1,0,9,mixedType,1
9,1,0,10,mixedType,1
1,10,0,11,mixedType,1
5,4,0,9,mixedType,1
6,8,1,15,mixedType,2
6,3,0,9,mixedType,1
9,4,0,13,mixedType,1
5,3,0,8,mixedType,1
6,4,0,10,mixedType,1
6,2,0,8,mixedType,1
12,1,0,13,mixedType,1
2,6,0,8,mixedType,1
11,2,0,13,mixedType,1
6,2,0,8,mixedType,1
12,4,0,16,mixedType,2
4,2,0,6,mixedType,0
8,4,0,12,mixedType,1
7,3,0,10,mixedType,1
7,2,0,9,mixedType,1
9,1,0,10,mixedType,1
8,1,0,9,mixedType,1
10,2,0,12,mixedType,1
8,2,0,10,mixedType,1
7,2,0,9,mixedType,1
7,3,0,10,mixedType,1
7,2,0,9,mixedType,1
8,1,0,9,mixedType,1
5,2,0,7,mixedType,0
12,4,0,16,mixedType,2
7,2,0,9,mixedType,1
1,6,0,7,mixedType,0
10,4,0,14,mixedType,2
4,2,0,6,mixedType,0
7,3,0,10,mixedType,1
12,3,0,15,mixedType,2
8,1,0,9,mixedType,1
11,3,0,14,mixedType,2
5,8,0,13,mixedType,1
4,5,0,9,mixedType,1
5,5,0,10,mixedType,1
3,6,0,9,mixedType,1
1,8,0,9,mixedType,1
7,1,0,8,mixedType,1
6,3,0,9,mixedType,1
3,3,0,6,mixedType,0
5,6,0,11,mixedType,1
7,3,0,10,mixedType,1
8,2,0,10,mixedType,1
7,3,0,10,mixedType,1
8,1,0,9,mixedType,1
5,3,0,8,mixedType,1
2,4,0,6,mixedType,0
9,3,0,12,mixedType,1
7,3,0,10,mixedType,1
4,4,0,8,mixedType,1
6,3,0,9,mixedType,1
1,10,0,11,mixedType,1
8,3,0,11,mixedType,1
8,2,0,10,mixedType,1
5,1,0,6,mixedType,0
6,4,0,10,mixedType,1
12,4,0,16,mixedType,2
7,3,0,10,mixedType,1
12,4,0,16,mixedType,2
6,4,0,10,mixedType,1
7,1,0,8,mixedType,1
6,3,0,9,mixedType,1
7,2,0,9,mixedType,1
6,3,0,9,mixedType,1
5,2,0,7,mixedType,0
6,1,0,7,mixedType,0
4,5,0,9,mixedType,1
6,3,0,9,mixedType,1
5,3,0,8,mixedType,1
9,2,0,11,mixedType,1
7,3,0,10,mixedType,1
6,2,0,8,mixedType,1
7,2,0,9,mixedType,1
14,2,0,16,mixedType,2
3,6,0,9,mixedType,1
0,8,1,9,mixedType,1
9,4,0,13,mixedType,1
2,8,0,10,mixedType,1
5,6,0,11,mixedType,1
2,6,0,8,mixedType,1
5,1,0,6,mixedType,0
7,3,0,10,mixedType,1
7,3,0,10,mixedType,1
5,3,0,8,mixedType,1
7,3,0,10,mixedType,1
6,1,0,7,mixedType,0
7,2,0,9,mixedType,1
1,8,0,9,mixedType,1
5,2,0,7,mixedType,0
5,8,0,13,mixedType,1
6,6,0,12,mixedType,1
9,2,0,11,mixedType,1
6,4,0,10,mixedType,1
15,1,0,16,mixedType,2
7,1,0,8,mixedType,1
14,2,0,16,mixedType,2
2,6,0,8,mixedType,1
6,1,0,7,mixedType,0
8,2,0,10,mixedType,1
9,1,0,10,mixedType,1
8,2,0,10,mixedType,1
7,3,0,10,mixedType,1
9,6,0,15,mixedType,2
5,4,0,9,mixedType,1
6,2,0,8,mixedType,1
5,3,0,8,mixedType,1
2,6,0,8,mixedType,1
8,2,0,10,mixedType,1
5,6,0,11,mixedType,1
5,2,0,7,mixedType,0
9,1,0,10,mixedType,1
1,8,0,9,mixedType,1
6,4,0,10,mixedType,1
2,4,0,6,mixedType,0
5,3,0,8,mixedType,1
4,4,0,8,mixedType,1
6,1,0,7,mixedType,0
5,4,0,9,mixedType,1
8,1,0,9,mixedType,1
11,2,0,13,mixedType,1
8,3,0,11,mixedType,1
2,9,0,11,mixedType,1
6,4,0,10,mixedType,1
5,3,0,8,mixedType,1
7,2,0,9,mixedType,1
5,3,0,8,mixedType,1
5,3,0,8,mixedType,1
2,6,0,8,mixedType,1
7,3,0,10,mixedType,1
13,3,0,16,mixedType,2
5,4,0,9,mixedType,1
12,4,0,16,mixedType,2
0,8,1,9,mixedType,1
7,2,0,9,mixedType,1
5,3,0,8,mixedType,1
5,3,0,8,mixedType,1
8,1,0,9,mixedType,1
4,2,0,6,mixedType,0
7,3,0,10,mixedType,1
11,0,1,12,mixedType,1
3,8,0,11,mixedType,1
14,2,0,16,mixedType,2
6,2,0,8,mixedType,1
8,1,0,9,mixedType,1
8,3,0,11,mixedType,1
9,3,0,12,mixedType,1
6,1,0,7,mixedType,0
3,5,0,8,mixedType,1
7,2,0,9,mixedType,1
13,3,0,16,mixedType,2
12,4,0,16,mixedType,2
14,2,0,16,mixedType,2
11,3,0,14,mixedType,2
8,1,0,9,mixedType,1
1,9,0,10,mixedType,1
6,8,0,14,mixedType,2
5,3,0,8,mixedType,1
2,6,0,8,mixedType,1
2,8,0,10,mixedType,1
7,3,0,10,mixedType,1
6,3,0,9,mixedType,1
7,2,0,9,mixedType,1
8,4,0,12,mixedType,1
9,1,0,10,mixedType,1
6,4,0,10,mixedType,1
8,2,0,10,mixedType,1
1,8,0,9,mixedType,1
8,2,0,10,mixedType,1
6,3,0,9,mixedType,1
7,3,0,10,mixedType,1
7,2,0,9,mixedType,1
5,1,0,6,mixedType,0
11,3,0,14,mixedType,2
8,2,0,10,mixedType,1
15,1,0,16,mixedType,2
7,5,0,12,mixedType,1
5,4,0,9,mixedType,1
3,3,0,6,mixedType,0
8,2,0,10,mixedType,1
3,7,0,10,mixedType,1
10,1,0,11,mixedType,1
6,3,0,9,mixedType,1
8,2,0,10,mixedType,1
5,3,0,8,mixedType,1
8,1,0,9,mixedType,1
6,2,0,8,mixedType,1
4,4,0,8,mixedType,1
3,8,0,11,mixedType,1
4,6,0,10,mixedType,1
4,8,0,12,mixedType,1
13,3,0,16,mixedType,2
9,1,0,10,mixedType,1
11,3,0,14,mixedType,2
8,1,0,9,mixedType,1
7,2,0,9,mixedType,1
6,3,0,9,mixedType,1
7,2,0,9,mixedType,1
7,5,0,12,mixedType,1
2,4,0,6,mixedType,0
4,4,0,8,mixedType,1
9,3,0,12,mixedType,1
6,4,0,10,mixedType,1
6,2,0,8,mixedType,1
8,3,0,11,mixedType,1
6,2,0,8,mixedType,1
7,2,0,9,mixedType,1
7,2,0,9,mixedType,1
4,2,0,6,mixedType,0
6,1,0,7,mixedType,0
14,1,1,16,mixedType,2
6,6,0,12,mixedType,1
6,3,0,9,mixedType,1
8,2,0,10,mixedType,1
3,6,0,9,mixedType,1
8,2,0,10,mixedType,1
2,6,0,8,mixedType,1
6,6,0,12,mixedType,1
11,5,0,16,mixedType,2
2,8,0,10,mixedType,1
7,3,0,10,mixedType,1
10,2,0,12,mixedType,1
8,2,0,10,mixedType,1
4,6,0,10,mixedType,1
6,2,0,8,mixedType,1
1,11,0,12,mixedType,1
9,3,0,12,mixedType,1
4,2,0,6,mixedType,0
7,3,0,10,mixedType,1
2,4,0,6,mixedType,0
6,3,0,9,mixedType,1
6,3,0,9,mixedType,1
5,3,0,8,mixedType,1
5,5,0,10,mixedType,1
14,2,0,16,mixedType,2
7,3,0,10,mixedType,1
15,1,0,16,mixedType,2
6,4,0,10,mixedType,1
6,3,0,9,mixedType,1
6,2,0,8,mixedType,1
1,9,0,10,mixedType,1
12,4,0,16,mixedType,2
2,6,0,8,mixedType,1
2,12,0,14,mixedType,2
3,3,0,6,mixedType,0
7,3,0,10,mixedType,1
4,6,0,10,mixedType,1
7,2,0,9,mixedType,1
6,6,0,12,mixedType,1
8,1,0,9,mixedType,1
9,2,0,11,mixedType,1
14,2,0,16,mixedType,2
8,3,0,11,mixedType,1
6,1,0,7,mixedType,0
6,4,0,10,mixedType,1
7,1,0,8,mixedType,1
4,4,0,8,mixedType,1
5,4,0,9,mixedType,1
7,1,0,8,mixedType,1
9,4,0,13,mixedType,1
4,4,0,8,mixedType,1
6,1,0,7,mixedType,0
8,1,0,9,mixedType,1
6,4,0,10,mixedType,1
7,2,0,9,mixedType,1
7,2,0,9,mixedType,1
7,3,0,10,mixedType,1
4,2,0,6,mixedType,0
8,2,0,10,mixedType,1
14,2,0,16,mixedType,2
8,1,0,9,mixedType,1
13,3,0,16,mixedType,2
5,4,0,9,mixedType,1
8,1,0,9,mixedType,1
6,2,0,8,mixedType,1
5,2,0,7,mixedType,0
5,2,0,7,mixedType,0
12,3,0,15,mixedType,2
7,4,0,11,mixedType,1
7,4,0,11,mixedType,1
12,1,0,13,mixedType,1
10,0,1,11,mixedType,1
5,4,0,9,mixedType,1
4,4,0,8,mixedType,1
3,10,0,13,mixedType,1
5,3,0,8,mixedType,1
4,2,0,6,mixedType,0
8,1,0,9,mixedType,1
8,1,0,9,mixedType,1
5,1,0,6,mixedType,0
4,2,0,6,mixedType,0
7,1,0,8,mixedType,1
7,3,0,10,mixedType,1
5,0,1,6,mixedType,0
5,4,0,9,mixedType,1
7,4,0,11,mixedType,1
6,4,0,10,mixedType,1
10,4,0,14,mixedType,2
3,6,0,9,mixedType,1
3,6,0,9,mixedType,1
3,8,0,11,mixedType,1
8,2,0,10,mixedType,1
6,1,0,7,mixedType,0
7,3,0,10,mixedType,1
4,5,0,9,mixedType,1
2,7,0,9,mixedType,1
12,3,0,15,mixedType,2
6,4,0,10,mixedType,1
4,9,0,13,mixedType,1
6,4,0,10,mixedType,1
6,4,0,10,mixedType,1
10,2,0,12,mixedType,1
7,4,0,11,mixedType,1
8,4,0,12,mixedType,1
6,4,0,10,mixedType,1
5,3,0,8,mixedType,1
9,4,0,13,mixedType,1
3,8,0,11,mixedType,1
13,3,0,16,mixedType,2
1,8,0,9,mixedType,1
3,8,0,11,mixedType,1
6,1,0,7,mixedType,0
2,6,0,8,mixedType,1
15,1,0,16,mixedType,2
7,2,0,9,mixedType,1
7,2,0,9,mixedType,1
8,2,0,10,mixedType,1
6,2,0,8,mixedType,1
5,3,0,8,mixedType,1
3,6,0,9,mixedType,1
8,4,0,12,mixedType,1
7,3,0,10,mixedType,1
13,3,0,16,mixedType,2
3,5,0,8,mixedType,1
5,4,0,9,mixedType,1
3,3,0,6,mixedType,0
4,6,0,10,mixedType,1
5,2,0,7,mixedType,0
14,2,0,16,mixedType,2
3,6,0,9,mixedType,1
4,6,0,10,mixedType,1
5,2,0,7,mixedType,0
7,3,0,10,mixedType,1
8,1,0,9,mixedType,1
6,3,0,9,mixedType,1
8,1,0,9,mixedType,1
8,3,0,11,mixedType,1
9,4,1,14,mixedType,2
14,2,0,16,mixedType,2
3,6,0,9,mixedType,1
4,4,0,8,mixedType,1
6,1,0,7,mixedType,0
8,4,0,12,mixedType,1
8,1,0,9,mixedType,1
8,1,0,9,mixedType,1
6,4,0,10,mixedType,1
6,2,0,8,mixedType,1
3,8,0,11,mixedType,1
9,1,0,10,mixedType,1
9,2,0,11,mixedType,1
4,4,0,8,mixedType,1
3,8,0,11,mixedType,1
6,1,0,7,mixedType,0
7,1,0,8,mixedType,1
7,3,0,10,mixedType,1
4,2,0,6,mixedType,0
1,8,0,9,mixedType,1
4,2,0,6,mixedType,0
5,2,0,7,mixedType,0
7,2,0,9,mixedType,1
5,5,0,10,mixedType,1
7,4,0,11,mixedType,1
6,2,0,8,mixedType,1
5,2,0,7,mixedType,0
8,4,0,12,mixedType,1
7,3,0,10,mixedType,1
2,7,0,9,mixedType,1
6,4,0,10,mixedType,1
7,3,0,10,mixedType,1
3,3,0,6,mixedType,0
8,2,0,10,mixedType,1
9,1,0,10,mixedType,1
7,3,5,15,mixedType,2
9,1,0,10,mixedType,1
12,4,0,16,mixedType,2
9,1,0,10,mixedType,1
7,3,0,10,mixedType,1
5,2,0,7,mixedType,0
7,2,0,9,mixedType,1
12,3,0,15,mixedType,2
6,4,0,10,mixedType,1
14,2,0,16,mixedType,2
5,6,0,11,mixedType,1
6,4,0,10,mixedType,1
8,4,0,12,mixedType,1
7,2,0,9,mixedType,1
7,3,0,10,mixedType,1
4,4,0,8,mixedType,1
13,3,0,16,mixedType,2
5,2,0,7,mixedType,0
5,3,0,8,mixedType,1
3,5,0,8,mixedType,1
5,2,0,7,mixedType,0
7,2,0,9,mixedType,1
5,4,0,9,mixedType,1
6,2,0,8,mixedType,1
14,2,0,16,mixedType,2
12,1,0,13,mixedType,1
5,3,0,8,mixedType,1
6,1,0,7,mixedType,0
8,2,0,10,mixedType,1
4,2,0,6,mixedType,0
4,2,0,6,mixedType,0
5,3,0,8,mixedType,1
5,3,0,8,mixedType,1
14,2,0,16,mixedType,2
10,1,0,11,mixedType,1
4,2,0,6,mixedType,0
5,3,0,8,mixedType,1
8,2,0,10,mixedType,1
9,2,0,11,mixedType,1
7,3,0,10,mixedType,1
6,2,0,8,mixedType,1
5,1,0,6,mixedType,0
5,3,0,8,mixedType,1
6,3,0,9,mixedType,1
5,3,0,8,mixedType,1
9,2,0,11,mixedType,1
14,2,0,16,mixedType,2
15,1,0,16,mixedType,2
8,4,0,12,mixedType,1
7,1,0,8,mixedType,1
5,3,0,8,mixedType,1
9,3,0,12,mixedType,1
13,3,0,16,mixedType,2
5,4,1,10,mixedType,1
9,4,0,13,mixedType,1
7,4,0,11,mixedType,1
5,3,0,8,mixedType,1
2,7,0,9,mixedType,1
9,5,1,15,mixedType,2
3,6,0,9,mixedType,1
2,6,0,8,mixedType,1
1,8,0,9,mixedType,1
4,6,0,10,mixedType,1
6,3,0,9,mixedType,1
8,1,0,9,mixedType,1
5,4,0,9,mixedType,1
9,1,0,10,mixedType,1
8,2,0,10,mixedType,1
2,8,0,10,mixedType,1
7,4,0,11,mixedType,1
1,10,0,11,mixedType,1
2,6,0,8,mixedType,1
2,6,0,8,mixedType,1
8,2,0,10,mixedType,1
7,2,0,9,mixedType,1
1,8,0,9,mixedType,1
5,2,0,7,mixedType,0
4,4,0,8,mixedType,1
6,3,0,9,mixedType,1
12,4,0,16,mixedType,2
9,2,0,11,mixedType,1
8,3,0,11,mixedType,1
13,3,0,16,mixedType,2
3,6,0,9,mixedType,1
3,3,0,6,mixedType,0
7,3,0,10,mixedType,1
7,2,0,9,mixedType,1
2,8,0,10,mixedType,1
7,2,0,9,mixedType,1
5,3,0,8,mixedType,1
5,4,0,9,mixedType,1
10,1,0,11,mixedType,1
6,4,0,10,mixedType,1
5,2,0,7,mixedType,0
8,1,0,9,mixedType,1
4,2,0,6,mixedType,0
2,4,0,6,mixedType,0
6,2,0,8,mixedType,1
4,2,0,6,mixedType,0
10,2,0,12,mixedType,1
8,2,0,10,mixedType,1
15,1,0,16,mixedType,2
10,2,0,12,mixedType,1
9,3,0,12,mixedType,1
3,6,0,9,mixedType,1
7,1,0,8,mixedType,1
5,4,0,9,mixedType,1
7,1,0,8,mixedType,1
12,4,0,16,mixedType,2
5,2,0,7,mixedType,0
5,4,0,9,mixedType,1
8,4,0,12,mixedType,1
12,4,0,16,mixedType,2
6,1,0,7,mixedType,0
14,2,0,16,mixedType,2
11,1,0,12,mixedType,1
14,2,0,16,mixedType,2
5,3,0,8,mixedType,1
4,6,0,10,mixedType,1
7,4,0,11,mixedType,1
18,1,1,20,mixedType,2
7,3,0,10,mixedType,1
7,3,0,10,mixedType,1
6,2,0,8,mixedType,1
5,3,0,8,mixedType,1
6,3,0,9,mixedType,1
7,3,0,10,mixedType,1
2,6,0,8,mixedType,1
8,1,0,9,mixedType,1
3,7,0,10,mixedType,1
6,1,0,7,mixedType,0
7,1,0,8,mixedType,1
11,3,0,14,mixedType,2
8,2,0,10,mixedType,1
10,7,1,18,mixedType,2
6,2,0,8,mixedType,1
5,2,0,7,mixedType,0
8,2,0,10,mixedType,1
9,2,0,11,mixedType,1
8,1,0,9,mixedType,1
8,2,0,10,mixedType,1
8,2,0,10,mixedType,1
5,1,0,6,mixedType,0
6,2,0,8,mixedType,1
9,5,0,14,mixedType,2
11,2,0,13,mixedType,1
4,4,0,8,mixedType,1
7,2,0,9,mixedType,1
5,1,0,6,mixedType,0
7,3,0,10,mixedType,1
10,2,0,12,mixedType,1
11,3,0,14,mixedType,2
12,3,0,15,mixedType,2
4,4,0,8,mixedType,1
6,3,0,9,mixedType,1
4,2,0,6,mixedType,0
6,3,0,9,mixedType,1
8,5,0,13,mixedType,1
7,1,0,8,mixedType,1
13,3,0,16,mixedType,2
8,2,0,10,mixedType,1
8,1,0,9,mixedType,1
6,8,0,14,mixedType,2
7,3,0,10,mixedType,1
10,2,0,12,mixedType,1
6,4,0,10,mixedType,1
4,2,0,6,mixedType,0
8,2,0,10,mixedType,1
1,9,0,10,mixedType,1
4,4,0,8,mixedType,1
6,1,0,7,mixedType,0
5,4,0,9,mixedType,1
7,3,0,10,mixedType,1
2,6,0,8,mixedType,1
5,2,0,7,mixedType,0
1,10,0,11,mixedType,1
4,9,0,13,mixedType,1
12,4,0,16,mixedType,2
4,8,0,12,mixedType,1
4,4,0,8,mixedType,1
5,1,0,6,mixedType,0
5,6,0,11,mixedType,1
3,9,0,12,mixedType,1
5,3,0,8,mixedType,1
3,7,0,10,mixedType,1
9,3,2,14,mixedType,2
8,2,0,10,mixedType,1
6,3,0,9,mixedType,1
6,6,2,14,mixedType,2
4,2,0,6,mixedType,0
5,3,0,8,mixedType,1
6,6,0,12,mixedType,1
8,2,0,10,mixedType,1
16,1,0,17,mixedType,2
13,3,0,16,mixedType,2
6,3,0,9,mixedType,1
4,4,0,8,mixedType,1
4,6,0,10,mixedType,1
6,3,0,9,mixedType,1
6,3,0,9,mixedType,1
7,1,0,8,mixedType,1
8,2,0,10,mixedType,1
6,2,0,8,mixedType,1
2,7,0,9,mixedType,1
6,4,0,10,mixedType,1
7,3,0,10,mixedType,1
8,2,0,10,mixedType,1
6,1,0,7,mixedType,0
6,1,0,7,mixedType,0
6,3,0,9,mixedType,1
6,3,0,9,mixedType,1
4,6,0,10,mixedType,1
2,4,0,6,mixedType,0
6,3,0,9,mixedType,1
4,6,0,10,mixedType,1
3,6,0,9,mixedType,1
13,3,0,16,mixedType,2
7,2,0,9,mixedType,1
11,4,0,15,mixedType,2
15,1,0,16,mixedType,2
6,4,0,10,mixedType,1
7,2,0,9,mixedType,1
7,3,0,10,mixedType,1
7,1,0,8,mixedType,1
2,6,0,8,mixedType,1
8,1,0,9,mixedType,1
11,8,0,19,mixedType,2
5,3,0,8,mixedType,1
3,3,0,6,mixedType,0
8,3,0,11,mixedType,1
7,2,0,9,mixedType,1
6,3,0,9,mixedType,1
6,1,0,7,mixedType,0
4,4,0,8,mixedType,1
3,9,0,12,mixedType,1
13,3,0,16,mixedType,2
3,7,0,10,mixedType,1
13,3,0,16,mixedType,2
7,3,0,10,mixedType,1
6,2,0,8,mixedType,1
2,8,0,10,mixedType,1
6,0,1,7,mixedType,0
3,9,0,12,mixedType,1
7,1,0,8,mixedType,1
5,4,0,9,mixedType,1
8,1,0,9,mixedType,1
3,7,0,10,mixedType,1
5,2,0,7,mixedType,0
7,4,0,11,mixedType,1
5,2,0,7,mixedType,0
7,4,0,11,mixedType,1
6,4,0,10,mixedType,1
0,9,2,11,mixedType,1
4,6,0,10,mixedType,1
3,3,0,6,mixedType,0
9,1,0,10,mixedType,1
6,3,0,9,mixedType,1
8,1,0,9,mixedType,1
5,3,0,8,mixedType,1
6,3,0,9,mixedType,1
11,3,1,15,mixedType,2
8,2,0,10,mixedType,1
4,4,0,8,mixedType,1
7,1,0,8,mixedType,1
7,2,0,9,mixedType,1
10,1,0,11,mixedType,1
8,5,0,13,mixedType,1
6,3,0,9,mixedType,1
3,6,0,9,mixedType,1
1,10,0,11,mixedType,1
8,1,0,9,mixedType,1
9,1,0,10,mixedType,1
10,2,0,12,mixedType,1
7,2,0,9,mixedType,1
5,3,0,8,mixedType,1
10,7,0,17,mixedType,2
1,8,0,9,mixedType,1
6,2,0,8,mixedType,1
7,3,0,10,mixedType,1
8,1,0,9,mixedType,1
9,4,0,13,mixedType,1
13,1,1,15,mixedType,2
8,2,0,10,mixedType,1
4,8,0,12,mixedType,1
8,1,0,9,mixedType,1
13,3,0,16,mixedType,2
4,4,0,8,mixedType,1
7,5,0,12,mixedType,1
7,1,0,8,mixedType,1
6,3,0,9,mixedType,1
3,8,0,11,mixedType,1
12,3,0,15,mixedType,2
8,1,0,9,mixedType,1
6,1,0,7,mixedType,0
6,2,0,8,mixedType,1
7,2,0,9,mixedType,1
4,2,0,6,mixedType,0
6,3,0,9,mixedType,1
9,3,0,12,mixedType,1
4,6,0,10,mixedType,1
4,4,0,8,mixedType,1
4,2,0,6,mixedType,0
6,3,0,9,mixedType,1
6,4,0,10,mixedType,1
3,5,0,8,mixedType,1
5,4,0,9,mixedType,1
8,2,0,10,mixedType,1
4,2,0,6,mixedType,0
8,2,0,10,mixedType,1
6,1,0,7,mixedType,0
9,3,0,12,mixedType,1
6,3,0,9,mixedType,1
8,2,0,10,mixedType,1
9,1,0,10,mixedType,1
5,4,0,9,mixedType,1
7,3,0,10,mixedType,1
5,2,0,7,mixedType,0
11,3,0,14,mixedType,2
5,3,0,8,mixedType,1
13,3,0,16,mixedType,2
1,8,0,9,mixedType,1
8,3,0,11,mixedType,1
12,4,0,16,mixedType,2
8,5,0,13,mixedType,1
6,2,0,8,mixedType,1
6,3,0,9,mixedType,1
14,2,0,16,mixedType,2
6,3,0,9,mixedType,1
1,8,0,9,mixedType,1
8,4,0,12,mixedType,1
2,7,0,9,mixedType,1
8,2,0,10,mixedType,1
7,3,0,10,mixedType,1
6,4,0,10,mixedType,1
7,1,0,8,mixedType,1
6,3,0,9,mixedType,1
5,3,0,8,mixedType,1
7,4,0,11,mixedType,1
7,2,0,9,mixedType,1
4,6,0,10,mixedType,1
4,2,0,6,mixedType,0
8,2,0,10,mixedType,1
7,3,0,10,mixedType,1
8,1,0,9,mixedType,1
9,1,0,10,mixedType,1
5,1,0,6,mixedType,0
5,4,0,9,mixedType,1
1,7,0,8,mixedType,1
6,2,0,8,mixedType,1
7,3,0,10,mixedType,1
7,4,0,11,mixedType,1
6,2,0,8,mixedType,1
4,6,0,10,mixedType,1
6,1,0,7,mixedType,0
9,2,0,11,mixedType,1
3,6,0,9,mixedType,1
8,2,0,10,mixedType,1
3,6,0,9,mixedType,1
8,1,0,9,mixedType,1
6,3,0,9,mixedType,1
5,1,0,6,mixedType,0
6,1,0,7,mixedType,0
8,1,0,9,mixedType,1
6,4,0,10,mixedType,1
7,3,0,10,mixedType,1
4,4,0,8,mixedType,1
12,4,0,16,mixedType,2
3,8,0,11,mixedType,1
4,2,0,6,mixedType,0
5,2,0,7,mixedType,0
5,5,0,10,mixedType,1
5,4,0,9,mixedType,1
6,2,0,8,mixedType,1
7,2,0,9,mixedType,1
8,3,0,11,mixedType,1
6,3,0,9,mixedType,1
4,4,0,8,mixedType,1
5,6,0,11,mixedType,1
7,3,0,10,mixedType,1
5,1,0,6,mixedType,0
7,4,0,11,mixedType,1
7,3,0,10,mixedType,1
6,1,0,7,mixedType,0
7,4,0,11,mixedType,1
6,3,0,9,mixedType,1
6,2,0,8,mixedType,1
5,4,0,9,mixedType,1
7,2,0,9,mixedType,1
5,3,0,8,mixedType,1
4,2,0,6,mixedType,0
6,2,0,8,mixedType,1
6,2,0,8,mixedType,1
13,3,0,16,mixedType,2
6,3,0,9,mixedType,1
7,1,0,8,mixedType,1
10,2,0,12,mixedType,1
1,9,0,10,mixedType,1
2,4,0,6,mixedType,0
15,1,0,16,mixedType,2
6,2,0,8,mixedType,1
5,4,0,9,mixedType,1
13,3,0,16,mixedType,2
5,4,0,9,mixedType,1
6,3,0,9,mixedType,1
5,3,0,8,mixedType,1
5,3,0,8,mixedType,1
11,1,0,12,mixedType,1
8,1,0,9,mixedType,1
1,8,0,9,mixedType,1
7,3,0,10,mixedType,1
4,2,0,6,mixedType,0
7,1,0,8,mixedType,1
15,1,0,16,mixedType,2
15,1,0,16,mixedType,2
9,1,0,10,mixedType,1
9,2,0,11,mixedType,1
5,1,0,6,mixedType,0
8,2,0,10,mixedType,1
4,4,0,8,mixedType,1
3,6,0,9,mixedType,1
6,3,0,9,mixedType,1
7,3,0,10,mixedType,1
9,1,0,10,mixedType,1
6,3,0,9,mixedType,1
4,4,0,8,mixedType,1
8,2,0,10,mixedType,1
9,2,0,11,mixedType,1
9,1,0,10,mixedType,1
12,4,0,16,mixedType,2
8,2,0,10,mixedType,1
5,1,0,6,mixedType,0
4,6,0,10,mixedType,1
5,2,0,7,mixedType,0
3,6,0,9,mixedType,1
7,3,0,10,mixedType,1
9,3,0,12,mixedType,1
6,3,0,9,mixedType,1
11,1,0,12,mixedType,1
8,1,0,9,mixedType,1
7,1,0,8,mixedType,1
7,3,0,10,mixedType,1
5,3,0,8,mixedType,1
10,4,0,14,mixedType,2
7,3,0,10,mixedType,1
5,1,0,6,mixedType,0
11,3,0,14,mixedType,2
1,11,0,12,mixedType,1
12,3,0,15,mixedType,2
4,6,0,10,mixedType,1
6,3,0,9,mixedType,1
3,9,0,12,mixedType,1
5,2,0,7,mixedType,0
15,1,0,16,mixedType,2
5,2,0,7,mixedType,0
6,4,0,10,mixedType,1
7,4,0,11,mixedType,1
6,4,0,10,mixedType,1
2,7,0,9,mixedType,1
9,2,0,11,mixedType,1
13,3,0,16,mixedType,2
7,3,0,10,mixedType,1
3,9,0,12,mixedType,1
9,1,0,10,mixedType,1
2,10,0,12,mixedType,1
5,5,0,10,mixedType,1
4,6,0,10,mixedType,1
9,4,0,13,mixedType,1
6,3,0,9,mixedType,1
4,2,0,6,mixedType,0
7,4,0,11,mixedType,1
6,1,0,7,mixedType,0
3,6,0,9,mixedType,1
8,3,0,11,mixedType,1
4,6,0,10,mixedType,1
5,3,0,8,mixedType,1
6,6,0,12,mixedType,1
15,1,0,16,mixedType,2
7,3,0,10,mixedType,1
9,2,0,11,mixedType,1
9,1,0,10,mixedType,1
5,2,6,13,mixedType,1
6,1,0,7,mixedType,0
11,2,0,13,mixedType,1
14,2,0,16,mixedType,2
14,2,0,16,mixedType,2
7,4,0,11,mixedType,1
6,4,0,10,mixedType,1
7,1,0,8,mixedType,1
5,2,0,7,mixedType,0
7,3,0,10,mixedType,1
6,1,0,7,mixedType,0
3,6,0,9,mixedType,1
5,4,0,9,mixedType,1
14,2,0,16,mixedType,2
3,5,0,8,mixedType,1
7,0,2,9,mixedType,1
11,2,0,13,mixedType,1
5,3,0,8,mixedType,1
7,3,0,10,mixedType,1
11,5,0,16,mixedType,2
5,3,0,8,mixedType,1
14,2,0,16,mixedType,2
1,8,0,9,mixedType,1
4,4,0,8,mixedType,1
4,2,0,6,mixedType,0
2,4,0,6,mixedType,0
4,2,0,6,mixedType,0
9,1,0,10,mixedType,1
7,2,0,9,mixedType,1
13,3,0,16,mixedType,2
5,2,0,7,mixedType,0
8,3,0,11,mixedType,1
5,2,0,7,mixedType,0
11,3,0,14,mixedType,2
6,0,0,6,sameType,0
9,4,0,13,mixedType,1
7,3,0,10,mixedType,1
4,7,0,11,mixedType,1
8,2,0,10,mixedType,1
6,2,0,8,mixedType,1
12,3,0,15,mixedType,2
6,3,0,9,mixedType,1
8,1,0,9,mixedType,1
1,8,0,9,mixedType,1
5,1,0,6,mixedType,0
5,3,0,8,mixedType,1
6,1,0,7,mixedType,0
2,8,0,10,mixedType,1
7,3,0,10,mixedType,1
10,2,0,12,mixedType,1
9,1,0,10,mixedType,1
7,3,0,10,mixedType,1
5,2,0,7,mixedType,0
7,2,0,9,mixedType,1
3,7,0,10,mixedType,1
8,1,0,9,mixedType,1
6,2,0,8,mixedType,1
6,1,0,7,mixedType,0
12,0,1,13,mixedType,1
10,2,0,12,mixedType,1
2,6,0,8,mixedType,1
6,3,0,9,mixedType,1
6,4,0,10,mixedType,1
1,8,0,9,mixedType,1
8,1,0,9,mixedType,1
1,8,0,9,mixedType,1
13,3,0,16,mixedType,2
7,3,0,10,mixedType,1
11,2,0,13,mixedType,1
7,1,0,8,mixedType,1
8,1,0,9,mixedType,1
7,2,0,9,mixedType,1
6,3,0,9,mixedType,1
7,2,0,9,mixedType,1
3,6,0,9,mixedType,1
5,4,0,9,mixedType,1
5,3,0,8,mixedType,1
3,8,0,11,mixedType,1
4,4,0,8,mixedType,1
9,2,0,11,mixedType,1
7,3,0,10,mixedType,1
14,2,0,16,mixedType,2
5,5,0,10,mixedType,1
7,2,0,9,mixedType,1
7,1,0,8,mixedType,1
6,2,0,8,mixedType,1
6,4,0,10,mixedType,1
5,3,0,8,mixedType,1
7,2,0,9,mixedType,1
7,2,0,9,mixedType,1
14,2,0,16,mixedType,2
7,2,0,9,mixedType,1
3,3,0,6,mixedType,0
15,1,0,16,mixedType,2
7,3,0,10,mixedType,1
8,1,0,9,mixedType,1
8,2,0,10,mixedType,1
10,3,0,13,mixedType,1
4,5,0,9,mixedType,1
14,2,0,16,mixedType,2
5,1,0,6,mixedType,0
6,3,0,9,mixedType,1
4,2,0,6,mixedType,0
4,4,0,8,mixedType,1
11,2,0,13,mixedType,1
9,2,0,11,mixedType,1
9,1,0,10,mixedType,1
5,4,0,9,mixedType,1
5,4,0,9,mixedType,1
11,2,0,13,mixedType,1
4,6,0,10,mixedType,1
1,8,0,9,mixedType,1
2,9,0,11,mixedType,1
6,3,0,9,mixedType,1
4,6,0,10,mixedType,1
7,2,0,9,mixedType,1
6,1,0,7,mixedType,0
12,3,0,15,mixedType,2
6,3,0,9,mixedType,1
0,6,1,7,mixedType,0
5,3,0,8,mixedType,1
6,3,0,9,mixedType,1
3,10,0,13,mixedType,1
8,4,0,12,mixedType,1
5,4,0,9,mixedType,1
6,3,0,9,mixedType,1
7,1,0,8,mixedType,1
3,7,0,10,mixedType,1
11,4,0,15,mixedType,2
6,3,0,9,mixedType,1
7,3,0,10,mixedType,1
6,3,0,9,mixedType,1
14,2,0,16,mixedType,2
6,1,0,7,mixedType,0
7,3,0,10,mixedType,1
7,3,0,10,mixedType,1
5,3,0,8,mixedType,1
3,6,0,9,mixedType,1
8,3,0,11,mixedType,1
9,3,0,12,mixedType,1
4,8,0,12,mixedType,1
14,2,0,16,mixedType,2
7,4,0,11,mixedType,1
6,1,0,7,mixedType,0
9,1,0,10,mixedType,1
14,1,0,15,mixedType,2
11,5,0,16,mixedType,2
7,3,0,10,mixedType,1
7,3,0,10,mixedType,1
9,3,0,12,mixedType,1
8,3,0,11,mixedType,1
9,1,0,10,mixedType,1
6,3,0,9,mixedType,1
15,1,0,16,mixedType,2
3,6,0,9,mixedType,1
9,1,0,10,mixedType,1
11,3,0,14,mixedType,2
4,4,0,8,mixedType,1
6,1,0,7,mixedType,0
5,3,0,8,mixedType,1
9,1,0,10,mixedType,1
8,1,0,9,mixedType,1
7,3,0,10,mixedType,1
7,1,0,8,mixedType,1
5,4,0,9,mixedType,1
5,4,0,9,mixedType,1
7,3,0,10,mixedType,1
8,1,0,9,mixedType,1
6,4,0,10,mixedType,1
4,9,0,13,mixedType,1
4,6,0,10,mixedType,1
8,1,0,9,mixedType,1
12,3,1,16,mixedType,2
5,4,0,9,mixedType,1
7,2,0,9,mixedType,1
7,3,0,10,mixedType,1
6,3,0,9,mixedType,1
8,1,0,9,mixedType,1
8,2,0,10,mixedType,1
14,2,0,16,mixedType,2
5,3,0,8,mixedType,1
4,2,0,6,mixedType,0
14,2,0,16,mixedType,2
6,2,0,8,mixedType,1
2,7,0,9,mixedType,1
4,4,0,8,mixedType,1
14,2,0,16,mixedType,2
3,6,0,9,mixedType,1
6,3,0,9,mixedType,1
6,4,0,10,mixedType,1
6,2,0,8,mixedType,1
6,3,0,9,mixedType,1
7,3,0,10,mixedType,1
6,3,0,9,mixedType,1
3,1,0,4,mixedType,0
7,3,0,10,mixedType,1
4,6,0,10,mixedType,1
7,2,0,9,mixedType,1
8,3,0,11,mixedType,1
6,3,0,9,mixedType,1
8,5,0,13,mixedType,1
5,3,0,8,mixedType,1
5,3,0,8,mixedType,1
5,3,0,8,mixedType,1
2,8,0,10,mixedType,1
15,1,0,16,mixedType,2
0,10,2,12,mixedType,1
7,1,0,8,mixedType,1
14,2,0,16,mixedType,2
8,2,0,10,mixedType,1
11,3,0,14,mixedType,2
6,1,0,7,mixedType,0
5,2,0,7,mixedType,0
1,9,0,10,mixedType,1
2,10,0,12,mixedType,1
4,2,0,6,mixedType,0
7,2,0,9,mixedType,1
8,3,0,11,mixedType,1
6,2,0,8,mixedType,1
8,3,0,11,mixedType,1
11,3,0,14,mixedType,2
6,3,0,9,mixedType,1
8,3,0,11,mixedType,1
8,5,0,13,mixedType,1
3,3,0,6,mixedType,0
6,7,0,13,mixedType,1
8,2,0,10,mixedType,1
8,1,0,9,mixedType,1
14,2,0,16,mixedType,2
2,8,0,10,mixedType,1
5,2,0,7,mixedType,0
6,3,0,9,mixedType,1
1,8,0,9,mixedType,1
11,6,1,18,mixedType,2
14,2,0,16,mixedType,2
9,4,0,13,mixedType,1
5,2,0,7,mixedType,0
14,2,0,16,mixedType,2
7,1,0,8,mixedType,1
6,3,0,9,mixedType,1
3,10,0,13,mixedType,1
6,3,0,9,mixedType,1
9,2,0,11,mixedType,1
9,3,0,12,mixedType,1
5,8,0,13,mixedType,1
9,3,0,12,mixedType,1
4,2,0,6,mixedType,0
9,1,0,10,mixedType,1
8,2,0,10,mixedType,1
5,1,0,6,mixedType,0
1,9,0,10,mixedType,1
6,4,0,10,mixedType,1
5,4,0,9,mixedType,1
6,1,0,7,mixedType,0
5,4,0,9,mixedType,1
6,3,0,9,mixedType,1
7,3,0,10,mixedType,1
6,2,0,8,mixedType,1
6,3,0,9,mixedType,1
6,1,0,7,mixedType,0
8,2,0,10,mixedType,1
7,2,0,9,mixedType,1
6,1,0,7,mixedType,0
5,2,0,7,mixedType,0
13,3,0,16,mixedType,2
4,2,0,6,mixedType,0
7,2,0,9,mixedType,1
6,2,0,8,mixedType,1
10,3,0,13,mixedType,1
6,1,0,7,mixedType,0
5,2,0,7,mixedType,0
6,4,0,10,mixedType,1
5,3,0,8,mixedType,1
5,3,0,8,mixedType,1
16,4,0,20,mixedType,2
5,3,0,8,mixedType,1
9,4,0,13,mixedType,1
5,2,0,7,mixedType,0
6,3,0,9,mixedType,1
10,1,0,11,mixedType,1
9,1,0,10,mixedType,1
6,3,0,9,mixedType,1
7,2,0,9,mixedType,1
1,8,0,9,mixedType,1
5,3,0,8,mixedType,1
2,8,0,10,mixedType,1
6,2,0,8,mixedType,1
7,2,0,9,mixedType,1
8,2,0,10,mixedType,1
6,7,0,13,mixedType,1
7,3,0,10,mixedType,1
9,2,0,11,mixedType,1
4,2,0,6,mixedType,0
15,1,0,16,mixedType,2
6,1,0,7,mixedType,0
6,2,0,8,mixedType,1
6,4,0,10,mixedType,1
7,3,0,10,mixedType,1
3,5,0,8,mixedType,1
7,2,0,9,mixedType,1
8,4,0,12,mixedType,1
5,3,0,8,mixedType,1
6,4,0,10,mixedType,1
12,4,0,16,mixedType,2
5,3,0,8,mixedType,1
2,4,0,6,mixedType,0
13,3,0,16,mixedType,2
6,1,0,7,mixedType,0
6,3,0,9,mixedType,1
8,1,0,9,mixedType,1
8,10,0,18,mixedType,2
14,2,0,16,mixedType,2
7,2,0,9,mixedType,1
6,1,0,7,mixedType,0
8,3,0,11,mixedType,1
4,4,0,8,mixedType,1
13,3,0,16,mixedType,2
5,2,0,7,mixedType,0
6,3,0,9,mixedType,1
4,2,0,6,mixedType,0
5,3,0,8,mixedType,1
10,1,0,11,mixedType,1
6,3,0,9,mixedType,1
6,3,0,9,mixedType,1
6,3,0,9,mixedType,1
12,4,0,16,mixedType,2
7,2,0,9,mixedType,1
7,2,0,9,mixedType,1
8,2,0,10,mixedType,1
9,2,0,11,mixedType,1
6,2,0,8,mixedType,1
1,9,0,10,mixedType,1
4,6,0,10,mixedType,1
11,5,0,16,mixedType,2
7,3,0,10,mixedType,1
4,7,0,11,mixedType,1
8,1,0,9,mixedType,1
5,2,0,7,mixedType,0
15,1,0,16,mixedType,2
6,2,0,8,mixedType,1
15,1,0,16,mixedType,2
3,8,0,11,mixedType,1
7,3,0,10,mixedType,1
6,2,0,8,mixedType,1
10,3,0,13,mixedType,1
7,1,0,8,mixedType,1
8,2,0,10,mixedType,1
4,2,0,6,mixedType,0
4,4,0,8,mixedType,1
3,8,0,11,mixedType,1
6,3,0,9,mixedType,1
6,3,0,9,mixedType,1
8,4,0,12,mixedType,1
4,2,0,6,mixedType,0
6,1,0,7,mixedType,0
7,3,0,10,mixedType,1
7,1,0,8,mixedType,1
7,3,0,10,mixedType,1
8,3,3,14,mixedType,2
5,3,0,8,mixedType,1
6,2,0,8,mixedType,1
7,3,0,10,mixedType,1
6,3,0,9,mixedType,1
6,2,0,8,mixedType,1
4,4,0,8,mixedType,1
15,1,0,16,mixedType,2
7,1,0,8,mixedType,1
5,3,0,8,mixedType,1
1,7,0,8,mixedType,1
12,4,0,16,mixedType,2
8,2,0,10,mixedType,1
6,3,0,9,mixedType,1
8,1,0,9,mixedType,1
11,5,0,16,mixedType,2
2,7,0,9,mixedType,1
7,1,0,8,mixedType,1
1,8,0,9,mixedType,1
7,2,0,9,mixedType,1
4,2,0,6,mixedType,0
6,4,0,10,mixedType,1
5,2,0,7,mixedType,0
4,2,0,6,mixedType,0
4,4,0,8,mixedType,1
7,2,0,9,mixedType,1
5,3,0,8,mixedType,1
10,2,0,12,mixedType,1
6,2,0,8,mixedType,1
7,3,0,10,mixedType,1
5,4,0,9,mixedType,1
7,4,0,11,mixedType,1
7,1,0,8,mixedType,1
4,4,0,8,mixedType,1
9,2,0,11,mixedType,1
14,2,0,16,mixedType,2
2,4,0,6,mixedType,0
9,1,0,10,mixedType,1
5,3,0,8,mixedType,1
6,3,0,9,mixedType,1
5,2,0,7,mixedType,0
4,5,0,9,mixedType,1
5,4,0,9,mixedType,1
6,2,0,8,mixedType,1
5,1,0,6,mixedType,0
12,4,0,16,mixedType,2
9,3,0,12,mixedType,1
7,5,0,12,mixedType,1
8,3,0,11,mixedType,1
5,2,0,7,mixedType,0
7,3,0,10,mixedType,1
6,3,0,9,mixedType,1
9,3,0,12,mixedType,1
5,4,0,9,mixedType,1
4,4,0,8,mixedType,1
9,2,0,11,mixedType,1
7,3,0,10,mixedType,1
8,1,0,9,mixedType,1
4,2,0,6,mixedType,0
6,1,0,7,mixedType,0
6,6,0,12,mixedType,1
6,1,0,7,mixedType,0
6,2,0,8,mixedType,1
8,2,0,10,mixedType,1
14,2,0,16,mixedType,2
9,2,0,11,mixedType,1
7,3,0,10,mixedType,1
7,2,0,9,mixedType,1
13,3,0,16,mixedType,2
5,4,0,9,mixedType,1
6,3,0,9,mixedType,1
8,2,0,10,mixedType,1
5,3,0,8,mixedType,1
6,3,0,9,mixedType,1
13,3,0,16,mixedType,2
8,2,0,10,mixedType,1
8,2,0,10,mixedType,1
6,4,0,10,mixedType,1
5,4,0,9,mixedType,1
5,3,0,8,mixedType,1
13,4,0,17,mixedType,2
7,3,0,10,mixedType,1
6,2,0,8,mixedType,1
9,1,0,10,mixedType,1
9,2,0,11,mixedType,1
9,1,0,10,mixedType,1
6,2,0,8,mixedType,1
9,3,0,12,mixedType,1
6,4,0,10,mixedType,1
5,5,0,10,mixedType,1
6,2,0,8,mixedType,1
8,3,0,11,mixedType,1
7,2,0,9,mixedType,1
8,1,0,9,mixedType,1
2,4,0,6,mixedType,0
7,3,0,10,mixedType,1
6,3,0,9,mixedType,1
6,4,0,10,mixedType,1
4,2,0,6,mixedType,0
5,6,0,11,mixedType,1
6,3,0,9,mixedType,1
7,2,0,9,mixedType,1
6,2,0,8,mixedType,1
8,2,0,10,mixedType,1
6,4,0,10,mixedType,1
7,3,0,10,mixedType,1
4,5,0,9,mixedType,1
13,3,0,16,mixedType,2
5,3,0,8,mixedType,1
7,1,0,8,mixedType,1
4,4,0,8,mixedType,1
8,3,0,11,mixedType,1
12,4,0,16,mixedType,2
8,1,0,9,mixedType,1
7,1,0,8,mixedType,1
8,3,0,11,mixedType,1
11,2,2,15,mixedType,2
6,1,0,7,mixedType,0
6,4,0,10,mixedType,1
5,3,0,8,mixedType,1
7,3,0,10,mixedType,1
8,0,2,10,mixedType,1
12,3,0,15,mixedType,2
7,1,0,8,mixedType,1
4,2,0,6,mixedType,0
3,8,0,11,mixedType,1
9,3,0,12,mixedType,1
4,5,0,9,mixedType,1
5,1,0,6,mixedType,0
6,3,0,9,mixedType,1
8,1,0,9,mixedType,1
3,3,0,6,mixedType,0
3,6,0,9,mixedType,1
5,2,0,7,mixedType,0
4,7,0,11,mixedType,1
6,3,0,9,mixedType,1
12,3,0,15,mixedType,2
10,1,0,11,mixedType,1
4,8,0,12,mixedType,1
8,3,0,11,mixedType,1
6,1,0,7,mixedType,0
7,1,0,8,mixedType,1
6,4,0,10,mixedType,1
4,2,0,6,mixedType,0
14,2,0,16,mixedType,2
6,1,0,7,mixedType,0
2,6,0,8,mixedType,1
12,4,0,16,mixedType,2
5,4,0,9,mixedType,1
3,3,0,6,mixedType,0
9,1,0,10,mixedType,1
12,3,0,15,mixedType,2
6,4,0,10,mixedType,1
7,3,0,10,mixedType,1
10,1,0,11,mixedType,1
7,4,0,11,mixedType,1
8,2,0,10,mixedType,1
5,3,0,8,mixedType,1
7,4,0,11,mixedType,1
7,3,0,10,mixedType,1
6,3,0,9,mixedType,1
6,3,0,9,mixedType,1
8,2,0,10,mixedType,1
7,2,0,9,mixedType,1
10,4,0,14,mixedType,2
5,3,0,8,mixedType,1
12,3,0,15,mixedType,2
8,1,0,9,mixedType,1
9,3,0,12,mixedType,1
7,3,0,10,mixedType,1
6,2,0,8,mixedType,1
6,3,0,9,mixedType,1
10,3,0,13,mixedType,1
6,1,0,7,mixedType,0
2,4,0,6,mixedType,0
6,2,0,8,mixedType,1
7,2,0,9,mixedType,1
6,7,0,13,mixedType,1
9,1,0,10,mixedType,1
9,2,0,11,mixedType,1
4,2,0,6,mixedType,0
7,3,0,10,mixedType,1
8,3,0,11,mixedType,1
9,3,0,12,mixedType,1
12,4,0,16,mixedType,2
4,8,0,12,mixedType,1
9,2,0,11,mixedType,1
9,2,0,11,mixedType,1
3,5,0,8,mixedType,1
6,7,0,13,mixedType,1
7,1,0,8,mixedType,1
5,5,0,10,mixedType,1
6,4,0,10,mixedType,1
9,8,0,17,mixedType,2
4,2,0,6,mixedType,0
7,3,0,10,mixedType,1
2,8,0,10,mixedType,1
3,6,0,9,mixedType,1
5,3,0,8,mixedType,1
8,4,0,12,mixedType,1
6,4,0,10,mixedType,1
5,4,0,9,mixedType,1
8,2,0,10,mixedType,1
8,3,0,11,mixedType,1
2,8,0,10,mixedType,1
5,2,0,7,mixedType,0
7,3,0,10,mixedType,1
5,2,0,7,mixedType,0
3,5,0,8,mixedType,1
11,3,0,14,mixedType,2
5,3,0,8,mixedType,1
7,3,0,10,mixedType,1
9,1,0,10,mixedType,1
13,3,0,16,mixedType,2
5,3,0,8,mixedType,1
10,2,0,12,mixedType,1
6,2,0,8,mixedType,1
7,3,0,10,mixedType,1
8,2,0,10,mixedType,1
9,1,0,10,mixedType,1
6,3,0,9,mixedType,1
8,1,0,9,mixedType,1
5,6,0,11,mixedType,1
9,2,3,14,mixedType,2
5,4,0,9,mixedType,1
9,2,0,11,mixedType,1
9,2,0,11,mixedType,1
6,3,0,9,mixedType,1
8,4,0,12,mixedType,1
6,3,0,9,mixedType,1
13,3,0,16,mixedType,2
7,2,0,9,mixedType,1
8,2,0,10,mixedType,1
12,1,0,13,mixedType,1
7,1,0,8,mixedType,1
6,3,0,9,mixedType,1
7,4,0,11,mixedType,1
6,3,0,9,mixedType,1
7,3,0,10,mixedType,1
5,1,0,6,mixedType,0
6,2,0,8,mixedType,1
6,4,0,10,mixedType,1
4,2,0,6,mixedType,0
14,2,0,16,mixedType,2
5,3,0,8,mixedType,1
7,3,0,10,mixedType,1
2,4,0,6,mixedType,0
13,3,0,16,mixedType,2
6,1,0,7,mixedType,0
4,6,0,10,mixedType,1
13,3,0,16,mixedType,2
6,4,0,10,mixedType,1
3,3,0,6,mixedType,0
5,5,0,10,mixedType,1
12,1,0,13,mixedType,1
4,8,0,12,mixedType,1
9,2,0,11,mixedType,1
12,4,0,16,mixedType,2
8,2,0,10,mixedType,1
5,4,0,9,mixedType,1
6,3,0,9,mixedType,1
5,4,0,9,mixedType,1
8,2,0,10,mixedType,1
5,4,0,9,mixedType,1
2,6,0,8,mixedType,1
7,2,0,9,mixedType,1
2,11,0,13,mixedType,1
6,4,0,10,mixedType,1
11,3,0,14,mixedType,2
7,3,0,10,mixedType,1
15,1,0,16,mixedType,2
9,1,0,10,mixedType,1
6,1,0,7,mixedType,0
4,2,0,6,mixedType,0
7,3,0,10,mixedType,1
7,3,0,10,mixedType,1
4,4,0,8,mixedType,1
5,1,0,6,mixedType,0
1,7,0,8,mixedType,1
5,4,0,9,mixedType,1
6,3,0,9,mixedType,1
5,9,1,15,mixedType,2
5,4,0,9,mixedType,1
5,2,0,7,mixedType,0
9,2,0,11,mixedType,1
5,4,0,9,mixedType,1
8,4,0,12,mixedType,1
8,2,0,10,mixedType,1
8,2,0,10,mixedType,1
9,3,0,12,mixedType,1
4,4,0,8,mixedType,1
7,6,0,13,mixedType,1
4,5,0,9,mixedType,1
3,6,0,9,mixedType,1
6,2,0,8,mixedType,1
4,4,0,8,mixedType,1
4,2,0,6,mixedType,0
8,2,0,10,mixedType,1
6,2,0,8,mixedType,1
6,3,0,9,mixedType,1
7,2,0,9,mixedType,1
5,1,0,6,mixedType,0
8,1,0,9,mixedType,1
1,9,0,10,mixedType,1
9,0,2,11,mixedType,1
5,2,0,7,mixedType,0
9,2,0,11,mixedType,1
8,2,0,10,mixedType,1
4,11,0,15,mixedType,2
7,3,0,10,mixedType,1
6,3,0,9,mixedType,1
8,1,0,9,mixedType,1
4,4,0,8,mixedType,1
8,2,0,10,mixedType,1
7,2,0,9,mixedType,1
7,3,0,10,mixedType,1
7,2,0,9,mixedType,1
2,11,0,13,mixedType,1
15,1,0,16,mixedType,2
5,2,0,7,mixedType,0
7,4,0,11,mixedType,1
11,3,0,14,mixedType,2
6,2,0,8,mixedType,1
5,3,0,8,mixedType,1
7,3,0,10,mixedType,1
5,3,0,8,mixedType,1
6,2,0,8,mixedType,1
1,8,0,9,mixedType,1
7,3,0,10,mixedType,1
7,3,0,10,mixedType,1
6,2,0,8,mixedType,1
8,4,0,12,mixedType,1
6,3,0,9,mixedType,1
14,2,0,16,mixedType,2
8,1,0,9,mixedType,1
5,1,0,6,mixedType,0
3,10,0,13,mixedType,1
6,1,0,7,mixedType,0
9,3,0,12,mixedType,1
6,4,0,10,mixedType,1
9,2,0,11,mixedType,1
7,3,0,10,mixedType,1
8,1,0,9,mixedType,1
6,3,0,9,mixedType,1
8,1,0,9,mixedType,1
14,2,0,16,mixedType,2
10,2,0,12,mixedType,1
8,1,0,9,mixedType,1
5,3,0,8,mixedType,1
3,3,0,6,mixedType,0
13,3,0,16,mixedType,2
2,8,0,10,mixedType,1
7,2,0,9,mixedType,1
8,1,0,9,mixedType,1
7,4,0,11,mixedType,1
15,1,0,16,mixedType,2
8,5,0,13,mixedType,1
6,2,0,8,mixedType,1
6,3,0,9,mixedType,1
1,8,0,9,mixedType,1
4,2,0,6,mixedType,0
3,7,0,10,mixedType,1
7,3,0,10,mixedType,1
6,3,0,9,mixedType,1
11,2,0,13,mixedType,1
7,3,0,10,mixedType,1
6,2,0,8,mixedType,1
6,3,0,9,mixedType,1
5,3,0,8,mixedType,1
7,1,0,8,mixedType,1
10,0,1,11,mixedType,1
12,2,1,15,mixedType,2
6,3,0,9,mixedType,1
9,3,0,12,mixedType,1
15,1,0,16,mixedType,2
4,4,0,8,mixedType,1
7,1,0,8,mixedType,1
8,3,0,11,mixedType,1
8,2,0,10,mixedType,1
5,4,0,9,mixedType,1
9,4,1,14,mixedType,2
3,5,0,8,mixedType,1
7,2,0,9,mixedType,1
5,2,0,7,mixedType,0
8,4,0,12,mixedType,1
5,2,0,7,mixedType,0
8,3,0,11,mixedType,1
8,2,0,10,mixedType,1
6,2,0,8,mixedType,1
7,3,0,10,mixedType,1
6,6,0,12,mixedType,1
7,1,0,8,mixedType,1
9,1,0,10,mixedType,1
4,7,0,11,mixedType,1
5,1,0,6,mixedType,0
7,2,0,9,mixedType,1
2,8,0,10,mixedType,1
14,2,0,16,mixedType,2
7,3,0,10,mixedType,1
1,9,0,10,mixedType,1
9,2,0,11,mixedType,1
3,3,0,6,mixedType,0
7,3,0,10,mixedType,1
11,1,0,12,mixedType,1
5,4,0,9,mixedType,1
7,3,0,10,mixedType,1
8,10,0,18,mixedType,2
8,2,0,10,mixedType,1
7,3,0,10,mixedType,1
5,7,0,12,mixedType,1
6,2,0,8,mixedType,1
4,4,0,8,mixedType,1
6,3,0,9,mixedType,1
5,4,0,9,mixedType,1
7,3,0,10,mixedType,1
5,5,0,10,mixedType,1
6,6,0,12,mixedType,1
6,3,0,9,mixedType,1
8,1,0,9,mixedType,1
6,4,0,10,mixedType,1
4,2,0,6,mixedType,0
7,2,0,9,mixedType,1
9,3,0,12,mixedType,1
4,4,0,8,mixedType,1
7,2,0,9,mixedType,1
6,2,0,8,mixedType,1
6,6,0,12,mixedType,1
4,2,0,6,mixedType,0
6,2,0,8,mixedType,1
4,6,0,10,mixedType,1
5,4,0,9,mixedType,1
1,8,0,9,mixedType,1
5,4,0,9,mixedType,1
7,3,0,10,mixedType,1
7,3,0,10,mixedType,1
6,1,0,7,mixedType,0
6,4,0,10,mixedType,1
14,2,0,16,mixedType,2
5,4,0,9,mixedType,1
0,7,2,9,mixedType,1
9,4,0,13,mixedType,1
7,2,0,9,mixedType,1
3,6,0,9,mixedType,1
2,4,0,6,mixedType,0
12,3,0,15,mixedType,2
3,5,0,8,mixedType,1
5,2,0,7,mixedType,0
8,2,0,10,mixedType,1
3,3,0,6,mixedType,0
7,2,0,9,mixedType,1
8,2,0,10,mixedType,1
9,5,0,14,mixedType,2
10,1,0,11,mixedType,1
6,1,0,7,mixedType,0
7,2,0,9,mixedType,1
11,2,0,13,mixedType,1
8,1,0,9,mixedType,1
5,1,0,6,mixedType,0
6,4,0,10,mixedType,1
6,6,0,12,mixedType,1
8,1,0,9,mixedType,1
8,3,0,11,mixedType,1
5,3,0,8,mixedType,1
1,8,0,9,mixedType,1
11,3,0,14,mixedType,2
0,10,1,11,mixedType,1
6,2,0,8,mixedType,1
7,3,0,10,mixedType,1
6,3,0,9,mixedType,1
4,6,0,10,mixedType,1
7,3,0,10,mixedType,1
7,1,0,8,mixedType,1
5,3,0,8,mixedType,1
6,3,0,9,mixedType,1
7,3,0,10,mixedType,1
6,1,0,7,mixedType,0
4,6,0,10,mixedType,1
6,2,0,8,mixedType,1
6,3,0,9,mixedType,1
5,1,0,6,mixedType,0
8,2,0,10,mixedType,1
7,1,0,8,mixedType,1
7,5,0,12,mixedType,1
6,2,0,8,mixedType,1
4,2,0,6,mixedType,0
8,2,0,10,mixedType,1
4,4,0,8,mixedType,1
7,2,0,9,mixedType,1
5,3,0,8,mixedType,1
6,4,0,10,mixedType,1
7,3,0,10,mixedType,1
4,2,0,6,mixedType,0
5,5,0,10,mixedType,1
7,3,0,10,mixedType,1
4,6,0,10,mixedType,1
7,3,0,10,mixedType,1
6,3,0,9,mixedType,1
4,2,0,6,mixedType,0
7,4,0,11,mixedType,1
7,1,0,8,mixedType,1
8,2,0,10,mixedType,1
7,1,0,8,mixedType,1
4,2,0,6,mixedType,0
3,10,0,13,mixedType,1
8,4,0,12,mixedType,1
6,3,0,9,mixedType,1
8,2,0,10,mixedType,1
3,6,0,9,mixedType,1
7,2,0,9,mixedType,1
6,3,0,9,mixedType,1
3,3,0,6,mixedType,0
4,2,0,6,mixedType,0
8,2,0,10,mixedType,1
6,3,0,9,mixedType,1
7,4,0,11,mixedType,1
5,1,0,6,mixedType,0
5,2,0,7,mixedType,0
9,3,0,12,mixedType,1
15,1,0,16,mixedType,2
9,4,0,13,mixedType,1
7,2,0,9,mixedType,1
6,2,0,8,mixedType,1
5,2,0,7,mixedType,0
7,1,0,8,mixedType,1
6,4,0,10,mixedType,1
5,4,0,9,mixedType,1
10,2,0,12,mixedType,1
12,4,0,16,mixedType,2
2,6,0,8,mixedType,1
6,4,0,10,mixedType,1
7,1,0,8,mixedType,1
4,7,0,11,mixedType,1
3,6,0,9,mixedType,1
11,3,0,14,mixedType,2
5,3,0,8,mixedType,1
6,2,0,8,mixedType,1
4,2,0,6,mixedType,0
9,4,0,13,mixedType,1
4,2,0,6,mixedType,0
7,4,0,11,mixedType,1
11,3,0,14,mixedType,2
5,2,0,7,mixedType,0
3,5,0,8,mixedType,1
7,2,0,9,mixedType,1
8,2,0,10,mixedType,1
10,2,0,12,mixedType,1
4,2,0,6,mixedType,0
6,3,0,9,mixedType,1
7,4,0,11,mixedType,1
7,1,0,8,mixedType,1
6,3,0,9,mixedType,1
5,4,0,9,mixedType,1
6,3,0,9,mixedType,1
4,2,0,6,mixedType,0
5,4,0,9,mixedType,1
8,2,0,10,mixedType,1
6,3,0,9,mixedType,1
2,4,0,6,mixedType,0
4,4,0,8,mixedType,1
6,4,0,10,mixedType,1
8,1,0,9,mixedType,1
5,3,0,8,mixedType,1
15,1,0,16,mixedType,2
4,4,0,8,mixedType,1
5,3,0,8,mixedType,1
5,6,0,11,mixedType,1
8,4,0,12,mixedType,1
5,3,0,8,mixedType,1
7,1,0,8,mixedType,1
8,1,0,9,mixedType,1
6,2,0,8,mixedType,1
2,4,0,6,mixedType,0
2,8,0,10,mixedType,1
5,3,0,8,mixedType,1
6,3,0,9,mixedType,1
6,4,0,10,mixedType,1
6,3,0,9,mixedType,1
8,3,0,11,mixedType,1
5,4,0,9,mixedType,1
9,1,0,10,mixedType,1
8,2,0,10,mixedType,1
6,2,0,8,mixedType,1
11,5,0,16,mixedType,2
6,4,0,10,mixedType,1
6,3,0,9,mixedType,1
14,2,0,16,mixedType,2
10,3,0,13,mixedType,1
5,2,0,7,mixedType,0
3,7,0,10,mixedType,1
6,3,0,9,mixedType,1
11,3,0,14,mixedType,2
3,6,0,9,mixedType,1
2,8,0,10,mixedType,1
6,2,0,8,mixedType,1
4,2,0,6,mixedType,0
8,10,2,20,mixedType,2
2,4,0,6,mixedType,0
6,2,0,8,mixedType,1
1,8,0,9,mixedType,1
8,4,0,12,mixedType,1
1,8,0,9,mixedType,1
7,1,0,8,mixedType,1
8,8,0,16,mixedType,2
6,3,0,9,mixedType,1
12,3,0,15,mixedType,2
1,7,0,8,mixedType,1
3,3,0,6,mixedType,0
6,3,0,9,mixedType,1
7,3,0,10,mixedType,1
10,3,0,13,mixedType,1
7,3,0,10,mixedType,1
4,2,0,6,mixedType,0
5,3,0,8,mixedType,1
4,4,1,9,mixedType,1
8,2,0,10,mixedType,1
9,5,0,14,mixedType,2
8,8,0,16,mixedType,2
1,9,0,10,mixedType,1
6,2,0,8,mixedType,1
12,4,0,16,mixedType,2
7,2,0,9,mixedType,1
10,1,0,11,mixedType,1
7,6,0,13,mixedType,1
8,2,0,10,mixedType,1
10,1,0,11,mixedType,1
4,6,0,10,mixedType,1
8,3,0,11,mixedType,1
13,3,0,16,mixedType,2
8,3,0,11,mixedType,1
5,2,0,7,mixedType,0
15,1,0,16,mixedType,2
15,1,0,16,mixedType,2
7,8,0,15,mixedType,2
7,3,0,10,mixedType,1
4,7,0,11,mixedType,1
6,3,0,9,mixedType,1
6,2,0,8,mixedType,1
8,1,0,9,mixedType,1
7,2,0,9,mixedType,1
4,2,6,12,mixedType,1
4,4,0,8,mixedType,1
3,6,0,9,mixedType,1
5,2,0,7,mixedType,0
13,3,0,16,mixedType,2
3,7,0,10,mixedType,1
7,0,0,7,sameType,0
9,3,0,12,mixedType,1
7,2,0,9,mixedType,1
6,4,0,10,mixedType,1
5,2,0,7,mixedType,0
13,3,0,16,mixedType,2
5,2,0,7,mixedType,0
3,6,0,9,mixedType,1
4,7,0,11,mixedType,1
4,4,0,8,mixedType,1
6,1,0,7,mixedType,0
8,1,0,9,mixedType,1
2,7,0,9,mixedType,1
4,5,0,9,mixedType,1
15,3,0,18,mixedType,2
4,8,0,12,mixedType,1
6,3,0,9,mixedType,1
2,8,0,10,mixedType,1
7,3,0,10,mixedType,1
14,2,0,16,mixedType,2
6,4,0,10,mixedType,1
7,1,0,8,mixedType,1
7,2,0,9,mixedType,1
6,3,0,9,mixedType,1
6,2,0,8,mixedType,1
14,2,0,16,mixedType,2
6,3,0,9,mixedType,1
4,9,0,13,mixedType,1
4,2,0,6,mixedType,0
6,3,0,9,mixedType,1
14,2,0,16,mixedType,2
6,3,0,9,mixedType,1
7,2,0,9,mixedType,1
6,3,0,9,mixedType,1
12,4,0,16,mixedType,2
8,2,0,10,mixedType,1
3,6,0,9,mixedType,1
6,2,0,8,mixedType,1
6,7,0,13,mixedType,1
12,4,0,16,mixedType,2
7,2,0,9,mixedType,1
3,6,0,9,mixedType,1
8,2,0,10,mixedType,1
6,3,0,9,mixedType,1
9,2,0,11,mixedType,1
6,3,0,9,mixedType,1
7,2,0,9,mixedType,1
14,2,0,16,mixedType,2
9,4,0,13,mixedType,1
8,6,0,14,mixedType,2
6,2,0,8,mixedType,1
12,4,0,16,mixedType,2
6,2,0,8,mixedType,1
4,2,0,6,mixedType,0
11,4,0,15,mixedType,2
3,6,0,9,mixedType,1
6,2,0,8,mixedType,1
6,3,0,9,mixedType,1
8,4,0,12,mixedType,1
6,2,0,8,mixedType,1
4,6,0,10,mixedType,1
14,2,0,16,mixedType,2
5,4,0,9,mixedType,1
7,2,0,9,mixedType,1
9,1,0,10,mixedType,1
9,2,0,11,mixedType,1
6,1,0,7,mixedType,0
9,1,0,10,mixedType,1
4,4,0,8,mixedType,1
8,3,0,11,mixedType,1
7,1,0,8,mixedType,1
8,1,0,9,mixedType,1
5,4,0,9,mixedType,1
9,1,0,10,mixedType,1
5,4,0,9,mixedType,1
7,1,0,8,mixedType,1
8,3,0,11,mixedType,1
8,3,0,11,mixedType,1
15,3,1,19,mixedType,2
7,2,0,9,mixedType,1
4,4,0,8,mixedType,1
2,4,0,6,mixedType,0
10,2,0,12,mixedType,1
5,4,0,9,mixedType,1
6,3,0,9,mixedType,1
9,1,0,10,mixedType,1
5,4,0,9,mixedType,1
7,2,0,9,mixedType,1
13,3,0,16,mixedType,2
3,3,0,6,mixedType,0
6,3,0,9,mixedType,1
4,2,0,6,mixedType,0
7,2,0,9,mixedType,1
4,4,0,8,mixedType,1
6,3,0,9,mixedType,1
5,4,0,9,mixedType,1
1,7,0,8,mixedType,1
0,8,0,8,sameType,1
10,3,0,13,mixedType,1
8,2,0,10,mixedType,1
1,8,0,9,mixedType,1
9,3,0,12,mixedType,1
5,3,0,8,mixedType,1
7,2,0,9,mixedType,1
5,2,0,7,mixedType,0
14,2,0,16,mixedType,2
6,1,0,7,mixedType,0
7,2,0,9,mixedType,1
7,1,0,8,mixedType,1
5,6,0,11,mixedType,1
7,2,0,9,mixedType,1
7,3,0,10,mixedType,1
14,2,0,16,mixedType,2
5,4,0,9,mixedType,1
14,2,0,16,mixedType,2
7,3,0,10,mixedType,1
7,2,0,9,mixedType,1
6,2,0,8,mixedType,1
12,4,0,16,mixedType,2
10,2,2,14,mixedType,2
6,3,0,9,mixedType,1
5,4,0,9,mixedType,1
8,1,0,9,mixedType,1
6,3,0,9,mixedType,1
2,8,0,10,mixedType,1
8,2,0,10,mixedType,1
5,3,0,8,mixedType,1
7,4,0,11,mixedType,1
11,1,0,12,mixedType,1
6,1,0,7,mixedType,0
7,2,0,9,mixedType,1
9,1,0,10,mixedType,1
7,1,0,8,mixedType,1
5,2,0,7,mixedType,0
6,6,0,12,mixedType,1
15,1,0,16,mixedType,2
10,1,0,11,mixedType,1
4,5,0,9,mixedType,1
12,1,0,13,mixedType,1
6,4,0,10,mixedType,1
9,1,0,10,mixedType,1
12,3,0,15,mixedType,2
7,4,0,11,mixedType,1
3,3,0,6,mixedType,0
5,3,0,8,mixedType,1
6,2,0,8,mixedType,1
5,3,0,8,mixedType,1
8,1,0,9,mixedType,1
6,3,0,9,mixedType,1
6,6,0,12,mixedType,1
11,3,0,14,mixedType,2
9,3,0,12,mixedType,1
5,0,2,7,mixedType,0
5,3,0,8,mixedType,1
2,4,0,6,mixedType,0
8,1,0,9,mixedType,1
1,11,0,12,mixedType,1
5,3,0,8,mixedType,1
13,3,0,16,mixedType,2
6,2,0,8,mixedType,1
7,2,0,9,mixedType,1
4,6,0,10,mixedType,1
3,3,0,6,mixedType,0
6,2,0,8,mixedType,1
11,4,1,16,mixedType,2
13,3,0,16,mixedType,2
5,2,0,7,mixedType,0
7,3,0,10,mixedType,1
3,7,0,10,mixedType,1
7,3,0,10,mixedType,1
5,3,0,8,mixedType,1
7,3,0,10,mixedType,1
6,2,0,8,mixedType,1
6,2,0,8,mixedType,1
6,3,0,9,mixedType,1
7,2,0,9,mixedType,1
7,3,0,10,mixedType,1
5,2,0,7,mixedType,0
6,3,0,9,mixedType,1
5,3,0,8,mixedType,1
7,2,0,9,mixedType,1
4,5,0,9,mixedType,1
4,2,0,6,mixedType,0
6,3,0,9,mixedType,1
8,2,0,10,mixedType,1
6,3,0,9,mixedType,1
4,2,0,6,mixedType,0
5,3,0,8,mixedType,1
4,2,0,6,mixedType,0
4,6,0,10,mixedType,1
4,5,0,9,mixedType,1
2,4,0,6,mixedType,0
8,3,0,11,mixedType,1
5,5,0,10,mixedType,1
6,2,0,8,mixedType,1
9,2,0,11,mixedType,1
6,1,0,7,mixedType,0
2,6,0,8,mixedType,1
12,4,0,16,mixedType,2
5,1,0,6,mixedType,0
5,2,0,7,mixedType,0
5,8,0,13,mixedType,1
7,2,0,9,mixedType,1
7,3,0,10,mixedType,1
4,4,0,8,mixedType,1
5,4,0,9,mixedType,1
5,3,0,8,mixedType,1
9,3,0,12,mixedType,1
8,3,0,11,mixedType,1
4,4,0,8,mixedType,1
8,3,0,11,mixedType,1
6,3,0,9,mixedType,1
4,6,0,10,mixedType,1
10,3,1,14,mixedType,2
10,2,0,12,mixedType,1
6,3,0,9,mixedType,1
13,3,0,16,mixedType,2
5,1,0,6,mixedType,0
12,3,0,15,mixedType,2
3,5,0,8,mixedType,1
8,2,0,10,mixedType,1
3,3,0,6,mixedType,0
6,1,0,7,mixedType,0
6,1,0,7,mixedType,0
5,3,0,8,mixedType,1
8,2,0,10,mixedType,1
14,2,0,16,mixedType,2
5,1,0,6,mixedType,0
7,4,0,11,mixedType,1
7,3,0,10,mixedType,1
4,4,0,8,mixedType,1
6,3,0,9,mixedType,1
7,2,0,9,mixedType,1
2,8,0,10,mixedType,1
5,5,0,10,mixedType,1
1,9,0,10,mixedType,1
6,3,0,9,mixedType,1
6,2,0,8,mixedType,1
7,3,0,10,mixedType,1
6,4,0,10,mixedType,1
7,2,0,9,mixedType,1
6,1,0,7,mixedType,0
4,2,0,6,mixedType,0
9,4,0,13,mixedType,1
6,3,0,9,mixedType,1
9,3,0,12,mixedType,1
6,2,0,8,mixedType,1
13,3,0,16,mixedType,2
4,4,0,8,mixedType,1
7,3,0,10,mixedType,1
5,2,0,7,mixedType,0
14,2,0,16,mixedType,2
10,3,0,13,mixedType,1
6,1,0,7,mixedType,0
2,4,0,6,mixedType,0
1,5,0,6,mixedType,0
5,3,0,8,mixedType,1
9,1,0,10,mixedType,1
7,2,0,9,mixedType,1
6,4,0,10,mixedType,1
5,9,0,14,mixedType,2
6,3,0,9,mixedType,1
9,3,0,12,mixedType,1
8,4,0,12,mixedType,1
9,1,0,10,mixedType,1
7,1,0,8,mixedType,1
6,1,0,7,mixedType,0
8,3,0,11,mixedType,1
7,3,0,10,mixedType,1
7,2,0,9,mixedType,1
9,3,0,12,mixedType,1
4,7,0,11,mixedType,1
7,3,0,10,mixedType,1
7,3,0,10,mixedType,1
13,3,0,16,mixedType,2
7,2,0,9,mixedType,1
8,1,0,9,mixedType,1
5,3,0,8,mixedType,1
8,4,0,12,mixedType,1
6,3,0,9,mixedType,1
5,2,0,7,mixedType,0
1,8,0,9,mixedType,1
8,1,0,9,mixedType,1
5,3,0,8,mixedType,1
6,1,0,7,mixedType,0
9,2,0,11,mixedType,1
2,8,0,10,mixedType,1
5,2,0,7,mixedType,0
13,3,0,16,mixedType,2
9,1,0,10,mixedType,1
7,3,0,10,mixedType,1
2,8,0,10,mixedType,1
9,2,0,11,mixedType,1
7,1,0,8,mixedType,1
7,2,0,9,mixedType,1
12,0,1,13,mixedType,1
6,1,0,7,mixedType,0
8,3,0,11,mixedType,1
9,2,0,11,mixedType,1
6,3,0,9,mixedType,1
14,2,0,16,mixedType,2
4,7,0,11,mixedType,1
8,3,0,11,mixedType,1
7,3,0,10,mixedType,1
7,3,0,10,mixedType,1
8,4,0,12,mixedType,1
5,4,0,9,mixedType,1
6,1,0,7,mixedType,0
5,2,0,7,mixedType,0
6,3,0,9,mixedType,1
12,4,0,16,mixedType,2
6,3,0,9,mixedType,1
15,1,0,16,mixedType,2
5,2,0,7,mixedType,0
12,4,0,16,mixedType,2
8,1,0,9,mixedType,1
7,3,0,10,mixedType,1
7,2,0,9,mixedType,1
4,6,0,10,mixedType,1
5,4,0,9,mixedType,1
3,3,0,6,mixedType,0
8,2,0,10,mixedType,1
4,4,0,8,mixedType,1
4,6,0,10,mixedType,1
14,2,0,16,mixedType,2
5,2,0,7,mixedType,0
8,2,0,10,mixedType,1
12,3,0,15,mixedType,2
10,2,0,12,mixedType,1
6,1,0,7,mixedType,0
7,3,0,10,mixedType,1
6,2,0,8,mixedType,1
6,3,0,9,mixedType,1
2,4,0,6,mixedType,0
11,0,1,12,mixedType,1
7,3,0,10,mixedType,1
4,4,0,8,mixedType,1
14,2,0,16,mixedType,2
5,3,0,8,mixedType,1
14,2,0,16,mixedType,2
7,3,0,10,mixedType,1
12,4,0,16,mixedType,2
8,3,0,11,mixedType,1
8,4,0,12,mixedType,1
7,3,0,10,mixedType,1
6,4,0,10,mixedType,1
6,4,0,10,mixedType,1
2,6,0,8,mixedType,1
1,7,0,8,mixedType,1
9,1,0,10,mixedType,1
6,4,0,10,mixedType,1
6,3,0,9,mixedType,1
5,4,0,9,mixedType,1
7,2,0,9,mixedType,1
7,3,0,10,mixedType,1
8,2,0,10,mixedType,1
7,3,0,10,mixedType,1
5,1,0,6,mixedType,0
7,2,0,9,mixedType,1
6,1,0,7,mixedType,0
9,1,0,10,mixedType,1
7,3,0,10,mixedType,1
10,11,0,21,mixedType,2
4,4,0,8,mixedType,1
4,2,0,6,mixedType,0
6,4,0,10,mixedType,1
10,1,0,11,mixedType,1
5,2,0,7,mixedType,0
7,1,0,8,mixedType,1
7,2,0,9,mixedType,1
14,2,0,16,mixedType,2
7,1,0,8,mixedType,1
6,2,0,8,mixedType,1
6,4,0,10,mixedType,1
6,3,0,9,mixedType,1
3,6,0,9,mixedType,1
8,1,0,9,mixedType,1
3,3,0,6,mixedType,0
11,5,0,16,mixedType,2
8,2,0,10,mixedType,1
1,7,0,8,mixedType,1
5,5,0,10,mixedType,1
5,1,0,6,mixedType,0
15,2,1,18,mixedType,2
5,3,0,8,mixedType,1
8,6,0,14,mixedType,2
8,2,0,10,mixedType,1
14,2,0,16,mixedType,2
6,3,0,9,mixedType,1
6,2,0,8,mixedType,1
15,1,0,16,mixedType,2
6,2,0,8,mixedType,1
3,6,0,9,mixedType,1
12,1,0,13,mixedType,1
5,2,0,7,mixedType,0
4,5,0,9,mixedType,1
15,1,0,16,mixedType,2
9,2,0,11,mixedType,1
5,3,0,8,mixedType,1
9,2,0,11,mixedType,1
4,4,0,8,mixedType,1
5,1,0,6,mixedType,0
5,4,0,9,mixedType,1
3,6,0,9,mixedType,1
9,4,0,13,mixedType,1
9,1,0,10,mixedType,1
8,1,0,9,mixedType,1
7,1,0,8,mixedType,1
7,3,0,10,mixedType,1
9,2,0,11,mixedType,1
7,1,0,8,mixedType,1
7,3,0,10,mixedType,1
14,2,0,16,mixedType,2
3,3,0,6,mixedType,0
7,1,0,8,mixedType,1
7,1,0,8,mixedType,1
6,1,0,7,mixedType,0
6,4,0,10,mixedType,1
9,2,0,11,mixedType,1
5,4,0,9,mixedType,1
7,0,2,9,mixedType,1
5,4,0,9,mixedType,1
5,2,0,7,mixedType,0
6,3,0,9,mixedType,1
11,4,0,15,mixedType,2
8,4,0,12,mixedType,1
5,3,0,8,mixedType,1
5,4,0,9,mixedType,1
13,3,0,16,mixedType,2
8,2,0,10,mixedType,1
5,2,0,7,mixedType,0
13,3,0,16,mixedType,2
7,3,0,10,mixedType,1
6,3,0,9,mixedType,1
14,2,0,16,mixedType,2
6,1,0,7,mixedType,0
8,1,0,9,mixedType,1
12,3,2,17,mixedType,2
7,3,0,10,mixedType,1
9,2,0,11,mixedType,1
14,2,0,16,mixedType,2
12,3,0,15,mixedType,2
5,2,0,7,mixedType,0
6,1,0,7,mixedType,0
6,1,0,7,mixedType,0
14,2,0,16,mixedType,2
6,1,0,7,mixedType,0
6,3,0,9,mixedType,1
4,4,0,8,mixedType,1
5,2,0,7,mixedType,0
6,1,0,7,mixedType,0
4,4,0,8,mixedType,1
7,2,0,9,mixedType,1
7,3,0,10,mixedType,1
5,2,0,7,mixedType,0
7,6,0,13,mixedType,1
8,1,0,9,mixedType,1
6,1,0,7,mixedType,0
5,3,0,8,mixedType,1
13,3,0,16,mixedType,2
1,10,0,11,mixedType,1
1,8,0,9,mixedType,1
7,3,0,10,mixedType,1
9,4,0,13,mixedType,1
6,1,0,7,mixedType,0
6,1,0,7,mixedType,0
15,1,0,16,mixedType,2
7,2,0,9,mixedType,1
6,1,0,7,mixedType,0
5,4,1,10,mixedType,1
2,7,0,9,mixedType,1
10,1,0,11,mixedType,1
9,4,0,13,mixedType,1
6,2,0,8,mixedType,1
9,1,0,10,mixedType,1
6,1,0,7,mixedType,0
6,4,0,10,mixedType,1
7,3,0,10,mixedType,1
5,2,0,7,mixedType,0
6,3,0,9,mixedType,1
3,6,0,9,mixedType,1
9,1,0,10,mixedType,1
7,3,0,10,mixedType,1
7,1,0,8,mixedType,1
15,1,0,16,mixedType,2
5,0,1,6,mixedType,0
7,1,0,8,mixedType,1
9,3,0,12,mixedType,1
9,3,0,12,mixedType,1
8,2,0,10,mixedType,1
15,1,0,16,mixedType,2
4,7,0,11,mixedType,1
6,2,0,8,mixedType,1
13,3,0,16,mixedType,2
3,5,0,8,mixedType,1
5,2,0,7,mixedType,0
12,3,0,15,mixedType,2
6,1,0,7,mixedType,0
6,2,0,8,mixedType,1
4,6,0,10,mixedType,1
7,3,0,10,mixedType,1
7,3,0,10,mixedType,1
5,2,0,7,mixedType,0
6,2,0,8,mixedType,1
7,2,0,9,mixedType,1
4,2,0,6,mixedType,0
7,2,0,9,mixedType,1
13,3,0,16,mixedType,2
10,1,0,11,mixedType,1
10,3,0,13,mixedType,1
13,3,0,16,mixedType,2
8,2,0,10,mixedType,1
1,8,0,9,mixedType,1
5,2,0,7,mixedType,0
6,4,0,10,mixedType,1
4,4,0,8,mixedType,1
14,3,0,17,mixedType,2
8,1,0,9,mixedType,1
15,1,0,16,mixedType,2
7,2,0,9,mixedType,1
11,3,0,14,mixedType,2
8,1,0,9,mixedType,1
3,8,0,11,mixedType,1
5,8,2,15,mixedType,2
6,1,0,7,mixedType,0
3,6,0,9,mixedType,1
7,3,0,10,mixedType,1
9,1,0,10,mixedType,1
5,1,0,6,mixedType,0
6,4,0,10,mixedType,1
0,7,1,8,mixedType,1
8,2,0,10,mixedType,1
5,2,0,7,mixedType,0
2,7,0,9,mixedType,1
7,1,0,8,mixedType,1
0,6,1,7,mixedType,0
4,4,0,8,mixedType,1
9,3,0,12,mixedType,1
8,3,0,11,mixedType,1
3,6,0,9,mixedType,1
1,8,0,9,mixedType,1
7,1,0,8,mixedType,1
7,3,0,10,mixedType,1
6,2,0,8,mixedType,1
6,4,0,10,mixedType,1
7,3,0,10,mixedType,1
8,1,0,9,mixedType,1
6,3,0,9,mixedType,1
15,1,0,16,mixedType,2
12,4,2,18,mixedType,2
2,4,0,6,mixedType,0
13,3,0,16,mixedType,2
4,8,0,12,mixedType,1
5,3,0,8,mixedType,1
5,3,0,8,mixedType,1
9,1,0,10,mixedType,1
6,1,0,7,mixedType,0
7,3,0,10,mixedType,1
5,4,0,9,mixedType,1
6,3,0,9,mixedType,1
6,2,0,8,mixedType,1
4,2,0,6,mixedType,0
5,3,0,8,mixedType,1
8,2,0,10,mixedType,1
9,3,0,12,mixedType,1
6,6,0,12,mixedType,1
4,6,0,10,mixedType,1
4,7,0,11,mixedType,1
8,1,0,9,mixedType,1
11,2,0,13,mixedType,1
7,3,0,10,mixedType,1
5,2,0,7,mixedType,0
9,7,0,16,mixedType,2
5,2,0,7,mixedType,0
1,10,0,11,mixedType,1
12,3,0,15,mixedType,2
8,4,0,12,mixedType,1
14,2,0,16,mixedType,2
6,1,0,7,mixedType,0
7,2,0,9,mixedType,1
6,3,0,9,mixedType,1
7,6,2,15,mixedType,2
6,1,0,7,mixedType,0
6,2,0,8,mixedType,1
4,2,0,6,mixedType,0
7,3,0,10,mixedType,1
5,3,0,8,mixedType,1
12,3,0,15,mixedType,2
6,4,0,10,mixedType,1
6,3,0,9,mixedType,1
5,3,0,8,mixedType,1
5,2,0,7,mixedType,0
5,4,0,9,mixedType,1
8,1,0,9,mixedType,1
9,2,0,11,mixedType,1
8,4,0,12,mixedType,1
5,3,0,8,mixedType,1
5,6,0,11,mixedType,1
7,5,0,12,mixedType,1
12,4,0,16,mixedType,2
1,8,0,9,mixedType,1
8,1,0,9,mixedType,1
6,3,0,9,mixedType,1
14,2,0,16,mixedType,2
8,1,0,9,mixedType,1
9,1,0,10,mixedType,1
7,2,0,9,mixedType,1
7,2,0,9,mixedType,1
8,4,0,12,mixedType,1
5,1,0,6,mixedType,0
4,4,0,8,mixedType,1
11,1,0,12,mixedType,1
15,1,0,16,mixedType,2
5,2,0,7,mixedType,0
8,2,0,10,mixedType,1
14,2,0,16,mixedType,2
6,2,0,8,mixedType,1
5,3,0,8,mixedType,1
14,2,0,16,mixedType,2
6,4,0,10,mixedType,1
6,4,0,10,mixedType,1
6,4,0,10,mixedType,1
4,4,0,8,mixedType,1
7,3,0,10,mixedType,1
5,2,0,7,mixedType,0
7,3,0,10,mixedType,1
3,6,0,9,mixedType,1
9,3,0,12,mixedType,1
5,1,0,6,mixedType,0
6,1,0,7,mixedType,0
6,2,0,8,mixedType,1
5,3,0,8,mixedType,1
5,3,0,8,mixedType,1
7,5,0,12,mixedType,1
8,2,0,10,mixedType,1
7,1,0,8,mixedType,1
4,4,0,8,mixedType,1
12,4,0,16,mixedType,2
15,1,0,16,mixedType,2
7,1,0,8,mixedType,1
8,4,0,12,mixedType,1
14,2,0,16,mixedType,2
5,2,0,7,mixedType,0
6,1,0,7,mixedType,0
9,1,0,10,mixedType,1
14,2,0,16,mixedType,2
14,2,0,16,mixedType,2
6,6,0,12,mixedType,1
8,3,0,11,mixedType,1
6,2,0,8,mixedType,1
5,1,0,6,mixedType,0
14,2,0,16,mixedType,2
7,3,0,10,mixedType,1
8,1,0,9,mixedType,1
6,1,0,7,mixedType,0
9,1,0,10,mixedType,1
7,2,0,9,mixedType,1
12,1,0,13,mixedType,1
1,8,0,9,mixedType,1
8,2,0,10,mixedType,1
5,3,0,8,mixedType,1
6,2,0,8,mixedType,1
7,4,0,11,mixedType,1
5,6,0,11,mixedType,1
7,3,0,10,mixedType,1
6,2,0,8,mixedType,1
15,1,0,16,mixedType,2
11,1,0,12,mixedType,1
9,2,0,11,mixedType,1
7,4,0,11,mixedType,1
2,6,0,8,mixedType,1
2,6,0,8,mixedType,1
6,3,0,9,mixedType,1
4,6,0,10,mixedType,1
3,6,0,9,mixedType,1
8,7,0,15,mixedType,2
4,2,0,6,mixedType,0
7,6,0,13,mixedType,1
5,2,0,7,mixedType,0
7,3,0,10,mixedType,1
3,3,0,6,mixedType,0
10,1,0,11,mixedType,1
9,3,0,12,mixedType,1
5,4,0,9,mixedType,1
4,2,0,6,mixedType,0
7,4,0,11,mixedType,1
10,1,0,11,mixedType,1
10,1,0,11,mixedType,1
6,3,0,9,mixedType,1
2,10,0,12,mixedType,1
5,1,0,6,mixedType,0
1,9,0,10,mixedType,1
11,5,1,17,mixedType,2
8,2,0,10,mixedType,1
8,2,0,10,mixedType,1
3,3,0,6,mixedType,0
9,1,0,10,mixedType,1
6,3,0,9,mixedType,1
8,1,0,9,mixedType,1
5,5,0,10,mixedType,1
6,3,0,9,mixedType,1
14,2,0,16,mixedType,2
5,3,0,8,mixedType,1
3,9,0,12,mixedType,1
7,3,0,10,mixedType,1
9,2,0,11,mixedType,1
5,4,0,9,mixedType,1
7,4,0,11,mixedType,1
6,4,0,10,mixedType,1
3,5,0,8,mixedType,1
4,6,0,10,mixedType,1
9,1,0,10,mixedType,1
5,3,0,8,mixedType,1
4,2,0,6,mixedType,0
6,1,0,7,mixedType,0
10,1,0,11,mixedType,1
6,3,0,9,mixedType,1
6,4,0,10,mixedType,1
5,3,0,8,mixedType,1
6,3,0,9,mixedType,1
5,3,0,8,mixedType,1
6,4,0,10,mixedType,1
7,3,0,10,mixedType,1
9,3,0,12,mixedType,1
12,1,0,13,mixedType,1
6,3,0,9,mixedType,1
6,1,0,7,mixedType,0
7,2,0,9,mixedType,1
1,8,0,9,mixedType,1
4,6,0,10,mixedType,1
4,9,0,13,mixedType,1
7,6,0,13,mixedType,1
14,2,0,16,mixedType,2
3,6,0,9,mixedType,1
5,6,0,11,mixedType,1
6,2,0,8,mixedType,1
15,1,0,16,mixedType,2
13,1,1,15,mixedType,2
6,2,0,8,mixedType,1
7,2,0,9,mixedType,1
8,2,0,10,mixedType,1
6,3,0,9,mixedType,1
9,1,0,10,mixedType,1
4,4,0,8,mixedType,1
5,2,0,7,mixedType,0
7,2,0,9,mixedType,1
9,3,0,12,mixedType,1
8,2,0,10,mixedType,1
7,2,0,9,mixedType,1
12,4,0,16,mixedType,2
7,3,0,10,mixedType,1
5,1,0,6,mixedType,0
5,1,0,6,mixedType,0
6,3,0,9,mixedType,1
6,4,0,10,mixedType,1
12,4,0,16,mixedType,2
2,7,0,9,mixedType,1
15,1,0,16,mixedType,2
14,2,0,16,mixedType,2
6,4,0,10,mixedType,1
6,3,0,9,mixedType,1
5,2,0,7,mixedType,0
8,2,0,10,mixedType,1
9,1,0,10,mixedType,1
5,4,0,9,mixedType,1
7,2,0,9,mixedType,1
6,4,0,10,mixedType,1
6,4,0,10,mixedType,1
5,2,0,7,mixedType,0
5,3,0,8,mixedType,1
6,1,0,7,mixedType,0
8,1,0,9,mixedType,1
6,4,0,10,mixedType,1
7,2,0,9,mixedType,1
4,4,0,8,mixedType,1
1,10,0,11,mixedType,1
6,2,0,8,mixedType,1
6,1,0,7,mixedType,0
2,8,0,10,mixedType,1
2,8,0,10,mixedType,1
5,3,0,8,mixedType,1
1,7,0,8,mixedType,1
8,3,0,11,mixedType,1
7,2,0,9,mixedType,1
3,6,0,9,mixedType,1
7,3,0,10,mixedType,1
6,4,0,10,mixedType,1
14,2,0,16,mixedType,2
6,1,0,7,mixedType,0
6,1,0,7,mixedType,0
6,4,0,10,mixedType,1
6,4,0,10,mixedType,1
7,3,0,10,mixedType,1
9,1,0,10,mixedType,1
5,2,0,7,mixedType,0
11,1,0,12,mixedType,1
14,2,0,16,mixedType,2
11,3,0,14,mixedType,2
5,3,0,8,mixedType,1
2,8,0,10,mixedType,1
5,2,0,7,mixedType,0
5,1,0,6,mixedType,0
5,4,0,9,mixedType,1
9,1,0,10,mixedType,1
12,4,0,16,mixedType,2
10,2,0,12,mixedType,1
8,1,0,9,mixedType,1
5,2,0,7,mixedType,0
4,2,0,6,mixedType,0
6,4,0,10,mixedType,1
7,3,0,10,mixedType,1
6,4,0,10,mixedType,1
4,4,0,8,mixedType,1
4,4,0,8,mixedType,1
7,3,0,10,mixedType,1
6,1,0,7,mixedType,0
5,3,0,8,mixedType,1
11,5,0,16,mixedType,2
3,6,0,9,mixedType,1
6,4,0,10,mixedType,1
6,3,0,9,mixedType,1
7,2,0,9,mixedType,1
5,3,0,8,mixedType,1
5,4,0,9,mixedType,1
9,1,0,10,mixedType,1
7,3,0,10,mixedType,1
5,3,0,8,mixedType,1
7,4,0,11,mixedType,1
8,3,0,11,mixedType,1
6,6,0,12,mixedType,1
8,2,0,10,mixedType,1
6,1,0,7,mixedType,0
3,5,0,8,mixedType,1
8,2,0,10,mixedType,1
5,2,0,7,mixedType,0
4,4,0,8,mixedType,1
5,1,0,6,mixedType,0
4,2,0,6,mixedType,0
6,4,0,10,mixedType,1
1,5,0,6,mixedType,0
5,3,0,8,mixedType,1
5,4,0,9,mixedType,1
13,3,0,16,mixedType,2
11,0,1,12,mixedType,1
8,1,0,9,mixedType,1
13,3,0,16,mixedType,2
15,1,0,16,mixedType,2
5,2,0,7,mixedType,0
5,3,0,8,mixedType,1
8,2,0,10,mixedType,1
6,3,0,9,mixedType,1
6,3,0,9,mixedType,1
8,2,0,10,mixedType,1
4,2,0,6,mixedType,0
11,3,0,14,mixedType,2
6,1,0,7,mixedType,0
8,3,0,11,mixedType,1
5,8,0,13,mixedType,1
8,2,0,10,mixedType,1
6,3,0,9,mixedType,1
5,2,0,7,mixedType,0
7,2,0,9,mixedType,1
5,4,0,9,mixedType,1
4,2,0,6,mixedType,0
4,5,0,9,mixedType,1
7,8,0,15,mixedType,2
9,1,0,10,mixedType,1
7,3,0,10,mixedType,1
7,1,0,8,mixedType,1
6,1,0,7,mixedType,0
4,2,0,6,mixedType,0
1,9,0,10,mixedType,1
6,3,0,9,mixedType,1
10,1,0,11,mixedType,1
8,3,0,11,mixedType,1
6,4,0,10,mixedType,1
4,4,0,8,mixedType,1
9,1,0,10,mixedType,1
8,1,0,9,mixedType,1
7,1,0,8,mixedType,1
3,6,0,9,mixedType,1
6,7,0,13,mixedType,1
5,2,0,7,mixedType,0
5,2,0,7,mixedType,0
7,3,0,10,mixedType,1
7,8,1,16,mixedType,2
8,1,0,9,mixedType,1
7,2,0,9,mixedType,1
8,1,0,9,mixedType,1
7,3,0,10,mixedType,1
1,9,0,10,mixedType,1
11,1,0,12,mixedType,1
12,1,0,13,mixedType,1
8,2,0,10,mixedType,1
6,2,0,8,mixedType,1
5,2,0,7,mixedType,0
1,8,0,9,mixedType,1
7,3,0,10,mixedType,1
14,2,0,16,mixedType,2
2,8,0,10,mixedType,1
5,3,0,8,mixedType,1
6,4,0,10,mixedType,1
6,4,0,10,mixedType,1
4,4,0,8,mixedType,1
7,5,0,12,mixedType,1
5,3,0,8,mixedType,1
15,1,0,16,mixedType,2
5,4,0,9,mixedType,1
6,3,0,9,mixedType,1
8,2,0,10,mixedType,1
5,2,0,7,mixedType,0
6,4,0,10,mixedType,1
8,3,0,11,mixedType,1
9,1,0,10,mixedType,1
6,3,0,9,mixedType,1
5,1,0,6,mixedType,0
8,1,0,9,mixedType,1
6,3,0,9,mixedType,1
3,8,0,11,mixedType,1
2,6,0,8,mixedType,1
5,3,0,8,mixedType,1
4,2,0,6,mixedType,0
5,4,0,9,mixedType,1
9,2,0,11,mixedType,1
7,3,0,10,mixedType,1
9,3,0,12,mixedType,1
8,2,0,10,mixedType,1
5,5,0,10,mixedType,1
15,1,0,16,mixedType,2
15,1,0,16,mixedType,2
11,3,0,14,mixedType,2
5,3,0,8,mixedType,1
5,4,0,9,mixedType,1
1,8,0,9,mixedType,1
6,3,0,9,mixedType,1
8,2,0,10,mixedType,1
4,2,0,6,mixedType,0
7,3,0,10,mixedType,1
5,2,0,7,mixedType,0
5,2,0,7,mixedType,0
6,3,0,9,mixedType,1
7,2,0,9,mixedType,1
7,1,0,8,mixedType,1
15,1,0,16,mixedType,2
2,8,0,10,mixedType,1
11,1,0,12,mixedType,1
4,6,0,10,mixedType,1
8,2,0,10,mixedType,1
8,3,0,11,mixedType,1
14,1,0,15,mixedType,2
11,3,0,14,mixedType,2
4,8,0,12,mixedType,1
7,2,0,9,mixedType,1
7,4,0,11,mixedType,1
2,10,0,12,mixedType,1
16,1,1,18,mixedType,2
7,1,0,8,mixedType,1
5,2,0,7,mixedType,0
16,1,1,18,mixedType,2
8,2,0,10,mixedType,1
6,4,0,10,mixedType,1
7,1,0,8,mixedType,1
9,1,0,10,mixedType,1
1,10,0,11,mixedType,1
7,1,0,8,mixedType,1
13,3,0,16,mixedType,2
13,3,0,16,mixedType,2
5,1,0,6,mixedType,0
8,2,0,10,mixedType,1
6,3,0,9,mixedType,1
7,2,0,9,mixedType,1
4,2,0,6,mixedType,0
7,2,0,9,mixedType,1
8,2,0,10,mixedType,1
8,2,0,10,mixedType,1
9,3,0,12,mixedType,1
5,2,0,7,mixedType,0
9,2,0,11,mixedType,1
11,2,0,13,mixedType,1
5,2,0,7,mixedType,0
8,4,0,12,mixedType,1
7,4,0,11,mixedType,1
5,2,0,7,mixedType,0
6,4,0,10,mixedType,1
6,2,0,8,mixedType,1
8,2,0,10,mixedType,1
5,3,0,8,mixedType,1
6,4,0,10,mixedType,1
5,4,0,9,mixedType,1
7,1,0,8,mixedType,1
4,2,0,6,mixedType,0
4,4,0,8,mixedType,1
6,1,0,7,mixedType,0
8,2,0,10,mixedType,1
7,2,0,9,mixedType,1
4,4,0,8,mixedType,1
6,4,0,10,mixedType,1
4,6,0,10,mixedType,1
5,2,0,7,mixedType,0
6,3,0,9,mixedType,1
6,4,0,10,mixedType,1
1,8,0,9,mixedType,1
11,5,0,16,mixedType,2
7,2,0,9,mixedType,1
3,6,0,9,mixedType,1
12,4,0,16,mixedType,2
6,3,0,9,mixedType,1
5,2,0,7,mixedType,0
10,1,0,11,mixedType,1
5,3,0,8,mixedType,1
7,3,0,10,mixedType,1
11,2,0,13,mixedType,1
7,3,0,10,mixedType,1
6,2,0,8,mixedType,1
7,4,0,11,mixedType,1
4,4,0,8,mixedType,1
5,6,0,11,mixedType,1
6,1,0,7,mixedType,0
2,6,0,8,mixedType,1
6,3,0,9,mixedType,1
5,2,0,7,mixedType,0
7,2,0,9,mixedType,1
4,2,0,6,mixedType,0
2,8,0,10,mixedType,1
15,1,0,16,mixedType,2
7,2,0,9,mixedType,1
4,2,0,6,mixedType,0
4,2,0,6,mixedType,0
7,2,0,9,mixedType,1
7,2,0,9,mixedType,1
6,2,0,8,mixedType,1
14,2,0,16,mixedType,2
7,2,0,9,mixedType,1
4,4,0,8,mixedType,1
9,1,0,10,mixedType,1
12,4,0,16,mixedType,2
10,2,0,12,mixedType,1
6,3,0,9,mixedType,1
8,1,0,9,mixedType,1
4,5,0,9,mixedType,1
11,2,0,13,mixedType,1
6,4,0,10,mixedType,1
8,3,0,11,mixedType,1
7,6,0,13,mixedType,1
5,2,0,7,mixedType,0
13,3,0,16,mixedType,2
7,1,0,8,mixedType,1
7,2,0,9,mixedType,1
2,8,0,10,mixedType,1
5,1,0,6,mixedType,0
7,1,0,8,mixedType,1
11,3,0,14,mixedType,2
7,2,0,9,mixedType,1
2,4,0,6,mixedType,0
7,3,0,10,mixedType,1
2,8,0,10,mixedType,1
1,7,0,8,mixedType,1
7,3,0,10,mixedType,1
6,2,0,8,mixedType,1
3,7,0,10,mixedType,1
5,8,0,13,mixedType,1
11,3,0,14,mixedType,2
15,1,0,16,mixedType,2
1,7,0,8,mixedType,1
3,6,0,9,mixedType,1
5,3,0,8,mixedType,1
8,4,0,12,mixedType,1
4,4,0,8,mixedType,1
6,4,0,10,mixedType,1
7,3,0,10,mixedType,1
10,2,0,12,mixedType,1
1,7,0,8,mixedType,1
3,6,0,9,mixedType,1
5,1,0,6,mixedType,0
5,2,0,7,mixedType,0
12,4,0,16,mixedType,2
7,2,0,9,mixedType,1
7,6,0,13,mixedType,1
5,2,0,7,mixedType,0
7,3,0,10,mixedType,1
7,3,0,10,mixedType,1
7,5,0,12,mixedType,1
9,2,0,11,mixedType,1
8,2,0,10,mixedType,1
13,3,0,16,mixedType,2
13,3,0,16,mixedType,2
6,4,0,10,mixedType,1
4,4,0,8,mixedType,1
8,3,0,11,mixedType,1
12,1,1,14,mixedType,2
6,2,0,8,mixedType,1
6,3,0,9,mixedType,1
17,1,0,18,mixedType,2
7,3,0,10,mixedType,1
7,2,0,9,mixedType,1
6,5,0,11,mixedType,1
15,1,0,16,mixedType,2
5,3,0,8,mixedType,1
1,8,0,9,mixedType,1
11,5,0,16,mixedType,2
4,4,0,8,mixedType,1
5,4,0,9,mixedType,1
8,3,0,11,mixedType,1
8,5,0,13,mixedType,1
4,2,0,6,mixedType,0
7,3,0,10,mixedType,1
8,2,0,10,mixedType,1
11,3,0,14,mixedType,2
4,2,0,6,mixedType,0
6,2,0,8,mixedType,1
6,2,0,8,mixedType,1
5,3,0,8,mixedType,1
5,3,0,8,mixedType,1
7,3,0,10,mixedType,1
4,4,0,8,mixedType,1
5,3,0,8,mixedType,1
6,1,0,7,mixedType,0
7,1,0,8,mixedType,1
3,7,0,10,mixedType,1
7,3,0,10,mixedType,1
13,3,0,16,mixedType,2
6,3,0,9,mixedType,1
6,6,0,12,mixedType,1
6,1,0,7,mixedType,0
6,1,0,7,mixedType,0
5,2,0,7,mixedType,0
11,3,0,14,mixedType,2
8,1,0,9,mixedType,1
11,3,0,14,mixedType,2
1,8,0,9,mixedType,1
8,3,0,11,mixedType,1
6,2,0,8,mixedType,1
6,2,0,8,mixedType,1
5,2,0,7,mixedType,0
10,2,0,12,mixedType,1
7,3,0,10,mixedType,1
4,4,0,8,mixedType,1
4,4,0,8,mixedType,1
8,1,0,9,mixedType,1
5,4,0,9,mixedType,1
7,2,0,9,mixedType,1
8,1,0,9,mixedType,1
7,2,0,9,mixedType,1
5,1,0,6,mixedType,0
14,2,0,16,mixedType,2
6,1,0,7,mixedType,0
1,8,0,9,mixedType,1
6,3,0,9,mixedType,1
2,8,0,10,mixedType,1
5,2,0,7,mixedType,0
5,3,1,9,mixedType,1
5,3,0,8,mixedType,1
8,3,0,11,mixedType,1
5,4,0,9,mixedType,1
5,2,0,7,mixedType,0
6,1,0,7,mixedType,0
8,2,0,10,mixedType,1
6,2,0,8,mixedType,1
4,4,0,8,mixedType,1
5,3,0,8,mixedType,1
9,2,0,11,mixedType,1
5,2,0,7,mixedType,0
9,3,0,12,mixedType,1
9,3,0,12,mixedType,1
4,4,0,8,mixedType,1
5,2,0,7,mixedType,0
4,2,0,6,mixedType,0
5,2,0,7,mixedType,0
4,2,0,6,mixedType,0
10,1,0,11,mixedType,1
8,5,0,13,mixedType,1
2,4,0,6,mixedType,0
1,8,0,9,mixedType,1
7,3,0,10,mixedType,1
5,2,0,7,mixedType,0
13,3,0,16,mixedType,2
8,1,0,9,mixedType,1
3,6,0,9,mixedType,1
8,4,0,12,mixedType,1
6,4,0,10,mixedType,1
7,3,0,10,mixedType,1
4,2,0,6,mixedType,0
8,2,0,10,mixedType,1
2,8,0,10,mixedType,1
9,1,0,10,mixedType,1
3,8,0,11,mixedType,1
5,6,0,11,mixedType,1
5,4,0,9,mixedType,1
6,3,0,9,mixedType,1
4,2,0,6,mixedType,0
7,3,0,10,mixedType,1
6,4,0,10,mixedType,1
2,6,0,8,mixedType,1
7,2,0,9,mixedType,1
14,2,0,16,mixedType,2
5,3,0,8,mixedType,1
6,7,0,13,mixedType,1
4,6,0,10,mixedType,1
6,2,0,8,mixedType,1
9,1,0,10,mixedType,1
5,1,0,6,mixedType,0
8,2,0,10,mixedType,1
1,10,0,11,mixedType,1
9,1,0,10,mixedType,1
9,1,0,10,mixedType,1
8,2,0,10,mixedType,1
6,1,0,7,mixedType,0
3,8,0,11,mixedType,1
5,2,0,7,mixedType,0
4,6,0,10,mixedType,1
6,4,0,10,mixedType,1
9,1,0,10,mixedType,1
1,8,0,9,mixedType,1
15,1,0,16,mixedType,2
5,3,0,8,mixedType,1
3,7,0,10,mixedType,1
5,4,0,9,mixedType,1
6,1,0,7,mixedType,0
6,6,0,12,mixedType,1
4,2,0,6,mixedType,0
6,3,0,9,mixedType,1
9,1,0,10,mixedType,1
8,1,0,9,mixedType,1
6,3,0,9,mixedType,1
6,3,0,9,mixedType,1
3,7,0,10,mixedType,1
14,2,0,16,mixedType,2
9,1,0,10,mixedType,1
8,2,0,10,mixedType,1
5,3,0,8,mixedType,1
6,4,0,10,mixedType,1
10,1,0,11,mixedType,1
8,2,0,10,mixedType,1
14,2,0,16,mixedType,2
7,3,0,10,mixedType,1
7,1,0,8,mixedType,1
12,4,0,16,mixedType,2
6,3,0,9,mixedType,1
4,4,0,8,mixedType,1
6,4,0,10,mixedType,1
1,7,0,8,mixedType,1
8,1,0,9,mixedType,1
6,4,0,10,mixedType,1
14,2,3,19,mixedType,2
10,3,0,13,mixedType,1
8,2,0,10,mixedType,1
12,3,0,15,mixedType,2
8,2,0,10,mixedType,1
12,4,0,16,mixedType,2
8,3,0,11,mixedType,1
5,2,0,7,mixedType,0
5,3,0,8,mixedType,1
4,6,0,10,mixedType,1
6,3,0,9,mixedType,1
8,3,0,11,mixedType,1
7,4,0,11,mixedType,1
7,2,0,9,mixedType,1
8,3,0,11,mixedType,1
11,3,0,14,mixedType,2
8,1,0,9,mixedType,1
8,1,0,9,mixedType,1
9,2,0,11,mixedType,1
3,8,0,11,mixedType,1
7,3,0,10,mixedType,1
4,6,0,10,mixedType,1
16,4,0,20,mixedType,2
8,2,0,10,mixedType,1
6,3,0,9,mixedType,1
2,8,0,10,mixedType,1
8,2,0,10,mixedType,1
8,2,0,10,mixedType,1
3,6,0,9,mixedType,1
7,1,0,8,mixedType,1
5,1,0,6,mixedType,0
6,3,0,9,mixedType,1
4,4,0,8,mixedType,1
7,1,0,8,mixedType,1
5,2,0,7,mixedType,0
9,2,0,11,mixedType,1
5,3,0,8,mixedType,1
7,3,0,10,mixedType,1
4,4,0,8,mixedType,1
6,2,0,8,mixedType,1
4,2,0,6,mixedType,0
7,3,0,10,mixedType,1
5,3,0,8,mixedType,1
7,3,0,10,mixedType,1
7,2,0,9,mixedType,1
6,3,0,9,mixedType,1
7,3,0,10,mixedType,1
7,3,0,10,mixedType,1
1,8,0,9,mixedType,1
3,6,0,9,mixedType,1
2,6,0,8,mixedType,1
7,2,0,9,mixedType,1
13,2,0,15,mixedType,2
6,3,0,9,mixedType,1
5,2,0,7,mixedType,0
9,1,0,10,mixedType,1
5,5,0,10,mixedType,1
6,4,0,10,mixedType,1
15,1,0,16,mixedType,2
5,2,0,7,mixedType,0
4,6,0,10,mixedType,1
6,1,0,7,mixedType,0
5,3,0,8,mixedType,1
19,3,2,24,mixedType,2
5,4,0,9,mixedType,1
8,1,0,9,mixedType,1
10,3,0,13,mixedType,1
10,2,0,12,mixedType,1
13,3,0,16,mixedType,2
8,4,0,12,mixedType,1
9,4,0,13,mixedType,1
4,6,0,10,mixedType,1
8,1,0,9,mixedType,1
12,2,1,15,mixedType,2
10,2,0,12,mixedType,1
4,6,0,10,mixedType,1
7,3,0,10,mixedType,1
7,3,0,10,mixedType,1
9,1,0,10,mixedType,1
15,1,0,16,mixedType,2
9,2,0,11,mixedType,1
6,1,0,7,mixedType,0
6,3,0,9,mixedType,1
7,3,0,10,mixedType,1
6,1,0,7,mixedType,0
6,1,0,7,mixedType,0
4,4,0,8,mixedType,1
12,4,0,16,mixedType,2
7,1,0,8,mixedType,1
7,2,0,9,mixedType,1
8,3,0,11,mixedType,1
12,3,0,15,mixedType,2
7,1,0,8,mixedType,1
6,2,0,8,mixedType,1
7,2,0,9,mixedType,1
6,1,0,7,mixedType,0
6,2,0,8,mixedType,1
7,3,0,10,mixedType,1
7,3,0,10,mixedType,1
6,6,0,12,mixedType,1
4,2,0,6,mixedType,0
4,6,0,10,mixedType,1
5,1,0,6,mixedType,0
14,1,0,15,mixedType,2
13,3,0,16,mixedType,2
8,1,0,9,mixedType,1
7,3,0,10,mixedType,1
7,2,0,9,mixedType,1
6,3,0,9,mixedType,1
4,5,0,9,mixedType,1
6,3,0,9,mixedType,1
6,3,0,9,mixedType,1
6,3,0,9,mixedType,1
15,1,0,16,mixedType,2
5,2,0,7,mixedType,0
8,3,0,11,mixedType,1
4,4,0,8,mixedType,1
6,1,0,7,mixedType,0
5,2,0,7,mixedType,0
7,3,0,10,mixedType,1
7,1,0,8,mixedType,1
4,6,0,10,mixedType,1
5,2,0,7,mixedType,0
2,8,0,10,mixedType,1
2,7,0,9,mixedType,1
8,2,0,10,mixedType,1
5,4,0,9,mixedType,1
5,4,0,9,mixedType,1
4,4,0,8,mixedType,1
6,1,0,7,mixedType,0
6,1,0,7,mixedType,0
8,2,0,10,mixedType,1
8,3,0,11,mixedType,1
9,1,0,10,mixedType,1
7,3,0,10,mixedType,1
7,5,0,12,mixedType,1
13,3,0,16,mixedType,2
8,2,0,10,mixedType,1
6,1,0,7,mixedType,0
1,7,0,8,mixedType,1
7,1,0,8,mixedType,1
11,3,0,14,mixedType,2
8,2,0,10,mixedType,1
7,3,0,10,mixedType,1
5,5,0,10,mixedType,1
7,1,0,8,mixedType,1
4,9,0,13,mixedType,1
8,2,0,10,mixedType,1
5,4,0,9,mixedType,1
4,2,0,6,mixedType,0
7,1,0,8,mixedType,1
12,1,0,13,mixedType,1
8,1,0,9,mixedType,1
13,3,0,16,mixedType,2
6,0,1,7,mixedType,0
7,2,0,9,mixedType,1
9,3,0,12,mixedType,1
5,2,0,7,mixedType,0
9,3,0,12,mixedType,1
12,3,0,15,mixedType,2
6,3,0,9,mixedType,1
3,6,1,10,mixedType,1
6,4,0,10,mixedType,1
8,2,0,10,mixedType,1
11,1,0,12,mixedType,1
5,2,0,7,mixedType,0
6,1,0,7,mixedType,0
6,4,0,10,mixedType,1
8,1,0,9,mixedType,1
3,3,0,6,mixedType,0
15,1,0,16,mixedType,2
4,4,0,8,mixedType,1
9,1,0,10,mixedType,1
9,1,0,10,mixedType,1
6,6,0,12,mixedType,1
14,2,0,16,mixedType,2
7,3,0,10,mixedType,1
14,2,0,16,mixedType,2
8,1,0,9,mixedType,1
9,4,0,13,mixedType,1
4,2,0,6,mixedType,0
20,4,0,24,mixedType,2
3,6,0,9,mixedType,1
5,3,0,8,mixedType,1
8,2,0,10,mixedType,1
4,6,0,10,mixedType,1
5,3,0,8,mixedType,1
9,3,0,12,mixedType,1
6,3,0,9,mixedType,1
6,3,0,9,mixedType,1
8,2,0,10,mixedType,1
6,4,0,10,mixedType,1
7,4,0,11,mixedType,1
7,5,0,12,mixedType,1
5,3,0,8,mixedType,1
7,2,0,9,mixedType,1
7,3,0,10,mixedType,1
6,4,0,10,mixedType,1
9,2,0,11,mixedType,1
6,2,0,8,mixedType,1
5,4,0,9,mixedType,1
1,8,0,9,mixedType,1
4,4,0,8,mixedType,1
3,3,0,6,mixedType,0
7,1,0,8,mixedType,1
8,1,0,9,mixedType,1
3,3,0,6,mixedType,0
7,6,0,13,mixedType,1
6,2,0,8,mixedType,1
3,3,0,6,mixedType,0
7,4,0,11,mixedType,1
8,2,0,10,mixedType,1
11,3,0,14,mixedType,2
6,3,0,9,mixedType,1
0,6,0,6,sameType,0
6,2,0,8,mixedType,1
4,2,0,6,mixedType,0
3,5,0,8,mixedType,1
2,6,0,8,mixedType,1
6,1,0,7,mixedType,0
11,3,0,14,mixedType,2
9,3,0,12,mixedType,1
13,3,0,16,mixedType,2
7,3,0,10,mixedType,1
10,2,0,12,mixedType,1
10,1,0,11,mixedType,1
9,2,0,11,mixedType,1
4,4,0,8,mixedType,1
6,4,0,10,mixedType,1
6,1,0,7,mixedType,0
6,5,0,11,mixedType,1
7,3,0,10,mixedType,1
6,3,0,9,mixedType,1
5,1,0,6,mixedType,0
6,4,0,10,mixedType,1
7,10,0,17,mixedType,2
11,2,0,13,mixedType,1
4,2,0,6,mixedType,0
9,2,0,11,mixedType,1
6,4,0,10,mixedType,1
6,1,0,7,mixedType,0
6,2,0,8,mixedType,1
15,1,0,16,mixedType,2
5,2,0,7,mixedType,0
8,4,0,12,mixedType,1
14,2,0,16,mixedType,2
5,4,0,9,mixedType,1
7,3,0,10,mixedType,1
8,2,0,10,mixedType,1
7,1,0,8,mixedType,1
8,2,0,10,mixedType,1
4,2,0,6,mixedType,0
15,1,0,16,mixedType,2
5,3,0,8,mixedType,1
12,4,0,16,mixedType,2
7,1,0,8,mixedType,1
7,3,0,10,mixedType,1
7,3,0,10,mixedType,1
1,8,0,9,mixedType,1
7,2,0,9,mixedType,1
6,3,0,9,mixedType,1
6,3,0,9,mixedType,1
4,2,0,6,mixedType,0
7,4,0,11,mixedType,1
12,4,0,16,mixedType,2
10,1,0,11,mixedType,1
11,3,0,14,mixedType,2
4,2,0,6,mixedType,0
3,6,0,9,mixedType,1
9,1,0,10,mixedType,1
5,2,0,7,mixedType,0
8,1,0,9,mixedType,1
6,3,0,9,mixedType,1
12,1,0,13,mixedType,1
11,1,0,12,mixedType,1
8,2,0,10,mixedType,1
6,3,0,9,mixedType,1
7,4,0,11,mixedType,1
3,7,0,10,mixedType,1
8,2,0,10,mixedType,1
14,2,0,16,mixedType,2
14,2,0,16,mixedType,2
15,1,0,16,mixedType,2
2,7,0,9,mixedType,1
5,1,0,6,mixedType,0
6,0,1,7,mixedType,0
5,1,0,6,mixedType,0
8,3,0,11,mixedType,1
7,3,0,10,mixedType,1
8,2,0,10,mixedType,1
8,3,0,11,mixedType,1
4,4,0,8,mixedType,1
7,3,0,10,mixedType,1
7,2,0,9,mixedType,1
8,1,0,9,mixedType,1
5,4,0,9,mixedType,1
11,5,0,16,mixedType,2
7,3,0,10,mixedType,1
2,8,0,10,mixedType,1
4,2,0,6,mixedType,0
4,6,0,10,mixedType,1
8,1,0,9,mixedType,1
8,1,0,9,mixedType,1
6,1,0,7,mixedType,0
8,1,0,9,mixedType,1
15,1,0,16,mixedType,2
4,2,0,6,mixedType,0
8,2,0,10,mixedType,1
10,1,0,11,mixedType,1
8,2,0,10,mixedType,1
5,8,0,13,mixedType,1
13,3,0,16,mixedType,2
3,7,0,10,mixedType,1
1,11,0,12,mixedType,1
14,2,0,16,mixedType,2
12,4,0,16,mixedType,2
5,3,0,8,mixedType,1
5,3,0,8,mixedType,1
9,1,0,10,mixedType,1
7,3,0,10,mixedType,1
3,7,0,10,mixedType,1
7,1,0,8,mixedType,1
8,2,0,10,mixedType,1
7,3,0,10,mixedType,1
4,4,0,8,mixedType,1
4,4,0,8,mixedType,1
5,2,0,7,mixedType,0
10,1,0,11,mixedType,1
8,6,0,14,mixedType,2
8,1,0,9,mixedType,1
14,6,0,20,mixedType,2
7,2,0,9,mixedType,1
5,6,0,11,mixedType,1
15,1,0,16,mixedType,2
5,4,0,9,mixedType,1
4,6,0,10,mixedType,1
6,3,0,9,mixedType,1
14,2,0,16,mixedType,2
6,2,0,8,mixedType,1
2,4,0,6,mixedType,0
8,2,0,10,mixedType,1
8,2,0,10,mixedType,1
4,2,0,6,mixedType,0
1,7,0,8,mixedType,1
5,2,0,7,mixedType,0
9,2,0,11,mixedType,1
5,6,0,11,mixedType,1
6,4,0,10,mixedType,1
4,8,0,12,mixedType,1
8,2,0,10,mixedType,1
2,4,0,6,mixedType,0
9,3,0,12,mixedType,1
5,3,0,8,mixedType,1
6,1,0,7,mixedType,0
1,8,0,9,mixedType,1
4,5,0,9,mixedType,1
4,5,0,9,mixedType,1
10,3,0,13,mixedType,1
4,4,0,8,mixedType,1
9,1,0,10,mixedType,1
5,6,0,11,mixedType,1
6,4,0,10,mixedType,1
12,1,0,13,mixedType,1
6,3,0,9,mixedType,1
6,1,0,7,mixedType,0
4,2,0,6,mixedType,0
6,2,0,8,mixedType,1
5,6,0,11,mixedType,1
5,2,0,7,mixedType,0
7,2,0,9,mixedType,1
7,5,0,12,mixedType,1
8,1,0,9,mixedType,1
1,5,0,6,mixedType,0
7,2,0,9,mixedType,1
6,8,1,15,mixedType,2
7,3,0,10,mixedType,1
10,1,0,11,mixedType,1
9,2,0,11,mixedType,1
5,3,0,8,mixedType,1
14,2,0,16,mixedType,2
7,2,0,9,mixedType,1
5,2,0,7,mixedType,0
7,2,0,9,mixedType,1
4,4,0,8,mixedType,1
14,2,0,16,mixedType,2
3,7,0,10,mixedType,1
5,4,0,9,mixedType,1
6,3,0,9,mixedType,1
12,3,0,15,mixedType,2
7,3,0,10,mixedType,1
5,2,0,7,mixedType,0
6,3,0,9,mixedType,1
7,3,0,10,mixedType,1
6,1,0,7,mixedType,0
6,4,0,10,mixedType,1
13,3,0,16,mixedType,2
6,6,0,12,mixedType,1
2,6,0,8,mixedType,1
4,7,0,11,mixedType,1
4,5,0,9,mixedType,1
5,3,0,8,mixedType,1
11,2,0,13,mixedType,1
3,5,0,8,mixedType,1
19,1,1,21,mixedType,2
14,2,0,16,mixedType,2
4,4,0,8,mixedType,1
1,9,0,10,mixedType,1
6,2,0,8,mixedType,1
8,1,0,9,mixedType,1
16,2,0,18,mixedType,2
6,3,0,9,mixedType,1
2,7,0,9,mixedType,1
6,4,0,10,mixedType,1
5,2,0,7,mixedType,0
7,2,0,9,mixedType,1
8,1,0,9,mixedType,1
4,4,0,8,mixedType,1
4,4,0,8,mixedType,1
8,1,0,9,mixedType,1
12,4,0,16,mixedType,2
7,1,0,8,mixedType,1
6,3,0,9,mixedType,1
10,3,0,13,mixedType,1
7,3,0,10,mixedType,1
6,3,0,9,mixedType,1
12,4,0,16,mixedType,2
13,2,0,15,mixedType,2
6,3,0,9,mixedType,1
7,3,0,10,mixedType,1
8,3,0,11,mixedType,1
8,1,0,9,mixedType,1
7,3,0,10,mixedType,1
9,2,0,11,mixedType,1
5,4,0,9,mixedType,1
2,11,0,13,mixedType,1
4,4,0,8,mixedType,1
3,7,0,10,mixedType,1
6,4,0,10,mixedType,1
5,1,0,6,mixedType,0
5,6,0,11,mixedType,1
5,3,0,8,mixedType,1
7,2,0,9,mixedType,1
6,4,0,10,mixedType,1
9,4,0,13,mixedType,1
6,3,0,9,mixedType,1
7,2,0,9,mixedType,1
5,5,0,10,mixedType,1
8,4,0,12,mixedType,1
7,3,0,10,mixedType,1
8,3,0,11,mixedType,1
13,3,0,16,mixedType,2
4,4,0,8,mixedType,1
8,2,0,10,mixedType,1
4,4,0,8,mixedType,1
6,1,0,7,mixedType,0
14,2,0,16,mixedType,2
7,4,0,11,mixedType,1
15,1,0,16,mixedType,2
6,1,0,7,mixedType,0
10,1,0,11,mixedType,1
5,4,0,9,mixedType,1
5,3,0,8,mixedType,1
12,3,0,15,mixedType,2
8,4,0,12,mixedType,1
5,2,0,7,mixedType,0
15,5,0,20,mixedType,2
5,1,0,6,mixedType,0
15,1,0,16,mixedType,2
7,2,0,9,mixedType,1
7,3,0,10,mixedType,1
7,3,0,10,mixedType,1
8,1,0,9,mixedType,1
9,2,0,11,mixedType,1
8,1,0,9,mixedType,1
7,3,0,10,mixedType,1
6,3,0,9,mixedType,1
12,3,0,15,mixedType,2
6,2,0,8,mixedType,1
1,8,0,9,mixedType,1
7,1,0,8,mixedType,1
6,3,0,9,mixedType,1
4,2,0,6,mixedType,0
14,2,0,16,mixedType,2
10,3,1,14,mixedType,2
9,4,0,13,mixedType,1
7,1,0,8,mixedType,1
5,7,0,12,mixedType,1
13,3,0,16,mixedType,2
6,4,0,10,mixedType,1
5,4,0,9,mixedType,1
11,3,0,14,mixedType,2
4,4,0,8,mixedType,1
6,2,0,8,mixedType,1
5,2,0,7,mixedType,0
11,5,0,16,mixedType,2
4,2,0,6,mixedType,0
4,2,0,6,mixedType,0
9,1,0,10,mixedType,1
6,3,0,9,mixedType,1
7,1,0,8,mixedType,1
7,3,0,10,mixedType,1
9,2,0,11,mixedType,1
5,2,0,7,mixedType,0
5,1,0,6,mixedType,0
7,1,0,8,mixedType,1
7,1,0,8,mixedType,1
6,4,0,10,mixedType,1
7,2,0,9,mixedType,1
5,2,0,7,mixedType,0
6,4,0,10,mixedType,1
15,1,0,16,mixedType,2
5,3,0,8,mixedType,1
9,3,0,12,mixedType,1
6,4,0,10,mixedType,1
3,10,0,13,mixedType,1
6,3,0,9,mixedType,1
8,1,0,9,mixedType,1
6,3,0,9,mixedType,1
5,2,0,7,mixedType,0
9,1,0,10,mixedType,1
6,3,0,9,mixedType,1
7,3,0,10,mixedType,1
6,3,0,9,mixedType,1
5,3,0,8,mixedType,1
17,1,1,19,mixedType,2
6,4,0,10,mixedType,1
4,6,0,10,mixedType,1
7,1,0,8,mixedType,1
15,1,0,16,mixedType,2
4,6,0,10,mixedType,1
6,1,0,7,mixedType,0
7,3,0,10,mixedType,1
9,2,0,11,mixedType,1
5,3,0,8,mixedType,1
9,2,0,11,mixedType,1
6,2,0,8,mixedType,1
4,2,0,6,mixedType,0
15,1,0,16,mixedType,2
6,5,0,11,mixedType,1
7,2,0,9,mixedType,1
1,9,0,10,mixedType,1
8,1,0,9,mixedType,1
6,1,0,7,mixedType,0
4,4,0,8,mixedType,1
8,1,0,9,mixedType,1
9,2,0,11,mixedType,1
8,1,0,9,mixedType,1
7,2,0,9,mixedType,1
2,6,0,8,mixedType,1
4,5,0,9,mixedType,1
6,3,0,9,mixedType,1
11,1,0,12,mixedType,1
5,2,0,7,mixedType,0
9,1,0,10,mixedType,1
7,1,0,8,mixedType,1
6,6,0,12,mixedType,1
3,5,0,8,mixedType,1
6,3,0,9,mixedType,1
3,6,0,9,mixedType,1
5,3,0,8,mixedType,1
1,8,0,9,mixedType,1
5,1,0,6,mixedType,0
6,4,0,10,mixedType,1
12,3,0,15,mixedType,2
5,3,0,8,mixedType,1
7,3,0,10,mixedType,1
6,4,0,10,mixedType,1
8,2,0,10,mixedType,1
8,4,0,12,mixedType,1
6,3,0,9,mixedType,1
7,3,0,10,mixedType,1
1,8,0,9,mixedType,1
7,4,0,11,mixedType,1
4,4,0,8,mixedType,1
10,2,0,12,mixedType,1
9,3,0,12,mixedType,1
5,2,0,7,mixedType,0
5,1,0,6,mixedType,0
4,4,0,8,mixedType,1
7,3,0,10,mixedType,1
7,3,0,10,mixedType,1
5,2,0,7,mixedType,0
10,1,0,11,mixedType,1
6,3,0,9,mixedType,1
10,4,0,14,mixedType,2
8,3,0,11,mixedType,1
7,1,0,8,mixedType,1
6,2,0,8,mixedType,1
15,1,0,16,mixedType,2
7,2,0,9,mixedType,1
3,5,0,8,mixedType,1
4,2,0,6,mixedType,0
6,3,0,9,mixedType,1
14,2,0,16,mixedType,2
6,2,0,8,mixedType,1
7,3,0,10,mixedType,1
7,3,0,10,mixedType,1
8,2,0,10,mixedType,1
1,8,0,9,mixedType,1
11,3,0,14,mixedType,2
9,2,0,11,mixedType,1
15,1,0,16,mixedType,2
7,1,0,8,mixedType,1
8,3,0,11,mixedType,1
6,2,0,8,mixedType,1
15,1,0,16,mixedType,2
7,1,0,8,mixedType,1
13,1,1,15,mixedType,2
8,2,0,10,mixedType,1
7,1,0,8,mixedType,1
15,1,0,16,mixedType,2
6,1,0,7,mixedType,0
8,3,0,11,mixedType,1
11,1,0,12,mixedType,1
11,5,0,16,mixedType,2
8,2,0,10,mixedType,1
6,3,0,9,mixedType,1
2,7,0,9,mixedType,1
6,6,0,12,mixedType,1
13,4,1,18,mixedType,2
5,1,0,6,mixedType,0
4,4,0,8,mixedType,1
8,2,0,10,mixedType,1
5,3,0,8,mixedType,1
5,4,0,9,mixedType,1
6,6,0,12,mixedType,1
8,2,0,10,mixedType,1
8,2,0,10,mixedType,1
8,2,0,10,mixedType,1
5,3,0,8,mixedType,1
5,2,0,7,mixedType,0
6,2,0,8,mixedType,1
9,2,0,11,mixedType,1
6,3,0,9,mixedType,1
7,2,0,9,mixedType,1
3,5,0,8,mixedType,1
4,4,0,8,mixedType,1
1,8,0,9,mixedType,1
6,3,0,9,mixedType,1
1,8,0,9,mixedType,1
12,4,0,16,mixedType,2
10,6,0,16,mixedType,2
7,3,0,10,mixedType,1
9,3,0,12,mixedType,1
6,2,0,8,mixedType,1
9,3,0,12,mixedType,1
5,4,0,9,mixedType,1
3,6,0,9,mixedType,1
8,2,0,10,mixedType,1
4,2,0,6,mixedType,0
6,3,0,9,mixedType,1
6,3,0,9,mixedType,1
5,5,0,10,mixedType,1
8,2,0,10,mixedType,1
5,2,0,7,mixedType,0
6,1,0,7,mixedType,0
1,13,1,15,mixedType,2
5,2,0,7,mixedType,0
15,1,0,16,mixedType,2
6,4,0,10,mixedType,1
6,3,0,9,mixedType,1
6,3,0,9,mixedType,1
5,4,0,9,mixedType,1
1,7,0,8,mixedType,1
5,4,0,9,mixedType,1
5,2,0,7,mixedType,0
5,1,0,6,mixedType,0
10,1,0,11,mixedType,1
10,4,0,14,mixedType,2
5,4,0,9,mixedType,1
5,2,0,7,mixedType,0
6,1,0,7,mixedType,0
7,3,0,10,mixedType,1
7,2,0,9,mixedType,1
8,6,0,14,mixedType,2
2,7,0,9,mixedType,1
7,1,0,8,mixedType,1
11,5,0,16,mixedType,2
6,4,0,10,mixedType,1
3,8,0,11,mixedType,1
7,1,0,8,mixedType,1
8,1,0,9,mixedType,1
13,3,0,16,mixedType,2
6,3,0,9,mixedType,1
7,3,0,10,mixedType,1
8,1,0,9,mixedType,1
8,4,0,12,mixedType,1
7,4,0,11,mixedType,1
7,3,0,10,mixedType,1
5,4,0,9,mixedType,1
3,3,0,6,mixedType,0
8,2,0,10,mixedType,1
14,2,0,16,mixedType,2
1,8,0,9,mixedType,1
8,2,0,10,mixedType,1
13,3,0,16,mixedType,2
8,1,0,9,mixedType,1
4,4,0,8,mixedType,1
8,2,0,10,mixedType,1
4,4,0,8,mixedType,1
1,8,0,9,mixedType,1
7,1,0,8,mixedType,1
1,8,0,9,mixedType,1
7,2,0,9,mixedType,1
2,6,0,8,mixedType,1
3,5,0,8,mixedType,1
7,3,0,10,mixedType,1
6,2,0,8,mixedType,1
10,3,0,13,mixedType,1
5,2,0,7,mixedType,0
6,4,0,10,mixedType,1
3,5,0,8,mixedType,1
14,2,0,16,mixedType,2
8,1,0,9,mixedType,1
7,2,0,9,mixedType,1
7,2,0,9,mixedType,1
4,4,0,8,mixedType,1
9,3,0,12,mixedType,1
5,3,0,8,mixedType,1
9,3,0,12,mixedType,1
6,3,0,9,mixedType,1
4,2,0,6,mixedType,0
12,3,0,15,mixedType,2
6,3,0,9,mixedType,1
5,2,0,7,mixedType,0
7,1,0,8,mixedType,1
9,3,0,12,mixedType,1
4,4,0,8,mixedType,1
7,1,0,8,mixedType,1
6,4,0,10,mixedType,1
6,2,0,8,mixedType,1
6,6,0,12,mixedType,1
7,1,0,8,mixedType,1
6,4,0,10,mixedType,1
6,4,0,10,mixedType,1
0,8,3,11,mixedType,1
5,3,0,8,mixedType,1
5,4,0,9,mixedType,1
7,1,0,8,mixedType,1
7,1,0,8,mixedType,1
4,6,0,10,mixedType,1
8,1,0,9,mixedType,1
6,2,0,8,mixedType,1
6,2,0,8,mixedType,1
14,2,0,16,mixedType,2
6,3,0,9,mixedType,1
5,8,0,13,mixedType,1
5,2,0,7,mixedType,0
3,3,0,6,mixedType,0
7,3,0,10,mixedType,1
7,2,0,9,mixedType,1
7,2,0,9,mixedType,1
6,2,0,8,mixedType,1
4,4,0,8,mixedType,1
2,7,0,9,mixedType,1
6,1,0,7,mixedType,0
8,2,0,10,mixedType,1
6,3,0,9,mixedType,1
3,4,0,7,mixedType,0
7,2,0,9,mixedType,1
8,2,0,10,mixedType,1
14,2,0,16,mixedType,2
7,2,0,9,mixedType,1
6,2,0,8,mixedType,1
8,1,0,9,mixedType,1
3,8,0,11,mixedType,1
6,4,0,10,mixedType,1
6,3,0,9,mixedType,1
9,1,0,10,mixedType,1
5,3,0,8,mixedType,1
10,6,0,16,mixedType,2
5,3,0,8,mixedType,1
4,6,0,10,mixedType,1
4,5,0,9,mixedType,1
6,4,0,10,mixedType,1
2,8,0,10,mixedType,1
14,2,0,16,mixedType,2
14,2,0,16,mixedType,2
1,8,0,9,mixedType,1
4,9,0,13,mixedType,1
8,4,0,12,mixedType,1
6,1,0,7,mixedType,0
7,2,0,9,mixedType,1
1,8,0,9,mixedType,1
5,3,0,8,mixedType,1
9,3,0,12,mixedType,1
4,4,0,8,mixedType,1
6,2,0,8,mixedType,1
6,3,0,9,mixedType,1
10,1,0,11,mixedType,1
6,2,0,8,mixedType,1
4,6,0,10,mixedType,1
7,2,0,9,mixedType,1
5,4,0,9,mixedType,1
7,1,0,8,mixedType,1
8,2,0,10,mixedType,1
12,4,0,16,mixedType,2
12,4,0,16,mixedType,2
6,6,0,12,mixedType,1
6,3,0,9,mixedType,1
4,4,0,8,mixedType,1
6,2,0,8,mixedType,1
12,3,0,15,mixedType,2
5,4,0,9,mixedType,1
6,3,0,9,mixedType,1
6,3,0,9,mixedType,1
12,4,0,16,mixedType,2
5,3,0,8,mixedType,1
8,1,0,9,mixedType,1
1,5,0,6,mixedType,0
6,1,0,7,mixedType,0
3,7,0,10,mixedType,1
7,3,0,10,mixedType,1
2,6,0,8,mixedType,1
9,1,0,10,mixedType,1
15,1,0,16,mixedType,2
1,8,0,9,mixedType,1
7,4,0,11,mixedType,1
9,2,0,11,mixedType,1
9,2,0,11,mixedType,1
6,1,0,7,mixedType,0
5,2,0,7,mixedType,0
5,1,0,6,mixedType,0
7,3,0,10,mixedType,1
6,3,0,9,mixedType,1
3,6,0,9,mixedType,1
4,2,0,6,mixedType,0
4,5,0,9,mixedType,1
5,2,0,7,mixedType,0
6,1,0,7,mixedType,0
10,1,0,11,mixedType,1
3,6,0,9,mixedType,1
6,1,0,7,mixedType,0
6,1,0,7,mixedType,0
8,1,0,9,mixedType,1
8,2,0,10,mixedType,1
5,3,0,8,mixedType,1
8,1,0,9,mixedType,1
6,4,0,10,mixedType,1
7,3,0,10,mixedType,1
13,3,0,16,mixedType,2
5,7,0,12,mixedType,1
4,4,0,8,mixedType,1
6,1,0,7,mixedType,0
8,1,0,9,mixedType,1
11,3,0,14,mixedType,2
5,3,0,8,mixedType,1
7,6,0,13,mixedType,1
3,5,0,8,mixedType,1
6,3,0,9,mixedType,1
6,2,0,8,mixedType,1
5,3,0,8,mixedType,1
2,8,0,10,mixedType,1
7,3,0,10,mixedType,1
8,4,0,12,mixedType,1
6,3,0,9,mixedType,1
5,2,0,7,mixedType,0
8,3,0,11,mixedType,1
7,2,0,9,mixedType,1
6,1,0,7,mixedType,0
4,5,0,9,mixedType,1
5,3,0,8,mixedType,1
4,2,0,6,mixedType,0
4,2,0,6,mixedType,0
6,3,0,9,mixedType,1
1,8,0,9,mixedType,1
8,1,0,9,mixedType,1
7,3,0,10,mixedType,1
6,3,0,9,mixedType,1
14,2,0,16,mixedType,2
4,4,0,8,mixedType,1
7,4,0,11,mixedType,1
7,2,0,9,mixedType,1
7,1,0,8,mixedType,1
14,2,0,16,mixedType,2
9,1,0,10,mixedType,1
4,6,0,10,mixedType,1
7,1,0,8,mixedType,1
9,2,0,11,mixedType,1
5,3,0,8,mixedType,1
8,1,0,9,mixedType,1
5,2,0,7,mixedType,0
5,1,0,6,mixedType,0
8,2,0,10,mixedType,1
7,1,0,8,mixedType,1
5,3,0,8,mixedType,1
12,4,0,16,mixedType,2
6,3,0,9,mixedType,1
7,1,0,8,mixedType,1
6,6,0,12,mixedType,1
8,2,0,10,mixedType,1
12,4,0,16,mixedType,2
3,6,0,9,mixedType,1
8,1,0,9,mixedType,1
9,2,0,11,mixedType,1
8,2,0,10,mixedType,1
6,5,0,11,mixedType,1
5,2,0,7,mixedType,0
5,2,0,7,mixedType,0
6,1,0,7,mixedType,0
5,1,0,6,mixedType,0
11,3,0,14,mixedType,2
2,8,0,10,mixedType,1
5,1,0,6,mixedType,0
8,2,0,10,mixedType,1
1,9,0,10,mixedType,1
5,3,0,8,mixedType,1
14,2,0,16,mixedType,2
6,3,0,9,mixedType,1
2,8,0,10,mixedType,1
7,2,0,9,mixedType,1
5,3,0,8,mixedType,1
7,2,0,9,mixedType,1
7,3,0,10,mixedType,1
4,4,0,8,mixedType,1
4,6,0,10,mixedType,1
7,1,0,8,mixedType,1
6,1,0,7,mixedType,0
1,12,0,13,mixedType,1
1,7,0,8,mixedType,1
4,8,0,12,mixedType,1
8,2,0,10,mixedType,1
6,3,0,9,mixedType,1
5,4,0,9,mixedType,1
13,3,0,16,mixedType,2
7,3,0,10,mixedType,1
3,7,0,10,mixedType,1
11,2,0,13,mixedType,1
1,8,0,9,mixedType,1
7,2,0,9,mixedType,1
11,1,0,12,mixedType,1
7,3,0,10,mixedType,1
14,2,0,16,mixedType,2
8,1,0,9,mixedType,1
15,1,0,16,mixedType,2
7,5,0,12,mixedType,1
6,1,0,7,mixedType,0
5,3,0,8,mixedType,1
12,3,2,17,mixedType,2
7,3,0,10,mixedType,1
9,1,0,10,mixedType,1
14,4,0,18,mixedType,2
6,2,0,8,mixedType,1
8,2,0,10,mixedType,1
6,4,0,10,mixedType,1
4,6,0,10,mixedType,1
4,4,0,8,mixedType,1
6,3,0,9,mixedType,1
6,1,0,7,mixedType,0
7,1,0,8,mixedType,1
6,3,0,9,mixedType,1
10,1,0,11,mixedType,1
8,3,0,11,mixedType,1
9,1,0,10,mixedType,1
3,3,0,6,mixedType,0
8,1,0,9,mixedType,1
1,7,0,8,mixedType,1
9,2,0,11,mixedType,1
6,4,0,10,mixedType,1
14,1,0,15,mixedType,2
14,2,0,16,mixedType,2
8,1,0,9,mixedType,1
6,1,0,7,mixedType,0
5,1,0,6,mixedType,0
5,2,0,7,mixedType,0
6,3,0,9,mixedType,1
9,4,0,13,mixedType,1
8,1,0,9,mixedType,1
1,7,0,8,mixedType,1
8,4,0,12,mixedType,1
3,6,0,9,mixedType,1
1,8,0,9,mixedType,1
0,9,1,10,mixedType,1
12,4,0,16,mixedType,2
6,3,0,9,mixedType,1
4,8,0,12,mixedType,1
5,2,0,7,mixedType,0
2,6,0,8,mixedType,1
6,4,0,10,mixedType,1
8,1,0,9,mixedType,1
7,1,0,8,mixedType,1
15,1,0,16,mixedType,2
11,5,0,16,mixedType,2
5,2,0,7,mixedType,0
7,2,0,9,mixedType,1
7,2,0,9,mixedType,1
11,5,0,16,mixedType,2
2,6,0,8,mixedType,1
5,2,0,7,mixedType,0
4,4,0,8,mixedType,1
6,4,0,10,mixedType,1
7,3,0,10,mixedType,1
7,3,0,10,mixedType,1
3,5,0,8,mixedType,1
11,3,0,14,mixedType,2
14,2,0,16,mixedType,2
8,2,0,10,mixedType,1
2,6,0,8,mixedType,1
6,2,0,8,mixedType,1
6,3,0,9,mixedType,1
6,6,0,12,mixedType,1
15,1,0,16,mixedType,2
2,8,0,10,mixedType,1
6,3,0,9,mixedType,1
8,2,0,10,mixedType,1
13,3,0,16,mixedType,2
7,3,0,10,mixedType,1
5,3,0,8,mixedType,1
13,3,0,16,mixedType,2
6,3,0,9,mixedType,1
7,2,0,9,mixedType,1
3,6,0,9,mixedType,1
14,2,0,16,mixedType,2
7,3,0,10,mixedType,1
5,4,0,9,mixedType,1
6,4,0,10,mixedType,1
6,2,0,8,mixedType,1
9,3,0,12,mixedType,1
6,1,0,7,mixedType,0
7,3,0,10,mixedType,1
8,2,0,10,mixedType,1
5,4,0,9,mixedType,1
15,1,0,16,mixedType,2
11,2,0,13,mixedType,1
11,3,0,14,mixedType,2
8,1,0,9,mixedType,1
4,4,0,8,mixedType,1
9,1,0,10,mixedType,1
2,7,0,9,mixedType,1
2,6,0,8,mixedType,1
4,4,0,8,mixedType,1
7,1,0,8,mixedType,1
5,3,0,8,mixedType,1
8,2,0,10,mixedType,1
14,2,0,16,mixedType,2
2,4,0,6,mixedType,0
6,1,0,7,mixedType,0
4,4,0,8,mixedType,1
6,2,0,8,mixedType,1
10,1,0,11,mixedType,1
4,2,0,6,mixedType,0
1,8,0,9,mixedType,1
13,3,0,16,mixedType,2
7,2,0,9,mixedType,1
15,1,0,16,mixedType,2
6,1,0,7,mixedType,0
5,3,0,8,mixedType,1
5,4,0,9,mixedType,1
9,4,1,14,mixedType,2
8,2,0,10,mixedType,1
6,3,0,9,mixedType,1
3,5,0,8,mixedType,1
7,2,0,9,mixedType,1
8,2,0,10,mixedType,1
6,4,0,10,mixedType,1
5,2,0,7,mixedType,0
5,2,0,7,mixedType,0
1,11,0,12,mixedType,1
6,2,0,8,mixedType,1
7,3,0,10,mixedType,1
6,2,0,8,mixedType,1
7,1,0,8,mixedType,1
6,4,0,10,mixedType,1
9,2,0,11,mixedType,1
5,2,0,7,mixedType,0
7,3,0,10,mixedType,1
7,3,0,10,mixedType,1
7,3,0,10,mixedType,1
5,2,0,7,mixedType,0
11,1,0,12,mixedType,1
7,2,0,9,mixedType,1
6,3,0,9,mixedType,1
5,4,0,9,mixedType,1
6,1,0,7,mixedType,0
8,2,0,10,mixedType,1
8,6,1,15,mixedType,2
7,6,0,13,mixedType,1
5,4,0,9,mixedType,1
3,6,0,9,mixedType,1
15,1,0,16,mixedType,2
2,7,0,9,mixedType,1
6,2,0,8,mixedType,1
2,8,0,10,mixedType,1
9,1,0,10,mixedType,1
5,1,0,6,mixedType,0
5,4,0,9,mixedType,1
7,2,0,9,mixedType,1
5,3,0,8,mixedType,1
1,8,0,9,mixedType,1
5,3,0,8,mixedType,1
6,1,0,7,mixedType,0
7,2,0,9,mixedType,1
7,3,0,10,mixedType,1
7,2,0,9,mixedType,1
7,1,0,8,mixedType,1
6,3,0,9,mixedType,1
2,8,0,10,mixedType,1
7,1,0,8,mixedType,1
6,4,0,10,mixedType,1
9,1,0,10,mixedType,1
6,3,0,9,mixedType,1
7,2,0,9,mixedType,1
9,2,0,11,mixedType,1
5,1,0,6,mixedType,0
6,4,0,10,mixedType,1
7,3,0,10,mixedType,1
8,2,0,10,mixedType,1
2,8,0,10,mixedType,1
6,3,0,9,mixedType,1
3,3,0,6,mixedType,0
6,4,0,10,mixedType,1
7,4,0,11,mixedType,1
6,1,0,7,mixedType,0
6,4,0,10,mixedType,1
4,4,0,8,mixedType,1
6,3,0,9,mixedType,1
6,3,0,9,mixedType,1
14,2,0,16,mixedType,2
9,1,0,10,mixedType,1
4,2,0,6,mixedType,0
13,3,0,16,mixedType,2
6,6,0,12,mixedType,1
5,6,0,11,mixedType,1
4,4,0,8,mixedType,1
4,2,0,6,mixedType,0
9,2,0,11,mixedType,1
5,3,0,8,mixedType,1
5,3,0,8,mixedType,1
1,9,0,10,mixedType,1
6,0,1,7,mixedType,0
10,2,0,12,mixedType,1
2,7,0,9,mixedType,1
9,1,0,10,mixedType,1
7,3,0,10,mixedType,1
6,3,0,9,mixedType,1
7,2,0,9,mixedType,1
6,1,0,7,mixedType,0
9,3,0,12,mixedType,1
8,4,0,12,mixedType,1
5,5,0,10,mixedType,1
4,6,0,10,mixedType,1
0,7,1,8,mixedType,1
6,3,0,9,mixedType,1
8,4,0,12,mixedType,1
8,2,0,10,mixedType,1
11,4,0,15,mixedType,2
7,2,0,9,mixedType,1
7,2,0,9,mixedType,1
8,2,0,10,mixedType,1
1,7,0,8,mixedType,1
8,6,0,14,mixedType,2
10,1,0,11,mixedType,1
6,1,0,7,mixedType,0
6,1,0,7,mixedType,0
6,1,0,7,mixedType,0
6,2,0,8,mixedType,1
1,10,4,15,mixedType,2
7,3,0,10,mixedType,1
6,3,0,9,mixedType,1
6,3,0,9,mixedType,1
3,6,0,9,mixedType,1
7,3,0,10,mixedType,1
9,1,0,10,mixedType,1
6,3,0,9,mixedType,1
5,5,0,10,mixedType,1
7,2,0,9,mixedType,1
7,2,0,9,mixedType,1
14,2,0,16,mixedType,2
2,6,0,8,mixedType,1
5,3,0,8,mixedType,1
5,1,0,6,mixedType,0
14,2,0,16,mixedType,2
6,1,0,7,mixedType,0
8,1,0,9,mixedType,1
9,3,0,12,mixedType,1
7,4,0,11,mixedType,1
7,3,0,10,mixedType,1
8,1,0,9,mixedType,1
9,4,0,13,mixedType,1
6,6,0,12,mixedType,1
2,4,0,6,mixedType,0
4,4,0,8,mixedType,1
5,4,0,9,mixedType,1
8,2,0,10,mixedType,1
1,10,0,11,mixedType,1
6,3,0,9,mixedType,1
5,3,0,8,mixedType,1
9,1,0,10,mixedType,1
5,2,0,7,mixedType,0
4,2,0,6,mixedType,0
7,2,0,9,mixedType,1
9,1,0,10,mixedType,1
4,6,0,10,mixedType,1
6,1,0,7,mixedType,0
5,1,0,6,mixedType,0
8,3,0,11,mixedType,1
7,2,0,9,mixedType,1
6,3,0,9,mixedType,1
7,3,0,10,mixedType,1
5,7,0,12,mixedType,1
5,2,0,7,mixedType,0
6,4,0,10,mixedType,1
3,3,0,6,mixedType,0
4,4,0,8,mixedType,1
4,4,0,8,mixedType,1
7,1,0,8,mixedType,1
12,3,0,15,mixedType,2
5,2,0,7,mixedType,0
13,3,0,16,mixedType,2
7,1,0,8,mixedType,1
6,3,0,9,mixedType,1
8,2,0,10,mixedType,1
0,10,1,11,mixedType,1
5,6,0,11,mixedType,1
7,4,0,11,mixedType,1
4,6,0,10,mixedType,1
7,3,0,10,mixedType,1
10,3,0,13,mixedType,1
2,8,0,10,mixedType,1
4,2,0,6,mixedType,0
8,1,0,9,mixedType,1
10,2,0,12,mixedType,1
5,4,0,9,mixedType,1
2,7,0,9,mixedType,1
4,4,0,8,mixedType,1
4,5,0,9,mixedType,1
6,3,0,9,mixedType,1
7,2,0,9,mixedType,1
11,5,0,16,mixedType,2
2,9,0,11,mixedType,1
4,6,0,10,mixedType,1
5,8,0,13,mixedType,1
7,3,0,10,mixedType,1
6,3,0,9,mixedType,1
9,2,0,11,mixedType,1
5,2,0,7,mixedType,0
7,2,0,9,mixedType,1
2,9,0,11,mixedType,1
8,2,0,10,mixedType,1
1,5,0,6,mixedType,0
5,3,0,8,mixedType,1
7,1,0,8,mixedType,1
8,2,0,10,mixedType,1
5,2,0,7,mixedType,0
8,2,0,10,mixedType,1
5,2,0,7,mixedType,0
2,6,0,8,mixedType,1
7,1,0,8,mixedType,1
7,3,0,10,mixedType,1
14,2,0,16,mixedType,2
6,6,0,12,mixedType,1
9,2,0,11,mixedType,1
15,1,0,16,mixedType,2
7,2,0,9,mixedType,1
8,2,0,10,mixedType,1
6,6,0,12,mixedType,1
6,4,0,10,mixedType,1
7,3,0,10,mixedType,1
13,3,0,16,mixedType,2
4,4,0,8,mixedType,1
7,3,0,10,mixedType,1
8,2,0,10,mixedType,1
3,6,0,9,mixedType,1
6,3,0,9,mixedType,1
8,4,0,12,mixedType,1
8,3,0,11,mixedType,1
1,8,0,9,mixedType,1
4,2,0,6,mixedType,0
3,6,0,9,mixedType,1
5,2,0,7,mixedType,0
6,1,0,7,mixedType,0
8,3,0,11,mixedType,1
6,2,0,8,mixedType,1
8,1,0,9,mixedType,1
5,4,0,9,mixedType,1
9,1,0,10,mixedType,1
7,3,0,10,mixedType,1
7,1,0,8,mixedType,1
5,4,1,10,mixedType,1
9,1,0,10,mixedType,1
8,3,0,11,mixedType,1
8,2,0,10,mixedType,1
2,8,0,10,mixedType,1
6,3,0,9,mixedType,1
8,1,0,9,mixedType,1
10,3,0,13,mixedType,1
5,3,0,8,mixedType,1
7,3,0,10,mixedType,1
2,6,0,8,mixedType,1
9,3,0,12,mixedType,1
1,8,0,9,mixedType,1
8,2,0,10,mixedType,1
12,4,0,16,mixedType,2
2,8,0,10,mixedType,1
6,2,0,8,mixedType,1
8,4,0,12,mixedType,1
7,2,0,9,mixedType,1
15,1,0,16,mixedType,2
15,1,0,16,mixedType,2
6,1,0,7,mixedType,0
4,2,0,6,mixedType,0
7,2,0,9,mixedType,1
7,1,0,8,mixedType,1
6,3,0,9,mixedType,1
6,1,0,7,mixedType,0
8,1,0,9,mixedType,1
12,3,0,15,mixedType,2
3,8,0,11,mixedType,1
6,3,0,9,mixedType,1
14,2,0,16,mixedType,2
4,4,0,8,mixedType,1
5,3,0,8,mixedType,1
7,3,0,10,mixedType,1
4,2,0,6,mixedType,0
4,2,0,6,mixedType,0
6,2,0,8,mixedType,1
12,3,0,15,mixedType,2
8,1,0,9,mixedType,1
12,3,0,15,mixedType,2
10,1,0,11,mixedType,1
3,6,0,9,mixedType,1
10,2,0,12,mixedType,1
5,1,0,6,mixedType,0
12,4,0,16,mixedType,2
4,4,0,8,mixedType,1
8,1,0,9,mixedType,1
4,4,0,8,mixedType,1
15,1,0,16,mixedType,2
7,3,0,10,mixedType,1
5,3,0,8,mixedType,1
15,1,0,16,mixedType,2
1,8,0,9,mixedType,1
6,2,0,8,mixedType,1
2,8,0,10,mixedType,1
2,8,0,10,mixedType,1
5,2,0,7,mixedType,0
5,2,0,7,mixedType,0
7,3,0,10,mixedType,1
6,1,0,7,mixedType,0
8,1,0,9,mixedType,1
6,4,0,10,mixedType,1
12,4,0,16,mixedType,2
8,3,0,11,mixedType,1
4,4,0,8,mixedType,1
5,2,0,7,mixedType,0
4,6,0,10,mixedType,1
3,6,0,9,mixedType,1
7,1,0,8,mixedType,1
7,3,0,10,mixedType,1
9,2,0,11,mixedType,1
6,1,0,7,mixedType,0
11,3,0,14,mixedType,2
3,7,0,10,mixedType,1
3,9,0,12,mixedType,1
9,1,0,10,mixedType,1
5,3,0,8,mixedType,1
8,1,0,9,mixedType,1
12,3,0,15,mixedType,2
8,4,0,12,mixedType,1
6,4,0,10,mixedType,1
5,2,0,7,mixedType,0
6,3,0,9,mixedType,1
3,5,0,8,mixedType,1
6,3,0,9,mixedType,1
5,2,0,7,mixedType,0
6,5,0,11,mixedType,1
15,1,0,16,mixedType,2
5,3,0,8,mixedType,1
1,8,0,9,mixedType,1
5,3,0,8,mixedType,1
4,4,0,8,mixedType,1
5,1,0,6,mixedType,0
10,2,0,12,mixedType,1
14,2,0,16,mixedType,2
8,2,0,10,mixedType,1
8,2,0,10,mixedType,1
7,3,0,10,mixedType,1
7,3,0,10,mixedType,1
12,3,0,15,mixedType,2
7,2,0,9,mixedType,1
4,4,0,8,mixedType,1
6,3,0,9,mixedType,1
3,3,0,6,mixedType,0
5,3,0,8,mixedType,1
6,3,0,9,mixedType,1
6,3,0,9,mixedType,1
2,4,0,6,mixedType,0
8,2,0,10,mixedType,1
4,6,0,10,mixedType,1
6,2,0,8,mixedType,1
6,1,0,7,mixedType,0
8,2,0,10,mixedType,1
9,2,0,11,mixedType,1
2,4,0,6,mixedType,0
8,2,0,10,mixedType,1
6,3,0,9,mixedType,1
12,4,0,16,mixedType,2
6,1,0,7,mixedType,0
5,1,0,6,mixedType,0
7,3,0,10,mixedType,1
5,3,0,8,mixedType,1
7,6,6,19,mixedType,2
10,2,0,12,mixedType,1
6,2,0,8,mixedType,1
7,2,0,9,mixedType,1
8,1,0,9,mixedType,1
6,1,0,7,mixedType,0
6,3,0,9,mixedType,1
10,3,0,13,mixedType,1
6,6,0,12,mixedType,1
6,4,0,10,mixedType,1
2,7,0,9,mixedType,1
6,2,0,8,mixedType,1
8,4,0,12,mixedType,1
8,2,0,10,mixedType,1
5,7,0,12,mixedType,1
5,2,0,7,mixedType,0
3,5,0,8,mixedType,1
7,2,0,9,mixedType,1
6,1,0,7,mixedType,0
6,3,0,9,mixedType,1
4,2,0,6,mixedType,0
9,2,0,11,mixedType,1
7,1,0,8,mixedType,1
7,3,0,10,mixedType,1
6,0,1,7,mixedType,0
6,4,0,10,mixedType,1
7,3,0,10,mixedType,1
13,3,0,16,mixedType,2
5,2,0,7,mixedType,0
7,6,0,13,mixedType,1
8,4,0,12,mixedType,1
6,3,0,9,mixedType,1
8,1,0,9,mixedType,1
6,1,0,7,mixedType,0
3,5,0,8,mixedType,1
6,4,0,10,mixedType,1
5,5,0,10,mixedType,1
11,2,0,13,mixedType,1
5,3,0,8,mixedType,1
6,1,0,7,mixedType,0
5,2,0,7,mixedType,0
5,4,0,9,mixedType,1
7,2,0,9,mixedType,1
7,3,0,10,mixedType,1
10,2,0,12,mixedType,1
7,2,0,9,mixedType,1
5,3,0,8,mixedType,1
6,1,0,7,mixedType,0
7,3,0,10,mixedType,1
6,5,0,11,mixedType,1
8,2,0,10,mixedType,1
11,3,0,14,mixedType,2
1,7,0,8,mixedType,1
8,4,0,12,mixedType,1
8,5,0,13,mixedType,1
7,3,0,10,mixedType,1
6,3,0,9,mixedType,1
7,1,0,8,mixedType,1
8,2,0,10,mixedType,1
15,1,0,16,mixedType,2
12,5,1,18,mixedType,2
3,7,0,10,mixedType,1
10,6,0,16,mixedType,2
13,3,0,16,mixedType,2
6,4,0,10,mixedType,1
3,6,0,9,mixedType,1
5,2,0,7,mixedType,0
4,4,0,8,mixedType,1
9,1,0,10,mixedType,1
9,0,1,10,mixedType,1
3,6,0,9,mixedType,1
12,3,0,15,mixedType,2
6,3,0,9,mixedType,1
5,3,0,8,mixedType,1
4,4,0,8,mixedType,1
6,2,0,8,mixedType,1
4,6,0,10,mixedType,1
6,2,0,8,mixedType,1
5,2,0,7,mixedType,0
11,2,0,13,mixedType,1
7,2,0,9,mixedType,1
2,5,0,7,mixedType,0
9,1,0,10,mixedType,1
7,4,0,11,mixedType,1
9,1,0,10,mixedType,1
5,3,0,8,mixedType,1
4,4,0,8,mixedType,1
4,6,0,10,mixedType,1
7,3,0,10,mixedType,1
4,4,0,8,mixedType,1
3,6,0,9,mixedType,1
2,4,0,6,mixedType,0
8,2,0,10,mixedType,1
10,1,0,11,mixedType,1
11,3,0,14,mixedType,2
5,4,0,9,mixedType,1
1,10,0,11,mixedType,1
7,4,0,11,mixedType,1
6,1,0,7,mixedType,0
7,1,0,8,mixedType,1
7,3,0,10,mixedType,1
5,3,0,8,mixedType,1
9,4,0,13,mixedType,1
8,1,1,10,mixedType,1
6,3,0,9,mixedType,1
8,2,0,10,mixedType,1
6,2,0,8,mixedType,1
8,1,0,9,mixedType,1
4,4,0,8,mixedType,1
5,3,0,8,mixedType,1
8,2,0,10,mixedType,1
2,12,0,14,mixedType,2
5,7,2,14,mixedType,2
6,2,0,8,mixedType,1
7,1,0,8,mixedType,1
4,4,0,8,mixedType,1
5,1,0,6,mixedType,0
5,1,0,6,mixedType,0
6,0,3,9,mixedType,1
9,4,0,13,mixedType,1
7,2,0,9,mixedType,1
5,3,0,8,mixedType,1
7,3,0,10,mixedType,1
7,3,0,10,mixedType,1
6,4,0,10,mixedType,1
7,1,0,8,mixedType,1
7,2,0,9,mixedType,1
8,2,0,10,mixedType,1
8,1,0,9,mixedType,1
8,2,0,10,mixedType,1
7,2,0,9,mixedType,1
5,1,0,6,mixedType,0
4,2,0,6,mixedType,0
8,2,0,10,mixedType,1
1,11,0,12,mixedType,1
6,3,0,9,mixedType,1
6,1,0,7,mixedType,0
8,2,0,10,mixedType,1
4,5,0,9,mixedType,1
6,4,0,10,mixedType,1
6,1,0,7,mixedType,0
12,4,0,16,mixedType,2
4,2,0,6,mixedType,0
11,2,0,13,mixedType,1
5,3,0,8,mixedType,1
5,3,0,8,mixedType,1
8,3,0,11,mixedType,1
5,1,0,6,mixedType,0
6,3,0,9,mixedType,1
7,2,0,9,mixedType,1
6,4,0,10,mixedType,1
2,7,0,9,mixedType,1
7,3,0,10,mixedType,1
7,3,0,10,mixedType,1
1,8,0,9,mixedType,1
5,2,0,7,mixedType,0
2,8,0,10,mixedType,1
8,4,0,12,mixedType,1
5,1,0,6,mixedType,0
10,4,1,15,mixedType,2
9,1,0,10,mixedType,1
9,6,0,15,mixedType,2
8,2,0,10,mixedType,1
6,4,0,10,mixedType,1
4,4,0,8,mixedType,1
5,3,0,8,mixedType,1
4,4,0,8,mixedType,1
8,1,0,9,mixedType,1
5,3,0,8,mixedType,1
7,2,0,9,mixedType,1
3,3,0,6,mixedType,0
1,8,0,9,mixedType,1
7,3,0,10,mixedType,1
4,2,0,6,mixedType,0
6,6,0,12,mixedType,1
8,3,0,11,mixedType,1
6,1,0,7,mixedType,0
13,3,0,16,mixedType,2
4,6,0,10,mixedType,1
5,3,0,8,mixedType,1
12,3,0,15,mixedType,2
8,2,0,10,mixedType,1
2,7,0,9,mixedType,1
8,2,0,10,mixedType,1
7,3,0,10,mixedType,1
6,3,0,9,mixedType,1
8,2,0,10,mixedType,1
7,1,0,8,mixedType,1
4,4,0,8,mixedType,1
4,2,0,6,mixedType,0
2,8,0,10,mixedType,1
8,2,0,10,mixedType,1
14,2,0,16,mixedType,2
6,3,0,9,mixedType,1
4,2,0,6,mixedType,0
5,6,0,11,mixedType,1
9,2,0,11,mixedType,1
7,1,0,8,mixedType,1
9,1,0,10,mixedType,1
8,2,0,10,mixedType,1
2,9,0,11,mixedType,1
14,2,0,16,mixedType,2
1,7,0,8,mixedType,1
8,2,0,10,mixedType,1
6,3,0,9,mixedType,1
3,10,0,13,mixedType,1
5,3,0,8,mixedType,1
4,4,0,8,mixedType,1
10,2,0,12,mixedType,1
9,4,0,13,mixedType,1
7,1,0,8,mixedType,1
9,2,0,11,mixedType,1
6,3,0,9,mixedType,1
8,4,0,12,mixedType,1
4,4,0,8,mixedType,1
7,2,0,9,mixedType,1
7,3,0,10,mixedType,1
10,1,0,11,mixedType,1
2,8,0,10,mixedType,1
8,2,0,10,mixedType,1
5,4,0,9,mixedType,1
6,4,0,10,mixedType,1
9,6,0,15,mixedType,2
5,1,0,6,mixedType,0
5,3,0,8,mixedType,1
4,5,0,9,mixedType,1
8,4,0,12,mixedType,1
5,4,0,9,mixedType,1
8,1,0,9,mixedType,1
5,3,0,8,mixedType,1
6,1,0,7,mixedType,0
4,2,0,6,mixedType,0
6,3,0,9,mixedType,1
8,2,0,10,mixedType,1
14,2,0,16,mixedType,2
5,2,0,7,mixedType,0
13,3,0,16,mixedType,2
8,3,0,11,mixedType,1
1,9,0,10,mixedType,1
9,1,0,10,mixedType,1
13,3,0,16,mixedType,2
5,4,0,9,mixedType,1
12,4,0,16,mixedType,2
9,2,0,11,mixedType,1
1,7,0,8,mixedType,1
3,5,0,8,mixedType,1
8,2,0,10,mixedType,1
7,2,0,9,mixedType,1
10,3,0,13,mixedType,1
4,2,0,6,mixedType,0
8,2,0,10,mixedType,1
4,8,2,14,mixedType,2
7,1,0,8,mixedType,1
10,0,1,11,mixedType,1
5,4,0,9,mixedType,1
13,3,0,16,mixedType,2
4,6,0,10,mixedType,1
7,3,0,10,mixedType,1
7,4,0,11,mixedType,1
11,1,0,12,mixedType,1
8,3,0,11,mixedType,1
6,1,0,7,mixedType,0
5,4,0,9,mixedType,1
5,2,0,7,mixedType,0
5,1,0,6,mixedType,0
2,7,0,9,mixedType,1
13,3,0,16,mixedType,2
8,1,0,9,mixedType,1
6,4,0,10,mixedType,1
4,2,0,6,mixedType,0
6,2,0,8,mixedType,1
5,3,0,8,mixedType,1
5,2,0,7,mixedType,0
9,2,0,11,mixedType,1
15,1,0,16,mixedType,2
6,1,0,7,mixedType,0
4,2,0,6,mixedType,0
12,4,0,16,mixedType,2
5,8,0,13,mixedType,1
4,2,0,6,mixedType,0
14,2,0,16,mixedType,2
6,6,0,12,mixedType,1
8,2,0,10,mixedType,1
8,3,0,11,mixedType,1
5,2,0,7,mixedType,0
7,3,0,10,mixedType,1
8,2,0,10,mixedType,1
6,3,0,9,mixedType,1
4,5,0,9,mixedType,1
8,2,0,10,mixedType,1
13,3,0,16,mixedType,2
9,3,0,12,mixedType,1
6,3,0,9,mixedType,1
12,4,0,16,mixedType,2
8,1,0,9,mixedType,1
7,4,0,11,mixedType,1
6,3,0,9,mixedType,1
2,4,0,6,mixedType,0
2,10,0,12,mixedType,1
8,3,0,11,mixedType,1
6,3,0,9,mixedType,1
1,8,0,9,mixedType,1
2,6,0,8,mixedType,1
5,2,0,7,mixedType,0
7,3,0,10,mixedType,1
5,3,0,8,mixedType,1
7,4,0,11,mixedType,1
0,7,1,8,mixedType,1
7,2,0,9,mixedType,1
9,1,0,10,mixedType,1
6,4,0,10,mixedType,1
13,3,0,16,mixedType,2
2,6,0,8,mixedType,1
9,2,0,11,mixedType,1
10,4,0,14,mixedType,2
10,2,0,12,mixedType,1
6,3,0,9,mixedType,1
6,2,0,8,mixedType,1
5,1,0,6,mixedType,0
5,2,0,7,mixedType,0
6,3,0,9,mixedType,1
6,1,0,7,mixedType,0
11,3,0,14,mixedType,2
9,2,0,11,mixedType,1
12,4,0,16,mixedType,2
7,6,0,13,mixedType,1
10,3,0,13,mixedType,1
14,2,0,16,mixedType,2
4,6,0,10,mixedType,1
6,1,0,7,mixedType,0
8,1,0,9,mixedType,1
5,2,0,7,mixedType,0
6,4,0,10,mixedType,1
7,1,0,8,mixedType,1
5,4,0,9,mixedType,1
10,4,0,14,mixedType,2
6,3,0,9,mixedType,1
7,3,0,10,mixedType,1
11,3,0,14,mixedType,2
5,2,0,7,mixedType,0
6,2,0,8,mixedType,1
9,3,0,12,mixedType,1
5,2,0,7,mixedType,0
6,3,0,9,mixedType,1
10,3,0,13,mixedType,1
3,7,0,10,mixedType,1
4,2,0,6,mixedType,0
3,6,0,9,mixedType,1
10,3,3,16,mixedType,2
9,1,0,10,mixedType,1
11,3,0,14,mixedType,2
9,3,0,12,mixedType,1
5,3,0,8,mixedType,1
6,3,0,9,mixedType,1
4,6,0,10,mixedType,1
6,4,0,10,mixedType,1
7,4,0,11,mixedType,1
2,6,0,8,mixedType,1
5,2,0,7,mixedType,0
1,8,0,9,mixedType,1
11,2,0,13,mixedType,1
13,3,0,16,mixedType,2
9,1,0,10,mixedType,1
8,2,0,10,mixedType,1
4,2,0,6,mixedType,0
10,2,0,12,mixedType,1
11,5,0,16,mixedType,2
7,2,0,9,mixedType,1
9,2,0,11,mixedType,1
4,8,0,12,mixedType,1
6,3,0,9,mixedType,1
7,4,0,11,mixedType,1
10,4,0,14,mixedType,2
7,2,0,9,mixedType,1
4,4,0,8,mixedType,1
3,3,0,6,mixedType,0
5,3,0,8,mixedType,1
7,2,0,9,mixedType,1
8,1,0,9,mixedType,1
6,2,0,8,mixedType,1
12,4,0,16,mixedType,2
8,2,0,10,mixedType,1
14,2,0,16,mixedType,2
6,1,0,7,mixedType,0
8,2,0,10,mixedType,1
7,4,0,11,mixedType,1
5,2,0,7,mixedType,0
6,3,0,9,mixedType,1
6,1,0,7,mixedType,0
9,3,0,12,mixedType,1
2,4,0,6,mixedType,0
5,1,0,6,mixedType,0
10,4,1,15,mixedType,2
5,5,0,10,mixedType,1
15,1,0,16,mixedType,2
5,3,0,8,mixedType,1
2,7,0,9,mixedType,1
6,4,0,10,mixedType,1
6,2,0,8,mixedType,1
6,3,0,9,mixedType,1
8,4,0,12,mixedType,1
8,2,0,10,mixedType,1
5,6,0,11,mixedType,1
9,1,0,10,mixedType,1
9,3,0,12,mixedType,1
8,4,0,12,mixedType,1
6,3,0,9,mixedType,1
5,2,0,7,mixedType,0
9,3,0,12,mixedType,1
3,5,0,8,mixedType,1
14,2,0,16,mixedType,2
8,4,0,12,mixedType,1
5,2,0,7,mixedType,0
6,2,0,8,mixedType,1
8,3,0,11,mixedType,1
2,8,0,10,mixedType,1
8,2,0,10,mixedType,1
12,4,0,16,mixedType,2
6,3,0,9,mixedType,1
7,1,0,8,mixedType,1
1,12,0,13,mixedType,1
5,3,0,8,mixedType,1
6,5,0,11,mixedType,1
4,6,0,10,mixedType,1
4,2,0,6,mixedType,0
7,2,0,9,mixedType,1
4,8,0,12,mixedType,1
5,3,0,8,mixedType,1
7,3,0,10,mixedType,1
3,7,0,10,mixedType,1
6,1,0,7,mixedType,0
7,3,0,10,mixedType,1
6,3,0,9,mixedType,1
6,2,0,8,mixedType,1
7,3,0,10,mixedType,1
6,3,0,9,mixedType,1
4,4,0,8,mixedType,1
11,1,0,12,mixedType,1
3,3,0,6,mixedType,0
2,8,0,10,mixedType,1
3,8,0,11,mixedType,1
4,4,0,8,mixedType,1
7,4,0,11,mixedType,1
7,2,0,9,mixedType,1
5,4,0,9,mixedType,1
6,4,0,10,mixedType,1
5,4,0,9,mixedType,1
5,2,0,7,mixedType,0
4,4,0,8,mixedType,1
6,1,0,7,mixedType,0
8,2,0,10,mixedType,1
13,3,0,16,mixedType,2
6,1,0,7,mixedType,0
7,2,0,9,mixedType,1
6,3,0,9,mixedType,1
6,4,0,10,mixedType,1
1,8,0,9,mixedType,1
5,3,0,8,mixedType,1
6,11,0,17,mixedType,2
10,2,0,12,mixedType,1
12,3,0,15,mixedType,2
6,0,1,7,mixedType,0
13,3,0,16,mixedType,2
6,4,0,10,mixedType,1
8,1,0,9,mixedType,1
6,3,0,9,mixedType,1
6,3,0,9,mixedType,1
7,1,0,8,mixedType,1
9,2,0,11,mixedType,1
1,8,0,9,mixedType,1
5,4,0,9,mixedType,1
15,1,0,16,mixedType,2
7,3,0,10,mixedType,1
8,1,0,9,mixedType,1
8,2,0,10,mixedType,1
7,2,0,9,mixedType,1
11,3,1,15,mixedType,2
4,2,0,6,mixedType,0
7,1,0,8,mixedType,1
8,4,0,12,mixedType,1
3,6,0,9,mixedType,1
14,2,0,16,mixedType,2
6,4,0,10,mixedType,1
8,2,0,10,mixedType,1
8,1,0,9,mixedType,1
6,1,0,7,mixedType,0
7,2,0,9,mixedType,1
7,2,0,9,mixedType,1
6,3,0,9,mixedType,1
8,1,0,9,mixedType,1
3,11,1,15,mixedType,2
12,4,0,16,mixedType,2
6,4,0,10,mixedType,1
6,4,0,10,mixedType,1
6,2,0,8,mixedType,1
7,2,0,9,mixedType,1
4,2,0,6,mixedType,0
8,2,0,10,mixedType,1
7,3,0,10,mixedType,1
6,4,0,10,mixedType,1
5,1,0,6,mixedType,0
5,3,0,8,mixedType,1
5,3,0,8,mixedType,1
6,1,0,7,mixedType,0
6,3,0,9,mixedType,1
6,1,0,7,mixedType,0
6,4,0,10,mixedType,1
9,3,0,12,mixedType,1
7,3,0,10,mixedType,1
5,4,0,9,mixedType,1
5,2,0,7,mixedType,0
8,2,0,10,mixedType,1
9,1,0,10,mixedType,1
8,2,0,10,mixedType,1
5,1,0,6,mixedType,0
6,3,0,9,mixedType,1
1,10,0,11,mixedType,1
5,2,0,7,mixedType,0
3,7,0,10,mixedType,1
5,7,0,12,mixedType,1
8,1,0,9,mixedType,1
5,4,0,9,mixedType,1
4,4,0,8,mixedType,1
5,2,0,7,mixedType,0
6,3,0,9,mixedType,1
6,3,0,9,mixedType,1
6,4,0,10,mixedType,1
16,0,1,17,mixedType,2
8,2,0,10,mixedType,1
8,4,0,12,mixedType,1
8,1,0,9,mixedType,1
5,4,0,9,mixedType,1
1,8,0,9,mixedType,1
1,8,0,9,mixedType,1
0,8,1,9,mixedType,1
11,2,0,13,mixedType,1
6,1,0,7,mixedType,0
7,1,0,8,mixedType,1
6,2,0,8,mixedType,1
15,1,0,16,mixedType,2
11,0,1,12,mixedType,1
1,8,0,9,mixedType,1
14,2,0,16,mixedType,2
15,1,0,16,mixedType,2
7,3,0,10,mixedType,1
12,1,2,15,mixedType,2
7,2,0,9,mixedType,1
7,3,0,10,mixedType,1
5,4,0,9,mixedType,1
2,6,0,8,mixedType,1
7,1,0,8,mixedType,1
4,4,0,8,mixedType,1
8,1,0,9,mixedType,1
1,9,0,10,mixedType,1
6,1,0,7,mixedType,0
5,3,0,8,mixedType,1
6,1,0,7,mixedType,0
6,2,0,8,mixedType,1
5,10,0,15,mixedType,2
11,1,0,12,mixedType,1
9,2,0,11,mixedType,1
3,7,0,10,mixedType,1
7,3,0,10,mixedType,1
5,8,0,13,mixedType,1
5,3,0,8,mixedType,1
4,4,0,8,mixedType,1
13,3,0,16,mixedType,2
5,4,0,9,mixedType,1
5,8,0,13,mixedType,1
3,7,0,10,mixedType,1
6,6,0,12,mixedType,1
15,1,0,16,mixedType,2
6,4,0,10,mixedType,1
5,2,0,7,mixedType,0
9,1,0,10,mixedType,1
7,3,0,10,mixedType,1
11,1,0,12,mixedType,1
14,1,0,15,mixedType,2
2,8,0,10,mixedType,1
12,0,1,13,mixedType,1
6,8,0,14,mixedType,2
5,8,0,13,mixedType,1
14,2,0,16,mixedType,2
8,3,0,11,mixedType,1
7,2,0,9,mixedType,1
6,4,0,10,mixedType,1
7,3,0,10,mixedType,1
10,4,0,14,mixedType,2
6,4,0,10,mixedType,1
1,8,0,9,mixedType,1
6,3,0,9,mixedType,1
10,2,0,12,mixedType,1
4,6,0,10,mixedType,1
7,3,0,10,mixedType,1
6,3,0,9,mixedType,1
2,6,0,8,mixedType,1
7,4,0,11,mixedType,1
5,6,0,11,mixedType,1
10,3,0,13,mixedType,1
6,2,0,8,mixedType,1
4,6,0,10,mixedType,1
4,4,0,8,mixedType,1
8,1,0,9,mixedType,1
12,3,1,16,mixedType,2
10,1,0,11,mixedType,1
8,2,0,10,mixedType,1
6,4,0,10,mixedType,1
6,3,0,9,mixedType,1
6,2,0,8,mixedType,1
7,2,0,9,mixedType,1
8,4,0,12,mixedType,1
6,4,0,10,mixedType,1
9,2,0,11,mixedType,1
1,10,0,11,mixedType,1
7,3,0,10,mixedType,1
7,3,0,10,mixedType,1
6,4,0,10,mixedType,1
13,3,0,16,mixedType,2
15,1,0,16,mixedType,2
5,5,0,10,mixedType,1
13,3,0,16,mixedType,2
7,3,0,10,mixedType,1
5,2,0,7,mixedType,0
9,1,0,10,mixedType,1
6,4,0,10,mixedType,1
6,4,0,10,mixedType,1
9,1,0,10,mixedType,1
10,3,0,13,mixedType,1
3,10,0,13,mixedType,1
8,4,0,12,mixedType,1
7,3,0,10,mixedType,1
7,2,0,9,mixedType,1
11,4,0,15,mixedType,2
1,8,0,9,mixedType,1
6,0,1,7,mixedType,0
6,1,0,7,mixedType,0
11,1,0,12,mixedType,1
4,2,0,6,mixedType,0
7,2,0,9,mixedType,1
7,1,0,8,mixedType,1
7,3,0,10,mixedType,1
6,2,0,8,mixedType,1
1,10,0,11,mixedType,1
6,3,0,9,mixedType,1
5,1,0,6,mixedType,0
6,1,0,7,mixedType,0
11,2,0,13,mixedType,1
9,1,0,10,mixedType,1
6,1,0,7,mixedType,0
4,2,0,6,mixedType,0
8,1,0,9,mixedType,1
5,3,0,8,mixedType,1
7,3,0,10,mixedType,1
8,4,0,12,mixedType,1
7,2,0,9,mixedType,1
12,4,0,16,mixedType,2
15,1,0,16,mixedType,2
5,3,0,8,mixedType,1
4,4,0,8,mixedType,1
11,3,0,14,mixedType,2
2,10,0,12,mixedType,1
7,3,0,10,mixedType,1
5,2,0,7,mixedType,0
6,3,0,9,mixedType,1
6,3,0,9,mixedType,1
6,2,0,8,mixedType,1
9,1,0,10,mixedType,1
8,2,0,10,mixedType,1
6,2,0,8,mixedType,1
8,3,0,11,mixedType,1
6,2,0,8,mixedType,1
5,7,0,12,mixedType,1
6,3,0,9,mixedType,1
6,1,0,7,mixedType,0
8,2,0,10,mixedType,1
6,8,0,14,mixedType,2
3,6,0,9,mixedType,1
9,3,0,12,mixedType,1
1,9,0,10,mixedType,1
6,3,0,9,mixedType,1
7,2,0,9,mixedType,1
15,1,0,16,mixedType,2
9,2,0,11,mixedType,1
3,7,0,10,mixedType,1
8,1,0,9,mixedType,1
4,4,0,8,mixedType,1
12,4,0,16,mixedType,2
5,2,0,7,mixedType,0
8,1,0,9,mixedType,1
4,2,0,6,mixedType,0
7,3,0,10,mixedType,1
8,2,0,10,mixedType,1
8,1,0,9,mixedType,1
7,2,0,9,mixedType,1
7,1,0,8,mixedType,1
5,3,0,8,mixedType,1
2,6,0,8,mixedType,1
6,2,0,8,mixedType,1
7,3,0,10,mixedType,1
8,5,0,13,mixedType,1
7,3,0,10,mixedType,1
4,2,0,6,mixedType,0
7,3,0,10,mixedType,1
4,6,0,10,mixedType,1
6,3,0,9,mixedType,1
5,2,0,7,mixedType,0
4,4,0,8,mixedType,1
5,2,0,7,mixedType,0
7,2,0,9,mixedType,1
10,3,0,13,mixedType,1
0,5,2,7,mixedType,0
7,2,0,9,mixedType,1
6,3,0,9,mixedType,1
8,1,0,9,mixedType,1
9,6,1,16,mixedType,2
7,2,0,9,mixedType,1
6,3,0,9,mixedType,1
5,3,0,8,mixedType,1
15,1,0,16,mixedType,2
12,3,0,15,mixedType,2
8,2,0,10,mixedType,1
6,3,0,9,mixedType,1
10,3,0,13,mixedType,1
11,3,0,14,mixedType,2
5,4,0,9,mixedType,1
8,1,0,9,mixedType,1
10,2,0,12,mixedType,1
6,3,0,9,mixedType,1
13,3,0,16,mixedType,2
12,4,0,16,mixedType,2
5,3,0,8,mixedType,1
7,2,0,9,mixedType,1
6,3,0,9,mixedType,1
6,4,0,10,mixedType,1
7,3,0,10,mixedType,1
6,3,0,9,mixedType,1
8,4,0,12,mixedType,1
4,4,0,8,mixedType,1
10,2,0,12,mixedType,1
8,2,0,10,mixedType,1
15,1,0,16,mixedType,2
6,2,0,8,mixedType,1
14,2,0,16,mixedType,2
5,4,0,9,mixedType,1
6,3,0,9,mixedType,1
4,2,0,6,mixedType,0
7,3,0,10,mixedType,1
5,6,0,11,mixedType,1
6,1,0,7,mixedType,0
8,4,0,12,mixedType,1
7,2,0,9,mixedType,1
10,1,0,11,mixedType,1
2,7,0,9,mixedType,1
5,4,0,9,mixedType,1
10,1,0,11,mixedType,1
7,4,0,11,mixedType,1
7,3,0,10,mixedType,1
7,2,0,9,mixedType,1
8,3,0,11,mixedType,1
5,4,0,9,mixedType,1
6,3,0,9,mixedType,1
8,1,0,9,mixedType,1
14,2,0,16,mixedType,2
8,2,0,10,mixedType,1
6,1,0,7,mixedType,0
6,1,0,7,mixedType,0
3,5,0,8,mixedType,1
3,6,0,9,mixedType,1
6,1,0,7,mixedType,0
6,5,0,11,mixedType,1
5,4,0,9,mixedType,1
8,2,0,10,mixedType,1
7,3,0,10,mixedType,1
7,3,0,10,mixedType,1
5,3,0,8,mixedType,1
8,1,0,9,mixedType,1
8,1,0,9,mixedType,1
5,3,0,8,mixedType,1
5,4,0,9,mixedType,1
5,2,0,7,mixedType,0
9,1,0,10,mixedType,1
12,4,0,16,mixedType,2
5,1,0,6,mixedType,0
4,4,0,8,mixedType,1
6,3,0,9,mixedType,1
8,3,0,11,mixedType,1
8,2,0,10,mixedType,1
8,1,0,9,mixedType,1
5,3,0,8,mixedType,1
4,2,0,6,mixedType,0
3,7,0,10,mixedType,1
4,2,0,6,mixedType,0
8,1,0,9,mixedType,1
15,1,0,16,mixedType,2
4,6,0,10,mixedType,1
7,2,0,9,mixedType,1
8,2,0,10,mixedType,1
6,3,0,9,mixedType,1
5,2,0,7,mixedType,0
9,0,1,10,mixedType,1
6,1,0,7,mixedType,0
6,3,0,9,mixedType,1
5,2,0,7,mixedType,0
7,3,0,10,mixedType,1
13,0,11,24,mixedType,2
7,5,0,12,mixedType,1
6,3,0,9,mixedType,1
6,3,0,9,mixedType,1
2,6,0,8,mixedType,1
5,2,0,7,mixedType,0
5,3,0,8,mixedType,1
6,3,0,9,mixedType,1
9,2,0,11,mixedType,1
9,2,0,11,mixedType,1
4,6,0,10,mixedType,1
7,1,0,8,mixedType,1
5,4,0,9,mixedType,1
7,2,0,9,mixedType,1
7,3,0,10,mixedType,1
7,3,0,10,mixedType,1
13,3,0,16,mixedType,2
11,3,0,14,mixedType,2
7,3,0,10,mixedType,1
12,3,0,15,mixedType,2
10,2,0,12,mixedType,1
5,7,0,12,mixedType,1
7,6,0,13,mixedType,1
2,4,0,6,mixedType,0
6,1,0,7,mixedType,0
5,2,0,7,mixedType,0
4,4,0,8,mixedType,1
12,3,0,15,mixedType,2
7,3,0,10,mixedType,1
7,2,0,9,mixedType,1
12,4,0,16,mixedType,2
1,8,0,9,mixedType,1
4,4,0,8,mixedType,1
7,3,0,10,mixedType,1
12,4,0,16,mixedType,2
4,4,0,8,mixedType,1
2,8,0,10,mixedType,1
5,4,0,9,mixedType,1
5,2,0,7,mixedType,0
5,3,0,8,mixedType,1
7,3,0,10,mixedType,1
6,3,0,9,mixedType,1
5,3,0,8,mixedType,1
7,2,0,9,mixedType,1
4,4,0,8,mixedType,1
7,2,0,9,mixedType,1
9,1,0,10,mixedType,1
14,2,0,16,mixedType,2
9,4,0,13,mixedType,1
11,3,0,14,mixedType,2
7,3,0,10,mixedType,1
7,1,0,8,mixedType,1
6,4,0,10,mixedType,1
14,2,0,16,mixedType,2
15,1,0,16,mixedType,2
13,3,0,16,mixedType,2
6,1,0,7,mixedType,0
6,3,0,9,mixedType,1
6,3,0,9,mixedType,1
6,6,0,12,mixedType,1
6,2,0,8,mixedType,1
14,2,0,16,mixedType,2
5,4,0,9,mixedType,1
5,2,0,7,mixedType,0
0,6,0,6,sameType,0
3,8,0,11,mixedType,1
2,6,0,8,mixedType,1
7,3,0,10,mixedType,1
15,1,0,16,mixedType,2
6,2,0,8,mixedType,1
3,5,0,8,mixedType,1
7,4,0,11,mixedType,1
15,1,0,16,mixedType,2
5,2,0,7,mixedType,0
10,2,0,12,mixedType,1
10,2,0,12,mixedType,1
6,1,0,7,mixedType,0
2,6,0,8,mixedType,1
15,1,0,16,mixedType,2
6,5,0,11,mixedType,1
8,2,0,10,mixedType,1
7,3,0,10,mixedType,1
2,6,0,8,mixedType,1
5,4,0,9,mixedType,1
6,1,0,7,mixedType,0
3,8,0,11,mixedType,1
8,2,0,10,mixedType,1
7,1,0,8,mixedType,1
6,4,0,10,mixedType,1
2,7,0,9,mixedType,1
8,2,0,10,mixedType,1
4,4,0,8,mixedType,1
5,4,0,9,mixedType,1
5,4,0,9,mixedType,1
2,4,0,6,mixedType,0
7,3,0,10,mixedType,1
8,1,0,9,mixedType,1
5,3,0,8,mixedType,1
6,2,0,8,mixedType,1
11,5,0,16,mixedType,2
8,2,0,10,mixedType,1
5,4,0,9,mixedType,1
5,4,1,10,mixedType,1
4,2,0,6,mixedType,0
11,3,0,14,mixedType,2
7,3,0,10,mixedType,1
5,2,0,7,mixedType,0
6,2,0,8,mixedType,1
6,3,0,9,mixedType,1
7,2,0,9,mixedType,1
15,1,0,16,mixedType,2
7,2,0,9,mixedType,1
12,4,0,16,mixedType,2
14,2,0,16,mixedType,2
2,4,0,6,mixedType,0
6,1,0,7,mixedType,0
4,7,0,11,mixedType,1
8,2,0,10,mixedType,1
1,7,0,8,mixedType,1
8,1,0,9,mixedType,1
5,3,0,8,mixedType,1
0,9,1,10,mixedType,1
5,1,0,6,mixedType,0
9,1,0,10,mixedType,1
4,6,0,10,mixedType,1
7,4,0,11,mixedType,1
4,2,0,6,mixedType,0
15,1,0,16,mixedType,2
5,3,0,8,mixedType,1
12,3,0,15,mixedType,2
7,1,0,8,mixedType,1
5,2,0,7,mixedType,0
8,3,0,11,mixedType,1
6,3,0,9,mixedType,1
3,6,0,9,mixedType,1
6,3,0,9,mixedType,1
8,2,0,10,mixedType,1
9,0,1,10,mixedType,1
8,1,0,9,mixedType,1
7,3,0,10,mixedType,1
12,3,0,15,mixedType,2
4,4,0,8,mixedType,1
7,1,0,8,mixedType,1
4,6,0,10,mixedType,1
14,2,0,16,mixedType,2
11,3,0,14,mixedType,2
2,6,0,8,mixedType,1
8,4,0,12,mixedType,1
3,3,0,6,mixedType,0
12,3,0,15,mixedType,2
0,6,1,7,mixedType,0
5,2,0,7,mixedType,0
5,2,0,7,mixedType,0
6,3,0,9,mixedType,1
7,3,0,10,mixedType,1
8,1,0,9,mixedType,1
9,1,0,10,mixedType,1
8,2,0,10,mixedType,1
4,2,0,6,mixedType,0
13,3,0,16,mixedType,2
5,3,0,8,mixedType,1
12,3,0,15,mixedType,2
6,4,0,10,mixedType,1
6,3,0,9,mixedType,1
5,2,0,7,mixedType,0
5,2,0,7,mixedType,0
4,2,0,6,mixedType,0
5,3,0,8,mixedType,1
6,2,0,8,mixedType,1
6,6,0,12,mixedType,1
4,8,0,12,mixedType,1
2,4,0,6,mixedType,0
7,1,0,8,mixedType,1
2,7,0,9,mixedType,1
7,2,0,9,mixedType,1
7,3,0,10,mixedType,1
5,3,0,8,mixedType,1
14,2,0,16,mixedType,2
13,3,0,16,mixedType,2
6,4,0,10,mixedType,1
2,8,0,10,mixedType,1
5,3,0,8,mixedType,1
7,2,0,9,mixedType,1
5,3,0,8,mixedType,1
5,4,0,9,mixedType,1
2,4,0,6,mixedType,0
6,1,0,7,mixedType,0
7,2,0,9,mixedType,1
6,1,0,7,mixedType,0
7,1,0,8,mixedType,1
7,3,0,10,mixedType,1
1,10,0,11,mixedType,1
1,7,0,8,mixedType,1
10,3,0,13,mixedType,1
5,4,0,9,mixedType,1
6,4,0,10,mixedType,1
7,2,0,9,mixedType,1
6,4,0,10,mixedType,1
4,4,0,8,mixedType,1
6,2,0,8,mixedType,1
6,4,0,10,mixedType,1
10,2,0,12,mixedType,1
5,6,0,11,mixedType,1
5,4,0,9,mixedType,1
3,3,0,6,mixedType,0
9,1,0,10,mixedType,1
17,2,1,20,mixedType,2
5,2,0,7,mixedType,0
5,4,0,9,mixedType,1
7,4,0,11,mixedType,1
6,3,0,9,mixedType,1
7,1,0,8,mixedType,1
7,1,0,8,mixedType,1
6,3,0,9,mixedType,1
8,1,0,9,mixedType,1
5,5,0,10,mixedType,1
8,3,0,11,mixedType,1
8,3,0,11,mixedType,1
2,6,0,8,mixedType,1
6,1,0,7,mixedType,0
5,1,0,6,mixedType,0
6,5,0,11,mixedType,1
13,3,0,16,mixedType,2
13,3,0,16,mixedType,2
3,5,0,8,mixedType,1
9,1,0,10,mixedType,1
6,1,0,7,mixedType,0
7,3,0,10,mixedType,1
7,1,0,8,mixedType,1
9,2,0,11,mixedType,1
2,8,0,10,mixedType,1
7,2,0,9,mixedType,1
6,2,0,8,mixedType,1
7,2,0,9,mixedType,1
6,3,0,9,mixedType,1
4,2,0,6,mixedType,0
5,4,0,9,mixedType,1
8,1,0,9,mixedType,1
7,2,0,9,mixedType,1
6,2,0,8,mixedType,1
12,3,0,15,mixedType,2
5,3,0,8,mixedType,1
6,3,0,9,mixedType,1
8,2,0,10,mixedType,1
6,6,0,12,mixedType,1
8,3,0,11,mixedType,1
10,3,0,13,mixedType,1
6,2,0,8,mixedType,1
4,2,0,6,mixedType,0
7,1,0,8,mixedType,1
7,3,0,10,mixedType,1
13,3,0,16,mixedType,2
6,3,0,9,mixedType,1
8,2,0,10,mixedType,1
6,3,0,9,mixedType,1
7,2,0,9,mixedType,1
6,4,0,10,mixedType,1
8,4,0,12,mixedType,1
2,8,0,10,mixedType,1
6,2,0,8,mixedType,1
6,0,1,7,mixedType,0
7,4,0,11,mixedType,1
12,4,0,16,mixedType,2
9,1,0,10,mixedType,1
7,2,0,9,mixedType,1
10,2,0,12,mixedType,1
2,8,0,10,mixedType,1
5,1,0,6,mixedType,0
5,2,0,7,mixedType,0
5,4,0,9,mixedType,1
9,1,0,10,mixedType,1
6,3,0,9,mixedType,1
4,6,0,10,mixedType,1
8,1,0,9,mixedType,1
7,2,0,9,mixedType,1
11,5,0,16,mixedType,2
5,4,0,9,mixedType,1
7,2,0,9,mixedType,1
14,2,0,16,mixedType,2
5,3,0,8,mixedType,1
6,4,0,10,mixedType,1
5,3,0,8,mixedType,1
9,1,0,10,mixedType,1
8,2,0,10,mixedType,1
8,2,0,10,mixedType,1
7,2,0,9,mixedType,1
7,2,0,9,mixedType,1
13,3,0,16,mixedType,2
6,3,0,9,mixedType,1
16,2,0,18,mixedType,2
6,4,0,10,mixedType,1
3,7,0,10,mixedType,1
15,1,0,16,mixedType,2
1,8,0,9,mixedType,1
4,4,0,8,mixedType,1
7,3,0,10,mixedType,1
7,3,0,10,mixedType,1
7,2,0,9,mixedType,1
6,6,0,12,mixedType,1
3,6,0,9,mixedType,1
9,1,0,10,mixedType,1
11,3,0,14,mixedType,2
4,4,0,8,mixedType,1
15,1,0,16,mixedType,2
8,1,0,9,mixedType,1
6,3,0,9,mixedType,1
6,3,0,9,mixedType,1
5,2,0,7,mixedType,0
8,3,0,11,mixedType,1
5,4,0,9,mixedType,1
15,1,0,16,mixedType,2
1,9,0,10,mixedType,1
5,1,0,6,mixedType,0
0,8,0,8,sameType,1
5,4,0,9,mixedType,1
7,1,0,8,mixedType,1
6,4,0,10,mixedType,1
7,3,0,10,mixedType,1
2,6,0,8,mixedType,1
6,2,0,8,mixedType,1
6,2,0,8,mixedType,1
6,3,0,9,mixedType,1
5,3,0,8,mixedType,1
8,1,0,9,mixedType,1
7,4,0,11,mixedType,1
8,1,0,9,mixedType,1
6,2,0,8,mixedType,1
6,3,0,9,mixedType,1
6,2,0,8,mixedType,1
9,4,0,13,mixedType,1
8,4,0,12,mixedType,1
6,2,0,8,mixedType,1
4,4,0,8,mixedType,1
7,3,0,10,mixedType,1
5,4,0,9,mixedType,1
3,3,0,6,mixedType,0
6,3,0,9,mixedType,1
7,3,0,10,mixedType,1
7,4,0,11,mixedType,1
13,3,0,16,mixedType,2
7,2,0,9,mixedType,1
3,9,0,12,mixedType,1
7,4,0,11,mixedType,1
5,4,0,9,mixedType,1
5,4,0,9,mixedType,1
7,3,0,10,mixedType,1
7,1,0,8,mixedType,1
9,2,0,11,mixedType,1
10,2,0,12,mixedType,1
4,4,0,8,mixedType,1
9,2,0,11,mixedType,1
5,4,0,9,mixedType,1
5,6,0,11,mixedType,1
5,6,0,11,mixedType,1
8,2,0,10,mixedType,1
9,1,0,10,mixedType,1
6,1,0,7,mixedType,0
6,3,0,9,mixedType,1
5,6,0,11,mixedType,1
5,8,0,13,mixedType,1
5,2,0,7,mixedType,0
4,6,0,10,mixedType,1
5,4,0,9,mixedType,1
9,3,0,12,mixedType,1
12,4,0,16,mixedType,2
5,3,0,8,mixedType,1
5,2,0,7,mixedType,0
5,3,0,8,mixedType,1
5,2,0,7,mixedType,0
8,4,0,12,mixedType,1
6,3,0,9,mixedType,1
5,5,0,10,mixedType,1
5,3,0,8,mixedType,1
5,4,0,9,mixedType,1
7,2,0,9,mixedType,1
4,4,0,8,mixedType,1
6,4,0,10,mixedType,1
7,3,0,10,mixedType,1
9,3,0,12,mixedType,1
9,4,0,13,mixedType,1
5,2,0,7,mixedType,0
5,2,0,7,mixedType,0
8,2,0,10,mixedType,1
5,3,0,8,mixedType,1
6,4,0,10,mixedType,1
7,3,0,10,mixedType,1
1,8,0,9,mixedType,1
13,3,0,16,mixedType,2
8,2,0,10,mixedType,1
9,1,0,10,mixedType,1
6,3,0,9,mixedType,1
6,1,0,7,mixedType,0
7,1,0,8,mixedType,1
8,3,0,11,mixedType,1
14,2,0,16,mixedType,2
4,5,0,9,mixedType,1
8,3,0,11,mixedType,1
5,3,0,8,mixedType,1
4,4,0,8,mixedType,1
4,2,0,6,mixedType,0
9,1,0,10,mixedType,1
5,3,0,8,mixedType,1
6,3,0,9,mixedType,1
7,3,0,10,mixedType,1
5,1,0,6,mixedType,0
14,2,0,16,mixedType,2
6,2,0,8,mixedType,1
8,2,0,10,mixedType,1
9,1,0,10,mixedType,1
9,4,0,13,mixedType,1
3,3,0,6,mixedType,0
8,2,0,10,mixedType,1
9,2,0,11,mixedType,1
14,2,0,16,mixedType,2
3,5,0,8,mixedType,1
7,3,0,10,mixedType,1
4,2,0,6,mixedType,0
5,2,0,7,mixedType,0
9,2,0,11,mixedType,1
6,2,0,8,mixedType,1
8,2,0,10,mixedType,1
5,3,0,8,mixedType,1
9,4,0,13,mixedType,1
7,3,0,10,mixedType,1
5,4,0,9,mixedType,1
6,4,0,10,mixedType,1
8,3,0,11,mixedType,1
8,2,0,10,mixedType,1
15,1,0,16,mixedType,2
6,3,0,9,mixedType,1
8,1,0,9,mixedType,1
5,4,0,9,mixedType,1
6,1,0,7,mixedType,0
7,3,0,10,mixedType,1
5,2,0,7,mixedType,0
5,6,0,11,mixedType,1
6,4,0,10,mixedType,1
6,3,0,9,mixedType,1
11,3,0,14,mixedType,2
3,9,0,12,mixedType,1
3,6,0,9,mixedType,1
11,0,1,12,mixedType,1
7,3,0,10,mixedType,1
9,1,0,10,mixedType,1
5,4,0,9,mixedType,1
5,2,0,7,mixedType,0
8,2,0,10,mixedType,1
8,1,0,9,mixedType,1
2,6,0,8,mixedType,1
7,3,0,10,mixedType,1
13,3,0,16,mixedType,2
4,2,0,6,mixedType,0
7,1,0,8,mixedType,1
5,2,0,7,mixedType,0
4,5,0,9,mixedType,1
7,3,0,10,mixedType,1
4,6,0,10,mixedType,1
7,4,0,11,mixedType,1
6,2,0,8,mixedType,1
7,3,0,10,mixedType,1
2,8,0,10,mixedType,1
8,1,0,9,mixedType,1
6,4,0,10,mixedType,1
5,2,0,7,mixedType,0
2,8,0,10,mixedType,1
10,4,0,14,mixedType,2
6,2,0,8,mixedType,1
9,4,0,13,mixedType,1
15,1,0,16,mixedType,2
6,2,0,8,mixedType,1
5,3,0,8,mixedType,1
8,1,0,9,mixedType,1
4,2,0,6,mixedType,0
6,3,0,9,mixedType,1
4,2,0,6,mixedType,0
6,2,0,8,mixedType,1
7,3,0,10,mixedType,1
8,1,0,9,mixedType,1
5,3,0,8,mixedType,1
9,1,0,10,mixedType,1
6,2,0,8,mixedType,1
13,3,0,16,mixedType,2
4,2,0,6,mixedType,0
4,6,0,10,mixedType,1
1,5,0,6,mixedType,0
5,4,0,9,mixedType,1
6,2,0,8,mixedType,1
13,3,0,16,mixedType,2
1,8,0,9,mixedType,1
6,1,0,7,mixedType,0
0,5,1,6,mixedType,0
7,3,0,10,mixedType,1
13,3,0,16,mixedType,2
7,4,0,11,mixedType,1
1,9,0,10,mixedType,1
3,3,0,6,mixedType,0
11,3,0,14,mixedType,2
3,6,0,9,mixedType,1
5,3,0,8,mixedType,1
14,2,0,16,mixedType,2
7,3,0,10,mixedType,1
0,7,1,8,mixedType,1
9,1,0,10,mixedType,1
12,2,1,15,mixedType,2
8,2,0,10,mixedType,1
7,3,0,10,mixedType,1
6,1,0,7,mixedType,0
4,4,0,8,mixedType,1
15,1,0,16,mixedType,2
8,2,0,10,mixedType,1
5,5,0,10,mixedType,1
3,6,0,9,mixedType,1
11,3,0,14,mixedType,2
5,7,0,12,mixedType,1
11,3,0,14,mixedType,2
3,6,0,9,mixedType,1
5,4,2,11,mixedType,1
1,5,0,6,mixedType,0
5,3,0,8,mixedType,1
7,3,0,10,mixedType,1
6,3,0,9,mixedType,1
5,4,0,9,mixedType,1
14,2,0,16,mixedType,2
6,3,0,9,mixedType,1
5,1,0,6,mixedType,0
7,4,0,11,mixedType,1
10,3,0,13,mixedType,1
6,1,0,7,mixedType,0
9,1,0,10,mixedType,1
7,2,0,9,mixedType,1
3,5,0,8,mixedType,1
3,6,0,9,mixedType,1
1,10,0,11,mixedType,1
7,3,0,10,mixedType,1
10,3,0,13,mixedType,1
5,4,0,9,mixedType,1
6,3,0,9,mixedType,1
2,7,0,9,mixedType,1
6,2,0,8,mixedType,1
8,2,0,10,mixedType,1
3,6,0,9,mixedType,1
5,2,0,7,mixedType,0
6,3,0,9,mixedType,1
15,1,0,16,mixedType,2
1,8,0,9,mixedType,1
8,2,0,10,mixedType,1
7,2,0,9,mixedType,1
13,3,0,16,mixedType,2
9,3,0,12,mixedType,1
1,7,0,8,mixedType,1
7,3,0,10,mixedType,1
7,3,0,10,mixedType,1
9,3,0,12,mixedType,1
6,3,0,9,mixedType,1
15,1,0,16,mixedType,2
7,2,0,9,mixedType,1
7,6,1,14,mixedType,2
7,3,0,10,mixedType,1
10,4,0,14,mixedType,2
4,2,0,6,mixedType,0
5,6,0,11,mixedType,1
6,2,0,8,mixedType,1
8,3,0,11,mixedType,1
5,1,0,6,mixedType,0
7,3,0,10,mixedType,1
4,9,0,13,mixedType,1
4,5,0,9,mixedType,1
2,4,0,6,mixedType,0
7,3,0,10,mixedType,1
12,3,0,15,mixedType,2
14,2,0,16,mixedType,2
13,3,0,16,mixedType,2
5,4,0,9,mixedType,1
5,4,0,9,mixedType,1
4,2,0,6,mixedType,0
9,4,0,13,mixedType,1
5,4,0,9,mixedType,1
6,3,0,9,mixedType,1
4,6,0,10,mixedType,1
5,2,0,7,mixedType,0
8,4,0,12,mixedType,1
15,1,0,16,mixedType,2
5,6,0,11,mixedType,1
4,2,0,6,mixedType,0
6,1,0,7,mixedType,0
2,6,0,8,mixedType,1
2,6,0,8,mixedType,1
6,2,0,8,mixedType,1
6,6,0,12,mixedType,1
8,3,0,11,mixedType,1
4,5,0,9,mixedType,1
7,2,0,9,mixedType,1
11,3,0,14,mixedType,2
14,2,0,16,mixedType,2
6,3,0,9,mixedType,1
7,3,0,10,mixedType,1
6,4,0,10,mixedType,1
7,2,0,9,mixedType,1
10,1,0,11,mixedType,1
10,2,0,12,mixedType,1
7,2,0,9,mixedType,1
11,1,0,12,mixedType,1
6,4,0,10,mixedType,1
9,1,0,10,mixedType,1
15,1,0,16,mixedType,2
5,4,0,9,mixedType,1
7,3,0,10,mixedType,1
6,2,0,8,mixedType,1
7,1,0,8,mixedType,1
8,1,0,9,mixedType,1
7,4,0,11,mixedType,1
7,6,0,13,mixedType,1
5,3,0,8,mixedType,1
8,4,0,12,mixedType,1
5,4,0,9,mixedType,1
7,3,0,10,mixedType,1
5,2,0,7,mixedType,0
7,1,0,8,mixedType,1
6,3,0,9,mixedType,1
5,8,0,13,mixedType,1
6,3,0,9,mixedType,1
5,4,0,9,mixedType,1
5,5,0,10,mixedType,1
7,5,0,12,mixedType,1
8,4,0,12,mixedType,1
5,3,0,8,mixedType,1
7,4,0,11,mixedType,1
2,8,0,10,mixedType,1
8,6,0,14,mixedType,2
8,1,0,9,mixedType,1
7,1,0,8,mixedType,1
8,1,0,9,mixedType,1
7,3,0,10,mixedType,1
4,2,0,6,mixedType,0
6,1,0,7,mixedType,0
2,7,0,9,mixedType,1
6,1,0,7,mixedType,0
6,0,1,7,mixedType,0
4,4,0,8,mixedType,1
6,3,0,9,mixedType,1
13,3,0,16,mixedType,2
8,2,0,10,mixedType,1
8,1,0,9,mixedType,1
8,1,0,9,mixedType,1
6,2,0,8,mixedType,1
7,4,0,11,mixedType,1
14,2,0,16,mixedType,2
7,2,0,9,mixedType,1
5,2,0,7,mixedType,0
6,2,0,8,mixedType,1
8,2,0,10,mixedType,1
4,2,0,6,mixedType,0
7,3,0,10,mixedType,1
4,4,0,8,mixedType,1
5,3,0,8,mixedType,1
1,10,0,11,mixedType,1
6,2,0,8,mixedType,1
5,2,0,7,mixedType,0
12,4,0,16,mixedType,2
8,2,0,10,mixedType,1
3,10,0,13,mixedType,1
9,1,0,10,mixedType,1
5,4,0,9,mixedType,1
7,3,0,10,mixedType,1
5,2,0,7,mixedType,0
7,2,0,9,mixedType,1
4,6,0,10,mixedType,1
14,2,0,16,mixedType,2
11,3,0,14,mixedType,2
1,9,0,10,mixedType,1
5,3,0,8,mixedType,1
7,2,0,9,mixedType,1
8,3,0,11,mixedType,1
7,3,0,10,mixedType,1
6,2,0,8,mixedType,1
7,3,0,10,mixedType,1
4,2,0,6,mixedType,0
6,7,0,13,mixedType,1
9,5,0,14,mixedType,2
5,4,0,9,mixedType,1
1,8,0,9,mixedType,1
2,9,0,11,mixedType,1
5,3,0,8,mixedType,1
2,6,0,8,mixedType,1
4,2,0,6,mixedType,0
15,1,0,16,mixedType,2
15,1,0,16,mixedType,2
8,2,0,10,mixedType,1
7,3,0,10,mixedType,1
1,8,0,9,mixedType,1
14,2,0,16,mixedType,2
6,3,0,9,mixedType,1
7,2,0,9,mixedType,1
5,2,0,7,mixedType,0
4,6,0,10,mixedType,1
6,1,0,7,mixedType,0
9,3,0,12,mixedType,1
9,4,0,13,mixedType,1
6,4,0,10,mixedType,1
9,1,0,10,mixedType,1
9,1,0,10,mixedType,1
7,1,0,8,mixedType,1
7,1,0,8,mixedType,1
12,4,0,16,mixedType,2
6,3,0,9,mixedType,1
9,1,0,10,mixedType,1
6,3,0,9,mixedType,1
3,5,0,8,mixedType,1
7,5,0,12,mixedType,1
5,2,0,7,mixedType,0
5,4,0,9,mixedType,1
6,7,1,14,mixedType,2
4,8,0,12,mixedType,1
6,4,0,10,mixedType,1
7,3,0,10,mixedType,1
6,3,0,9,mixedType,1
8,2,0,10,mixedType,1
4,2,0,6,mixedType,0
5,4,0,9,mixedType,1
13,3,0,16,mixedType,2
7,3,0,10,mixedType,1
8,2,0,10,mixedType,1
2,4,0,6,mixedType,0
5,2,0,7,mixedType,0
4,5,0,9,mixedType,1
7,3,0,10,mixedType,1
4,6,0,10,mixedType,1
5,2,0,7,mixedType,0
5,1,0,6,mixedType,0
15,1,0,16,mixedType,2
14,2,0,16,mixedType,2
3,6,0,9,mixedType,1
15,1,0,16,mixedType,2
7,3,0,10,mixedType,1
9,2,0,11,mixedType,1
4,6,0,10,mixedType,1
4,9,0,13,mixedType,1
7,1,0,8,mixedType,1
4,2,0,6,mixedType,0
7,3,0,10,mixedType,1
6,3,0,9,mixedType,1
7,2,0,9,mixedType,1
4,8,0,12,mixedType,1
7,3,0,10,mixedType,1
4,7,0,11,mixedType,1
4,4,0,8,mixedType,1
7,2,0,9,mixedType,1
15,1,0,16,mixedType,2
6,3,0,9,mixedType,1
7,2,0,9,mixedType,1
8,1,0,9,mixedType,1
5,4,0,9,mixedType,1
7,1,0,8,mixedType,1
2,8,0,10,mixedType,1
6,3,0,9,mixedType,1
7,3,0,10,mixedType,1
2,8,0,10,mixedType,1
12,4,0,16,mixedType,2
7,1,0,8,mixedType,1
7,3,0,10,mixedType,1
13,3,0,16,mixedType,2
15,1,0,16,mixedType,2
9,5,0,14,mixedType,2
8,1,0,9,mixedType,1
5,3,0,8,mixedType,1
10,1,0,11,mixedType,1
7,3,0,10,mixedType,1
5,4,0,9,mixedType,1
8,2,0,10,mixedType,1
5,1,0,6,mixedType,0
7,2,0,9,mixedType,1
6,2,0,8,mixedType,1
9,2,0,11,mixedType,1
8,2,0,10,mixedType,1
12,4,0,16,mixedType,2
2,8,0,10,mixedType,1
7,2,0,9,mixedType,1
11,3,0,14,mixedType,2
5,3,0,8,mixedType,1
7,2,0,9,mixedType,1
4,2,0,6,mixedType,0
6,3,0,9,mixedType,1
7,1,0,8,mixedType,1
3,8,0,11,mixedType,1
6,2,0,8,mixedType,1
8,1,0,9,mixedType,1
15,1,0,16,mixedType,2
5,3,0,8,mixedType,1
8,2,0,10,mixedType,1
5,4,0,9,mixedType,1
4,2,0,6,mixedType,0
6,3,0,9,mixedType,1
15,1,0,16,mixedType,2
5,1,0,6,mixedType,0
7,3,0,10,mixedType,1
5,4,0,9,mixedType,1
14,2,0,16,mixedType,2
6,4,0,10,mixedType,1
6,4,0,10,mixedType,1
4,2,0,6,mixedType,0
5,3,0,8,mixedType,1
7,2,0,9,mixedType,1
10,1,0,11,mixedType,1
6,2,0,8,mixedType,1
1,5,0,6,mixedType,0
11,1,0,12,mixedType,1
9,4,0,13,mixedType,1
6,2,0,8,mixedType,1
6,3,0,9,mixedType,1
12,3,0,15,mixedType,2
5,3,0,8,mixedType,1
4,4,0,8,mixedType,1
7,2,0,9,mixedType,1
5,3,0,8,mixedType,1
12,1,0,13,mixedType,1
7,2,0,9,mixedType,1
14,2,0,16,mixedType,2
4,4,0,8,mixedType,1
15,1,0,16,mixedType,2
1,8,0,9,mixedType,1
7,3,0,10,mixedType,1
7,3,0,10,mixedType,1
3,5,0,8,mixedType,1
12,4,0,16,mixedType,2
8,2,0,10,mixedType,1
4,4,0,8,mixedType,1
5,4,0,9,mixedType,1
13,3,0,16,mixedType,2
8,3,0,11,mixedType,1
5,3,0,8,mixedType,1
13,3,0,16,mixedType,2
3,6,0,9,mixedType,1
6,3,0,9,mixedType,1
7,2,0,9,mixedType,1
5,2,0,7,mixedType,0
6,2,0,8,mixedType,1
9,3,0,12,mixedType,1
6,5,0,11,mixedType,1
6,4,0,10,mixedType,1
5,1,0,6,mixedType,0
2,7,0,9,mixedType,1
9,4,0,13,mixedType,1
7,2,0,9,mixedType,1
8,4,0,12,mixedType,1
5,3,0,8,mixedType,1
3,7,0,10,mixedType,1
8,2,0,10,mixedType,1
9,3,0,12,mixedType,1
8,1,0,9,mixedType,1
4,4,0,8,mixedType,1
7,3,0,10,mixedType,1
7,3,0,10,mixedType,1
6,4,0,10,mixedType,1
6,2,0,8,mixedType,1
8,3,0,11,mixedType,1
6,2,0,8,mixedType,1
10,2,0,12,mixedType,1
4,4,0,8,mixedType,1
6,2,0,8,mixedType,1
8,1,0,9,mixedType,1
15,1,0,16,mixedType,2
3,6,0,9,mixedType,1
6,2,0,8,mixedType,1
7,3,0,10,mixedType,1
8,1,0,9,mixedType,1
6,3,0,9,mixedType,1
12,3,0,15,mixedType,2
7,2,0,9,mixedType,1
1,7,0,8,mixedType,1
14,2,0,16,mixedType,2
6,2,0,8,mixedType,1
8,1,0,9,mixedType,1
14,2,0,16,mixedType,2
5,2,0,7,mixedType,0
7,3,0,10,mixedType,1
6,3,0,9,mixedType,1
5,6,0,11,mixedType,1
7,3,0,10,mixedType,1
7,4,0,11,mixedType,1
6,3,0,9,mixedType,1
6,4,0,10,mixedType,1
9,1,0,10,mixedType,1
5,4,0,9,mixedType,1
5,2,0,7,mixedType,0
5,2,0,7,mixedType,0
8,4,0,12,mixedType,1
7,2,0,9,mixedType,1
5,2,0,7,mixedType,0
10,1,0,11,mixedType,1
7,3,0,10,mixedType,1
5,2,0,7,mixedType,0
7,2,0,9,mixedType,1
5,4,0,9,mixedType,1
7,1,0,8,mixedType,1
3,6,0,9,mixedType,1
7,1,0,8,mixedType,1
9,3,0,12,mixedType,1
5,1,0,6,mixedType,0
7,3,0,10,mixedType,1
8,3,0,11,mixedType,1
6,3,0,9,mixedType,1
14,2,0,16,mixedType,2
8,2,0,10,mixedType,1
8,1,0,9,mixedType,1
7,2,0,9,mixedType,1
6,4,0,10,mixedType,1
4,2,0,6,mixedType,0
6,2,0,8,mixedType,1
8,2,0,10,mixedType,1
12,3,0,15,mixedType,2
7,3,0,10,mixedType,1
3,6,0,9,mixedType,1
14,2,0,16,mixedType,2
14,2,0,16,mixedType,2
6,1,0,7,mixedType,0
2,8,0,10,mixedType,1
8,1,0,9,mixedType,1
1,10,0,11,mixedType,1
6,2,0,8,mixedType,1
5,1,0,6,mixedType,0
5,3,0,8,mixedType,1
3,6,0,9,mixedType,1
5,2,0,7,mixedType,0
13,2,0,15,mixedType,2
4,4,0,8,mixedType,1
7,3,0,10,mixedType,1
13,3,0,16,mixedType,2
10,2,0,12,mixedType,1
7,2,0,9,mixedType,1
6,1,0,7,mixedType,0
5,4,0,9,mixedType,1
8,1,0,9,mixedType,1
6,3,0,9,mixedType,1
9,6,0,15,mixedType,2
6,2,0,8,mixedType,1
8,1,0,9,mixedType,1
17,1,1,19,mixedType,2
7,4,0,11,mixedType,1
7,2,0,9,mixedType,1
4,2,0,6,mixedType,0
15,1,0,16,mixedType,2
3,3,0,6,mixedType,0
8,2,0,10,mixedType,1
14,2,0,16,mixedType,2
8,1,0,9,mixedType,1
6,2,0,8,mixedType,1
7,1,0,8,mixedType,1
7,2,0,9,mixedType,1
11,1,0,12,mixedType,1
6,3,0,9,mixedType,1
13,3,0,16,mixedType,2
5,4,0,9,mixedType,1
15,1,0,16,mixedType,2
7,4,0,11,mixedType,1
5,3,0,8,mixedType,1
7,3,0,10,mixedType,1
8,1,0,9,mixedType,1
7,1,0,8,mixedType,1
6,3,0,9,mixedType,1
6,4,0,10,mixedType,1
6,3,0,9,mixedType,1
3,6,0,9,mixedType,1
5,4,0,9,mixedType,1
6,4,0,10,mixedType,1
7,6,0,13,mixedType,1
7,3,0,10,mixedType,1
7,2,0,9,mixedType,1
7,3,0,10,mixedType,1
8,2,0,10,mixedType,1
1,9,0,10,mixedType,1
6,3,0,9,mixedType,1
6,2,0,8,mixedType,1
8,4,0,12,mixedType,1
4,2,0,6,mixedType,0
5,4,0,9,mixedType,1
4,4,0,8,mixedType,1
5,1,0,6,mixedType,0
5,3,0,8,mixedType,1
6,5,0,11,mixedType,1
9,3,0,12,mixedType,1
6,3,0,9,mixedType,1
6,3,0,9,mixedType,1
12,4,0,16,mixedType,2
10,0,1,11,mixedType,1
8,2,0,10,mixedType,1
6,3,0,9,mixedType,1
12,3,0,15,mixedType,2
6,2,0,8,mixedType,1
7,3,0,10,mixedType,1
7,3,0,10,mixedType,1
8,2,0,10,mixedType,1
4,4,0,8,mixedType,1
7,3,0,10,mixedType,1
4,2,0,6,mixedType,0
6,4,0,10,mixedType,1
6,1,0,7,mixedType,0
7,1,0,8,mixedType,1
8,2,0,10,mixedType,1
8,2,0,10,mixedType,1
8,4,0,12,mixedType,1
7,2,0,9,mixedType,1
7,2,0,9,mixedType,1
6,1,0,7,mixedType,0
6,1,0,7,mixedType,0
5,3,0,8,mixedType,1
4,6,0,10,mixedType,1
7,3,0,10,mixedType,1
2,6,0,8,mixedType,1
6,4,0,10,mixedType,1
15,1,0,16,mixedType,2
2,9,0,11,mixedType,1
9,1,0,10,mixedType,1
5,2,0,7,mixedType,0
9,1,0,10,mixedType,1
6,1,0,7,mixedType,0
6,4,0,10,mixedType,1
2,6,0,8,mixedType,1
18,4,0,22,mixedType,2
5,3,0,8,mixedType,1
6,1,0,7,mixedType,0
5,4,0,9,mixedType,1
12,1,0,13,mixedType,1
13,3,0,16,mixedType,2
6,3,0,9,mixedType,1
5,3,0,8,mixedType,1
4,2,0,6,mixedType,0
6,3,0,9,mixedType,1
3,8,0,11,mixedType,1
8,1,0,9,mixedType,1
12,1,0,13,mixedType,1
7,2,0,9,mixedType,1
14,2,0,16,mixedType,2
13,3,0,16,mixedType,2
6,1,0,7,mixedType,0
2,8,0,10,mixedType,1
11,5,0,16,mixedType,2
7,4,0,11,mixedType,1
5,7,0,12,mixedType,1
3,3,0,6,mixedType,0
2,6,0,8,mixedType,1
8,3,0,11,mixedType,1
12,3,0,15,mixedType,2
5,3,0,8,mixedType,1
5,1,0,6,mixedType,0
3,6,0,9,mixedType,1
7,2,0,9,mixedType,1
2,6,0,8,mixedType,1
6,3,0,9,mixedType,1
7,2,0,9,mixedType,1
5,4,0,9,mixedType,1
6,3,0,9,mixedType,1
3,7,0,10,mixedType,1
6,1,0,7,mixedType,0
1,8,0,9,mixedType,1
9,1,0,10,mixedType,1
7,3,0,10,mixedType,1
6,4,0,10,mixedType,1
5,4,0,9,mixedType,1
7,6,0,13,mixedType,1
8,4,0,12,mixedType,1
4,2,0,6,mixedType,0
4,6,0,10,mixedType,1
1,9,0,10,mixedType,1
7,2,0,9,mixedType,1
6,4,0,10,mixedType,1
3,5,0,8,mixedType,1
7,5,0,12,mixedType,1
6,3,0,9,mixedType,1
5,2,0,7,mixedType,0
8,2,0,10,mixedType,1
12,4,0,16,mixedType,2
6,2,0,8,mixedType,1
2,7,0,9,mixedType,1
5,2,0,7,mixedType,0
5,3,0,8,mixedType,1
8,2,0,10,mixedType,1
8,1,0,9,mixedType,1
12,3,0,15,mixedType,2
4,4,0,8,mixedType,1
9,2,0,11,mixedType,1
5,3,0,8,mixedType,1
2,9,0,11,mixedType,1
7,2,0,9,mixedType,1
14,2,0,16,mixedType,2
4,2,0,6,mixedType,0
6,1,0,7,mixedType,0
5,3,0,8,mixedType,1
8,2,0,10,mixedType,1
13,3,0,16,mixedType,2
1,8,0,9,mixedType,1
4,5,0,9,mixedType,1
14,2,0,16,mixedType,2
14,2,0,16,mixedType,2
1,7,0,8,mixedType,1
6,2,0,8,mixedType,1
4,4,0,8,mixedType,1
14,2,0,16,mixedType,2
5,4,0,9,mixedType,1
14,2,0,16,mixedType,2
10,3,0,13,mixedType,1
4,5,0,9,mixedType,1
2,9,0,11,mixedType,1
4,7,0,11,mixedType,1
8,2,0,10,mixedType,1
6,4,0,10,mixedType,1
7,2,0,9,mixedType,1
7,4,0,11,mixedType,1
9,2,0,11,mixedType,1
11,5,0,16,mixedType,2
5,3,0,8,mixedType,1
7,3,0,10,mixedType,1
8,3,0,11,mixedType,1
6,4,0,10,mixedType,1
1,7,0,8,mixedType,1
7,3,0,10,mixedType,1
7,4,0,11,mixedType,1
2,6,0,8,mixedType,1
7,3,0,10,mixedType,1
8,3,0,11,mixedType,1
5,2,0,7,mixedType,0
6,3,0,9,mixedType,1
6,2,0,8,mixedType,1
7,1,0,8,mixedType,1
14,2,0,16,mixedType,2
8,2,0,10,mixedType,1
6,2,0,8,mixedType,1
5,2,0,7,mixedType,0
6,4,0,10,mixedType,1
7,2,0,9,mixedType,1
2,8,0,10,mixedType,1
4,6,0,10,mixedType,1
4,2,0,6,mixedType,0
5,4,0,9,mixedType,1
5,3,0,8,mixedType,1
7,0,1,8,mixedType,1
6,4,0,10,mixedType,1
6,3,0,9,mixedType,1
5,4,0,9,mixedType,1
7,2,0,9,mixedType,1
3,9,0,12,mixedType,1
2,9,0,11,mixedType,1
7,1,0,8,mixedType,1
5,3,0,8,mixedType,1
8,2,0,10,mixedType,1
13,3,0,16,mixedType,2
6,3,0,9,mixedType,1
6,3,0,9,mixedType,1
10,6,0,16,mixedType,2
5,4,0,9,mixedType,1
10,2,0,12,mixedType,1
7,3,0,10,mixedType,1
4,2,0,6,mixedType,0
7,1,0,8,mixedType,1
7,3,0,10,mixedType,1
6,6,0,12,mixedType,1
5,3,0,8,mixedType,1
14,2,0,16,mixedType,2
6,4,0,10,mixedType,1
3,6,0,9,mixedType,1
6,2,0,8,mixedType,1
3,6,0,9,mixedType,1
5,4,0,9,mixedType,1
6,2,0,8,mixedType,1
8,2,0,10,mixedType,1
10,2,0,12,mixedType,1
7,3,0,10,mixedType,1
5,4,0,9,mixedType,1
5,4,0,9,mixedType,1
12,3,0,15,mixedType,2
5,3,0,8,mixedType,1
6,3,0,9,mixedType,1
9,1,0,10,mixedType,1
5,4,0,9,mixedType,1
8,2,0,10,mixedType,1
8,2,0,10,mixedType,1
5,2,0,7,mixedType,0
7,3,0,10,mixedType,1
1,10,0,11,mixedType,1
15,1,1,17,mixedType,2
2,6,0,8,mixedType,1
7,3,0,10,mixedType,1
6,4,0,10,mixedType,1
18,2,1,21,mixedType,2
8,2,0,10,mixedType,1
7,2,0,9,mixedType,1
10,1,0,11,mixedType,1
5,4,0,9,mixedType,1
5,2,0,7,mixedType,0
8,1,0,9,mixedType,1
4,4,0,8,mixedType,1
6,2,0,8,mixedType,1
7,3,0,10,mixedType,1
7,3,0,10,mixedType,1
6,2,0,8,mixedType,1
11,1,0,12,mixedType,1
5,2,0,7,mixedType,0
5,1,0,6,mixedType,0
11,1,0,12,mixedType,1
7,4,0,11,mixedType,1
6,2,0,8,mixedType,1
6,6,0,12,mixedType,1
6,1,0,7,mixedType,0
3,6,0,9,mixedType,1
4,6,0,10,mixedType,1
8,3,0,11,mixedType,1
8,2,0,10,mixedType,1
4,2,0,6,mixedType,0
6,1,0,7,mixedType,0
4,6,0,10,mixedType,1
13,3,0,16,mixedType,2
6,2,0,8,mixedType,1
6,1,0,7,mixedType,0
11,3,2,16,mixedType,2
7,3,0,10,mixedType,1
12,1,0,13,mixedType,1
4,4,0,8,mixedType,1
7,1,0,8,mixedType,1
8,4,0,12,mixedType,1
9,1,0,10,mixedType,1
14,2,0,16,mixedType,2
8,2,0,10,mixedType,1
10,4,0,14,mixedType,2
0,8,0,8,sameType,1
4,10,1,15,mixedType,2
1,9,0,10,mixedType,1
6,1,0,7,mixedType,0
6,1,0,7,mixedType,0
15,1,0,16,mixedType,2
13,3,0,16,mixedType,2
5,2,0,7,mixedType,0
4,4,0,8,mixedType,1
13,3,0,16,mixedType,2
11,2,0,13,mixedType,1
5,2,0,7,mixedType,0
5,5,0,10,mixedType,1
6,1,0,7,mixedType,0
8,5,0,13,mixedType,1
5,3,0,8,mixedType,1
3,6,0,9,mixedType,1
5,4,0,9,mixedType,1
1,10,0,11,mixedType,1
6,4,0,10,mixedType,1
5,6,0,11,mixedType,1
10,2,0,12,mixedType,1
6,1,0,7,mixedType,0
6,4,0,10,mixedType,1
4,2,0,6,mixedType,0
6,3,0,9,mixedType,1
7,1,0,8,mixedType,1
6,4,0,10,mixedType,1
5,3,0,8,mixedType,1
14,2,0,16,mixedType,2
2,8,0,10,mixedType,1
13,3,0,16,mixedType,2
7,3,0,10,mixedType,1
6,2,0,8,mixedType,1
4,2,0,6,mixedType,0
8,2,0,10,mixedType,1
5,1,0,6,mixedType,0
12,3,0,15,mixedType,2
14,2,0,16,mixedType,2
6,4,0,10,mixedType,1
5,2,0,7,mixedType,0
8,8,0,16,mixedType,2
9,3,0,12,mixedType,1
6,3,0,9,mixedType,1
5,5,0,10,mixedType,1
6,2,0,8,mixedType,1
7,1,0,8,mixedType,1
10,1,0,11,mixedType,1
2,6,0,8,mixedType,1
6,2,0,8,mixedType,1
5,2,0,7,mixedType,0
9,1,0,10,mixedType,1
9,6,1,16,mixedType,2
5,4,0,9,mixedType,1
7,2,0,9,mixedType,1
8,1,0,9,mixedType,1
12,4,0,16,mixedType,2
1,9,0,10,mixedType,1
5,3,0,8,mixedType,1
4,4,0,8,mixedType,1
10,3,0,13,mixedType,1
6,0,1,7,mixedType,0
4,4,0,8,mixedType,1
7,3,0,10,mixedType,1
6,3,0,9,mixedType,1
5,4,0,9,mixedType,1
4,5,0,9,mixedType,1
13,3,0,16,mixedType,2
8,2,0,10,mixedType,1
5,1,0,6,mixedType,0
10,2,0,12,mixedType,1
6,3,0,9,mixedType,1
6,2,0,8,mixedType,1
13,3,0,16,mixedType,2
6,1,0,7,mixedType,0
6,4,0,10,mixedType,1
5,4,0,9,mixedType,1
6,2,0,8,mixedType,1
6,3,0,9,mixedType,1
6,2,0,8,mixedType,1
6,4,0,10,mixedType,1
6,1,0,7,mixedType,0
8,1,0,9,mixedType,1
8,3,0,11,mixedType,1
2,6,0,8,mixedType,1
5,2,0,7,mixedType,0
9,3,0,12,mixedType,1
7,4,0,11,mixedType,1
5,1,0,6,mixedType,0
8,3,0,11,mixedType,1
8,1,0,9,mixedType,1
5,2,0,7,mixedType,0
9,2,0,11,mixedType,1
4,8,0,12,mixedType,1
10,4,0,14,mixedType,2
5,4,0,9,mixedType,1
6,3,0,9,mixedType,1
7,3,0,10,mixedType,1
13,3,0,16,mixedType,2
5,2,0,7,mixedType,0
4,4,0,8,mixedType,1
9,1,0,10,mixedType,1
5,4,0,9,mixedType,1
4,4,0,8,mixedType,1
6,2,0,8,mixedType,1
6,2,0,8,mixedType,1
5,7,0,12,mixedType,1
8,1,0,9,mixedType,1
6,2,0,8,mixedType,1
8,2,0,10,mixedType,1
8,1,0,9,mixedType,1
9,4,0,13,mixedType,1
5,4,0,9,mixedType,1
12,1,0,13,mixedType,1
9,1,0,10,mixedType,1
6,4,0,10,mixedType,1
6,4,0,10,mixedType,1
3,8,0,11,mixedType,1
7,2,0,9,mixedType,1
8,1,0,9,mixedType,1
12,1,0,13,mixedType,1
7,2,0,9,mixedType,1
1,8,0,9,mixedType,1
1,8,0,9,mixedType,1
6,4,0,10,mixedType,1
13,3,0,16,mixedType,2
7,4,0,11,mixedType,1
8,1,0,9,mixedType,1
9,3,0,12,mixedType,1
11,2,0,13,mixedType,1
5,6,0,11,mixedType,1
3,6,0,9,mixedType,1
8,2,0,10,mixedType,1
8,2,0,10,mixedType,1
7,2,0,9,mixedType,1
4,2,0,6,mixedType,0
9,1,0,10,mixedType,1
4,4,0,8,mixedType,1
6,3,0,9,mixedType,1
4,6,0,10,mixedType,1
9,1,0,10,mixedType,1
4,4,0,8,mixedType,1
13,3,0,16,mixedType,2
6,2,0,8,mixedType,1
8,4,0,12,mixedType,1
0,8,0,8,sameType,1
5,3,0,8,mixedType,1
8,1,0,9,mixedType,1
2,7,0,9,mixedType,1
5,2,0,7,mixedType,0
6,1,0,7,mixedType,0
8,2,0,10,mixedType,1
5,3,0,8,mixedType,1
8,1,0,9,mixedType,1
6,8,0,14,mixedType,2
6,3,0,9,mixedType,1
4,4,0,8,mixedType,1
4,4,0,8,mixedType,1
8,1,0,9,mixedType,1
8,1,0,9,mixedType,1
3,6,0,9,mixedType,1
5,3,0,8,mixedType,1
6,3,0,9,mixedType,1
7,1,0,8,mixedType,1
9,3,0,12,mixedType,1
4,4,0,8,mixedType,1
5,6,0,11,mixedType,1
2,8,0,10,mixedType,1
7,3,0,10,mixedType,1
8,3,0,11,mixedType,1
7,2,0,9,mixedType,1
6,2,0,8,mixedType,1
6,2,0,8,mixedType,1
12,3,0,15,mixedType,2
6,2,0,8,mixedType,1
2,8,0,10,mixedType,1
6,3,0,9,mixedType,1
13,3,0,16,mixedType,2
9,1,0,10,mixedType,1
11,5,0,16,mixedType,2
13,3,0,16,mixedType,2
8,1,0,9,mixedType,1
5,4,0,9,mixedType,1
12,1,0,13,mixedType,1
3,10,0,13,mixedType,1
7,1,0,8,mixedType,1
4,2,0,6,mixedType,0
3,6,0,9,mixedType,1
13,3,0,16,mixedType,2
7,1,0,8,mixedType,1
6,4,0,10,mixedType,1
5,6,0,11,mixedType,1
7,4,0,11,mixedType,1
4,4,0,8,mixedType,1
10,4,0,14,mixedType,2
4,4,0,8,mixedType,1
7,1,0,8,mixedType,1
7,2,0,9,mixedType,1
14,2,0,16,mixedType,2
5,3,0,8,mixedType,1
7,3,0,10,mixedType,1
2,12,2,16,mixedType,2
7,3,0,10,mixedType,1
13,3,0,16,mixedType,2
6,2,0,8,mixedType,1
12,3,0,15,mixedType,2
2,8,0,10,mixedType,1
1,8,0,9,mixedType,1
5,3,0,8,mixedType,1
6,5,0,11,mixedType,1
10,1,0,11,mixedType,1
7,3,0,10,mixedType,1
4,6,0,10,mixedType,1
8,4,0,12,mixedType,1
1,10,0,11,mixedType,1
7,1,0,8,mixedType,1
9,1,0,10,mixedType,1
1,8,0,9,mixedType,1
5,3,0,8,mixedType,1
6,2,0,8,mixedType,1
6,3,0,9,mixedType,1
7,1,0,8,mixedType,1
1,9,0,10,mixedType,1
7,3,0,10,mixedType,1
8,2,0,10,mixedType,1
5,2,0,7,mixedType,0
10,1,0,11,mixedType,1
12,4,0,16,mixedType,2
4,4,0,8,mixedType,1
6,4,0,10,mixedType,1
0,6,1,7,mixedType,0
7,3,0,10,mixedType,1
6,2,0,8,mixedType,1
5,4,0,9,mixedType,1
7,3,0,10,mixedType,1
14,2,0,16,mixedType,2
15,1,0,16,mixedType,2
14,2,0,16,mixedType,2
6,2,0,8,mixedType,1
7,2,0,9,mixedType,1
11,3,0,14,mixedType,2
7,3,0,10,mixedType,1
3,8,0,11,mixedType,1
5,3,0,8,mixedType,1
4,4,0,8,mixedType,1
3,8,0,11,mixedType,1
13,3,0,16,mixedType,2
14,2,0,16,mixedType,2
5,2,0,7,mixedType,0
2,4,0,6,mixedType,0
5,5,0,10,mixedType,1
6,3,0,9,mixedType,1
7,3,0,10,mixedType,1
5,3,0,8,mixedType,1
7,4,0,11,mixedType,1
13,3,0,16,mixedType,2
15,1,0,16,mixedType,2
6,2,0,8,mixedType,1
6,1,0,7,mixedType,0
3,6,0,9,mixedType,1
8,2,0,10,mixedType,1
7,2,0,9,mixedType,1
7,2,0,9,mixedType,1
7,4,0,11,mixedType,1
15,1,0,16,mixedType,2
1,7,0,8,mixedType,1
6,2,0,8,mixedType,1
10,1,0,11,mixedType,1
8,6,0,14,mixedType,2
7,3,0,10,mixedType,1
4,6,0,10,mixedType,1
8,4,0,12,mixedType,1
5,2,0,7,mixedType,0
5,2,0,7,mixedType,0
7,3,0,10,mixedType,1
8,1,0,9,mixedType,1
14,2,0,16,mixedType,2
7,3,0,10,mixedType,1
1,8,0,9,mixedType,1
11,3,0,14,mixedType,2
7,4,0,11,mixedType,1
8,4,0,12,mixedType,1
8,1,0,9,mixedType,1
6,3,0,9,mixedType,1
3,5,0,8,mixedType,1
6,1,0,7,mixedType,0
5,2,0,7,mixedType,0
7,3,0,10,mixedType,1
11,5,0,16,mixedType,2
8,2,0,10,mixedType,1
10,3,0,13,mixedType,1
5,4,0,9,mixedType,1
6,1,0,7,mixedType,0
3,6,0,9,mixedType,1
5,3,0,8,mixedType,1
8,2,0,10,mixedType,1
12,1,0,13,mixedType,1
5,3,0,8,mixedType,1
8,4,0,12,mixedType,1
5,6,0,11,mixedType,1
5,2,0,7,mixedType,0
6,3,0,9,mixedType,1
1,9,0,10,mixedType,1
7,6,0,13,mixedType,1
1,8,0,9,mixedType,1
14,2,0,16,mixedType,2
6,1,0,7,mixedType,0
8,1,0,9,mixedType,1
8,1,0,9,mixedType,1
5,2,0,7,mixedType,0
8,2,0,10,mixedType,1
9,3,0,12,mixedType,1
3,3,0,6,mixedType,0
6,3,0,9,mixedType,1
11,1,0,12,mixedType,1
8,2,0,10,mixedType,1
4,2,0,6,mixedType,0
7,4,0,11,mixedType,1
4,2,0,6,mixedType,0
5,6,0,11,mixedType,1
5,3,0,8,mixedType,1
15,1,0,16,mixedType,2
4,6,0,10,mixedType,1
14,2,0,16,mixedType,2
11,1,0,12,mixedType,1
8,1,0,9,mixedType,1
8,1,0,9,mixedType,1
6,3,0,9,mixedType,1
5,5,0,10,mixedType,1
1,9,0,10,mixedType,1
3,8,0,11,mixedType,1
9,4,0,13,mixedType,1
8,4,0,12,mixedType,1
5,0,0,5,sameType,0
5,4,0,9,mixedType,1
8,3,0,11,mixedType,1
10,3,0,13,mixedType,1
9,2,0,11,mixedType,1
11,3,0,14,mixedType,2
5,2,0,7,mixedType,0
5,1,0,6,mixedType,0
6,2,0,8,mixedType,1
4,2,0,6,mixedType,0
6,1,0,7,mixedType,0
9,3,0,12,mixedType,1
5,3,0,8,mixedType,1
7,3,0,10,mixedType,1
9,3,0,12,mixedType,1
6,1,0,7,mixedType,0
8,3,0,11,mixedType,1
17,3,0,20,mixedType,2
8,1,0,9,mixedType,1
7,2,0,9,mixedType,1
7,2,0,9,mixedType,1
7,2,0,9,mixedType,1
5,3,0,8,mixedType,1
13,3,0,16,mixedType,2
14,2,0,16,mixedType,2
4,2,0,6,mixedType,0
4,4,0,8,mixedType,1
6,3,0,9,mixedType,1
6,3,0,9,mixedType,1
8,3,0,11,mixedType,1
6,3,0,9,mixedType,1
9,4,0,13,mixedType,1
5,2,0,7,mixedType,0
2,6,0,8,mixedType,1
7,3,0,10,mixedType,1
4,4,0,8,mixedType,1
10,2,0,12,mixedType,1
7,1,0,8,mixedType,1
5,5,0,10,mixedType,1
7,2,0,9,mixedType,1
10,4,0,14,mixedType,2
14,2,0,16,mixedType,2
9,3,0,12,mixedType,1
5,2,0,7,mixedType,0
6,1,0,7,mixedType,0
7,2,0,9,mixedType,1
6,2,0,8,mixedType,1
9,2,0,11,mixedType,1
7,2,0,9,mixedType,1
8,2,0,10,mixedType,1
12,4,0,16,mixedType,2
6,7,0,13,mixedType,1
10,1,0,11,mixedType,1
6,1,0,7,mixedType,0
6,1,0,7,mixedType,0
4,5,0,9,mixedType,1
6,4,0,10,mixedType,1
7,3,0,10,mixedType,1
5,4,0,9,mixedType,1
8,2,0,10,mixedType,1
5,2,0,7,mixedType,0
3,5,0,8,mixedType,1
4,5,0,9,mixedType,1
6,1,0,7,mixedType,0
6,3,0,9,mixedType,1
3,10,0,13,mixedType,1
8,0,1,9,mixedType,1
6,2,0,8,mixedType,1
3,6,0,9,mixedType,1
4,2,0,6,mixedType,0
1,9,0,10,mixedType,1
6,0,1,7,mixedType,0
14,2,0,16,mixedType,2
5,2,0,7,mixedType,0
6,3,0,9,mixedType,1
8,2,0,10,mixedType,1
2,4,0,6,mixedType,0
7,3,0,10,mixedType,1
6,3,0,9,mixedType,1
7,4,0,11,mixedType,1
8,2,0,10,mixedType,1
4,2,0,6,mixedType,0
6,4,0,10,mixedType,1
4,6,0,10,mixedType,1
6,2,0,8,mixedType,1
7,2,0,9,mixedType,1
9,0,2,11,mixedType,1
7,2,0,9,mixedType,1
5,3,0,8,mixedType,1
5,1,0,6,mixedType,0
7,3,0,10,mixedType,1
1,8,0,9,mixedType,1
3,5,0,8,mixedType,1
9,1,0,10,mixedType,1
7,1,0,8,mixedType,1
3,3,0,6,mixedType,0
6,1,0,7,mixedType,0
14,2,0,16,mixedType,2
15,1,0,16,mixedType,2
6,3,0,9,mixedType,1
1,8,0,9,mixedType,1
8,2,0,10,mixedType,1
2,6,0,8,mixedType,1
12,3,0,15,mixedType,2
5,3,0,8,mixedType,1
8,3,0,11,mixedType,1
7,2,0,9,mixedType,1
8,2,0,10,mixedType,1
7,5,0,12,mixedType,1
7,3,0,10,mixedType,1
4,4,0,8,mixedType,1
7,2,0,9,mixedType,1
12,4,0,16,mixedType,2
5,2,0,7,mixedType,0
6,1,0,7,mixedType,0
6,1,0,7,mixedType,0
6,3,0,9,mixedType,1
14,2,0,16,mixedType,2
5,2,0,7,mixedType,0
7,2,0,9,mixedType,1
10,6,0,16,mixedType,2
6,3,0,9,mixedType,1
14,2,0,16,mixedType,2
7,2,0,9,mixedType,1
10,4,0,14,mixedType,2
9,2,0,11,mixedType,1
6,3,0,9,mixedType,1
4,6,0,10,mixedType,1
4,2,0,6,mixedType,0
12,4,0,16,mixedType,2
8,4,0,12,mixedType,1
2,6,0,8,mixedType,1
7,1,0,8,mixedType,1
1,7,0,8,mixedType,1
5,3,0,8,mixedType,1
8,2,0,10,mixedType,1
8,1,0,9,mixedType,1
13,3,0,16,mixedType,2
7,1,0,8,mixedType,1
5,3,0,8,mixedType,1
0,7,1,8,mixedType,1
12,1,0,13,mixedType,1
8,2,0,10,mixedType,1
10,5,1,16,mixedType,2
10,2,0,12,mixedType,1
5,2,0,7,mixedType,0
5,3,0,8,mixedType,1
6,2,0,8,mixedType,1
8,2,0,10,mixedType,1
6,4,0,10,mixedType,1
9,1,0,10,mixedType,1
7,2,0,9,mixedType,1
7,1,0,8,mixedType,1
8,2,0,10,mixedType,1
8,1,0,9,mixedType,1
4,4,0,8,mixedType,1
9,1,0,10,mixedType,1
1,8,0,9,mixedType,1
7,3,0,10,mixedType,1
4,2,0,6,mixedType,0
5,2,0,7,mixedType,0
4,8,0,12,mixedType,1
6,2,0,8,mixedType,1
9,3,0,12,mixedType,1
9,3,0,12,mixedType,1
12,3,0,15,mixedType,2
8,3,0,11,mixedType,1
6,1,0,7,mixedType,0
6,3,0,9,mixedType,1
7,2,4,13,mixedType,1
8,2,0,10,mixedType,1
7,3,0,10,mixedType,1
5,4,0,9,mixedType,1
5,3,0,8,mixedType,1
7,3,0,10,mixedType,1
5,3,0,8,mixedType,1
5,3,0,8,mixedType,1
7,2,0,9,mixedType,1
1,9,0,10,mixedType,1
8,1,0,9,mixedType,1
4,4,0,8,mixedType,1
7,2,0,9,mixedType,1
9,3,0,12,mixedType,1
7,2,0,9,mixedType,1
6,1,0,7,mixedType,0
5,4,0,9,mixedType,1
12,4,0,16,mixedType,2
6,3,0,9,mixedType,1
3,7,0,10,mixedType,1
8,3,0,11,mixedType,1
6,4,0,10,mixedType,1
5,3,0,8,mixedType,1
4,4,0,8,mixedType,1
6,4,0,10,mixedType,1
3,3,0,6,mixedType,0
5,3,0,8,mixedType,1
7,1,0,8,mixedType,1
6,3,0,9,mixedType,1
2,8,0,10,mixedType,1
10,4,0,14,mixedType,2
14,2,0,16,mixedType,2
6,2,0,8,mixedType,1
5,2,0,7,mixedType,0
5,7,0,12,mixedType,1
14,2,0,16,mixedType,2
3,7,0,10,mixedType,1
5,3,0,8,mixedType,1
2,6,0,8,mixedType,1
5,4,0,9,mixedType,1
3,7,0,10,mixedType,1
3,6,0,9,mixedType,1
6,3,0,9,mixedType,1
5,4,0,9,mixedType,1
6,3,0,9,mixedType,1
7,3,0,10,mixedType,1
5,3,0,8,mixedType,1
6,2,0,8,mixedType,1
11,5,0,16,mixedType,2
6,4,0,10,mixedType,1
5,3,0,8,mixedType,1
10,3,0,13,mixedType,1
7,2,0,9,mixedType,1
14,2,0,16,mixedType,2
5,3,0,8,mixedType,1
5,4,0,9,mixedType,1
10,1,0,11,mixedType,1
5,1,0,6,mixedType,0
6,3,0,9,mixedType,1
4,4,0,8,mixedType,1
5,2,0,7,mixedType,0
4,5,0,9,mixedType,1
4,2,0,6,mixedType,0
2,10,0,12,mixedType,1
0,6,0,6,sameType,0
8,4,0,12,mixedType,1
7,4,0,11,mixedType,1
5,7,0,12,mixedType,1
2,8,0,10,mixedType,1
8,4,0,12,mixedType,1
2,4,0,6,mixedType,0
6,4,0,10,mixedType,1
15,1,0,16,mixedType,2
6,3,0,9,mixedType,1
5,4,0,9,mixedType,1
6,3,0,9,mixedType,1
7,3,0,10,mixedType,1
5,3,0,8,mixedType,1
8,2,0,10,mixedType,1
5,3,0,8,mixedType,1
5,4,0,9,mixedType,1
7,3,0,10,mixedType,1
13,3,0,16,mixedType,2
6,3,0,9,mixedType,1
9,2,0,11,mixedType,1
15,1,0,16,mixedType,2
4,4,0,8,mixedType,1
3,7,0,10,mixedType,1
8,2,0,10,mixedType,1
6,2,0,8,mixedType,1
7,2,0,9,mixedType,1
5,8,0,13,mixedType,1
9,2,0,11,mixedType,1
3,8,0,11,mixedType,1
5,3,0,8,mixedType,1
7,2,0,9,mixedType,1
6,1,0,7,mixedType,0
8,1,0,9,mixedType,1
8,3,0,11,mixedType,1
15,1,0,16,mixedType,2
9,2,0,11,mixedType,1
5,3,0,8,mixedType,1
4,4,0,8,mixedType,1
5,1,0,6,mixedType,0
4,4,0,8,mixedType,1
1,7,0,8,mixedType,1
5,4,0,9,mixedType,1
6,2,0,8,mixedType,1
6,1,0,7,mixedType,0
6,2,0,8,mixedType,1
5,3,0,8,mixedType,1
8,2,0,10,mixedType,1
7,3,0,10,mixedType,1
4,2,0,6,mixedType,0
7,2,0,9,mixedType,1
6,3,0,9,mixedType,1
15,1,0,16,mixedType,2
14,2,0,16,mixedType,2
5,4,0,9,mixedType,1
8,4,0,12,mixedType,1
2,8,0,10,mixedType,1
5,5,0,10,mixedType,1
6,1,0,7,mixedType,0
14,2,0,16,mixedType,2
8,4,0,12,mixedType,1
5,4,0,9,mixedType,1
2,8,0,10,mixedType,1
3,6,0,9,mixedType,1
6,3,0,9,mixedType,1
6,3,0,9,mixedType,1
7,1,0,8,mixedType,1
6,3,0,9,mixedType,1
5,3,0,8,mixedType,1
6,1,0,7,mixedType,0
4,8,0,12,mixedType,1
11,3,0,14,mixedType,2
7,4,0,11,mixedType,1
12,1,0,13,mixedType,1
7,2,0,9,mixedType,1
11,5,0,16,mixedType,2
12,3,0,15,mixedType,2
5,3,0,8,mixedType,1
5,3,0,8,mixedType,1
3,5,0,8,mixedType,1
6,2,0,8,mixedType,1
9,3,0,12,mixedType,1
7,4,0,11,mixedType,1
2,6,0,8,mixedType,1
7,4,0,11,mixedType,1
15,1,0,16,mixedType,2
8,2,0,10,mixedType,1
6,1,0,7,mixedType,0
1,11,0,12,mixedType,1
5,3,0,8,mixedType,1
5,5,0,10,mixedType,1
13,3,0,16,mixedType,2
7,2,0,9,mixedType,1
6,2,0,8,mixedType,1
1,9,0,10,mixedType,1
9,4,0,13,mixedType,1
15,1,0,16,mixedType,2
8,1,0,9,mixedType,1
15,1,0,16,mixedType,2
4,6,0,10,mixedType,1
10,2,0,12,mixedType,1
7,3,0,10,mixedType,1
4,6,0,10,mixedType,1
7,3,0,10,mixedType,1
5,3,0,8,mixedType,1
7,1,0,8,mixedType,1
7,3,0,10,mixedType,1
6,3,0,9,mixedType,1
7,2,0,9,mixedType,1
8,2,0,10,mixedType,1
8,3,0,11,mixedType,1
8,1,0,9,mixedType,1
5,2,0,7,mixedType,0
5,2,0,7,mixedType,0
2,6,0,8,mixedType,1
6,6,0,12,mixedType,1
6,2,0,8,mixedType,1
5,2,0,7,mixedType,0
6,4,0,10,mixedType,1
7,2,0,9,mixedType,1
7,2,0,9,mixedType,1
8,1,0,9,mixedType,1
7,1,0,8,mixedType,1
6,1,0,7,mixedType,0
10,3,0,13,mixedType,1
10,4,0,14,mixedType,2
3,5,0,8,mixedType,1
8,2,0,10,mixedType,1
3,3,0,6,mixedType,0
5,3,0,8,mixedType,1
6,3,0,9,mixedType,1
4,4,0,8,mixedType,1
6,4,0,10,mixedType,1
10,3,0,13,mixedType,1
5,7,0,12,mixedType,1
7,5,0,12,mixedType,1
4,6,0,10,mixedType,1
1,5,0,6,mixedType,0
4,4,0,8,mixedType,1
7,3,0,10,mixedType,1
7,4,0,11,mixedType,1
8,1,0,9,mixedType,1
7,3,0,10,mixedType,1
9,4,0,13,mixedType,1
4,2,0,6,mixedType,0
7,2,0,9,mixedType,1
6,3,0,9,mixedType,1
13,3,0,16,mixedType,2
12,4,0,16,mixedType,2
6,3,0,9,mixedType,1
7,2,0,9,mixedType,1
4,5,0,9,mixedType,1
8,1,0,9,mixedType,1
7,4,0,11,mixedType,1
4,7,0,11,mixedType,1
1,8,0,9,mixedType,1
6,3,0,9,mixedType,1
6,4,0,10,mixedType,1
6,2,0,8,mixedType,1
10,3,0,13,mixedType,1
9,1,0,10,mixedType,1
9,4,0,13,mixedType,1
8,4,0,12,mixedType,1
2,6,0,8,mixedType,1
13,3,0,16,mixedType,2
6,2,0,8,mixedType,1
8,2,0,10,mixedType,1
9,1,0,10,mixedType,1
8,2,0,10,mixedType,1
7,3,0,10,mixedType,1
5,6,0,11,mixedType,1
6,1,0,7,mixedType,0
5,2,0,7,mixedType,0
8,2,0,10,mixedType,1
5,10,0,15,mixedType,2
5,4,0,9,mixedType,1
14,2,0,16,mixedType,2
7,2,0,9,mixedType,1
9,2,0,11,mixedType,1
9,3,0,12,mixedType,1
3,6,0,9,mixedType,1
14,2,0,16,mixedType,2
9,2,0,11,mixedType,1
14,2,0,16,mixedType,2
2,6,0,8,mixedType,1
6,4,0,10,mixedType,1
7,3,0,10,mixedType,1
5,3,0,8,mixedType,1
5,4,0,9,mixedType,1
12,1,0,13,mixedType,1
6,3,0,9,mixedType,1
11,5,0,16,mixedType,2
5,1,0,6,mixedType,0
14,2,0,16,mixedType,2
6,4,0,10,mixedType,1
5,2,0,7,mixedType,0
5,3,0,8,mixedType,1
9,2,0,11,mixedType,1
7,1,0,8,mixedType,1
5,3,0,8,mixedType,1
14,2,0,16,mixedType,2
5,1,0,6,mixedType,0
7,2,0,9,mixedType,1
7,2,0,9,mixedType,1
4,2,0,6,mixedType,0
2,4,0,6,mixedType,0
5,3,0,8,mixedType,1
6,3,0,9,mixedType,1
6,4,0,10,mixedType,1
8,3,0,11,mixedType,1
9,1,0,10,mixedType,1
4,2,0,6,mixedType,0
5,2,0,7,mixedType,0
9,5,0,14,mixedType,2
8,1,0,9,mixedType,1
7,3,0,10,mixedType,1
7,3,0,10,mixedType,1
4,6,0,10,mixedType,1
8,2,0,10,mixedType,1
12,4,0,16,mixedType,2
0,9,1,10,mixedType,1
6,2,0,8,mixedType,1
4,4,0,8,mixedType,1
15,2,3,20,mixedType,2
2,10,0,12,mixedType,1
7,3,0,10,mixedType,1
5,5,0,10,mixedType,1
14,2,0,16,mixedType,2
2,6,0,8,mixedType,1
5,2,0,7,mixedType,0
5,2,0,7,mixedType,0
6,3,0,9,mixedType,1
8,2,0,10,mixedType,1
11,4,0,15,mixedType,2
8,2,0,10,mixedType,1
2,10,0,12,mixedType,1
6,3,0,9,mixedType,1
6,3,0,9,mixedType,1
15,1,0,16,mixedType,2
5,2,0,7,mixedType,0
7,2,0,9,mixedType,1
7,1,0,8,mixedType,1
15,1,0,16,mixedType,2
6,4,0,10,mixedType,1
15,1,0,16,mixedType,2
2,6,0,8,mixedType,1
7,4,0,11,mixedType,1
13,3,0,16,mixedType,2
9,1,0,10,mixedType,1
7,1,0,8,mixedType,1
9,2,0,11,mixedType,1
1,8,0,9,mixedType,1
7,3,0,10,mixedType,1
9,1,0,10,mixedType,1
5,4,0,9,mixedType,1
13,3,0,16,mixedType,2
4,5,0,9,mixedType,1
4,4,0,8,mixedType,1
7,1,0,8,mixedType,1
7,1,0,8,mixedType,1
5,3,0,8,mixedType,1
5,8,0,13,mixedType,1
5,5,0,10,mixedType,1
7,3,0,10,mixedType,1
8,2,0,10,mixedType,1
10,4,0,14,mixedType,2
3,6,0,9,mixedType,1
8,1,0,9,mixedType,1
7,2,0,9,mixedType,1
7,2,0,9,mixedType,1
7,3,0,10,mixedType,1
12,3,1,16,mixedType,2
5,6,0,11,mixedType,1
4,4,0,8,mixedType,1
6,2,0,8,mixedType,1
5,3,0,8,mixedType,1
1,8,0,9,mixedType,1
4,4,0,8,mixedType,1
10,3,0,13,mixedType,1
8,1,0,9,mixedType,1
7,3,0,10,mixedType,1
15,1,0,16,mixedType,2
5,6,0,11,mixedType,1
4,2,0,6,mixedType,0
13,3,0,16,mixedType,2
5,6,0,11,mixedType,1
8,2,0,10,mixedType,1
5,3,0,8,mixedType,1
6,1,0,7,mixedType,0
7,3,0,10,mixedType,1
6,2,0,8,mixedType,1
6,5,0,11,mixedType,1
3,6,0,9,mixedType,1
6,3,0,9,mixedType,1
5,3,0,8,mixedType,1
6,3,0,9,mixedType,1
14,2,0,16,mixedType,2
6,4,0,10,mixedType,1
5,2,0,7,mixedType,0
8,3,0,11,mixedType,1
14,2,0,16,mixedType,2
7,3,0,10,mixedType,1
4,7,0,11,mixedType,1
2,6,0,8,mixedType,1
8,3,0,11,mixedType,1
9,1,0,10,mixedType,1
7,2,0,9,mixedType,1
15,1,0,16,mixedType,2
3,6,0,9,mixedType,1
6,4,0,10,mixedType,1
6,3,0,9,mixedType,1
8,3,3,14,mixedType,2
7,3,0,10,mixedType,1
3,4,0,7,mixedType,0
4,4,0,8,mixedType,1
5,1,0,6,mixedType,0
7,3,0,10,mixedType,1
6,1,0,7,mixedType,0
6,1,0,7,mixedType,0
5,2,0,7,mixedType,0
8,1,0,9,mixedType,1
4,4,0,8,mixedType,1
7,3,0,10,mixedType,1
8,2,0,10,mixedType,1
8,2,0,10,mixedType,1
11,3,1,15,mixedType,2
6,4,0,10,mixedType,1
2,7,0,9,mixedType,1
6,6,0,12,mixedType,1
7,2,0,9,mixedType,1
7,2,0,9,mixedType,1
7,0,1,8,mixedType,1
8,3,0,11,mixedType,1
9,3,0,12,mixedType,1
6,1,0,7,mixedType,0
9,3,0,12,mixedType,1
4,6,0,10,mixedType,1
6,4,0,10,mixedType,1
6,1,0,7,mixedType,0
7,2,0,9,mixedType,1
15,1,0,16,mixedType,2
12,4,0,16,mixedType,2
14,2,0,16,mixedType,2
9,2,0,11,mixedType,1
6,4,0,10,mixedType,1
7,3,0,10,mixedType,1
9,1,0,10,mixedType,1
8,1,0,9,mixedType,1
8,2,0,10,mixedType,1
8,1,0,9,mixedType,1
6,4,0,10,mixedType,1
7,5,0,12,mixedType,1
6,4,0,10,mixedType,1
6,3,0,9,mixedType,1
4,4,0,8,mixedType,1
9,1,0,10,mixedType,1
7,2,0,9,mixedType,1
7,2,0,9,mixedType,1
4,2,0,6,mixedType,0
8,4,0,12,mixedType,1
4,4,0,8,mixedType,1
5,2,0,7,mixedType,0
7,3,0,10,mixedType,1
5,4,0,9,mixedType,1
6,2,0,8,mixedType,1
6,3,0,9,mixedType,1
9,1,0,10,mixedType,1
9,1,0,10,mixedType,1
5,1,0,6,mixedType,0
3,3,0,6,mixedType,0
8,2,0,10,mixedType,1
3,6,0,9,mixedType,1
2,4,0,6,mixedType,0
6,3,0,9,mixedType,1
6,2,0,8,mixedType,1
3,7,0,10,mixedType,1
10,0,1,11,mixedType,1
3,6,0,9,mixedType,1
9,2,0,11,mixedType,1
9,1,0,10,mixedType,1
6,4,0,10,mixedType,1
8,1,0,9,mixedType,1
15,1,0,16,mixedType,2
1,7,0,8,mixedType,1
8,1,0,9,mixedType,1
7,2,0,9,mixedType,1
1,6,0,7,mixedType,0
11,4,0,15,mixedType,2
5,3,0,8,mixedType,1
9,2,0,11,mixedType,1
5,3,0,8,mixedType,1
6,3,0,9,mixedType,1
5,6,0,11,mixedType,1
6,3,0,9,mixedType,1
6,3,0,9,mixedType,1
9,1,0,10,mixedType,1
5,5,0,10,mixedType,1
7,1,0,8,mixedType,1
16,1,0,17,mixedType,2
5,8,0,13,mixedType,1
5,4,0,9,mixedType,1
8,2,0,10,mixedType,1
4,4,0,8,mixedType,1
3,10,0,13,mixedType,1
2,6,0,8,mixedType,1
10,1,0,11,mixedType,1
9,2,0,11,mixedType,1
12,1,0,13,mixedType,1
6,4,0,10,mixedType,1
6,1,0,7,mixedType,0
8,3,0,11,mixedType,1
6,1,0,7,mixedType,0
4,4,0,8,mixedType,1
8,3,0,11,mixedType,1
9,1,0,10,mixedType,1
5,4,0,9,mixedType,1
3,8,0,11,mixedType,1
6,3,0,9,mixedType,1
15,1,0,16,mixedType,2
4,2,0,6,mixedType,0
15,1,0,16,mixedType,2
7,1,0,8,mixedType,1
1,8,0,9,mixedType,1
10,1,0,11,mixedType,1
2,8,0,10,mixedType,1
5,3,0,8,mixedType,1
13,3,0,16,mixedType,2
6,3,0,9,mixedType,1
8,1,0,9,mixedType,1
5,1,0,6,mixedType,0
4,2,0,6,mixedType,0
7,3,0,10,mixedType,1
6,1,0,7,mixedType,0
11,1,0,12,mixedType,1
7,2,0,9,mixedType,1
4,2,0,6,mixedType,0
7,1,0,8,mixedType,1
12,1,0,13,mixedType,1
2,11,0,13,mixedType,1
6,1,0,7,mixedType,0
8,3,0,11,mixedType,1
15,1,0,16,mixedType,2
2,4,0,6,mixedType,0
7,3,0,10,mixedType,1
6,4,0,10,mixedType,1
8,1,0,9,mixedType,1
5,2,0,7,mixedType,0
6,1,0,7,mixedType,0
6,2,0,8,mixedType,1
6,2,0,8,mixedType,1
6,3,0,9,mixedType,1
6,1,0,7,mixedType,0
7,7,0,14,mixedType,2
5,3,0,8,mixedType,1
13,1,1,15,mixedType,2
6,3,0,9,mixedType,1
5,2,0,7,mixedType,0
7,4,0,11,mixedType,1
3,6,0,9,mixedType,1
5,2,0,7,mixedType,0
8,2,0,10,mixedType,1
7,4,0,11,mixedType,1
5,2,0,7,mixedType,0
6,4,0,10,mixedType,1
7,4,0,11,mixedType,1
5,4,0,9,mixedType,1
13,3,0,16,mixedType,2
9,1,0,10,mixedType,1
12,1,0,13,mixedType,1
5,3,0,8,mixedType,1
7,3,0,10,mixedType,1
9,2,0,11,mixedType,1
8,2,0,10,mixedType,1
6,9,0,15,mixedType,2
8,2,0,10,mixedType,1
6,2,0,8,mixedType,1
6,1,0,7,mixedType,0
5,4,0,9,mixedType,1
13,3,0,16,mixedType,2
7,3,0,10,mixedType,1
4,4,0,8,mixedType,1
5,2,0,7,mixedType,0
6,3,0,9,mixedType,1
7,3,0,10,mixedType,1
7,2,0,9,mixedType,1
7,3,0,10,mixedType,1
4,4,0,8,mixedType,1
9,1,0,10,mixedType,1
7,5,0,12,mixedType,1
10,1,0,11,mixedType,1
7,2,0,9,mixedType,1
9,3,0,12,mixedType,1
4,4,0,8,mixedType,1
3,7,0,10,mixedType,1
7,3,0,10,mixedType,1
3,6,0,9,mixedType,1
5,6,0,11,mixedType,1
4,2,0,6,mixedType,0
7,2,0,9,mixedType,1
6,3,0,9,mixedType,1
8,3,0,11,mixedType,1
5,2,0,7,mixedType,0
5,4,0,9,mixedType,1
7,3,0,10,mixedType,1
7,3,0,10,mixedType,1
6,3,0,9,mixedType,1
6,3,0,9,mixedType,1
3,7,0,10,mixedType,1
6,1,0,7,mixedType,0
10,2,0,12,mixedType,1
6,3,0,9,mixedType,1
7,2,0,9,mixedType,1
7,2,0,9,mixedType,1
7,4,0,11,mixedType,1
3,6,0,9,mixedType,1
8,1,0,9,mixedType,1
8,3,0,11,mixedType,1
9,2,0,11,mixedType,1
8,2,0,10,mixedType,1
6,2,0,8,mixedType,1
7,2,0,9,mixedType,1
2,4,0,6,mixedType,0
11,5,0,16,mixedType,2
6,3,0,9,mixedType,1
12,3,0,15,mixedType,2
10,1,0,11,mixedType,1
14,2,0,16,mixedType,2
12,1,0,13,mixedType,1
3,6,0,9,mixedType,1
9,1,0,10,mixedType,1
3,10,0,13,mixedType,1
5,2,0,7,mixedType,0
9,2,0,11,mixedType,1
6,2,0,8,mixedType,1
5,1,0,6,mixedType,0
1,10,0,11,mixedType,1
7,1,0,8,mixedType,1
6,1,0,7,mixedType,0
5,2,0,7,mixedType,0
7,2,0,9,mixedType,1
3,6,0,9,mixedType,1
10,1,0,11,mixedType,1
7,0,1,8,mixedType,1
1,9,0,10,mixedType,1
4,6,0,10,mixedType,1
9,1,0,10,mixedType,1
14,2,0,16,mixedType,2
5,3,0,8,mixedType,1
10,1,0,11,mixedType,1
5,3,0,8,mixedType,1
3,6,0,9,mixedType,1
5,2,0,7,mixedType,0
14,2,0,16,mixedType,2
5,3,0,8,mixedType,1
6,3,0,9,mixedType,1
4,2,0,6,mixedType,0
8,1,0,9,mixedType,1
7,2,0,9,mixedType,1
7,2,0,9,mixedType,1
1,7,0,8,mixedType,1
5,3,0,8,mixedType,1
6,4,0,10,mixedType,1
4,2,0,6,mixedType,0
6,3,0,9,mixedType,1
8,3,0,11,mixedType,1
7,2,0,9,mixedType,1
7,2,0,9,mixedType,1
5,3,0,8,mixedType,1
11,5,0,16,mixedType,2
5,2,0,7,mixedType,0
13,3,0,16,mixedType,2
5,2,0,7,mixedType,0
4,7,0,11,mixedType,1
5,6,0,11,mixedType,1
9,1,0,10,mixedType,1
5,5,0,10,mixedType,1
15,1,0,16,mixedType,2
10,1,0,11,mixedType,1
7,3,0,10,mixedType,1
4,4,0,8,mixedType,1
5,4,0,9,mixedType,1
17,3,0,20,mixedType,2
6,4,0,10,mixedType,1
4,5,0,9,mixedType,1
5,4,0,9,mixedType,1
6,3,0,9,mixedType,1
4,8,0,12,mixedType,1
7,2,0,9,mixedType,1
8,3,0,11,mixedType,1
7,6,0,13,mixedType,1
13,3,0,16,mixedType,2
7,2,0,9,mixedType,1
6,2,0,8,mixedType,1
6,4,0,10,mixedType,1
9,1,0,10,mixedType,1
7,3,0,10,mixedType,1
6,3,0,9,mixedType,1
2,8,0,10,mixedType,1
9,1,0,10,mixedType,1
6,4,0,10,mixedType,1
14,2,0,16,mixedType,2
7,4,0,11,mixedType,1
4,4,0,8,mixedType,1
7,3,0,10,mixedType,1
9,1,0,10,mixedType,1
9,1,0,10,mixedType,1
2,6,0,8,mixedType,1
12,4,0,16,mixedType,2
5,2,0,7,mixedType,0
8,1,0,9,mixedType,1
3,6,0,9,mixedType,1
4,2,0,6,mixedType,0
9,1,0,10,mixedType,1
5,2,0,7,mixedType,0
1,7,0,8,mixedType,1
5,3,0,8,mixedType,1
1,9,0,10,mixedType,1
6,2,0,8,mixedType,1
7,3,0,10,mixedType,1
4,6,0,10,mixedType,1
4,6,0,10,mixedType,1
10,2,0,12,mixedType,1
4,6,0,10,mixedType,1
3,6,0,9,mixedType,1
8,1,0,9,mixedType,1
5,2,0,7,mixedType,0
7,3,0,10,mixedType,1
6,2,0,8,mixedType,1
1,8,0,9,mixedType,1
3,6,0,9,mixedType,1
2,8,0,10,mixedType,1
9,3,0,12,mixedType,1
7,1,0,8,mixedType,1
4,5,0,9,mixedType,1
6,1,0,7,mixedType,0
4,4,0,8,mixedType,1
4,2,0,6,mixedType,0
8,1,0,9,mixedType,1
6,1,0,7,mixedType,0
4,5,0,9,mixedType,1
1,7,0,8,mixedType,1
9,2,0,11,mixedType,1
9,4,0,13,mixedType,1
5,3,0,8,mixedType,1
15,1,0,16,mixedType,2
7,2,0,9,mixedType,1
1,7,0,8,mixedType,1
9,2,0,11,mixedType,1
5,6,0,11,mixedType,1
7,2,0,9,mixedType,1
5,3,0,8,mixedType,1
5,6,0,11,mixedType,1
5,4,0,9,mixedType,1
4,2,0,6,mixedType,0
7,6,0,13,mixedType,1
5,2,0,7,mixedType,0
6,1,0,7,mixedType,0
14,2,0,16,mixedType,2
6,3,0,9,mixedType,1
7,3,0,10,mixedType,1
12,4,0,16,mixedType,2
5,2,0,7,mixedType,0
5,6,0,11,mixedType,1
5,3,0,8,mixedType,1
7,1,0,8,mixedType,1
7,3,0,10,mixedType,1
8,3,0,11,mixedType,1
4,5,0,9,mixedType,1
5,5,0,10,mixedType,1
11,2,0,13,mixedType,1
4,2,0,6,mixedType,0
11,2,0,13,mixedType,1
6,3,0,9,mixedType,1
6,3,0,9,mixedType,1
7,3,0,10,mixedType,1
6,4,0,10,mixedType,1
4,4,0,8,mixedType,1
14,2,0,16,mixedType,2
6,6,0,12,mixedType,1
15,1,0,16,mixedType,2
5,4,0,9,mixedType,1
11,1,0,12,mixedType,1
7,1,0,8,mixedType,1
11,3,0,14,mixedType,2
6,3,0,9,mixedType,1
5,2,0,7,mixedType,0
4,7,0,11,mixedType,1
13,3,0,16,mixedType,2
5,2,0,7,mixedType,0
5,4,0,9,mixedType,1
15,1,0,16,mixedType,2
3,8,0,11,mixedType,1
6,3,0,9,mixedType,1
7,2,0,9,mixedType,1
5,5,0,10,mixedType,1
7,4,0,11,mixedType,1
10,1,0,11,mixedType,1
10,2,0,12,mixedType,1
6,4,0,10,mixedType,1
6,3,0,9,mixedType,1
5,3,0,8,mixedType,1
5,4,0,9,mixedType,1
5,1,0,6,mixedType,0
15,1,0,16,mixedType,2
6,1,0,7,mixedType,0
3,5,0,8,mixedType,1
4,4,0,8,mixedType,1
6,4,0,10,mixedType,1
5,3,0,8,mixedType,1
7,3,0,10,mixedType,1
8,2,0,10,mixedType,1
6,3,0,9,mixedType,1
4,4,0,8,mixedType,1
8,1,0,9,mixedType,1
7,1,0,8,mixedType,1
7,2,0,9,mixedType,1
5,3,0,8,mixedType,1
6,3,0,9,mixedType,1
3,8,0,11,mixedType,1
5,4,0,9,mixedType,1
9,2,0,11,mixedType,1
13,3,0,16,mixedType,2
15,1,0,16,mixedType,2
1,7,0,8,mixedType,1
5,1,0,6,mixedType,0
7,2,0,9,mixedType,1
6,2,0,8,mixedType,1
15,1,0,16,mixedType,2
6,2,0,8,mixedType,1
8,4,0,12,mixedType,1
6,2,0,8,mixedType,1
8,1,0,9,mixedType,1
5,2,0,7,mixedType,0
6,3,0,9,mixedType,1
4,4,0,8,mixedType,1
8,1,0,9,mixedType,1
8,1,0,9,mixedType,1
6,1,0,7,mixedType,0
14,2,0,16,mixedType,2
5,1,0,6,mixedType,0
7,1,0,8,mixedType,1
4,4,0,8,mixedType,1
7,3,0,10,mixedType,1
6,4,0,10,mixedType,1
12,3,0,15,mixedType,2
15,1,0,16,mixedType,2
5,4,0,9,mixedType,1
5,5,0,10,mixedType,1
7,3,0,10,mixedType,1
11,3,0,14,mixedType,2
7,3,0,10,mixedType,1
6,3,0,9,mixedType,1
4,4,0,8,mixedType,1
4,4,0,8,mixedType,1
5,2,0,7,mixedType,0
6,2,0,8,mixedType,1
6,2,0,8,mixedType,1
13,3,0,16,mixedType,2
13,3,0,16,mixedType,2
8,4,0,12,mixedType,1
20,10,0,30,mixedType,2
7,4,0,11,mixedType,1
8,3,0,11,mixedType,1
6,3,0,9,mixedType,1
9,2,0,11,mixedType,1
8,1,0,9,mixedType,1
7,3,0,10,mixedType,1
8,1,0,9,mixedType,1
5,2,0,7,mixedType,0
12,3,0,15,mixedType,2
5,1,0,6,mixedType,0
6,3,0,9,mixedType,1
6,3,0,9,mixedType,1
6,3,0,9,mixedType,1
14,2,0,16,mixedType,2
6,1,0,7,mixedType,0
7,1,0,8,mixedType,1
4,8,0,12,mixedType,1
6,5,0,11,mixedType,1
13,3,0,16,mixedType,2
9,1,0,10,mixedType,1
6,2,0,8,mixedType,1
6,3,0,9,mixedType,1
6,4,0,10,mixedType,1
14,2,0,16,mixedType,2
1,8,0,9,mixedType,1
2,8,0,10,mixedType,1
6,2,0,8,mixedType,1
15,1,0,16,mixedType,2
7,1,0,8,mixedType,1
5,5,0,10,mixedType,1
7,3,0,10,mixedType,1
7,3,0,10,mixedType,1
9,1,0,10,mixedType,1
5,2,0,7,mixedType,0
9,3,0,12,mixedType,1
6,2,0,8,mixedType,1
5,2,0,7,mixedType,0
7,2,0,9,mixedType,1
7,4,0,11,mixedType,1
8,3,0,11,mixedType,1
6,4,0,10,mixedType,1
1,9,0,10,mixedType,1
6,8,0,14,mixedType,2
7,3,0,10,mixedType,1
8,2,0,10,mixedType,1
6,3,0,9,mixedType,1
7,1,0,8,mixedType,1
14,2,0,16,mixedType,2
8,1,0,9,mixedType,1
5,2,0,7,mixedType,0
4,2,0,6,mixedType,0
10,2,0,12,mixedType,1
5,1,0,6,mixedType,0
8,2,0,10,mixedType,1
5,3,0,8,mixedType,1
7,3,0,10,mixedType,1
8,2,0,10,mixedType,1
9,3,0,12,mixedType,1
7,3,0,10,mixedType,1
9,2,0,11,mixedType,1
9,1,0,10,mixedType,1
6,2,0,8,mixedType,1
12,4,0,16,mixedType,2
5,2,0,7,mixedType,0
3,6,0,9,mixedType,1
7,3,0,10,mixedType,1
9,4,0,13,mixedType,1
7,2,0,9,mixedType,1
7,1,0,8,mixedType,1
4,2,0,6,mixedType,0
7,2,0,9,mixedType,1
6,3,0,9,mixedType,1
7,3,0,10,mixedType,1
3,3,0,6,mixedType,0
14,2,0,16,mixedType,2
6,3,0,9,mixedType,1
8,2,0,10,mixedType,1
0,9,1,10,mixedType,1
5,1,0,6,mixedType,0
6,4,0,10,mixedType,1
13,1,1,15,mixedType,2
14,2,0,16,mixedType,2
6,3,0,9,mixedType,1
6,3,0,9,mixedType,1
5,4,0,9,mixedType,1
8,3,0,11,mixedType,1
5,2,0,7,mixedType,0
5,4,0,9,mixedType,1
8,2,0,10,mixedType,1
9,2,0,11,mixedType,1
7,2,0,9,mixedType,1
13,3,0,16,mixedType,2
4,2,0,6,mixedType,0
7,3,0,10,mixedType,1
1,8,0,9,mixedType,1
4,4,0,8,mixedType,1
5,1,0,6,mixedType,0
5,4,0,9,mixedType,1
7,2,0,9,mixedType,1
9,1,0,10,mixedType,1
3,6,0,9,mixedType,1
6,1,0,7,mixedType,0
9,2,0,11,mixedType,1
5,3,0,8,mixedType,1
6,3,0,9,mixedType,1
9,1,0,10,mixedType,1
9,3,0,12,mixedType,1
4,8,0,12,mixedType,1
7,3,0,10,mixedType,1
5,2,0,7,mixedType,0
13,2,1,16,mixedType,2
7,2,0,9,mixedType,1
6,1,0,7,mixedType,0
7,2,0,9,mixedType,1
6,3,0,9,mixedType,1
5,2,0,7,mixedType,0
0,6,0,6,sameType,0
12,4,0,16,mixedType,2
7,3,0,10,mixedType,1
12,3,0,15,mixedType,2
5,2,0,7,mixedType,0
7,6,0,13,mixedType,1
9,1,0,10,mixedType,1
6,4,0,10,mixedType,1
10,3,0,13,mixedType,1
6,4,0,10,mixedType,1
7,2,0,9,mixedType,1
2,4,0,6,mixedType,0
7,3,0,10,mixedType,1
3,6,0,9,mixedType,1
2,6,0,8,mixedType,1
5,5,0,10,mixedType,1
14,2,0,16,mixedType,2
6,3,0,9,mixedType,1
7,1,0,8,mixedType,1
2,6,0,8,mixedType,1
14,2,0,16,mixedType,2
7,3,0,10,mixedType,1
4,5,0,9,mixedType,1
8,2,0,10,mixedType,1
6,5,0,11,mixedType,1
8,1,0,9,mixedType,1
7,3,0,10,mixedType,1
5,3,0,8,mixedType,1
6,7,0,13,mixedType,1
13,3,0,16,mixedType,2
8,2,0,10,mixedType,1
8,3,0,11,mixedType,1
10,2,0,12,mixedType,1
6,3,0,9,mixedType,1
1,9,0,10,mixedType,1
7,2,0,9,mixedType,1
5,8,0,13,mixedType,1
9,1,0,10,mixedType,1
7,2,0,9,mixedType,1
4,8,0,12,mixedType,1
9,3,0,12,mixedType,1
5,3,0,8,mixedType,1
7,2,0,9,mixedType,1
10,2,0,12,mixedType,1
13,3,0,16,mixedType,2
4,2,0,6,mixedType,0
13,3,0,16,mixedType,2
7,3,0,10,mixedType,1
8,4,0,12,mixedType,1
7,3,0,10,mixedType,1
6,3,0,9,mixedType,1
10,1,0,11,mixedType,1
7,3,0,10,mixedType,1
6,3,0,9,mixedType,1
8,2,0,10,mixedType,1
8,1,0,9,mixedType,1
9,2,0,11,mixedType,1
9,1,0,10,mixedType,1
13,3,0,16,mixedType,2
6,3,0,9,mixedType,1
6,4,0,10,mixedType,1
7,2,0,9,mixedType,1
3,3,0,6,mixedType,0
2,7,0,9,mixedType,1
3,3,0,6,mixedType,0
7,9,0,16,mixedType,2
13,3,0,16,mixedType,2
6,3,0,9,mixedType,1
7,1,0,8,mixedType,1
7,2,0,9,mixedType,1
4,4,0,8,mixedType,1
7,3,0,10,mixedType,1
8,1,0,9,mixedType,1
7,3,0,10,mixedType,1
2,7,0,9,mixedType,1
8,2,0,10,mixedType,1
5,4,0,9,mixedType,1
2,6,0,8,mixedType,1
3,8,0,11,mixedType,1
1,8,0,9,mixedType,1
4,5,0,9,mixedType,1
6,4,0,10,mixedType,1
8,3,0,11,mixedType,1
15,1,0,16,mixedType,2
3,5,0,8,mixedType,1
6,4,0,10,mixedType,1
8,2,0,10,mixedType,1
7,3,0,10,mixedType,1
9,2,0,11,mixedType,1
6,4,0,10,mixedType,1
10,1,0,11,mixedType,1
6,2,0,8,mixedType,1
7,2,0,9,mixedType,1
8,2,0,10,mixedType,1
7,3,0,10,mixedType,1
6,6,0,12,mixedType,1
7,4,0,11,mixedType,1
7,4,0,11,mixedType,1
8,1,0,9,mixedType,1
7,1,0,8,mixedType,1
6,2,0,8,mixedType,1
1,10,0,11,mixedType,1
8,1,0,9,mixedType,1
4,4,0,8,mixedType,1
6,2,0,8,mixedType,1
1,9,0,10,mixedType,1
14,2,0,16,mixedType,2
1,11,0,12,mixedType,1
7,3,0,10,mixedType,1
8,2,0,10,mixedType,1
6,2,0,8,mixedType,1
5,3,0,8,mixedType,1
9,2,0,11,mixedType,1
8,4,0,12,mixedType,1
6,3,0,9,mixedType,1
3,6,0,9,mixedType,1
8,4,0,12,mixedType,1
6,3,0,9,mixedType,1
6,3,0,9,mixedType,1
8,2,0,10,mixedType,1
5,3,0,8,mixedType,1
6,3,0,9,mixedType,1
4,4,0,8,mixedType,1
7,2,0,9,mixedType,1
6,2,0,8,mixedType,1
9,3,2,14,mixedType,2
4,4,0,8,mixedType,1
7,2,0,9,mixedType,1
3,7,0,10,mixedType,1
5,4,0,9,mixedType,1
9,1,0,10,mixedType,1
2,4,0,6,mixedType,0
6,2,0,8,mixedType,1
5,2,0,7,mixedType,0
3,6,0,9,mixedType,1
11,2,0,13,mixedType,1
4,2,0,6,mixedType,0
7,3,0,10,mixedType,1
6,4,0,10,mixedType,1
12,3,3,18,mixedType,2
9,5,0,14,mixedType,2
3,7,0,10,mixedType,1
4,4,0,8,mixedType,1
7,3,0,10,mixedType,1
3,5,0,8,mixedType,1
8,2,0,10,mixedType,1
8,2,0,10,mixedType,1
6,7,0,13,mixedType,1
6,3,0,9,mixedType,1
7,3,0,10,mixedType,1
4,6,0,10,mixedType,1
5,3,0,8,mixedType,1
8,2,0,10,mixedType,1
6,2,0,8,mixedType,1
14,2,0,16,mixedType,2
9,1,0,10,mixedType,1
10,1,0,11,mixedType,1
5,4,0,9,mixedType,1
7,2,0,9,mixedType,1
8,1,0,9,mixedType,1
5,4,0,9,mixedType,1
7,2,0,9,mixedType,1
8,1,0,9,mixedType,1
5,3,0,8,mixedType,1
11,3,0,14,mixedType,2
4,9,0,13,mixedType,1
6,1,0,7,mixedType,0
8,1,0,9,mixedType,1
9,2,0,11,mixedType,1
10,3,0,13,mixedType,1
8,4,0,12,mixedType,1
8,3,0,11,mixedType,1
5,1,0,6,mixedType,0
10,0,1,11,mixedType,1
9,1,0,10,mixedType,1
8,2,0,10,mixedType,1
9,4,1,14,mixedType,2
13,3,0,16,mixedType,2
8,8,0,16,mixedType,2
5,4,0,9,mixedType,1
5,2,0,7,mixedType,0
6,2,0,8,mixedType,1
8,1,0,9,mixedType,1
6,2,0,8,mixedType,1
6,3,0,9,mixedType,1
7,1,0,8,mixedType,1
9,3,0,12,mixedType,1
2,6,0,8,mixedType,1
8,0,1,9,mixedType,1
5,3,0,8,mixedType,1
2,8,0,10,mixedType,1
6,4,0,10,mixedType,1
8,3,0,11,mixedType,1
2,7,0,9,mixedType,1
14,2,0,16,mixedType,2
4,4,0,8,mixedType,1
7,3,0,10,mixedType,1
7,2,0,9,mixedType,1
8,1,0,9,mixedType,1
3,9,0,12,mixedType,1
7,4,0,11,mixedType,1
4,4,0,8,mixedType,1
4,2,0,6,mixedType,0
9,1,0,10,mixedType,1
6,1,0,7,mixedType,0
3,6,0,9,mixedType,1
3,8,0,11,mixedType,1
9,1,0,10,mixedType,1
2,8,0,10,mixedType,1
6,4,0,10,mixedType,1
6,2,0,8,mixedType,1
3,9,0,12,mixedType,1
5,3,0,8,mixedType,1
6,3,0,9,mixedType,1
4,8,0,12,mixedType,1
14,2,0,16,mixedType,2
2,6,0,8,mixedType,1
4,4,0,8,mixedType,1
6,3,0,9,mixedType,1
5,2,0,7,mixedType,0
6,2,0,8,mixedType,1
5,3,0,8,mixedType,1
7,2,0,9,mixedType,1
1,8,0,9,mixedType,1
8,2,0,10,mixedType,1
4,2,0,6,mixedType,0
1,8,0,9,mixedType,1
5,4,0,9,mixedType,1
1,8,0,9,mixedType,1
5,2,0,7,mixedType,0
5,4,0,9,mixedType,1
7,4,0,11,mixedType,1
5,3,0,8,mixedType,1
4,2,0,6,mixedType,0
6,2,0,8,mixedType,1
7,1,0,8,mixedType,1
5,1,0,6,mixedType,0
14,2,0,16,mixedType,2
3,5,0,8,mixedType,1
6,1,0,7,mixedType,0
11,3,0,14,mixedType,2
5,3,0,8,mixedType,1
14,2,0,16,mixedType,2
6,4,0,10,mixedType,1
4,6,0,10,mixedType,1
6,2,0,8,mixedType,1
8,4,0,12,mixedType,1
6,1,0,7,mixedType,0
6,3,0,9,mixedType,1
8,4,0,12,mixedType,1
13,3,0,16,mixedType,2
5,2,0,7,mixedType,0
6,2,0,8,mixedType,1
5,3,0,8,mixedType,1
1,8,0,9,mixedType,1
5,4,0,9,mixedType,1
4,2,0,6,mixedType,0
1,7,0,8,mixedType,1
5,3,0,8,mixedType,1
6,4,0,10,mixedType,1
1,7,0,8,mixedType,1
7,2,0,9,mixedType,1
8,3,0,11,mixedType,1
6,4,0,10,mixedType,1
1,5,0,6,mixedType,0
5,2,0,7,mixedType,0
8,2,0,10,mixedType,1
11,1,0,12,mixedType,1
5,2,0,7,mixedType,0
7,3,0,10,mixedType,1
5,3,0,8,mixedType,1
2,4,0,6,mixedType,0
4,2,0,6,mixedType,0
15,1,0,16,mixedType,2
4,2,0,6,mixedType,0
11,3,0,14,mixedType,2
6,4,0,10,mixedType,1
7,2,0,9,mixedType,1
5,5,0,10,mixedType,1
6,3,0,9,mixedType,1
12,3,0,15,mixedType,2
3,6,0,9,mixedType,1
12,4,0,16,mixedType,2
5,4,0,9,mixedType,1
9,3,0,12,mixedType,1
5,2,0,7,mixedType,0
15,1,0,16,mixedType,2
14,2,0,16,mixedType,2
8,4,0,12,mixedType,1
9,2,0,11,mixedType,1
12,3,0,15,mixedType,2
8,1,0,9,mixedType,1
10,0,1,11,mixedType,1
6,4,0,10,mixedType,1
13,3,0,16,mixedType,2
4,4,0,8,mixedType,1
7,3,0,10,mixedType,1
8,4,0,12,mixedType,1
5,1,0,6,mixedType,0
5,3,0,8,mixedType,1
7,4,0,11,mixedType,1
7,1,0,8,mixedType,1
5,4,0,9,mixedType,1
5,2,0,7,mixedType,0
6,3,0,9,mixedType,1
8,6,0,14,mixedType,2
14,2,0,16,mixedType,2
7,3,0,10,mixedType,1
4,9,0,13,mixedType,1
9,4,0,13,mixedType,1
1,7,0,8,mixedType,1
9,2,0,11,mixedType,1
5,3,0,8,mixedType,1
3,6,0,9,mixedType,1
6,2,0,8,mixedType,1
6,4,0,10,mixedType,1
2,8,0,10,mixedType,1
8,1,0,9,mixedType,1
5,3,0,8,mixedType,1
6,4,0,10,mixedType,1
3,7,0,10,mixedType,1
6,4,0,10,mixedType,1
5,1,0,6,mixedType,0
11,3,0,14,mixedType,2
7,3,0,10,mixedType,1
10,2,0,12,mixedType,1
7,3,0,10,mixedType,1
15,1,0,16,mixedType,2
6,3,0,9,mixedType,1
12,4,0,16,mixedType,2
7,2,0,9,mixedType,1
10,2,0,12,mixedType,1
7,2,0,9,mixedType,1
6,4,0,10,mixedType,1
11,3,0,14,mixedType,2
11,2,0,13,mixedType,1
14,2,0,16,mixedType,2
6,1,0,7,mixedType,0
1,9,0,10,mixedType,1
7,3,0,10,mixedType,1
4,2,0,6,mixedType,0
9,1,0,10,mixedType,1
4,4,0,8,mixedType,1
3,6,0,9,mixedType,1
7,3,0,10,mixedType,1
5,4,0,9,mixedType,1
4,4,0,8,mixedType,1
5,3,0,8,mixedType,1
12,4,0,16,mixedType,2
4,2,0,6,mixedType,0
6,2,0,8,mixedType,1
6,2,0,8,mixedType,1
10,2,0,12,mixedType,1
3,6,0,9,mixedType,1
8,1,0,9,mixedType,1
8,1,0,9,mixedType,1
9,1,0,10,mixedType,1
10,6,0,16,mixedType,2
7,2,0,9,mixedType,1
2,4,0,6,mixedType,0
6,4,1,11,mixedType,1
7,3,0,10,mixedType,1
1,8,0,9,mixedType,1
2,8,0,10,mixedType,1
6,3,0,9,mixedType,1
8,2,0,10,mixedType,1
13,2,1,16,mixedType,2
4,5,0,9,mixedType,1
8,4,0,12,mixedType,1
4,4,0,8,mixedType,1
7,2,0,9,mixedType,1
9,1,0,10,mixedType,1
6,1,0,7,mixedType,0
13,3,0,16,mixedType,2
3,7,0,10,mixedType,1
4,9,0,13,mixedType,1
8,1,0,9,mixedType,1
8,1,0,9,mixedType,1
7,4,0,11,mixedType,1
6,1,0,7,mixedType,0
5,4,0,9,mixedType,1
6,2,0,8,mixedType,1
7,3,0,10,mixedType,1
8,1,0,9,mixedType,1
7,3,0,10,mixedType,1
4,4,0,8,mixedType,1
5,6,0,11,mixedType,1
14,2,0,16,mixedType,2
15,1,0,16,mixedType,2
6,3,0,9,mixedType,1
6,1,0,7,mixedType,0
5,1,0,6,mixedType,0
5,4,0,9,mixedType,1
5,7,0,12,mixedType,1
6,1,0,7,mixedType,0
7,2,0,9,mixedType,1
2,7,0,9,mixedType,1
3,5,0,8,mixedType,1
7,3,0,10,mixedType,1
2,6,0,8,mixedType,1
4,4,0,8,mixedType,1
12,3,0,15,mixedType,2
5,1,0,6,mixedType,0
1,8,0,9,mixedType,1
9,1,0,10,mixedType,1
6,1,0,7,mixedType,0
5,1,0,6,mixedType,0
10,1,0,11,mixedType,1
5,4,0,9,mixedType,1
9,2,0,11,mixedType,1
5,2,0,7,mixedType,0
6,1,0,7,mixedType,0
6,2,0,8,mixedType,1
5,3,0,8,mixedType,1
5,2,0,7,mixedType,0
5,3,0,8,mixedType,1
6,2,0,8,mixedType,1
7,3,0,10,mixedType,1
5,3,0,8,mixedType,1
8,1,0,9,mixedType,1
9,4,0,13,mixedType,1
4,2,0,6,mixedType,0
8,3,0,11,mixedType,1
9,4,1,14,mixedType,2
7,2,0,9,mixedType,1
6,3,0,9,mixedType,1
4,2,0,6,mixedType,0
2,10,0,12,mixedType,1
4,5,0,9,mixedType,1
10,1,0,11,mixedType,1
6,1,0,7,mixedType,0
5,4,0,9,mixedType,1
4,6,0,10,mixedType,1
5,3,0,8,mixedType,1
6,1,0,7,mixedType,0
3,7,0,10,mixedType,1
4,6,0,10,mixedType,1
4,4,0,8,mixedType,1
4,4,0,8,mixedType,1
8,1,0,9,mixedType,1
9,7,0,16,mixedType,2
8,1,0,9,mixedType,1
1,8,0,9,mixedType,1
5,3,0,8,mixedType,1
6,3,0,9,mixedType,1
10,2,0,12,mixedType,1
7,2,0,9,mixedType,1
8,1,0,9,mixedType,1
11,3,0,14,mixedType,2
6,3,0,9,mixedType,1
14,2,0,16,mixedType,2
7,1,0,8,mixedType,1
6,3,0,9,mixedType,1
2,6,0,8,mixedType,1
2,6,0,8,mixedType,1
7,3,0,10,mixedType,1
6,3,0,9,mixedType,1
12,4,0,16,mixedType,2
10,1,0,11,mixedType,1
2,8,0,10,mixedType,1
7,2,0,9,mixedType,1
2,9,0,11,mixedType,1
10,6,1,17,mixedType,2
4,4,0,8,mixedType,1
7,4,0,11,mixedType,1
9,1,0,10,mixedType,1
6,2,0,8,mixedType,1
7,5,2,14,mixedType,2
4,2,0,6,mixedType,0
1,7,0,8,mixedType,1
5,2,0,7,mixedType,0
6,7,0,13,mixedType,1
6,3,0,9,mixedType,1
6,3,0,9,mixedType,1
1,8,0,9,mixedType,1
6,1,0,7,mixedType,0
4,4,0,8,mixedType,1
2,6,0,8,mixedType,1
4,5,0,9,mixedType,1
10,3,0,13,mixedType,1
1,7,0,8,mixedType,1
6,2,0,8,mixedType,1
4,2,0,6,mixedType,0
6,3,0,9,mixedType,1
8,1,0,9,mixedType,1
9,3,0,12,mixedType,1
5,3,0,8,mixedType,1
7,2,0,9,mixedType,1
6,3,0,9,mixedType,1
5,4,0,9,mixedType,1
8,2,0,10,mixedType,1
2,8,0,10,mixedType,1
8,2,0,10,mixedType,1
3,3,0,6,mixedType,0
6,3,0,9,mixedType,1
6,1,0,7,mixedType,0
6,1,0,7,mixedType,0
5,1,0,6,mixedType,0
7,2,0,9,mixedType,1
6,5,0,11,mixedType,1
7,2,0,9,mixedType,1
4,2,0,6,mixedType,0
7,3,0,10,mixedType,1
6,3,0,9,mixedType,1
13,3,0,16,mixedType,2
8,1,0,9,mixedType,1
9,2,0,11,mixedType,1
14,2,0,16,mixedType,2
3,5,0,8,mixedType,1
7,3,0,10,mixedType,1
6,6,0,12,mixedType,1
5,4,0,9,mixedType,1
7,1,0,8,mixedType,1
10,0,1,11,mixedType,1
7,1,0,8,mixedType,1
4,7,0,11,mixedType,1
4,6,0,10,mixedType,1
6,3,0,9,mixedType,1
7,5,0,12,mixedType,1
13,1,1,15,mixedType,2
6,1,0,7,mixedType,0
8,2,0,10,mixedType,1
5,2,0,7,mixedType,0
7,3,0,10,mixedType,1
15,1,0,16,mixedType,2
8,1,0,9,mixedType,1
4,6,0,10,mixedType,1
7,1,0,8,mixedType,1
5,3,0,8,mixedType,1
7,2,0,9,mixedType,1
8,4,0,12,mixedType,1
9,1,0,10,mixedType,1
5,3,0,8,mixedType,1
7,6,0,13,mixedType,1
5,3,0,8,mixedType,1
5,2,0,7,mixedType,0
9,1,0,10,mixedType,1
7,3,0,10,mixedType,1
7,1,0,8,mixedType,1
13,3,0,16,mixedType,2
6,1,0,7,mixedType,0
1,7,0,8,mixedType,1
9,2,0,11,mixedType,1
13,3,0,16,mixedType,2
6,1,0,7,mixedType,0
3,8,0,11,mixedType,1
8,4,0,12,mixedType,1
10,1,0,11,mixedType,1
7,3,0,10,mixedType,1
9,2,0,11,mixedType,1
2,4,0,6,mixedType,0
8,3,0,11,mixedType,1
8,2,0,10,mixedType,1
7,3,0,10,mixedType,1
7,1,0,8,mixedType,1
8,3,0,11,mixedType,1
4,2,0,6,mixedType,0
3,5,0,8,mixedType,1
14,2,0,16,mixedType,2
2,4,0,6,mixedType,0
11,3,0,14,mixedType,2
2,6,0,8,mixedType,1
6,1,0,7,mixedType,0
13,3,0,16,mixedType,2
9,2,0,11,mixedType,1
12,4,0,16,mixedType,2
3,3,0,6,mixedType,0
1,9,0,10,mixedType,1
9,1,0,10,mixedType,1
9,1,0,10,mixedType,1
5,4,0,9,mixedType,1
5,3,0,8,mixedType,1
7,3,0,10,mixedType,1
14,2,0,16,mixedType,2
1,9,0,10,mixedType,1
9,1,0,10,mixedType,1
8,1,0,9,mixedType,1
6,3,0,9,mixedType,1
7,4,0,11,mixedType,1
1,7,0,8,mixedType,1
3,8,0,11,mixedType,1
2,7,0,9,mixedType,1
5,1,0,6,mixedType,0
9,2,0,11,mixedType,1
8,3,0,11,mixedType,1
11,2,0,13,mixedType,1
9,1,0,10,mixedType,1
2,6,0,8,mixedType,1
8,4,0,12,mixedType,1
6,7,0,13,mixedType,1
4,7,0,11,mixedType,1
0,8,1,9,mixedType,1
5,2,0,7,mixedType,0
10,2,0,12,mixedType,1
6,3,0,9,mixedType,1
5,6,0,11,mixedType,1
2,7,0,9,mixedType,1
13,3,0,16,mixedType,2
5,4,0,9,mixedType,1
8,1,0,9,mixedType,1
6,4,0,10,mixedType,1
7,0,1,8,mixedType,1
8,1,0,9,mixedType,1
2,8,0,10,mixedType,1
9,1,0,10,mixedType,1
7,5,0,12,mixedType,1
4,2,0,6,mixedType,0
7,3,0,10,mixedType,1
9,1,0,10,mixedType,1
7,3,0,10,mixedType,1
15,1,0,16,mixedType,2
8,2,0,10,mixedType,1
7,2,0,9,mixedType,1
8,1,0,9,mixedType,1
14,2,0,16,mixedType,2
8,2,0,10,mixedType,1
8,1,0,9,mixedType,1
7,2,0,9,mixedType,1
14,2,0,16,mixedType,2
7,2,0,9,mixedType,1
3,6,0,9,mixedType,1
5,4,0,9,mixedType,1
11,3,0,14,mixedType,2
7,3,0,10,mixedType,1
6,2,0,8,mixedType,1
6,2,0,8,mixedType,1
4,2,0,6,mixedType,0
12,4,0,16,mixedType,2
8,1,0,9,mixedType,1
6,3,0,9,mixedType,1
3,5,0,8,mixedType,1
6,6,0,12,mixedType,1
7,6,0,13,mixedType,1
6,4,0,10,mixedType,1
8,3,0,11,mixedType,1
6,2,0,8,mixedType,1
9,2,0,11,mixedType,1
5,2,0,7,mixedType,0
5,3,0,8,mixedType,1
9,1,0,10,mixedType,1
7,1,0,8,mixedType,1
8,2,0,10,mixedType,1
7,2,0,9,mixedType,1
7,2,0,9,mixedType,1
5,2,0,7,mixedType,0
1,8,0,9,mixedType,1
3,6,0,9,mixedType,1
4,8,0,12,mixedType,1
5,1,0,6,mixedType,0
6,3,0,9,mixedType,1
7,3,0,10,mixedType,1
6,1,0,7,mixedType,0
8,0,1,9,mixedType,1
6,2,0,8,mixedType,1
13,3,0,16,mixedType,2
9,3,0,12,mixedType,1
6,3,0,9,mixedType,1
14,2,0,16,mixedType,2
4,6,0,10,mixedType,1
3,3,0,6,mixedType,0
6,1,0,7,mixedType,0
5,7,0,12,mixedType,1
8,1,0,9,mixedType,1
6,4,0,10,mixedType,1
14,2,0,16,mixedType,2
10,9,0,19,mixedType,2
9,1,0,10,mixedType,1
6,3,0,9,mixedType,1
10,1,0,11,mixedType,1
6,3,0,9,mixedType,1
7,1,0,8,mixedType,1
2,8,0,10,mixedType,1
5,3,0,8,mixedType,1
7,1,0,8,mixedType,1
8,1,0,9,mixedType,1
9,2,0,11,mixedType,1
8,1,0,9,mixedType,1
4,5,0,9,mixedType,1
4,2,0,6,mixedType,0
11,3,0,14,mixedType,2
1,8,0,9,mixedType,1
5,4,0,9,mixedType,1
4,4,0,8,mixedType,1
8,1,0,9,mixedType,1
4,4,0,8,mixedType,1
5,4,0,9,mixedType,1
9,2,0,11,mixedType,1
5,4,0,9,mixedType,1
8,2,0,10,mixedType,1
5,3,0,8,mixedType,1
8,0,1,9,mixedType,1
6,3,0,9,mixedType,1
4,6,0,10,mixedType,1
6,1,0,7,mixedType,0
5,2,0,7,mixedType,0
6,2,0,8,mixedType,1
7,3,0,10,mixedType,1
7,1,0,8,mixedType,1
5,6,3,14,mixedType,2
4,6,0,10,mixedType,1
9,3,0,12,mixedType,1
6,2,0,8,mixedType,1
4,4,0,8,mixedType,1
6,2,0,8,mixedType,1
7,2,0,9,mixedType,1
9,3,0,12,mixedType,1
9,4,0,13,mixedType,1
1,8,0,9,mixedType,1
5,3,0,8,mixedType,1
5,1,0,6,mixedType,0
5,4,0,9,mixedType,1
5,4,1,10,mixedType,1
5,3,0,8,mixedType,1
10,2,0,12,mixedType,1
5,2,0,7,mixedType,0
9,3,0,12,mixedType,1
1,7,0,8,mixedType,1
9,4,0,13,mixedType,1
11,2,0,13,mixedType,1
6,2,0,8,mixedType,1
5,4,0,9,mixedType,1
6,4,0,10,mixedType,1
6,1,0,7,mixedType,0
7,3,0,10,mixedType,1
6,3,0,9,mixedType,1
7,1,0,8,mixedType,1
13,3,0,16,mixedType,2
6,2,0,8,mixedType,1
4,6,0,10,mixedType,1
7,2,0,9,mixedType,1
8,4,0,12,mixedType,1
8,3,0,11,mixedType,1
8,4,0,12,mixedType,1
7,2,0,9,mixedType,1
10,2,0,12,mixedType,1
8,2,0,10,mixedType,1
8,4,0,12,mixedType,1
5,4,0,9,mixedType,1
7,2,0,9,mixedType,1
15,1,0,16,mixedType,2
5,3,0,8,mixedType,1
8,1,0,9,mixedType,1
6,3,0,9,mixedType,1
12,1,0,13,mixedType,1
9,1,0,10,mixedType,1
6,3,0,9,mixedType,1
7,2,0,9,mixedType,1
4,4,0,8,mixedType,1
9,3,0,12,mixedType,1
7,3,0,10,mixedType,1
5,3,0,8,mixedType,1
6,1,0,7,mixedType,0
7,2,0,9,mixedType,1
13,3,0,16,mixedType,2
1,8,0,9,mixedType,1
6,4,0,10,mixedType,1
7,2,0,9,mixedType,1
7,3,0,10,mixedType,1
6,2,0,8,mixedType,1
13,4,0,17,mixedType,2
7,1,0,8,mixedType,1
7,2,0,9,mixedType,1
4,2,0,6,mixedType,0
3,8,0,11,mixedType,1
6,2,0,8,mixedType,1
7,6,0,13,mixedType,1
2,4,0,6,mixedType,0
4,4,0,8,mixedType,1
7,4,0,11,mixedType,1
11,1,0,12,mixedType,1
7,2,0,9,mixedType,1
5,5,0,10,mixedType,1
3,10,0,13,mixedType,1
5,3,0,8,mixedType,1
8,1,0,9,mixedType,1
4,4,0,8,mixedType,1
7,2,0,9,mixedType,1
5,5,0,10,mixedType,1
2,6,0,8,mixedType,1
7,2,0,9,mixedType,1
5,4,0,9,mixedType,1
9,1,0,10,mixedType,1
5,4,0,9,mixedType,1
6,2,0,8,mixedType,1
8,3,0,11,mixedType,1
8,1,0,9,mixedType,1
7,3,0,10,mixedType,1
4,4,0,8,mixedType,1
10,3,0,13,mixedType,1
7,3,0,10,mixedType,1
10,2,0,12,mixedType,1
0,6,3,9,mixedType,1
4,2,0,6,mixedType,0
6,4,0,10,mixedType,1
6,1,0,7,mixedType,0
8,2,0,10,mixedType,1
10,3,0,13,mixedType,1
7,2,0,9,mixedType,1
9,4,0,13,mixedType,1
6,5,0,11,mixedType,1
7,2,0,9,mixedType,1
5,4,0,9,mixedType,1
8,3,0,11,mixedType,1
5,3,0,8,mixedType,1
4,6,0,10,mixedType,1
9,3,0,12,mixedType,1
7,2,0,9,mixedType,1
6,2,0,8,mixedType,1
6,2,0,8,mixedType,1
9,1,0,10,mixedType,1
5,2,0,7,mixedType,0
6,3,0,9,mixedType,1
7,4,0,11,mixedType,1
3,8,0,11,mixedType,1
5,3,0,8,mixedType,1
14,2,0,16,mixedType,2
5,4,0,9,mixedType,1
8,2,0,10,mixedType,1
4,5,0,9,mixedType,1
6,3,0,9,mixedType,1
6,1,0,7,mixedType,0
11,2,0,13,mixedType,1
13,3,0,16,mixedType,2
6,4,0,10,mixedType,1
7,2,0,9,mixedType,1
6,3,0,9,mixedType,1
12,1,0,13,mixedType,1
10,2,0,12,mixedType,1
4,4,0,8,mixedType,1
15,1,0,16,mixedType,2
10,2,0,12,mixedType,1
6,2,0,8,mixedType,1
15,1,0,16,mixedType,2
11,1,0,12,mixedType,1
6,4,0,10,mixedType,1
12,3,0,15,mixedType,2
7,1,0,8,mixedType,1
7,1,0,8,mixedType,1
7,2,0,9,mixedType,1
12,1,1,14,mixedType,2
7,2,0,9,mixedType,1
14,2,0,16,mixedType,2
6,2,0,8,mixedType,1
3,7,0,10,mixedType,1
6,3,0,9,mixedType,1
14,2,0,16,mixedType,2
7,1,0,8,mixedType,1
7,2,0,9,mixedType,1
6,3,0,9,mixedType,1
8,2,0,10,mixedType,1
8,2,0,10,mixedType,1
4,2,0,6,mixedType,0
3,6,0,9,mixedType,1
7,2,0,9,mixedType,1
13,3,0,16,mixedType,2
7,2,0,9,mixedType,1
2,4,0,6,mixedType,0
5,2,0,7,mixedType,0
7,3,0,10,mixedType,1
8,2,0,10,mixedType,1
5,6,0,11,mixedType,1
6,3,0,9,mixedType,1
6,7,0,13,mixedType,1
6,4,0,10,mixedType,1
4,2,0,6,mixedType,0
4,7,0,11,mixedType,1
6,3,0,9,mixedType,1
4,4,0,8,mixedType,1
12,3,0,15,mixedType,2
8,3,0,11,mixedType,1
8,2,0,10,mixedType,1
6,2,0,8,mixedType,1
14,2,0,16,mixedType,2
3,8,0,11,mixedType,1
3,6,0,9,mixedType,1
9,3,0,12,mixedType,1
6,1,0,7,mixedType,0
10,2,0,12,mixedType,1
8,2,0,10,mixedType,1
5,2,0,7,mixedType,0
9,1,0,10,mixedType,1
5,4,0,9,mixedType,1
11,2,0,13,mixedType,1
7,2,0,9,mixedType,1
6,1,0,7,mixedType,0
1,8,0,9,mixedType,1
5,1,0,6,mixedType,0
7,4,0,11,mixedType,1
7,3,0,10,mixedType,1
5,3,0,8,mixedType,1
3,5,0,8,mixedType,1
7,3,0,10,mixedType,1
5,4,0,9,mixedType,1
8,2,0,10,mixedType,1
8,2,0,10,mixedType,1
13,3,0,16,mixedType,2
5,3,0,8,mixedType,1
5,5,0,10,mixedType,1
8,2,0,10,mixedType,1
7,4,0,11,mixedType,1
8,0,2,10,mixedType,1
6,3,0,9,mixedType,1
1,8,0,9,mixedType,1
4,2,0,6,mixedType,0
7,3,0,10,mixedType,1
6,2,0,8,mixedType,1
6,3,0,9,mixedType,1
8,2,0,10,mixedType,1
2,6,0,8,mixedType,1
9,4,0,13,mixedType,1
8,2,0,10,mixedType,1
3,5,0,8,mixedType,1
8,4,0,12,mixedType,1
8,2,0,10,mixedType,1
9,1,0,10,mixedType,1
5,1,0,6,mixedType,0
7,3,0,10,mixedType,1
6,2,0,8,mixedType,1
6,4,0,10,mixedType,1
8,1,0,9,mixedType,1
7,1,0,8,mixedType,1
7,3,0,10,mixedType,1
8,2,0,10,mixedType,1
6,1,0,7,mixedType,0
9,2,0,11,mixedType,1
5,4,0,9,mixedType,1
7,3,0,10,mixedType,1
6,3,0,9,mixedType,1
9,2,0,11,mixedType,1
8,1,0,9,mixedType,1
1,7,0,8,mixedType,1
5,4,0,9,mixedType,1
6,3,0,9,mixedType,1
3,6,0,9,mixedType,1
6,3,0,9,mixedType,1
15,1,0,16,mixedType,2
12,3,0,15,mixedType,2
4,6,0,10,mixedType,1
6,2,0,8,mixedType,1
1,10,0,11,mixedType,1
6,1,0,7,mixedType,0
18,1,0,19,mixedType,2
8,1,0,9,mixedType,1
5,4,0,9,mixedType,1
8,1,0,9,mixedType,1
9,2,0,11,mixedType,1
3,3,0,6,mixedType,0
7,3,0,10,mixedType,1
9,4,0,13,mixedType,1
9,2,0,11,mixedType,1
4,2,0,6,mixedType,0
14,2,0,16,mixedType,2
2,6,0,8,mixedType,1
17,6,0,23,mixedType,2
5,4,0,9,mixedType,1
8,2,0,10,mixedType,1
5,2,0,7,mixedType,0
5,1,0,6,mixedType,0
5,2,0,7,mixedType,0
4,2,0,6,mixedType,0
9,3,0,12,mixedType,1
7,1,0,8,mixedType,1
6,3,0,9,mixedType,1
7,3,0,10,mixedType,1
10,4,0,14,mixedType,2
4,4,0,8,mixedType,1
9,3,0,12,mixedType,1
4,2,0,6,mixedType,0
10,3,0,13,mixedType,1
5,3,0,8,mixedType,1
6,2,0,8,mixedType,1
14,2,0,16,mixedType,2
5,2,0,7,mixedType,0
8,1,0,9,mixedType,1
7,1,0,8,mixedType,1
5,1,0,6,mixedType,0
4,5,0,9,mixedType,1
6,3,0,9,mixedType,1
6,3,0,9,mixedType,1
5,8,0,13,mixedType,1
6,2,0,8,mixedType,1
8,3,0,11,mixedType,1
7,2,0,9,mixedType,1
6,4,0,10,mixedType,1
6,2,0,8,mixedType,1
7,1,0,8,mixedType,1
8,2,0,10,mixedType,1
2,7,0,9,mixedType,1
5,5,0,10,mixedType,1
4,2,0,6,mixedType,0
5,3,0,8,mixedType,1
5,3,0,8,mixedType,1
8,2,0,10,mixedType,1
5,3,0,8,mixedType,1
5,2,0,7,mixedType,0
8,1,0,9,mixedType,1
7,1,0,8,mixedType,1
8,3,0,11,mixedType,1
6,4,0,10,mixedType,1
7,1,0,8,mixedType,1
8,2,0,10,mixedType,1
9,4,0,13,mixedType,1
8,3,0,11,mixedType,1
4,2,0,6,mixedType,0
4,4,0,8,mixedType,1
4,2,0,6,mixedType,0
13,3,0,16,mixedType,2
4,2,0,6,mixedType,0
14,2,0,16,mixedType,2
10,3,0,13,mixedType,1
6,3,0,9,mixedType,1
7,1,0,8,mixedType,1
6,1,0,7,mixedType,0
7,2,0,9,mixedType,1
8,2,0,10,mixedType,1
5,1,0,6,mixedType,0
8,2,0,10,mixedType,1
1,8,0,9,mixedType,1
9,3,0,12,mixedType,1
2,6,0,8,mixedType,1
7,3,0,10,mixedType,1
2,6,0,8,mixedType,1
5,2,0,7,mixedType,0
11,3,0,14,mixedType,2
7,3,0,10,mixedType,1
5,3,0,8,mixedType,1
3,9,0,12,mixedType,1
5,4,0,9,mixedType,1
7,3,0,10,mixedType,1
5,1,0,6,mixedType,0
8,2,0,10,mixedType,1
7,2,0,9,mixedType,1
5,5,0,10,mixedType,1
6,2,0,8,mixedType,1
9,1,0,10,mixedType,1
9,1,0,10,mixedType,1
1,7,0,8,mixedType,1
7,2,0,9,mixedType,1
5,4,0,9,mixedType,1
6,3,0,9,mixedType,1
6,1,0,7,mixedType,0
6,4,0,10,mixedType,1
6,4,0,10,mixedType,1
12,3,0,15,mixedType,2
8,2,0,10,mixedType,1
5,4,0,9,mixedType,1
9,2,0,11,mixedType,1
2,8,0,10,mixedType,1
4,2,0,6,mixedType,0
5,2,0,7,mixedType,0
6,1,0,7,mixedType,0
6,3,0,9,mixedType,1
6,1,0,7,mixedType,0
7,3,0,10,mixedType,1
14,2,0,16,mixedType,2
8,3,0,11,mixedType,1
9,2,0,11,mixedType,1
8,4,0,12,mixedType,1
7,1,0,8,mixedType,1
0,7,0,7,sameType,0
8,4,0,12,mixedType,1
5,5,0,10,mixedType,1
14,2,0,16,mixedType,2
6,1,0,7,mixedType,0
5,8,0,13,mixedType,1
14,2,0,16,mixedType,2
5,3,0,8,mixedType,1
4,4,0,8,mixedType,1
1,8,0,9,mixedType,1
5,4,0,9,mixedType,1
5,3,0,8,mixedType,1
8,4,0,12,mixedType,1
4,2,0,6,mixedType,0
4,7,0,11,mixedType,1
4,9,0,13,mixedType,1
10,1,0,11,mixedType,1
14,2,0,16,mixedType,2
6,2,0,8,mixedType,1
3,6,0,9,mixedType,1
7,3,0,10,mixedType,1
4,2,0,6,mixedType,0
9,1,0,10,mixedType,1
5,1,0,6,mixedType,0
15,6,6,27,mixedType,2
5,2,0,7,mixedType,0
6,2,0,8,mixedType,1
3,10,0,13,mixedType,1
6,4,0,10,mixedType,1
13,3,0,16,mixedType,2
7,2,0,9,mixedType,1
6,1,0,7,mixedType,0
8,1,0,9,mixedType,1
5,3,0,8,mixedType,1
5,1,0,6,mixedType,0
14,2,0,16,mixedType,2
6,3,0,9,mixedType,1
4,2,0,6,mixedType,0
8,2,0,10,mixedType,1
11,4,0,15,mixedType,2
6,2,0,8,mixedType,1
6,2,0,8,mixedType,1
3,5,0,8,mixedType,1
9,2,0,11,mixedType,1
9,5,0,14,mixedType,2
14,2,0,16,mixedType,2
2,7,0,9,mixedType,1
13,3,0,16,mixedType,2
7,1,0,8,mixedType,1
7,3,0,10,mixedType,1
1,7,0,8,mixedType,1
5,3,0,8,mixedType,1
7,2,0,9,mixedType,1
9,7,0,16,mixedType,2
6,3,0,9,mixedType,1
8,2,0,10,mixedType,1
6,2,0,8,mixedType,1
7,6,0,13,mixedType,1
5,3,0,8,mixedType,1
2,6,0,8,mixedType,1
3,6,0,9,mixedType,1
4,6,0,10,mixedType,1
5,4,0,9,mixedType,1
8,2,0,10,mixedType,1
7,2,0,9,mixedType,1
6,4,0,10,mixedType,1
2,8,0,10,mixedType,1
6,3,0,9,mixedType,1
1,8,0,9,mixedType,1
7,1,0,8,mixedType,1
7,3,0,10,mixedType,1
9,1,0,10,mixedType,1
4,8,0,12,mixedType,1
7,4,0,11,mixedType,1
7,3,0,10,mixedType,1
8,2,0,10,mixedType,1
7,3,0,10,mixedType,1
13,3,0,16,mixedType,2
7,4,0,11,mixedType,1
8,2,0,10,mixedType,1
5,3,0,8,mixedType,1
8,2,0,10,mixedType,1
7,3,0,10,mixedType,1
6,3,0,9,mixedType,1
5,6,0,11,mixedType,1
10,2,0,12,mixedType,1
7,3,0,10,mixedType,1
5,2,0,7,mixedType,0
15,1,0,16,mixedType,2
7,3,0,10,mixedType,1
14,2,0,16,mixedType,2
8,1,0,9,mixedType,1
11,4,1,16,mixedType,2
3,6,0,9,mixedType,1
5,3,0,8,mixedType,1
13,3,0,16,mixedType,2
4,2,0,6,mixedType,0
9,4,0,13,mixedType,1
6,1,0,7,mixedType,0
6,2,0,8,mixedType,1
5,1,0,6,mixedType,0
12,3,0,15,mixedType,2
6,1,0,7,mixedType,0
8,3,0,11,mixedType,1
10,2,0,12,mixedType,1
6,4,0,10,mixedType,1
8,1,0,9,mixedType,1
8,2,0,10,mixedType,1
8,3,0,11,mixedType,1
3,3,0,6,mixedType,0
1,8,0,9,mixedType,1
5,1,0,6,mixedType,0
12,4,0,16,mixedType,2
4,2,0,6,mixedType,0
7,3,0,10,mixedType,1
9,2,0,11,mixedType,1
8,1,0,9,mixedType,1
7,5,0,12,mixedType,1
10,2,0,12,mixedType,1
11,3,0,14,mixedType,2
6,3,0,9,mixedType,1
3,10,0,13,mixedType,1
6,4,0,10,mixedType,1
7,2,0,9,mixedType,1
4,4,0,8,mixedType,1
8,2,0,10,mixedType,1
5,3,0,8,mixedType,1
7,1,0,8,mixedType,1
14,2,0,16,mixedType,2
9,1,0,10,mixedType,1
9,4,0,13,mixedType,1
13,3,0,16,mixedType,2
8,4,0,12,mixedType,1
14,2,0,16,mixedType,2
6,3,0,9,mixedType,1
2,7,0,9,mixedType,1
7,5,0,12,mixedType,1
4,2,0,6,mixedType,0
7,2,0,9,mixedType,1
6,2,0,8,mixedType,1
6,4,0,10,mixedType,1
15,1,0,16,mixedType,2
7,3,0,10,mixedType,1
6,4,0,10,mixedType,1
6,3,0,9,mixedType,1
11,2,0,13,mixedType,1
6,1,0,7,mixedType,0
15,1,0,16,mixedType,2
5,4,0,9,mixedType,1
6,3,0,9,mixedType,1
15,1,0,16,mixedType,2
11,3,0,14,mixedType,2
1,7,0,8,mixedType,1
12,4,0,16,mixedType,2
4,7,0,11,mixedType,1
9,1,0,10,mixedType,1
14,3,2,19,mixedType,2
6,2,0,8,mixedType,1
6,2,0,8,mixedType,1
7,2,0,9,mixedType,1
8,1,0,9,mixedType,1
5,3,0,8,mixedType,1
9,2,0,11,mixedType,1
5,4,0,9,mixedType,1
2,4,0,6,mixedType,0
5,4,0,9,mixedType,1
5,2,0,7,mixedType,0
15,1,0,16,mixedType,2
8,1,0,9,mixedType,1
7,1,0,8,mixedType,1
2,6,0,8,mixedType,1
2,4,0,6,mixedType,0
5,2,0,7,mixedType,0
6,3,0,9,mixedType,1
5,3,0,8,mixedType,1
6,1,0,7,mixedType,0
5,4,0,9,mixedType,1
5,1,0,6,mixedType,0
6,2,0,8,mixedType,1
5,3,0,8,mixedType,1
8,2,0,10,mixedType,1
15,1,0,16,mixedType,2
8,1,0,9,mixedType,1
8,1,0,9,mixedType,1
5,8,0,13,mixedType,1
3,7,0,10,mixedType,1
1,8,0,9,mixedType,1
14,2,0,16,mixedType,2
6,3,0,9,mixedType,1
7,2,0,9,mixedType,1
5,1,0,6,mixedType,0
8,2,0,10,mixedType,1
5,4,0,9,mixedType,1
7,2,0,9,mixedType,1
6,1,0,7,mixedType,0
7,3,0,10,mixedType,1
6,2,0,8,mixedType,1
7,3,0,10,mixedType,1
9,2,0,11,mixedType,1
8,2,0,10,mixedType,1
7,1,0,8,mixedType,1
6,1,0,7,mixedType,0
7,3,0,10,mixedType,1
5,4,0,9,mixedType,1
7,1,0,8,mixedType,1
4,8,0,12,mixedType,1
3,6,0,9,mixedType,1
1,8,0,9,mixedType,1
7,3,0,10,mixedType,1
8,1,0,9,mixedType,1
8,2,0,10,mixedType,1
7,3,0,10,mixedType,1
4,6,0,10,mixedType,1
7,4,0,11,mixedType,1
7,2,0,9,mixedType,1
6,2,0,8,mixedType,1
10,2,0,12,mixedType,1
7,1,0,8,mixedType,1
8,2,0,10,mixedType,1
5,2,0,7,mixedType,0
5,8,0,13,mixedType,1
6,2,0,8,mixedType,1
7,3,0,10,mixedType,1
6,2,0,8,mixedType,1
6,3,0,9,mixedType,1
15,2,0,17,mixedType,2
7,2,0,9,mixedType,1
5,3,0,8,mixedType,1
3,5,0,8,mixedType,1
4,4,0,8,mixedType,1
8,3,0,11,mixedType,1
8,3,0,11,mixedType,1
8,2,0,10,mixedType,1
6,2,0,8,mixedType,1
8,3,0,11,mixedType,1
12,3,0,15,mixedType,2
6,4,0,10,mixedType,1
9,3,0,12,mixedType,1
8,2,0,10,mixedType,1
10,3,0,13,mixedType,1
1,9,0,10,mixedType,1
4,4,0,8,mixedType,1
4,7,0,11,mixedType,1
8,3,0,11,mixedType,1
6,3,0,9,mixedType,1
6,1,0,7,mixedType,0
10,1,0,11,mixedType,1
4,2,0,6,mixedType,0
5,4,0,9,mixedType,1
6,1,0,7,mixedType,0
11,4,0,15,mixedType,2
9,1,0,10,mixedType,1
1,8,0,9,mixedType,1
7,1,0,8,mixedType,1
8,2,0,10,mixedType,1
10,2,0,12,mixedType,1
2,7,0,9,mixedType,1
6,2,0,8,mixedType,1
4,2,0,6,mixedType,0
5,3,0,8,mixedType,1
5,1,0,6,mixedType,0
5,1,0,6,mixedType,0
8,4,0,12,mixedType,1
11,3,0,14,mixedType,2
6,4,0,10,mixedType,1
4,6,0,10,mixedType,1
7,2,0,9,mixedType,1
6,2,0,8,mixedType,1
7,3,0,10,mixedType,1
14,2,0,16,mixedType,2
8,2,0,10,mixedType,1
14,2,0,16,mixedType,2
10,1,0,11,mixedType,1
6,1,0,7,mixedType,0
4,2,0,6,mixedType,0
6,2,0,8,mixedType,1
3,6,0,9,mixedType,1
13,3,0,16,mixedType,2
8,1,0,9,mixedType,1
14,2,0,16,mixedType,2
10,2,0,12,mixedType,1
5,4,0,9,mixedType,1
4,2,0,6,mixedType,0
2,8,0,10,mixedType,1
3,9,0,12,mixedType,1
12,3,0,15,mixedType,2
9,1,0,10,mixedType,1
5,2,0,7,mixedType,0
7,3,0,10,mixedType,1
7,1,0,8,mixedType,1
5,2,0,7,mixedType,0
6,3,0,9,mixedType,1
5,5,0,10,mixedType,1
6,3,0,9,mixedType,1
4,4,0,8,mixedType,1
5,1,0,6,mixedType,0
7,1,0,8,mixedType,1
14,2,0,16,mixedType,2
8,1,0,9,mixedType,1
7,2,0,9,mixedType,1
8,3,0,11,mixedType,1
5,3,0,8,mixedType,1
6,1,0,7,mixedType,0
4,4,0,8,mixedType,1
8,1,0,9,mixedType,1
7,3,0,10,mixedType,1
5,3,0,8,mixedType,1
9,1,0,10,mixedType,1
1,8,0,9,mixedType,1
8,3,0,11,mixedType,1
5,2,0,7,mixedType,0
9,1,0,10,mixedType,1
3,8,0,11,mixedType,1
7,2,0,9,mixedType,1
6,4,0,10,mixedType,1
6,2,0,8,mixedType,1
5,3,0,8,mixedType,1
7,3,0,10,mixedType,1
7,2,0,9,mixedType,1
8,3,0,11,mixedType,1
7,2,0,9,mixedType,1
8,2,0,10,mixedType,1
3,10,0,13,mixedType,1
7,4,0,11,mixedType,1
4,6,0,10,mixedType,1
6,4,0,10,mixedType,1
6,2,0,8,mixedType,1
6,4,0,10,mixedType,1
7,3,0,10,mixedType,1
13,3,0,16,mixedType,2
6,3,0,9,mixedType,1
14,2,0,16,mixedType,2
8,3,0,11,mixedType,1
1,9,0,10,mixedType,1
9,1,0,10,mixedType,1
4,2,0,6,mixedType,0
6,6,0,12,mixedType,1
8,1,0,9,mixedType,1
6,1,0,7,mixedType,0
7,1,0,8,mixedType,1
7,3,0,10,mixedType,1
11,5,0,16,mixedType,2
7,4,0,11,mixedType,1
6,3,0,9,mixedType,1
6,3,0,9,mixedType,1
7,3,0,10,mixedType,1
4,5,0,9,mixedType,1
5,3,0,8,mixedType,1
5,0,1,6,mixedType,0
7,2,0,9,mixedType,1
7,2,0,9,mixedType,1
15,1,0,16,mixedType,2
2,5,0,7,mixedType,0
5,1,0,6,mixedType,0
7,2,0,9,mixedType,1
15,1,0,16,mixedType,2
4,2,0,6,mixedType,0
6,1,0,7,mixedType,0
12,6,0,18,mixedType,2
6,1,0,7,mixedType,0
7,1,0,8,mixedType,1
4,4,0,8,mixedType,1
7,3,0,10,mixedType,1
5,3,0,8,mixedType,1
4,4,0,8,mixedType,1
6,4,0,10,mixedType,1
5,3,0,8,mixedType,1
2,6,0,8,mixedType,1
14,2,0,16,mixedType,2
5,5,0,10,mixedType,1
4,4,0,8,mixedType,1
10,0,1,11,mixedType,1
8,1,0,9,mixedType,1
13,3,0,16,mixedType,2
7,3,0,10,mixedType,1
6,3,0,9,mixedType,1
1,8,0,9,mixedType,1
14,2,0,16,mixedType,2
15,1,0,16,mixedType,2
5,3,0,8,mixedType,1
5,1,0,6,mixedType,0
6,4,0,10,mixedType,1
6,1,0,7,mixedType,0
9,4,0,13,mixedType,1
3,9,0,12,mixedType,1
11,2,0,13,mixedType,1
8,2,0,10,mixedType,1
5,3,0,8,mixedType,1
5,3,0,8,mixedType,1
7,3,0,10,mixedType,1
6,4,0,10,mixedType,1
8,2,0,10,mixedType,1
5,4,0,9,mixedType,1
7,2,0,9,mixedType,1
14,2,0,16,mixedType,2
8,4,0,12,mixedType,1
7,4,0,11,mixedType,1
10,1,0,11,mixedType,1
9,5,2,16,mixedType,2
5,2,0,7,mixedType,0
9,1,0,10,mixedType,1
5,2,0,7,mixedType,0
12,6,1,19,mixedType,2
4,4,0,8,mixedType,1
7,3,0,10,mixedType,1
8,3,0,11,mixedType,1
5,1,0,6,mixedType,0
6,3,0,9,mixedType,1
7,3,0,10,mixedType,1
4,4,0,8,mixedType,1
6,2,0,8,mixedType,1
13,3,0,16,mixedType,2
7,6,0,13,mixedType,1
8,2,0,10,mixedType,1
5,3,0,8,mixedType,1
3,6,0,9,mixedType,1
8,4,0,12,mixedType,1
6,3,0,9,mixedType,1
5,3,0,8,mixedType,1
5,4,0,9,mixedType,1
7,3,0,10,mixedType,1
5,6,0,11,mixedType,1
12,4,0,16,mixedType,2
11,1,1,13,mixedType,1
5,2,0,7,mixedType,0
5,4,0,9,mixedType,1
6,1,0,7,mixedType,0
5,3,0,8,mixedType,1
6,1,0,7,mixedType,0
7,2,0,9,mixedType,1
12,3,0,15,mixedType,2
8,2,0,10,mixedType,1
8,1,0,9,mixedType,1
9,1,0,10,mixedType,1
6,1,0,7,mixedType,0
10,2,0,12,mixedType,1
5,3,0,8,mixedType,1
12,1,0,13,mixedType,1
7,4,0,11,mixedType,1
8,2,0,10,mixedType,1
7,2,0,9,mixedType,1
2,9,0,11,mixedType,1
4,6,0,10,mixedType,1
5,2,0,7,mixedType,0
6,2,0,8,mixedType,1
6,2,0,8,mixedType,1
4,5,0,9,mixedType,1
6,3,0,9,mixedType,1
9,1,0,10,mixedType,1
6,3,0,9,mixedType,1
1,8,0,9,mixedType,1
6,4,0,10,mixedType,1
5,5,0,10,mixedType,1
5,3,0,8,mixedType,1
5,3,0,8,mixedType,1
6,2,0,8,mixedType,1
14,2,0,16,mixedType,2
7,2,0,9,mixedType,1
6,4,0,10,mixedType,1
1,10,0,11,mixedType,1
5,2,0,7,mixedType,0
8,1,0,9,mixedType,1
17,1,1,19,mixedType,2
11,3,0,14,mixedType,2
5,3,0,8,mixedType,1
12,1,0,13,mixedType,1
12,4,0,16,mixedType,2
8,5,0,13,mixedType,1
6,2,0,8,mixedType,1
5,4,0,9,mixedType,1
5,2,0,7,mixedType,0
8,2,0,10,mixedType,1
13,3,0,16,mixedType,2
4,6,0,10,mixedType,1
5,2,0,7,mixedType,0
6,2,0,8,mixedType,1
12,4,0,16,mixedType,2
6,4,0,10,mixedType,1
1,8,0,9,mixedType,1
12,3,1,16,mixedType,2
12,1,0,13,mixedType,1
6,3,0,9,mixedType,1
12,4,0,16,mixedType,2
7,3,0,10,mixedType,1
5,7,0,12,mixedType,1
7,3,0,10,mixedType,1
4,6,0,10,mixedType,1
4,2,0,6,mixedType,0
6,3,0,9,mixedType,1
11,1,0,12,mixedType,1
15,1,0,16,mixedType,2
6,3,0,9,mixedType,1
9,4,0,13,mixedType,1
8,1,0,9,mixedType,1
6,4,0,10,mixedType,1
13,1,1,15,mixedType,2
4,2,0,6,mixedType,0
7,3,0,10,mixedType,1
2,6,0,8,mixedType,1
14,2,0,16,mixedType,2
12,4,0,16,mixedType,2
12,4,0,16,mixedType,2
6,3,0,9,mixedType,1
8,4,0,12,mixedType,1
7,1,0,8,mixedType,1
5,2,0,7,mixedType,0
7,3,0,10,mixedType,1
5,4,0,9,mixedType,1
5,1,0,6,mixedType,0
6,4,0,10,mixedType,1
3,6,0,9,mixedType,1
2,6,0,8,mixedType,1
8,2,0,10,mixedType,1
9,4,0,13,mixedType,1
7,3,0,10,mixedType,1
15,1,0,16,mixedType,2
6,3,0,9,mixedType,1
1,10,0,11,mixedType,1
10,2,0,12,mixedType,1
1,7,0,8,mixedType,1
4,4,0,8,mixedType,1
5,3,0,8,mixedType,1
5,6,0,11,mixedType,1
14,2,0,16,mixedType,2
5,3,0,8,mixedType,1
15,1,0,16,mixedType,2
13,3,0,16,mixedType,2
7,3,0,10,mixedType,1
7,2,0,9,mixedType,1
8,1,0,9,mixedType,1
12,3,0,15,mixedType,2
5,3,0,8,mixedType,1
15,1,0,16,mixedType,2
5,3,0,8,mixedType,1
5,3,0,8,mixedType,1
5,3,0,8,mixedType,1
6,2,0,8,mixedType,1
5,1,0,6,mixedType,0
14,2,0,16,mixedType,2
6,4,0,10,mixedType,1
7,1,0,8,mixedType,1
7,4,0,11,mixedType,1
7,3,0,10,mixedType,1
12,3,0,15,mixedType,2
2,4,0,6,mixedType,0
7,3,0,10,mixedType,1
6,3,0,9,mixedType,1
8,2,0,10,mixedType,1
9,3,0,12,mixedType,1
13,3,0,16,mixedType,2
2,4,0,6,mixedType,0
13,3,0,16,mixedType,2
5,4,0,9,mixedType,1
8,1,0,9,mixedType,1
3,3,0,6,mixedType,0
4,8,0,12,mixedType,1
4,6,0,10,mixedType,1
6,4,0,10,mixedType,1
4,4,0,8,mixedType,1
4,2,0,6,mixedType,0
5,2,0,7,mixedType,0
6,1,0,7,mixedType,0
14,2,0,16,mixedType,2
1,12,0,13,mixedType,1
13,5,2,20,mixedType,2
7,1,0,8,mixedType,1
2,7,0,9,mixedType,1
7,4,0,11,mixedType,1
3,6,0,9,mixedType,1
10,11,0,21,mixedType,2
10,1,0,11,mixedType,1
8,1,0,9,mixedType,1
8,2,0,10,mixedType,1
6,1,0,7,mixedType,0
5,1,0,6,mixedType,0
6,2,0,8,mixedType,1
5,2,0,7,mixedType,0
1,8,0,9,mixedType,1
5,4,0,9,mixedType,1
6,3,0,9,mixedType,1
14,2,0,16,mixedType,2
15,1,0,16,mixedType,2
8,4,0,12,mixedType,1
8,1,0,9,mixedType,1
8,2,0,10,mixedType,1
5,3,0,8,mixedType,1
11,2,0,13,mixedType,1
5,2,0,7,mixedType,0
6,3,0,9,mixedType,1
5,3,0,8,mixedType,1
5,2,0,7,mixedType,0
5,4,0,9,mixedType,1
7,1,0,8,mixedType,1
6,3,0,9,mixedType,1
6,3,0,9,mixedType,1
9,1,0,10,mixedType,1
15,1,0,16,mixedType,2
2,8,0,10,mixedType,1
7,2,0,9,mixedType,1
7,1,0,8,mixedType,1
8,2,0,10,mixedType,1
8,2,0,10,mixedType,1
11,3,0,14,mixedType,2
6,3,0,9,mixedType,1
6,2,0,8,mixedType,1
4,2,0,6,mixedType,0
7,2,0,9,mixedType,1
5,4,0,9,mixedType,1
8,1,0,9,mixedType,1
11,3,0,14,mixedType,2
6,1,0,7,mixedType,0
11,5,0,16,mixedType,2
5,2,0,7,mixedType,0
3,7,0,10,mixedType,1
1,8,0,9,mixedType,1
5,3,0,8,mixedType,1
12,3,0,15,mixedType,2
4,2,0,6,mixedType,0
6,3,0,9,mixedType,1
7,2,0,9,mixedType,1
7,2,0,9,mixedType,1
14,2,0,16,mixedType,2
6,4,0,10,mixedType,1
6,3,0,9,mixedType,1
7,2,0,9,mixedType,1
5,2,0,7,mixedType,0
5,3,0,8,mixedType,1
8,2,0,10,mixedType,1
7,1,0,8,mixedType,1
8,3,0,11,mixedType,1
5,3,0,8,mixedType,1
4,4,0,8,mixedType,1
9,2,0,11,mixedType,1
8,3,0,11,mixedType,1
5,8,0,13,mixedType,1
7,4,0,11,mixedType,1
7,1,0,8,mixedType,1
6,1,0,7,mixedType,0
6,2,0,8,mixedType,1
11,2,0,13,mixedType,1
6,4,0,10,mixedType,1
6,1,0,7,mixedType,0
8,3,0,11,mixedType,1
13,3,0,16,mixedType,2
4,6,0,10,mixedType,1
6,3,0,9,mixedType,1
10,3,0,13,mixedType,1
6,3,0,9,mixedType,1
5,3,0,8,mixedType,1
6,2,0,8,mixedType,1
3,6,0,9,mixedType,1
6,3,0,9,mixedType,1
8,2,0,10,mixedType,1
6,3,0,9,mixedType,1
4,2,0,6,mixedType,0
6,2,0,8,mixedType,1
6,4,0,10,mixedType,1
4,4,0,8,mixedType,1
15,1,0,16,mixedType,2
4,6,0,10,mixedType,1
6,2,0,8,mixedType,1
7,2,0,9,mixedType,1
4,2,0,6,mixedType,0
5,2,0,7,mixedType,0
5,3,0,8,mixedType,1
7,1,0,8,mixedType,1
10,2,2,14,mixedType,2
6,3,0,9,mixedType,1
8,1,0,9,mixedType,1
5,1,0,6,mixedType,0
14,7,1,22,mixedType,2
7,2,0,9,mixedType,1
10,2,0,12,mixedType,1
7,1,0,8,mixedType,1
6,4,0,10,mixedType,1
7,2,0,9,mixedType,1
9,1,0,10,mixedType,1
7,3,0,10,mixedType,1
4,2,0,6,mixedType,0
7,2,0,9,mixedType,1
2,7,0,9,mixedType,1
8,2,0,10,mixedType,1
8,4,0,12,mixedType,1
8,4,0,12,mixedType,1
5,3,0,8,mixedType,1
5,2,0,7,mixedType,0
5,2,0,7,mixedType,0
1,8,0,9,mixedType,1
7,4,0,11,mixedType,1
13,3,0,16,mixedType,2
4,5,0,9,mixedType,1
6,2,0,8,mixedType,1
8,2,0,10,mixedType,1
4,2,0,6,mixedType,0
7,2,0,9,mixedType,1
5,3,0,8,mixedType,1
13,3,0,16,mixedType,2
5,4,0,9,mixedType,1
10,3,0,13,mixedType,1
8,4,0,12,mixedType,1
8,2,0,10,mixedType,1
13,3,0,16,mixedType,2
5,4,0,9,mixedType,1
9,1,0,10,mixedType,1
6,3,0,9,mixedType,1
8,1,0,9,mixedType,1
6,2,0,8,mixedType,1
6,2,0,8,mixedType,1
6,2,0,8,mixedType,1
7,2,0,9,mixedType,1
6,3,0,9,mixedType,1
6,3,0,9,mixedType,1
10,2,4,16,mixedType,2
2,6,0,8,mixedType,1
3,8,0,11,mixedType,1
8,2,0,10,mixedType,1
6,3,0,9,mixedType,1
1,10,0,11,mixedType,1
4,4,0,8,mixedType,1
6,2,0,8,mixedType,1
6,1,0,7,mixedType,0
14,2,0,16,mixedType,2
6,2,0,8,mixedType,1
1,9,0,10,mixedType,1
4,2,0,6,mixedType,0
7,1,0,8,mixedType,1
4,6,0,10,mixedType,1
7,2,0,9,mixedType,1
6,2,0,8,mixedType,1
5,2,0,7,mixedType,0
4,6,0,10,mixedType,1
7,1,0,8,mixedType,1
8,4,0,12,mixedType,1
8,2,0,10,mixedType,1
9,1,0,10,mixedType,1
6,3,0,9,mixedType,1
12,4,0,16,mixedType,2
1,8,0,9,mixedType,1
3,6,0,9,mixedType,1
5,2,0,7,mixedType,0
8,2,0,10,mixedType,1
9,3,0,12,mixedType,1
5,2,0,7,mixedType,0
5,5,0,10,mixedType,1
5,4,0,9,mixedType,1
2,8,0,10,mixedType,1
12,4,0,16,mixedType,2
11,5,0,16,mixedType,2
3,6,0,9,mixedType,1
4,6,0,10,mixedType,1
12,3,0,15,mixedType,2
6,4,0,10,mixedType,1
7,5,0,12,mixedType,1
13,3,0,16,mixedType,2
8,1,0,9,mixedType,1
6,1,0,7,mixedType,0
3,7,0,10,mixedType,1
5,3,0,8,mixedType,1
13,3,0,16,mixedType,2
6,2,0,8,mixedType,1
5,7,0,12,mixedType,1
6,2,0,8,mixedType,1
7,3,0,10,mixedType,1
1,8,0,9,mixedType,1
6,2,0,8,mixedType,1
8,1,0,9,mixedType,1
12,3,0,15,mixedType,2
5,3,0,8,mixedType,1
5,6,0,11,mixedType,1
7,2,0,9,mixedType,1
6,3,0,9,mixedType,1
6,3,0,9,mixedType,1
5,4,0,9,mixedType,1
12,4,0,16,mixedType,2
6,1,0,7,mixedType,0
7,2,0,9,mixedType,1
1,9,0,10,mixedType,1
3,8,0,11,mixedType,1
8,1,0,9,mixedType,1
8,1,0,9,mixedType,1
14,2,0,16,mixedType,2
4,8,0,12,mixedType,1
5,3,0,8,mixedType,1
8,2,0,10,mixedType,1
8,2,0,10,mixedType,1
7,3,0,10,mixedType,1
8,1,0,9,mixedType,1
5,3,0,8,mixedType,1
10,3,0,13,mixedType,1
5,4,0,9,mixedType,1
2,6,0,8,mixedType,1
6,3,0,9,mixedType,1
6,4,0,10,mixedType,1
7,3,0,10,mixedType,1
6,4,0,10,mixedType,1
6,8,0,14,mixedType,2
1,10,0,11,mixedType,1
4,6,0,10,mixedType,1
11,3,0,14,mixedType,2
5,4,0,9,mixedType,1
13,3,0,16,mixedType,2
4,4,0,8,mixedType,1
13,3,0,16,mixedType,2
1,7,0,8,mixedType,1
5,3,0,8,mixedType,1
8,1,0,9,mixedType,1
5,3,0,8,mixedType,1
6,3,0,9,mixedType,1
15,1,0,16,mixedType,2
6,4,0,10,mixedType,1
9,3,0,12,mixedType,1
6,4,0,10,mixedType,1
6,4,0,10,mixedType,1
6,3,0,9,mixedType,1
10,2,0,12,mixedType,1
5,3,0,8,mixedType,1
7,2,0,9,mixedType,1
6,4,0,10,mixedType,1
4,2,0,6,mixedType,0
15,1,0,16,mixedType,2
6,4,0,10,mixedType,1
5,3,0,8,mixedType,1
1,7,0,8,mixedType,1
6,2,0,8,mixedType,1
5,2,0,7,mixedType,0
4,2,0,6,mixedType,0
6,1,0,7,mixedType,0
7,2,0,9,mixedType,1
3,6,0,9,mixedType,1
12,3,0,15,mixedType,2
6,4,0,10,mixedType,1
7,3,0,10,mixedType,1
9,1,0,10,mixedType,1
6,4,0,10,mixedType,1
6,4,0,10,mixedType,1
4,7,0,11,mixedType,1
10,1,0,11,mixedType,1
12,4,0,16,mixedType,2
6,1,0,7,mixedType,0
6,2,0,8,mixedType,1
6,4,0,10,mixedType,1
9,1,0,10,mixedType,1
5,2,0,7,mixedType,0
8,1,0,9,mixedType,1
7,3,0,10,mixedType,1
3,5,0,8,mixedType,1
4,4,0,8,mixedType,1
3,6,0,9,mixedType,1
5,3,0,8,mixedType,1
7,3,0,10,mixedType,1
2,4,0,6,mixedType,0
13,3,0,16,mixedType,2
7,3,0,10,mixedType,1
11,3,0,14,mixedType,2
6,2,0,8,mixedType,1
12,4,0,16,mixedType,2
11,3,0,14,mixedType,2
12,4,0,16,mixedType,2
10,3,0,13,mixedType,1
8,2,0,10,mixedType,1
6,4,0,10,mixedType,1
15,1,0,16,mixedType,2
9,1,0,10,mixedType,1
9,2,0,11,mixedType,1
2,4,0,6,mixedType,0
4,6,0,10,mixedType,1
3,6,0,9,mixedType,1
4,4,0,8,mixedType,1
5,2,0,7,mixedType,0
4,2,0,6,mixedType,0
2,10,0,12,mixedType,1
7,6,0,13,mixedType,1
6,4,0,10,mixedType,1
11,1,0,12,mixedType,1
6,2,0,8,mixedType,1
5,3,0,8,mixedType,1
5,2,0,7,mixedType,0
7,6,0,13,mixedType,1
7,3,0,10,mixedType,1
7,1,0,8,mixedType,1
11,4,0,15,mixedType,2
2,10,0,12,mixedType,1
7,3,0,10,mixedType,1
5,4,0,9,mixedType,1
8,4,0,12,mixedType,1
4,2,0,6,mixedType,0
7,1,0,8,mixedType,1
7,2,0,9,mixedType,1
6,3,0,9,mixedType,1
4,4,0,8,mixedType,1
1,9,0,10,mixedType,1
2,8,0,10,mixedType,1
5,3,0,8,mixedType,1
8,1,0,9,mixedType,1
8,6,0,14,mixedType,2
4,2,0,6,mixedType,0
3,3,0,6,mixedType,0
7,2,0,9,mixedType,1
6,3,0,9,mixedType,1
15,1,0,16,mixedType,2
8,3,0,11,mixedType,1
15,1,0,16,mixedType,2
2,9,0,11,mixedType,1
7,1,0,8,mixedType,1
9,3,0,12,mixedType,1
6,2,0,8,mixedType,1
2,8,0,10,mixedType,1
14,2,0,16,mixedType,2
5,1,0,6,mixedType,0
6,4,0,10,mixedType,1
9,4,0,13,mixedType,1
7,3,0,10,mixedType,1
4,2,0,6,mixedType,0
6,1,0,7,mixedType,0
4,6,0,10,mixedType,1
3,5,0,8,mixedType,1
7,3,0,10,mixedType,1
3,6,0,9,mixedType,1
8,4,0,12,mixedType,1
12,4,0,16,mixedType,2
6,2,0,8,mixedType,1
7,4,0,11,mixedType,1
14,2,0,16,mixedType,2
5,3,0,8,mixedType,1
6,3,0,9,mixedType,1
4,4,0,8,mixedType,1
5,2,0,7,mixedType,0
7,3,0,10,mixedType,1
8,4,0,12,mixedType,1
6,3,0,9,mixedType,1
4,2,0,6,mixedType,0
13,3,0,16,mixedType,2
5,2,0,7,mixedType,0
6,2,0,8,mixedType,1
4,6,0,10,mixedType,1
4,7,0,11,mixedType,1
8,2,0,10,mixedType,1
10,3,0,13,mixedType,1
7,2,0,9,mixedType,1
7,1,0,8,mixedType,1
8,2,0,10,mixedType,1
7,1,0,8,mixedType,1
9,1,0,10,mixedType,1
6,4,0,10,mixedType,1
1,9,0,10,mixedType,1
6,1,0,7,mixedType,0
8,2,0,10,mixedType,1
9,2,0,11,mixedType,1
5,3,0,8,mixedType,1
5,4,0,9,mixedType,1
4,4,0,8,mixedType,1
8,1,0,9,mixedType,1
7,1,0,8,mixedType,1
3,6,0,9,mixedType,1
12,1,0,13,mixedType,1
6,4,0,10,mixedType,1
5,4,0,9,mixedType,1
11,5,0,16,mixedType,2
5,2,0,7,mixedType,0
1,8,0,9,mixedType,1
5,4,0,9,mixedType,1
7,2,0,9,mixedType,1
11,3,0,14,mixedType,2
5,3,0,8,mixedType,1
5,2,0,7,mixedType,0
6,4,0,10,mixedType,1
1,10,0,11,mixedType,1
7,3,0,10,mixedType,1
6,3,0,9,mixedType,1
14,2,0,16,mixedType,2
12,4,0,16,mixedType,2
3,6,0,9,mixedType,1
8,2,0,10,mixedType,1
6,3,0,9,mixedType,1
8,2,0,10,mixedType,1
2,6,0,8,mixedType,1
5,1,0,6,mixedType,0
7,2,0,9,mixedType,1
13,3,0,16,mixedType,2
3,3,0,6,mixedType,0
6,1,0,7,mixedType,0
9,2,0,11,mixedType,1
13,3,0,16,mixedType,2
4,2,0,6,mixedType,0
7,3,0,10,mixedType,1
4,6,0,10,mixedType,1
7,1,0,8,mixedType,1
7,1,0,8,mixedType,1
4,4,0,8,mixedType,1
5,5,0,10,mixedType,1
13,3,0,16,mixedType,2
6,4,0,10,mixedType,1
7,1,0,8,mixedType,1
4,4,0,8,mixedType,1
9,2,0,11,mixedType,1
6,2,0,8,mixedType,1
3,7,0,10,mixedType,1
14,2,0,16,mixedType,2
6,4,0,10,mixedType,1
8,4,0,12,mixedType,1
11,2,0,13,mixedType,1
8,5,0,13,mixedType,1
11,3,0,14,mixedType,2
14,2,0,16,mixedType,2
3,6,0,9,mixedType,1
5,4,0,9,mixedType,1
6,3,0,9,mixedType,1
6,1,0,7,mixedType,0
7,2,0,9,mixedType,1
8,2,0,10,mixedType,1
7,1,0,8,mixedType,1
7,2,0,9,mixedType,1
3,3,0,6,mixedType,0
3,10,0,13,mixedType,1
7,1,0,8,mixedType,1
5,5,0,10,mixedType,1
7,3,0,10,mixedType,1
5,4,0,9,mixedType,1
6,2,0,8,mixedType,1
5,4,0,9,mixedType,1
6,3,0,9,mixedType,1
4,4,0,8,mixedType,1
7,1,0,8,mixedType,1
7,0,1,8,mixedType,1
6,2,0,8,mixedType,1
8,1,0,9,mixedType,1
7,5,0,12,mixedType,1
7,1,0,8,mixedType,1
5,3,0,8,mixedType,1
5,3,0,8,mixedType,1
14,2,0,16,mixedType,2
4,4,0,8,mixedType,1
6,1,0,7,mixedType,0
7,3,0,10,mixedType,1
6,1,0,7,mixedType,0
6,1,0,7,mixedType,0
4,6,0,10,mixedType,1
2,8,0,10,mixedType,1
8,1,0,9,mixedType,1
6,4,0,10,mixedType,1
6,3,0,9,mixedType,1
4,4,0,8,mixedType,1
7,4,0,11,mixedType,1
9,2,0,11,mixedType,1
6,3,0,9,mixedType,1
5,5,0,10,mixedType,1
12,4,0,16,mixedType,2
7,2,0,9,mixedType,1
6,1,0,7,mixedType,0
4,2,0,6,mixedType,0
7,3,0,10,mixedType,1
5,2,0,7,mixedType,0
7,1,0,8,mixedType,1
5,4,0,9,mixedType,1
6,4,0,10,mixedType,1
9,3,0,12,mixedType,1
7,3,0,10,mixedType,1
1,7,0,8,mixedType,1
6,3,0,9,mixedType,1
5,4,0,9,mixedType,1
6,3,0,9,mixedType,1
8,2,0,10,mixedType,1
4,2,0,6,mixedType,0
2,6,0,8,mixedType,1
6,3,0,9,mixedType,1
6,6,0,12,mixedType,1
6,3,0,9,mixedType,1
6,3,0,9,mixedType,1
4,2,0,6,mixedType,0
9,4,0,13,mixedType,1
5,4,0,9,mixedType,1
8,1,0,9,mixedType,1
5,1,0,6,mixedType,0
8,2,0,10,mixedType,1
10,2,0,12,mixedType,1
8,1,0,9,mixedType,1
3,5,0,8,mixedType,1
12,1,0,13,mixedType,1
15,1,0,16,mixedType,2
6,1,0,7,mixedType,0
14,2,0,16,mixedType,2
7,1,0,8,mixedType,1
9,1,0,10,mixedType,1
2,6,0,8,mixedType,1
9,1,0,10,mixedType,1
8,2,0,10,mixedType,1
6,1,0,7,mixedType,0
6,1,0,7,mixedType,0
6,3,0,9,mixedType,1
7,3,0,10,mixedType,1
2,7,0,9,mixedType,1
7,3,0,10,mixedType,1
7,1,0,8,mixedType,1
8,2,0,10,mixedType,1
5,3,0,8,mixedType,1
2,9,0,11,mixedType,1
5,1,0,6,mixedType,0
6,3,0,9,mixedType,1
6,4,0,10,mixedType,1
8,2,0,10,mixedType,1
6,3,0,9,mixedType,1
4,2,0,6,mixedType,0
10,2,0,12,mixedType,1
6,4,0,10,mixedType,1
5,3,0,8,mixedType,1
5,4,0,9,mixedType,1
9,4,0,13,mixedType,1
6,1,0,7,mixedType,0
9,1,0,10,mixedType,1
7,3,0,10,mixedType,1
5,2,0,7,mixedType,0
7,3,0,10,mixedType,1
7,2,0,9,mixedType,1
5,3,0,8,mixedType,1
9,1,0,10,mixedType,1
7,2,0,9,mixedType,1
10,3,0,13,mixedType,1
6,3,0,9,mixedType,1
4,8,0,12,mixedType,1
5,4,0,9,mixedType,1
2,6,0,8,mixedType,1
8,2,0,10,mixedType,1
7,6,0,13,mixedType,1
1,8,0,9,mixedType,1
6,3,0,9,mixedType,1
5,3,0,8,mixedType,1
5,2,0,7,mixedType,0
8,3,0,11,mixedType,1
6,2,0,8,mixedType,1
1,8,0,9,mixedType,1
8,4,0,12,mixedType,1
5,4,0,9,mixedType,1
7,0,1,8,mixedType,1
9,3,0,12,mixedType,1
13,3,0,16,mixedType,2
13,3,0,16,mixedType,2
6,3,0,9,mixedType,1
9,1,0,10,mixedType,1
3,9,0,12,mixedType,1
13,8,1,22,mixedType,2
9,2,0,11,mixedType,1
7,1,0,8,mixedType,1
7,3,0,10,mixedType,1
9,3,0,12,mixedType,1
6,2,0,8,mixedType,1
6,3,0,9,mixedType,1
4,5,0,9,mixedType,1
12,3,0,15,mixedType,2
1,8,0,9,mixedType,1
9,2,0,11,mixedType,1
5,3,0,8,mixedType,1
8,2,0,10,mixedType,1
4,2,0,6,mixedType,0
6,4,0,10,mixedType,1
5,2,0,7,mixedType,0
8,1,0,9,mixedType,1
8,4,0,12,mixedType,1
8,2,0,10,mixedType,1
8,1,0,9,mixedType,1
3,6,0,9,mixedType,1
8,2,0,10,mixedType,1
8,2,0,10,mixedType,1
6,1,0,7,mixedType,0
7,1,0,8,mixedType,1
2,6,0,8,mixedType,1
4,2,0,6,mixedType,0
5,1,0,6,mixedType,0
6,3,0,9,mixedType,1
6,4,0,10,mixedType,1
3,6,0,9,mixedType,1
1,8,0,9,mixedType,1
4,4,0,8,mixedType,1
6,3,0,9,mixedType,1
3,6,0,9,mixedType,1
1,9,0,10,mixedType,1
7,4,0,11,mixedType,1
7,3,0,10,mixedType,1
6,3,0,9,mixedType,1
5,4,0,9,mixedType,1
7,3,0,10,mixedType,1
7,6,0,13,mixedType,1
6,5,0,11,mixedType,1
6,1,0,7,mixedType,0
6,4,0,10,mixedType,1
1,8,0,9,mixedType,1
5,3,0,8,mixedType,1
2,6,0,8,mixedType,1
6,1,0,7,mixedType,0
6,2,0,8,mixedType,1
6,3,0,9,mixedType,1
6,1,0,7,mixedType,0
7,3,0,10,mixedType,1
7,3,0,10,mixedType,1
8,3,0,11,mixedType,1
15,1,0,16,mixedType,2
6,3,0,9,mixedType,1
8,1,0,9,mixedType,1
6,2,0,8,mixedType,1
3,5,0,8,mixedType,1
6,4,0,10,mixedType,1
12,4,0,16,mixedType,2
1,7,0,8,mixedType,1
5,3,0,8,mixedType,1
2,6,0,8,mixedType,1
6,3,0,9,mixedType,1
8,1,0,9,mixedType,1
4,2,0,6,mixedType,0
2,8,0,10,mixedType,1
5,3,0,8,mixedType,1
6,2,0,8,mixedType,1
1,8,0,9,mixedType,1
4,2,0,6,mixedType,0
11,3,0,14,mixedType,2
4,0,3,7,mixedType,0
4,6,0,10,mixedType,1
5,2,0,7,mixedType,0
13,3,0,16,mixedType,2
5,3,0,8,mixedType,1
1,9,0,10,mixedType,1
6,2,0,8,mixedType,1
9,0,1,10,mixedType,1
6,4,0,10,mixedType,1
7,3,0,10,mixedType,1
4,4,0,8,mixedType,1
6,4,0,10,mixedType,1
6,1,0,7,mixedType,0
1,8,0,9,mixedType,1
7,5,0,12,mixedType,1
5,3,0,8,mixedType,1
8,2,0,10,mixedType,1
6,3,0,9,mixedType,1
5,7,0,12,mixedType,1
8,2,0,10,mixedType,1
8,2,0,10,mixedType,1
3,8,0,11,mixedType,1
6,4,0,10,mixedType,1
6,2,0,8,mixedType,1
6,3,0,9,mixedType,1
6,3,0,9,mixedType,1
6,1,0,7,mixedType,0
1,7,0,8,mixedType,1
12,4,0,16,mixedType,2
9,1,0,10,mixedType,1
1,8,0,9,mixedType,1
6,1,0,7,mixedType,0
5,3,0,8,mixedType,1
5,5,0,10,mixedType,1
5,6,0,11,mixedType,1
8,4,0,12,mixedType,1
8,3,0,11,mixedType,1
9,4,0,13,mixedType,1
9,1,0,10,mixedType,1
11,1,0,12,mixedType,1
4,4,0,8,mixedType,1
11,5,0,16,mixedType,2
5,5,0,10,mixedType,1
5,4,0,9,mixedType,1
9,2,0,11,mixedType,1
5,2,0,7,mixedType,0
8,2,0,10,mixedType,1
3,3,0,6,mixedType,0
10,2,0,12,mixedType,1
4,7,0,11,mixedType,1
6,1,0,7,mixedType,0
9,1,0,10,mixedType,1
6,3,0,9,mixedType,1
3,8,0,11,mixedType,1
6,3,0,9,mixedType,1
7,2,0,9,mixedType,1
4,2,0,6,mixedType,0
11,2,0,13,mixedType,1
4,5,0,9,mixedType,1
5,3,0,8,mixedType,1
7,3,0,10,mixedType,1
15,1,0,16,mixedType,2
7,3,0,10,mixedType,1
5,2,0,7,mixedType,0
3,5,0,8,mixedType,1
9,3,0,12,mixedType,1
4,2,0,6,mixedType,0
6,2,0,8,mixedType,1
7,2,0,9,mixedType,1
6,3,0,9,mixedType,1
6,3,0,9,mixedType,1
5,5,0,10,mixedType,1
7,2,0,9,mixedType,1
5,2,0,7,mixedType,0
3,6,0,9,mixedType,1
5,4,0,9,mixedType,1
6,2,0,8,mixedType,1
8,2,0,10,mixedType,1
12,3,0,15,mixedType,2
6,1,0,7,mixedType,0
3,3,0,6,mixedType,0
10,4,1,15,mixedType,2
15,1,0,16,mixedType,2
8,5,0,13,mixedType,1
4,2,0,6,mixedType,0
3,10,0,13,mixedType,1
10,6,0,16,mixedType,2
6,2,0,8,mixedType,1
9,2,0,11,mixedType,1
7,3,0,10,mixedType,1
6,2,0,8,mixedType,1
7,3,0,10,mixedType,1
5,3,0,8,mixedType,1
5,4,0,9,mixedType,1
6,2,0,8,mixedType,1
6,3,0,9,mixedType,1
7,4,0,11,mixedType,1
6,4,0,10,mixedType,1
2,6,0,8,mixedType,1
5,2,0,7,mixedType,0
12,4,0,16,mixedType,2
8,2,0,10,mixedType,1
4,4,0,8,mixedType,1
6,4,0,10,mixedType,1
8,3,0,11,mixedType,1
8,4,0,12,mixedType,1
6,1,0,7,mixedType,0
5,3,0,8,mixedType,1
6,4,0,10,mixedType,1
8,2,0,10,mixedType,1
6,4,0,10,mixedType,1
2,11,0,13,mixedType,1
2,8,0,10,mixedType,1
13,3,0,16,mixedType,2
7,0,1,8,mixedType,1
4,2,0,6,mixedType,0
6,4,0,10,mixedType,1
9,2,0,11,mixedType,1
3,7,0,10,mixedType,1
6,3,0,9,mixedType,1
14,2,0,16,mixedType,2
7,3,0,10,mixedType,1
4,2,0,6,mixedType,0
8,1,1,10,mixedType,1
6,3,0,9,mixedType,1
4,6,0,10,mixedType,1
6,4,0,10,mixedType,1
6,4,0,10,mixedType,1
5,2,0,7,mixedType,0
6,3,0,9,mixedType,1
13,3,0,16,mixedType,2
10,2,0,12,mixedType,1
7,4,0,11,mixedType,1
8,3,0,11,mixedType,1
1,8,0,9,mixedType,1
1,7,0,8,mixedType,1
5,1,0,6,mixedType,0
2,8,0,10,mixedType,1
9,2,0,11,mixedType,1
7,2,0,9,mixedType,1
6,3,0,9,mixedType,1
8,2,0,10,mixedType,1
6,3,0,9,mixedType,1
8,3,0,11,mixedType,1
5,2,0,7,mixedType,0
11,2,0,13,mixedType,1
6,2,0,8,mixedType,1
5,4,0,9,mixedType,1
5,1,0,6,mixedType,0
5,3,0,8,mixedType,1
4,4,0,8,mixedType,1
8,1,0,9,mixedType,1
7,3,0,10,mixedType,1
7,1,0,8,mixedType,1
13,3,0,16,mixedType,2
8,3,0,11,mixedType,1
7,3,0,10,mixedType,1
6,4,0,10,mixedType,1
6,4,0,10,mixedType,1
15,1,0,16,mixedType,2
7,3,0,10,mixedType,1
6,3,0,9,mixedType,1
8,1,0,9,mixedType,1
3,3,0,6,mixedType,0
7,1,0,8,mixedType,1
6,3,0,9,mixedType,1
7,3,0,10,mixedType,1
5,3,0,8,mixedType,1
8,1,0,9,mixedType,1
6,1,0,7,mixedType,0
4,4,0,8,mixedType,1
8,1,0,9,mixedType,1
3,9,0,12,mixedType,1
7,3,0,10,mixedType,1
5,7,0,12,mixedType,1
5,4,0,9,mixedType,1
8,2,0,10,mixedType,1
9,3,0,12,mixedType,1
6,3,0,9,mixedType,1
5,3,0,8,mixedType,1
12,3,0,15,mixedType,2
7,4,0,11,mixedType,1
1,8,0,9,mixedType,1
7,3,0,10,mixedType,1
5,5,0,10,mixedType,1
7,4,0,11,mixedType,1
8,4,0,12,mixedType,1
7,1,0,8,mixedType,1
11,3,0,14,mixedType,2
7,4,0,11,mixedType,1
6,4,0,10,mixedType,1
11,1,0,12,mixedType,1
10,2,0,12,mixedType,1
5,6,0,11,mixedType,1
7,3,0,10,mixedType,1
8,2,0,10,mixedType,1
6,4,0,10,mixedType,1
9,2,0,11,mixedType,1
9,2,0,11,mixedType,1
7,6,0,13,mixedType,1
8,2,0,10,mixedType,1
5,4,0,9,mixedType,1
5,4,0,9,mixedType,1
1,8,0,9,mixedType,1
6,2,0,8,mixedType,1
5,4,0,9,mixedType,1
5,1,0,6,mixedType,0
9,2,0,11,mixedType,1
0,7,1,8,mixedType,1
6,4,0,10,mixedType,1
6,2,0,8,mixedType,1
4,5,0,9,mixedType,1
7,2,0,9,mixedType,1
4,2,0,6,mixedType,0
6,4,0,10,mixedType,1
5,2,0,7,mixedType,0
10,2,0,12,mixedType,1
12,3,0,15,mixedType,2
7,1,0,8,mixedType,1
10,7,0,17,mixedType,2
14,2,0,16,mixedType,2
4,2,0,6,mixedType,0
7,3,0,10,mixedType,1
7,2,0,9,mixedType,1
5,2,0,7,mixedType,0
4,6,0,10,mixedType,1
8,1,0,9,mixedType,1
7,3,0,10,mixedType,1
6,1,0,7,mixedType,0
5,3,0,8,mixedType,1
6,3,0,9,mixedType,1
7,5,0,12,mixedType,1
5,2,0,7,mixedType,0
6,3,0,9,mixedType,1
2,6,0,8,mixedType,1
2,4,0,6,mixedType,0
9,2,0,11,mixedType,1
5,4,0,9,mixedType,1
12,1,0,13,mixedType,1
7,1,0,8,mixedType,1
5,4,0,9,mixedType,1
6,2,0,8,mixedType,1
8,1,0,9,mixedType,1
6,2,0,8,mixedType,1
5,5,0,10,mixedType,1
1,9,0,10,mixedType,1
8,2,0,10,mixedType,1
6,2,0,8,mixedType,1
6,4,0,10,mixedType,1
8,1,0,9,mixedType,1
3,7,0,10,mixedType,1
4,6,0,10,mixedType,1
6,2,0,8,mixedType,1
4,5,0,9,mixedType,1
9,4,0,13,mixedType,1
6,3,0,9,mixedType,1
6,3,0,9,mixedType,1
6,4,0,10,mixedType,1
8,3,0,11,mixedType,1
5,2,0,7,mixedType,0
5,2,0,7,mixedType,0
8,1,0,9,mixedType,1
6,3,0,9,mixedType,1
6,4,0,10,mixedType,1
6,2,0,8,mixedType,1
3,5,0,8,mixedType,1
13,3,0,16,mixedType,2
11,3,0,14,mixedType,2
8,1,0,9,mixedType,1
6,2,0,8,mixedType,1
6,2,0,8,mixedType,1
8,1,0,9,mixedType,1
3,6,0,9,mixedType,1
13,1,1,15,mixedType,2
2,6,0,8,mixedType,1
3,8,0,11,mixedType,1
4,4,0,8,mixedType,1
12,3,0,15,mixedType,2
1,8,0,9,mixedType,1
9,2,0,11,mixedType,1
7,1,0,8,mixedType,1
7,1,0,8,mixedType,1
9,4,0,13,mixedType,1
7,5,0,12,mixedType,1
6,3,0,9,mixedType,1
7,1,0,8,mixedType,1
2,4,0,6,mixedType,0
6,2,0,8,mixedType,1
5,2,0,7,mixedType,0
15,1,0,16,mixedType,2
7,3,0,10,mixedType,1
9,1,0,10,mixedType,1
4,4,0,8,mixedType,1
5,4,0,9,mixedType,1
12,3,0,15,mixedType,2
5,2,0,7,mixedType,0
6,2,0,8,mixedType,1
3,5,0,8,mixedType,1
5,4,0,9,mixedType,1
6,4,0,10,mixedType,1
5,4,0,9,mixedType,1
9,1,0,10,mixedType,1
5,4,0,9,mixedType,1
10,2,0,12,mixedType,1
5,3,0,8,mixedType,1
6,2,0,8,mixedType,1
14,2,0,16,mixedType,2
7,3,0,10,mixedType,1
6,3,0,9,mixedType,1
14,2,0,16,mixedType,2
6,3,0,9,mixedType,1
5,6,0,11,mixedType,1
5,3,0,8,mixedType,1
6,2,0,8,mixedType,1
7,3,0,10,mixedType,1
4,6,0,10,mixedType,1
15,1,1,17,mixedType,2
5,3,0,8,mixedType,1
8,6,2,16,mixedType,2
8,2,0,10,mixedType,1
6,2,0,8,mixedType,1
8,3,1,12,mixedType,1
4,4,0,8,mixedType,1
13,3,0,16,mixedType,2
12,4,0,16,mixedType,2
4,2,0,6,mixedType,0
9,0,2,11,mixedType,1
8,1,0,9,mixedType,1
10,4,0,14,mixedType,2
10,6,0,16,mixedType,2
6,3,0,9,mixedType,1
8,3,0,11,mixedType,1
2,6,0,8,mixedType,1
8,2,0,10,mixedType,1
7,3,0,10,mixedType,1
6,2,0,8,mixedType,1
8,3,0,11,mixedType,1
5,4,0,9,mixedType,1
3,6,0,9,mixedType,1
7,2,0,9,mixedType,1
5,3,0,8,mixedType,1
5,3,0,8,mixedType,1
7,2,0,9,mixedType,1
1,8,0,9,mixedType,1
9,3,0,12,mixedType,1
5,3,0,8,mixedType,1
6,3,0,9,mixedType,1
6,3,0,9,mixedType,1
8,2,0,10,mixedType,1
12,4,0,16,mixedType,2
3,6,0,9,mixedType,1
8,2,0,10,mixedType,1
9,2,0,11,mixedType,1
4,4,0,8,mixedType,1
7,1,0,8,mixedType,1
6,4,0,10,mixedType,1
9,2,0,11,mixedType,1
4,7,0,11,mixedType,1
6,4,0,10,mixedType,1
5,3,0,8,mixedType,1
12,4,0,16,mixedType,2
2,9,0,11,mixedType,1
14,2,0,16,mixedType,2
6,3,0,9,mixedType,1
6,4,0,10,mixedType,1
7,3,0,10,mixedType,1
7,1,0,8,mixedType,1
5,8,0,13,mixedType,1
4,4,0,8,mixedType,1
8,3,0,11,mixedType,1
14,2,0,16,mixedType,2
3,5,0,8,mixedType,1
4,6,0,10,mixedType,1
6,1,0,7,mixedType,0
8,1,0,9,mixedType,1
9,1,0,10,mixedType,1
4,2,0,6,mixedType,0
4,5,0,9,mixedType,1
8,1,0,9,mixedType,1
4,4,0,8,mixedType,1
2,8,0,10,mixedType,1
5,4,0,9,mixedType,1
7,3,0,10,mixedType,1
4,4,0,8,mixedType,1
6,3,0,9,mixedType,1
2,4,0,6,mixedType,0
4,7,0,11,mixedType,1
12,4,0,16,mixedType,2
12,3,1,16,mixedType,2
9,3,0,12,mixedType,1
8,2,0,10,mixedType,1
15,1,0,16,mixedType,2
5,2,0,7,mixedType,0
3,3,0,6,mixedType,0
1,12,0,13,mixedType,1
8,4,0,12,mixedType,1
7,3,0,10,mixedType,1
3,7,0,10,mixedType,1
8,2,0,10,mixedType,1
7,3,0,10,mixedType,1
6,3,0,9,mixedType,1
1,9,0,10,mixedType,1
12,4,0,16,mixedType,2
8,2,0,10,mixedType,1
11,2,2,15,mixedType,2
7,6,0,13,mixedType,1
8,1,0,9,mixedType,1
10,4,0,14,mixedType,2
5,2,0,7,mixedType,0
6,2,0,8,mixedType,1
2,6,0,8,mixedType,1
8,1,0,9,mixedType,1
8,1,0,9,mixedType,1
7,2,0,9,mixedType,1
6,1,0,7,mixedType,0
12,4,0,16,mixedType,2
7,3,0,10,mixedType,1
4,4,0,8,mixedType,1
8,3,0,11,mixedType,1
7,2,0,9,mixedType,1
7,2,0,9,mixedType,1
3,5,0,8,mixedType,1
3,6,0,9,mixedType,1
1,8,0,9,mixedType,1
5,4,0,9,mixedType,1
4,4,0,8,mixedType,1
8,1,0,9,mixedType,1
1,9,0,10,mixedType,1
14,2,0,16,mixedType,2
4,5,0,9,mixedType,1
6,1,0,7,mixedType,0
9,1,0,10,mixedType,1
6,3,0,9,mixedType,1
7,2,0,9,mixedType,1
6,2,0,8,mixedType,1
3,3,0,6,mixedType,0
8,1,0,9,mixedType,1
4,4,0,8,mixedType,1
6,1,0,7,mixedType,0
8,2,0,10,mixedType,1
9,4,0,13,mixedType,1
6,2,0,8,mixedType,1
6,3,0,9,mixedType,1
6,3,0,9,mixedType,1
6,3,0,9,mixedType,1
7,3,0,10,mixedType,1
8,3,0,11,mixedType,1
5,6,0,11,mixedType,1
14,2,0,16,mixedType,2
6,3,0,9,mixedType,1
6,3,0,9,mixedType,1
8,2,0,10,mixedType,1
6,4,0,10,mixedType,1
4,2,0,6,mixedType,0
6,1,0,7,mixedType,0
3,10,0,13,mixedType,1
5,2,0,7,mixedType,0
12,4,0,16,mixedType,2
6,1,0,7,mixedType,0
1,8,0,9,mixedType,1
5,2,0,7,mixedType,0
7,2,0,9,mixedType,1
15,1,0,16,mixedType,2
6,5,0,11,mixedType,1
13,3,0,16,mixedType,2
4,6,0,10,mixedType,1
8,1,0,9,mixedType,1
14,2,0,16,mixedType,2
6,2,0,8,mixedType,1
7,1,0,8,mixedType,1
5,2,0,7,mixedType,0
4,7,0,11,mixedType,1
8,2,0,10,mixedType,1
10,3,0,13,mixedType,1
4,4,0,8,mixedType,1
7,3,0,10,mixedType,1
4,2,0,6,mixedType,0
7,3,0,10,mixedType,1
5,3,0,8,mixedType,1
8,1,0,9,mixedType,1
5,1,0,6,mixedType,0
15,1,0,16,mixedType,2
6,2,0,8,mixedType,1
14,2,0,16,mixedType,2
9,1,0,10,mixedType,1
6,1,0,7,mixedType,0
5,4,0,9,mixedType,1
6,4,0,10,mixedType,1
8,2,0,10,mixedType,1
5,6,0,11,mixedType,1
8,2,0,10,mixedType,1
7,3,0,10,mixedType,1
7,6,0,13,mixedType,1
14,2,0,16,mixedType,2
3,7,0,10,mixedType,1
7,3,0,10,mixedType,1
4,4,0,8,mixedType,1
6,4,0,10,mixedType,1
13,3,0,16,mixedType,2
6,4,0,10,mixedType,1
10,4,0,14,mixedType,2
9,1,0,10,mixedType,1
8,2,0,10,mixedType,1
5,3,0,8,mixedType,1
6,2,0,8,mixedType,1
8,3,0,11,mixedType,1
8,4,0,12,mixedType,1
6,4,0,10,mixedType,1
9,1,0,10,mixedType,1
6,3,0,9,mixedType,1
6,3,0,9,mixedType,1
7,3,0,10,mixedType,1
5,2,0,7,mixedType,0
7,3,0,10,mixedType,1
3,9,0,12,mixedType,1
9,1,0,10,mixedType,1
2,8,0,10,mixedType,1
4,2,0,6,mixedType,0
7,3,0,10,mixedType,1
6,1,0,7,mixedType,0
8,2,0,10,mixedType,1
8,2,0,10,mixedType,1
2,6,0,8,mixedType,1
4,2,0,6,mixedType,0
6,4,0,10,mixedType,1
6,2,0,8,mixedType,1
14,2,0,16,mixedType,2
6,4,0,10,mixedType,1
7,3,0,10,mixedType,1
5,4,0,9,mixedType,1
8,4,0,12,mixedType,1
7,3,0,10,mixedType,1
8,1,0,9,mixedType,1
8,2,0,10,mixedType,1
14,2,0,16,mixedType,2
4,4,0,8,mixedType,1
6,3,0,9,mixedType,1
9,3,0,12,mixedType,1
4,5,0,9,mixedType,1
6,6,0,12,mixedType,1
6,2,0,8,mixedType,1
6,3,0,9,mixedType,1
6,4,0,10,mixedType,1
6,3,0,9,mixedType,1
12,3,0,15,mixedType,2
7,2,0,9,mixedType,1
14,2,0,16,mixedType,2
5,1,0,6,mixedType,0
6,3,0,9,mixedType,1
1,8,0,9,mixedType,1
12,4,0,16,mixedType,2
3,6,0,9,mixedType,1
7,1,0,8,mixedType,1
6,4,0,10,mixedType,1
1,11,0,12,mixedType,1
6,4,0,10,mixedType,1
5,4,0,9,mixedType,1
3,7,0,10,mixedType,1
8,2,0,10,mixedType,1
5,3,0,8,mixedType,1
5,7,0,12,mixedType,1
3,6,0,9,mixedType,1
6,4,0,10,mixedType,1
5,3,0,8,mixedType,1
6,4,0,10,mixedType,1
6,6,0,12,mixedType,1
11,5,0,16,mixedType,2
5,4,0,9,mixedType,1
9,1,0,10,mixedType,1
5,3,0,8,mixedType,1
6,3,0,9,mixedType,1
5,3,0,8,mixedType,1
7,3,0,10,mixedType,1
5,2,0,7,mixedType,0
5,2,0,7,mixedType,0
11,3,0,14,mixedType,2
4,5,0,9,mixedType,1
6,4,0,10,mixedType,1
7,3,0,10,mixedType,1
6,3,0,9,mixedType,1
1,8,0,9,mixedType,1
5,2,0,7,mixedType,0
10,6,0,16,mixedType,2
2,7,0,9,mixedType,1
6,3,0,9,mixedType,1
8,2,0,10,mixedType,1
5,4,0,9,mixedType,1
2,10,0,12,mixedType,1
5,1,0,6,mixedType,0
8,1,0,9,mixedType,1
6,2,0,8,mixedType,1
7,4,0,11,mixedType,1
8,1,0,9,mixedType,1
7,3,0,10,mixedType,1
9,4,0,13,mixedType,1
6,2,0,8,mixedType,1
5,6,0,11,mixedType,1
8,1,0,9,mixedType,1
6,4,0,10,mixedType,1
15,2,1,18,mixedType,2
7,1,0,8,mixedType,1
8,4,0,12,mixedType,1
6,1,0,7,mixedType,0
4,4,0,8,mixedType,1
8,2,0,10,mixedType,1
7,3,0,10,mixedType,1
8,1,0,9,mixedType,1
8,2,0,10,mixedType,1
7,1,0,8,mixedType,1
8,2,0,10,mixedType,1
5,1,0,6,mixedType,0
6,2,0,8,mixedType,1
6,3,0,9,mixedType,1
10,1,0,11,mixedType,1
7,3,0,10,mixedType,1
4,2,0,6,mixedType,0
1,7,0,8,mixedType,1
7,3,0,10,mixedType,1
18,1,1,20,mixedType,2
7,3,0,10,mixedType,1
6,1,0,7,mixedType,0
7,2,0,9,mixedType,1
8,2,0,10,mixedType,1
8,1,0,9,mixedType,1
5,3,0,8,mixedType,1
6,3,0,9,mixedType,1
7,3,0,10,mixedType,1
9,3,0,12,mixedType,1
15,1,0,16,mixedType,2
6,3,0,9,mixedType,1
6,1,0,7,mixedType,0
15,1,0,16,mixedType,2
8,3,0,11,mixedType,1
6,3,0,9,mixedType,1
3,3,0,6,mixedType,0
9,1,0,10,mixedType,1
12,0,4,16,mixedType,2
6,1,0,7,mixedType,0
5,4,0,9,mixedType,1
2,8,0,10,mixedType,1
5,2,0,7,mixedType,0
9,1,0,10,mixedType,1
2,4,0,6,mixedType,0
5,4,0,9,mixedType,1
7,1,0,8,mixedType,1
10,2,0,12,mixedType,1
10,2,0,12,mixedType,1
7,3,0,10,mixedType,1
7,3,0,10,mixedType,1
1,8,0,9,mixedType,1
14,2,0,16,mixedType,2
5,4,0,9,mixedType,1
14,2,0,16,mixedType,2
5,3,0,8,mixedType,1
6,2,0,8,mixedType,1
8,1,0,9,mixedType,1
7,4,0,11,mixedType,1
10,1,0,11,mixedType,1
6,3,0,9,mixedType,1
5,3,0,8,mixedType,1
9,3,0,12,mixedType,1
5,2,0,7,mixedType,0
5,2,0,7,mixedType,0
6,2,0,8,mixedType,1
9,1,0,10,mixedType,1
2,6,0,8,mixedType,1
2,10,0,12,mixedType,1
6,4,0,10,mixedType,1
9,1,0,10,mixedType,1
8,1,0,9,mixedType,1
4,2,0,6,mixedType,0
5,4,0,9,mixedType,1
7,3,0,10,mixedType,1
5,8,0,13,mixedType,1
5,1,0,6,mixedType,0
2,8,0,10,mixedType,1
5,2,0,7,mixedType,0
6,3,0,9,mixedType,1
6,3,0,9,mixedType,1
2,4,0,6,mixedType,0
8,2,0,10,mixedType,1
7,3,0,10,mixedType,1
9,1,0,10,mixedType,1
7,2,0,9,mixedType,1
6,4,0,10,mixedType,1
8,1,0,9,mixedType,1
1,9,0,10,mixedType,1
6,3,0,9,mixedType,1
14,2,0,16,mixedType,2
5,6,0,11,mixedType,1
6,4,0,10,mixedType,1
7,6,0,13,mixedType,1
7,0,0,7,sameType,0
5,2,0,7,mixedType,0
7,2,0,9,mixedType,1
6,1,0,7,mixedType,0
8,3,0,11,mixedType,1
6,4,0,10,mixedType,1
9,1,0,10,mixedType,1
8,1,0,9,mixedType,1
15,1,0,16,mixedType,2
6,3,0,9,mixedType,1
7,2,0,9,mixedType,1
7,2,0,9,mixedType,1
4,2,0,6,mixedType,0
3,5,0,8,mixedType,1
6,4,0,10,mixedType,1
8,2,0,10,mixedType,1
6,2,0,8,mixedType,1
5,2,0,7,mixedType,0
7,1,0,8,mixedType,1
6,3,0,9,mixedType,1
6,1,0,7,mixedType,0
7,2,0,9,mixedType,1
6,2,0,8,mixedType,1
4,2,0,6,mixedType,0
9,1,0,10,mixedType,1
9,4,1,14,mixedType,2
10,6,0,16,mixedType,2
4,2,0,6,mixedType,0
13,3,0,16,mixedType,2
6,2,0,8,mixedType,1
5,4,0,9,mixedType,1
1,9,0,10,mixedType,1
6,3,0,9,mixedType,1
3,3,0,6,mixedType,0
8,1,0,9,mixedType,1
8,2,0,10,mixedType,1
10,2,0,12,mixedType,1
2,8,0,10,mixedType,1
5,6,0,11,mixedType,1
6,2,0,8,mixedType,1
13,3,0,16,mixedType,2
7,1,0,8,mixedType,1
5,2,0,7,mixedType,0
12,4,0,16,mixedType,2
7,2,0,9,mixedType,1
5,3,0,8,mixedType,1
7,2,0,9,mixedType,1
6,4,0,10,mixedType,1
9,2,0,11,mixedType,1
12,3,0,15,mixedType,2
5,4,0,9,mixedType,1
8,2,0,10,mixedType,1
5,2,0,7,mixedType,0
6,3,0,9,mixedType,1
6,4,0,10,mixedType,1
6,2,0,8,mixedType,1
3,5,0,8,mixedType,1
1,8,0,9,mixedType,1
1,8,0,9,mixedType,1
5,4,0,9,mixedType,1
4,2,0,6,mixedType,0
5,3,0,8,mixedType,1
8,1,0,9,mixedType,1
2,8,0,10,mixedType,1
4,4,0,8,mixedType,1
1,10,0,11,mixedType,1
4,4,0,8,mixedType,1
1,8,0,9,mixedType,1
6,1,0,7,mixedType,0
5,3,0,8,mixedType,1
9,3,0,12,mixedType,1
7,1,0,8,mixedType,1
2,7,0,9,mixedType,1
4,2,0,6,mixedType,0
7,1,0,8,mixedType,1
12,4,0,16,mixedType,2
7,6,0,13,mixedType,1
6,4,0,10,mixedType,1
8,2,0,10,mixedType,1
6,1,0,7,mixedType,0
4,4,0,8,mixedType,1
2,4,0,6,mixedType,0
4,4,0,8,mixedType,1
12,0,1,13,mixedType,1
5,4,0,9,mixedType,1
3,10,0,13,mixedType,1
6,5,0,11,mixedType,1
10,1,0,11,mixedType,1
3,5,0,8,mixedType,1
4,2,0,6,mixedType,0
15,1,0,16,mixedType,2
7,3,0,10,mixedType,1
4,4,0,8,mixedType,1
6,1,0,7,mixedType,0
6,1,0,7,mixedType,0
6,2,0,8,mixedType,1
6,4,0,10,mixedType,1
5,2,0,7,mixedType,0
6,6,0,12,mixedType,1
8,4,0,12,mixedType,1
6,3,0,9,mixedType,1
4,2,0,6,mixedType,0
12,1,0,13,mixedType,1
9,1,0,10,mixedType,1
2,7,0,9,mixedType,1
8,1,0,9,mixedType,1
7,4,0,11,mixedType,1
7,3,0,10,mixedType,1
15,1,0,16,mixedType,2
8,2,0,10,mixedType,1
6,1,0,7,mixedType,0
8,1,0,9,mixedType,1
7,4,0,11,mixedType,1
7,2,0,9,mixedType,1
1,9,0,10,mixedType,1
9,2,0,11,mixedType,1
5,6,0,11,mixedType,1
6,3,0,9,mixedType,1
6,2,0,8,mixedType,1
7,1,0,8,mixedType,1
10,2,0,12,mixedType,1
7,1,0,8,mixedType,1
12,4,0,16,mixedType,2
6,2,0,8,mixedType,1
7,2,0,9,mixedType,1
8,4,0,12,mixedType,1
9,2,0,11,mixedType,1
8,3,0,11,mixedType,1
7,3,0,10,mixedType,1
6,3,0,9,mixedType,1
9,2,0,11,mixedType,1
4,2,0,6,mixedType,0
7,2,0,9,mixedType,1
6,4,0,10,mixedType,1
1,8,0,9,mixedType,1
6,3,0,9,mixedType,1
5,3,0,8,mixedType,1
7,4,0,11,mixedType,1
8,5,0,13,mixedType,1
7,3,0,10,mixedType,1
5,2,0,7,mixedType,0
3,6,0,9,mixedType,1
4,6,0,10,mixedType,1
9,2,0,11,mixedType,1
5,1,0,6,mixedType,0
5,6,0,11,mixedType,1
5,1,0,6,mixedType,0
6,2,0,8,mixedType,1
10,2,0,12,mixedType,1
5,4,0,9,mixedType,1
4,2,0,6,mixedType,0
6,4,0,10,mixedType,1
1,7,0,8,mixedType,1
7,2,0,9,mixedType,1
5,3,0,8,mixedType,1
4,2,0,6,mixedType,0
10,2,0,12,mixedType,1
7,1,0,8,mixedType,1
18,1,1,20,mixedType,2
7,3,0,10,mixedType,1
6,4,0,10,mixedType,1
3,6,0,9,mixedType,1
8,1,0,9,mixedType,1
9,3,0,12,mixedType,1
7,1,0,8,mixedType,1
10,3,0,13,mixedType,1
8,1,0,9,mixedType,1
7,3,0,10,mixedType,1
14,2,0,16,mixedType,2
13,3,0,16,mixedType,2
15,1,0,16,mixedType,2
1,9,0,10,mixedType,1
7,3,0,10,mixedType,1
13,3,0,16,mixedType,2
14,2,0,16,mixedType,2
7,2,0,9,mixedType,1
7,2,0,9,mixedType,1
4,4,0,8,mixedType,1
14,2,0,16,mixedType,2
5,4,0,9,mixedType,1
5,4,0,9,mixedType,1
5,2,0,7,mixedType,0
8,3,0,11,mixedType,1
5,2,0,7,mixedType,0
5,3,0,8,mixedType,1
5,3,0,8,mixedType,1
6,1,0,7,mixedType,0
9,1,0,10,mixedType,1
6,2,0,8,mixedType,1
10,3,0,13,mixedType,1
9,4,0,13,mixedType,1
7,3,0,10,mixedType,1
9,1,0,10,mixedType,1
4,5,0,9,mixedType,1
5,3,0,8,mixedType,1
9,3,0,12,mixedType,1
4,2,0,6,mixedType,0
6,6,0,12,mixedType,1
2,6,0,8,mixedType,1
6,2,0,8,mixedType,1
4,8,0,12,mixedType,1
5,3,0,8,mixedType,1
5,2,0,7,mixedType,0
9,3,0,12,mixedType,1
4,4,0,8,mixedType,1
4,2,0,6,mixedType,0
7,3,0,10,mixedType,1
6,2,0,8,mixedType,1
6,4,0,10,mixedType,1
7,3,0,10,mixedType,1
9,1,0,10,mixedType,1
5,3,0,8,mixedType,1
7,3,0,10,mixedType,1
11,1,0,12,mixedType,1
2,4,0,6,mixedType,0
6,4,0,10,mixedType,1
9,4,0,13,mixedType,1
6,1,0,7,mixedType,0
7,2,0,9,mixedType,1
8,4,0,12,mixedType,1
4,2,0,6,mixedType,0
15,1,0,16,mixedType,2
6,2,0,8,mixedType,1
12,7,1,20,mixedType,2
6,3,0,9,mixedType,1
6,2,0,8,mixedType,1
5,1,0,6,mixedType,0
15,1,0,16,mixedType,2
5,5,0,10,mixedType,1
9,2,0,11,mixedType,1
6,3,0,9,mixedType,1
3,7,0,10,mixedType,1
5,1,0,6,mixedType,0
3,7,0,10,mixedType,1
11,1,0,12,mixedType,1
5,1,0,6,mixedType,0
5,3,0,8,mixedType,1
8,1,0,9,mixedType,1
4,6,0,10,mixedType,1
7,2,0,9,mixedType,1
7,4,0,11,mixedType,1
5,8,0,13,mixedType,1
5,3,0,8,mixedType,1
7,3,0,10,mixedType,1
9,3,0,12,mixedType,1
6,3,0,9,mixedType,1
5,2,0,7,mixedType,0
4,8,0,12,mixedType,1
4,2,0,6,mixedType,0
1,7,0,8,mixedType,1
5,4,0,9,mixedType,1
7,1,0,8,mixedType,1
7,3,0,10,mixedType,1
14,2,0,16,mixedType,2
8,2,0,10,mixedType,1
1,8,0,9,mixedType,1
6,6,0,12,mixedType,1
8,2,0,10,mixedType,1
3,8,0,11,mixedType,1
8,4,0,12,mixedType,1
8,3,0,11,mixedType,1
4,4,0,8,mixedType,1
7,3,0,10,mixedType,1
9,1,0,10,mixedType,1
14,2,0,16,mixedType,2
5,6,0,11,mixedType,1
6,4,0,10,mixedType,1
8,2,0,10,mixedType,1
5,4,0,9,mixedType,1
4,4,0,8,mixedType,1
6,2,0,8,mixedType,1
6,5,0,11,mixedType,1
3,6,0,9,mixedType,1
11,3,0,14,mixedType,2
12,3,0,15,mixedType,2
7,4,0,11,mixedType,1
9,3,0,12,mixedType,1
4,2,0,6,mixedType,0
6,3,0,9,mixedType,1
5,3,0,8,mixedType,1
6,2,0,8,mixedType,1
8,2,0,10,mixedType,1
3,6,0,9,mixedType,1
6,4,0,10,mixedType,1
6,4,0,10,mixedType,1
6,4,0,10,mixedType,1
6,2,0,8,mixedType,1
6,7,0,13,mixedType,1
8,2,0,10,mixedType,1
8,2,0,10,mixedType,1
8,1,0,9,mixedType,1
12,4,0,16,mixedType,2
6,4,0,10,mixedType,1
7,2,0,9,mixedType,1
7,6,0,13,mixedType,1
6,4,0,10,mixedType,1
6,4,0,10,mixedType,1
6,4,0,10,mixedType,1
6,2,0,8,mixedType,1
5,4,0,9,mixedType,1
5,3,0,8,mixedType,1
6,2,0,8,mixedType,1
6,2,0,8,mixedType,1
8,1,0,9,mixedType,1
1,7,0,8,mixedType,1
14,2,0,16,mixedType,2
6,3,0,9,mixedType,1
2,8,0,10,mixedType,1
8,2,0,10,mixedType,1
5,2,0,7,mixedType,0
6,4,0,10,mixedType,1
8,2,0,10,mixedType,1
1,12,0,13,mixedType,1
4,2,0,6,mixedType,0
9,3,0,12,mixedType,1
6,2,0,8,mixedType,1
8,1,0,9,mixedType,1
11,3,0,14,mixedType,2
6,1,0,7,mixedType,0
8,2,0,10,mixedType,1
5,4,0,9,mixedType,1
6,3,0,9,mixedType,1
9,1,0,10,mixedType,1
6,2,0,8,mixedType,1
6,1,0,7,mixedType,0
2,8,0,10,mixedType,1
7,1,0,8,mixedType,1
7,3,0,10,mixedType,1
5,3,0,8,mixedType,1
3,8,0,11,mixedType,1
11,3,0,14,mixedType,2
6,4,0,10,mixedType,1
15,1,0,16,mixedType,2
7,3,0,10,mixedType,1
13,3,0,16,mixedType,2
9,4,0,13,mixedType,1
7,2,0,9,mixedType,1
6,1,0,7,mixedType,0
6,2,0,8,mixedType,1
5,8,0,13,mixedType,1
6,3,0,9,mixedType,1
5,2,0,7,mixedType,0
3,9,0,12,mixedType,1
5,4,0,9,mixedType,1
8,3,0,11,mixedType,1
4,4,0,8,mixedType,1
4,8,0,12,mixedType,1
6,3,0,9,mixedType,1
2,6,0,8,mixedType,1
12,1,0,13,mixedType,1
11,4,1,16,mixedType,2
6,3,0,9,mixedType,1
8,2,0,10,mixedType,1
8,3,0,11,mixedType,1
5,1,0,6,mixedType,0
6,3,0,9,mixedType,1
8,4,0,12,mixedType,1
1,9,0,10,mixedType,1
7,2,0,9,mixedType,1
12,3,0,15,mixedType,2
4,4,0,8,mixedType,1
3,6,0,9,mixedType,1
8,1,0,9,mixedType,1
6,6,0,12,mixedType,1
6,6,0,12,mixedType,1
6,4,0,10,mixedType,1
6,3,0,9,mixedType,1
9,4,0,13,mixedType,1
8,1,0,9,mixedType,1
5,2,0,7,mixedType,0
11,2,0,13,mixedType,1
3,6,0,9,mixedType,1
4,2,0,6,mixedType,0
6,3,0,9,mixedType,1
3,7,0,10,mixedType,1
4,2,0,6,mixedType,0
2,9,0,11,mixedType,1
7,3,0,10,mixedType,1
8,2,0,10,mixedType,1
7,2,0,9,mixedType,1
13,3,0,16,mixedType,2
2,4,0,6,mixedType,0
7,2,0,9,mixedType,1
1,10,0,11,mixedType,1
10,4,0,14,mixedType,2
4,4,0,8,mixedType,1
6,2,0,8,mixedType,1
6,3,0,9,mixedType,1
7,3,0,10,mixedType,1
6,4,0,10,mixedType,1
6,3,0,9,mixedType,1
8,3,0,11,mixedType,1
6,1,0,7,mixedType,0
4,2,0,6,mixedType,0
4,4,0,8,mixedType,1
6,1,0,7,mixedType,0
6,3,0,9,mixedType,1
9,3,0,12,mixedType,1
5,4,0,9,mixedType,1
6,3,0,9,mixedType,1
8,2,0,10,mixedType,1
12,3,0,15,mixedType,2
10,3,0,13,mixedType,1
8,1,0,9,mixedType,1
5,2,0,7,mixedType,0
6,2,0,8,mixedType,1
3,6,0,9,mixedType,1
8,1,0,9,mixedType,1
13,3,0,16,mixedType,2
11,3,2,16,mixedType,2
7,3,0,10,mixedType,1
2,7,0,9,mixedType,1
1,7,0,8,mixedType,1
8,2,0,10,mixedType,1
4,2,0,6,mixedType,0
9,1,0,10,mixedType,1
12,4,0,16,mixedType,2
1,10,0,11,mixedType,1
2,6,0,8,mixedType,1
15,1,0,16,mixedType,2
4,4,0,8,mixedType,1
7,1,0,8,mixedType,1
6,3,0,9,mixedType,1
5,0,1,6,mixedType,0
6,3,0,9,mixedType,1
6,4,0,10,mixedType,1
11,1,0,12,mixedType,1
6,2,0,8,mixedType,1
7,3,0,10,mixedType,1
5,4,0,9,mixedType,1
6,2,0,8,mixedType,1
8,4,0,12,mixedType,1
6,4,0,10,mixedType,1
17,3,2,22,mixedType,2
7,6,0,13,mixedType,1
7,3,0,10,mixedType,1
6,3,0,9,mixedType,1
7,3,0,10,mixedType,1
7,2,0,9,mixedType,1
10,6,0,16,mixedType,2
6,6,0,12,mixedType,1
9,3,0,12,mixedType,1
4,4,0,8,mixedType,1
2,8,0,10,mixedType,1
6,6,0,12,mixedType,1
5,5,0,10,mixedType,1
7,3,0,10,mixedType,1
6,2,0,8,mixedType,1
14,2,0,16,mixedType,2
5,3,0,8,mixedType,1
4,2,0,6,mixedType,0
5,2,0,7,mixedType,0
2,9,0,11,mixedType,1
6,4,0,10,mixedType,1
8,2,0,10,mixedType,1
10,2,0,12,mixedType,1
7,3,0,10,mixedType,1
14,2,0,16,mixedType,2
5,3,0,8,mixedType,1
7,2,0,9,mixedType,1
9,1,0,10,mixedType,1
1,8,0,9,mixedType,1
0,6,1,7,mixedType,0
4,2,0,6,mixedType,0
15,1,0,16,mixedType,2
5,2,0,7,mixedType,0
6,3,0,9,mixedType,1
3,6,0,9,mixedType,1
8,2,0,10,mixedType,1
5,3,0,8,mixedType,1
8,1,0,9,mixedType,1
9,2,0,11,mixedType,1
3,3,0,6,mixedType,0
11,4,0,15,mixedType,2
3,5,0,8,mixedType,1
6,3,0,9,mixedType,1
6,2,0,8,mixedType,1
1,5,0,6,mixedType,0
12,4,0,16,mixedType,2
6,3,0,9,mixedType,1
13,3,0,16,mixedType,2
7,3,0,10,mixedType,1
8,1,0,9,mixedType,1
10,3,0,13,mixedType,1
5,2,0,7,mixedType,0
9,3,0,12,mixedType,1
5,1,0,6,mixedType,0
7,2,0,9,mixedType,1
2,6,0,8,mixedType,1
6,2,0,8,mixedType,1
2,6,0,8,mixedType,1
8,1,0,9,mixedType,1
13,3,0,16,mixedType,2
6,4,0,10,mixedType,1
5,3,0,8,mixedType,1
6,1,0,7,mixedType,0
7,3,0,10,mixedType,1
6,3,0,9,mixedType,1
11,5,0,16,mixedType,2
6,3,0,9,mixedType,1
12,3,0,15,mixedType,2
7,2,0,9,mixedType,1
4,4,0,8,mixedType,1
5,4,0,9,mixedType,1
12,4,0,16,mixedType,2
4,6,0,10,mixedType,1
7,4,0,11,mixedType,1
8,3,0,11,mixedType,1
6,4,0,10,mixedType,1
8,1,0,9,mixedType,1
8,2,0,10,mixedType,1
1,8,0,9,mixedType,1
7,2,0,9,mixedType,1
5,2,0,7,mixedType,0
6,3,0,9,mixedType,1
6,4,0,10,mixedType,1
8,3,0,11,mixedType,1
1,7,0,8,mixedType,1
7,2,0,9,mixedType,1
6,3,0,9,mixedType,1
5,1,0,6,mixedType,0
11,3,0,14,mixedType,2
4,6,0,10,mixedType,1
6,2,0,8,mixedType,1
11,2,0,13,mixedType,1
7,1,0,8,mixedType,1
15,1,0,16,mixedType,2
8,3,0,11,mixedType,1
8,2,0,10,mixedType,1
15,1,0,16,mixedType,2
3,6,0,9,mixedType,1
5,4,0,9,mixedType,1
7,3,0,10,mixedType,1
5,4,0,9,mixedType,1
7,2,0,9,mixedType,1
8,3,0,11,mixedType,1
5,3,0,8,mixedType,1
5,1,0,6,mixedType,0
5,5,0,10,mixedType,1
6,1,0,7,mixedType,0
1,9,0,10,mixedType,1
9,3,0,12,mixedType,1
7,2,0,9,mixedType,1
12,4,0,16,mixedType,2
9,3,0,12,mixedType,1
4,4,0,8,mixedType,1
6,1,0,7,mixedType,0
6,4,0,10,mixedType,1
15,1,0,16,mixedType,2
7,2,0,9,mixedType,1
8,3,0,11,mixedType,1
10,0,1,11,mixedType,1
4,6,0,10,mixedType,1
1,7,0,8,mixedType,1
14,2,0,16,mixedType,2
4,4,0,8,mixedType,1
6,3,0,9,mixedType,1
14,2,0,16,mixedType,2
9,3,0,12,mixedType,1
7,4,0,11,mixedType,1
8,3,0,11,mixedType,1
5,1,0,6,mixedType,0
6,2,0,8,mixedType,1
11,2,0,13,mixedType,1
4,2,0,6,mixedType,0
15,1,0,16,mixedType,2
8,4,0,12,mixedType,1
11,2,0,13,mixedType,1
8,2,0,10,mixedType,1
1,8,0,9,mixedType,1
5,4,0,9,mixedType,1
2,6,0,8,mixedType,1
5,2,0,7,mixedType,0
8,2,0,10,mixedType,1
14,1,0,15,mixedType,2
2,7,0,9,mixedType,1
7,1,0,8,mixedType,1
1,5,0,6,mixedType,0
5,1,0,6,mixedType,0
5,3,0,8,mixedType,1
6,3,0,9,mixedType,1
4,6,0,10,mixedType,1
7,3,0,10,mixedType,1
6,3,0,9,mixedType,1
8,3,0,11,mixedType,1
7,3,0,10,mixedType,1
9,2,0,11,mixedType,1
14,2,0,16,mixedType,2
2,8,0,10,mixedType,1
7,3,0,10,mixedType,1
9,1,0,10,mixedType,1
7,2,0,9,mixedType,1
7,3,0,10,mixedType,1
6,4,0,10,mixedType,1
8,1,0,9,mixedType,1
9,2,0,11,mixedType,1
6,3,0,9,mixedType,1
9,4,0,13,mixedType,1
14,2,0,16,mixedType,2
5,4,0,9,mixedType,1
6,3,0,9,mixedType,1
5,2,0,7,mixedType,0
5,3,0,8,mixedType,1
10,7,0,17,mixedType,2
6,2,0,8,mixedType,1
2,4,0,6,mixedType,0
4,2,0,6,mixedType,0
1,9,0,10,mixedType,1
7,4,0,11,mixedType,1
11,3,0,14,mixedType,2
7,2,0,9,mixedType,1
10,2,0,12,mixedType,1
6,2,0,8,mixedType,1
7,3,0,10,mixedType,1
5,3,0,8,mixedType,1
7,2,0,9,mixedType,1
3,8,0,11,mixedType,1
7,3,0,10,mixedType,1
9,2,0,11,mixedType,1
10,3,0,13,mixedType,1
14,2,0,16,mixedType,2
11,4,0,15,mixedType,2
5,4,0,9,mixedType,1
12,4,0,16,mixedType,2
8,1,0,9,mixedType,1
4,4,0,8,mixedType,1
14,2,0,16,mixedType,2
7,3,0,10,mixedType,1
3,3,0,6,mixedType,0
9,2,0,11,mixedType,1
5,4,0,9,mixedType,1
14,2,0,16,mixedType,2
6,2,0,8,mixedType,1
4,4,0,8,mixedType,1
4,4,0,8,mixedType,1
7,1,0,8,mixedType,1
7,3,0,10,mixedType,1
8,4,0,12,mixedType,1
4,4,0,8,mixedType,1
6,2,0,8,mixedType,1
8,3,0,11,mixedType,1
11,1,0,12,mixedType,1
4,2,0,6,mixedType,0
13,3,0,16,mixedType,2
6,3,0,9,mixedType,1
13,3,0,16,mixedType,2
8,1,0,9,mixedType,1
5,3,0,8,mixedType,1
7,2,0,9,mixedType,1
11,3,0,14,mixedType,2
6,2,0,8,mixedType,1
13,3,0,16,mixedType,2
4,2,0,6,mixedType,0
9,2,0,11,mixedType,1
4,2,0,6,mixedType,0
5,2,0,7,mixedType,0
5,4,0,9,mixedType,1
14,2,0,16,mixedType,2
5,3,0,8,mixedType,1
7,3,0,10,mixedType,1
12,1,0,13,mixedType,1
4,4,0,8,mixedType,1
9,1,0,10,mixedType,1
5,1,0,6,mixedType,0
6,2,0,8,mixedType,1
11,3,0,14,mixedType,2
6,3,0,9,mixedType,1
2,7,0,9,mixedType,1
9,2,0,11,mixedType,1
9,3,0,12,mixedType,1
15,1,0,16,mixedType,2
11,3,0,14,mixedType,2
6,1,0,7,mixedType,0
13,3,0,16,mixedType,2
7,3,0,10,mixedType,1
7,5,0,12,mixedType,1
8,2,0,10,mixedType,1
6,3,0,9,mixedType,1
7,3,0,10,mixedType,1
5,4,0,9,mixedType,1
6,2,0,8,mixedType,1
11,3,0,14,mixedType,2
6,3,0,9,mixedType,1
11,2,0,13,mixedType,1
5,4,0,9,mixedType,1
6,3,0,9,mixedType,1
9,2,0,11,mixedType,1
6,2,0,8,mixedType,1
12,3,0,15,mixedType,2
7,3,0,10,mixedType,1
6,2,0,8,mixedType,1
5,3,0,8,mixedType,1
8,1,0,9,mixedType,1
7,3,0,10,mixedType,1
7,3,0,10,mixedType,1
6,1,0,7,mixedType,0
15,1,0,16,mixedType,2
2,6,0,8,mixedType,1
6,1,0,7,mixedType,0
8,2,0,10,mixedType,1
5,7,0,12,mixedType,1
9,1,0,10,mixedType,1
6,1,0,7,mixedType,0
14,2,0,16,mixedType,2
12,3,0,15,mixedType,2
7,2,0,9,mixedType,1
7,3,0,10,mixedType,1
8,2,0,10,mixedType,1
11,3,0,14,mixedType,2
6,1,0,7,mixedType,0
6,2,0,8,mixedType,1
8,2,0,10,mixedType,1
6,3,0,9,mixedType,1
1,8,0,9,mixedType,1
8,2,0,10,mixedType,1
11,1,0,12,mixedType,1
5,3,0,8,mixedType,1
8,2,0,10,mixedType,1
6,1,0,7,mixedType,0
5,1,0,6,mixedType,0
8,1,0,9,mixedType,1
2,6,0,8,mixedType,1
6,4,0,10,mixedType,1
8,2,0,10,mixedType,1
3,6,0,9,mixedType,1
4,6,0,10,mixedType,1
14,2,0,16,mixedType,2
7,1,0,8,mixedType,1
14,2,0,16,mixedType,2
6,2,0,8,mixedType,1
8,3,0,11,mixedType,1
10,2,0,12,mixedType,1
9,1,0,10,mixedType,1
4,2,0,6,mixedType,0
6,4,0,10,mixedType,1
9,1,0,10,mixedType,1
6,2,0,8,mixedType,1
14,2,0,16,mixedType,2
11,3,0,14,mixedType,2
7,6,0,13,mixedType,1
4,5,0,9,mixedType,1
8,1,0,9,mixedType,1
5,4,0,9,mixedType,1
6,1,0,7,mixedType,0
4,2,0,6,mixedType,0
2,10,0,12,mixedType,1
5,1,0,6,mixedType,0
8,2,0,10,mixedType,1
7,2,0,9,mixedType,1
8,2,0,10,mixedType,1
6,3,0,9,mixedType,1
6,1,0,7,mixedType,0
3,8,0,11,mixedType,1
5,4,0,9,mixedType,1
7,3,0,10,mixedType,1
5,2,0,7,mixedType,0
5,3,0,8,mixedType,1
8,1,0,9,mixedType,1
11,0,1,12,mixedType,1
8,3,0,11,mixedType,1
6,3,0,9,mixedType,1
2,3,0,5,mixedType,0
4,2,0,6,mixedType,0
11,3,0,14,mixedType,2
5,4,0,9,mixedType,1
4,2,0,6,mixedType,0
6,1,0,7,mixedType,0
6,1,0,7,mixedType,0
2,6,0,8,mixedType,1
2,6,0,8,mixedType,1
5,5,0,10,mixedType,1
5,6,0,11,mixedType,1
12,4,0,16,mixedType,2
7,2,0,9,mixedType,1
1,10,0,11,mixedType,1
12,3,0,15,mixedType,2
8,1,0,9,mixedType,1
5,3,0,8,mixedType,1
14,2,0,16,mixedType,2
7,3,0,10,mixedType,1
5,3,0,8,mixedType,1
6,4,0,10,mixedType,1
12,3,0,15,mixedType,2
15,1,0,16,mixedType,2
7,3,0,10,mixedType,1
7,2,0,9,mixedType,1
5,2,0,7,mixedType,0
5,3,0,8,mixedType,1
8,4,0,12,mixedType,1
5,3,0,8,mixedType,1
5,3,0,8,mixedType,1
8,2,0,10,mixedType,1
9,2,0,11,mixedType,1
8,2,0,10,mixedType,1
8,7,0,15,mixedType,2
1,7,0,8,mixedType,1
9,2,0,11,mixedType,1
7,1,0,8,mixedType,1
8,2,0,10,mixedType,1
8,1,0,9,mixedType,1
5,1,0,6,mixedType,0
5,2,0,7,mixedType,0
5,2,0,7,mixedType,0
4,4,0,8,mixedType,1
6,3,0,9,mixedType,1
14,2,0,16,mixedType,2
4,4,0,8,mixedType,1
4,2,0,6,mixedType,0
6,2,0,8,mixedType,1
11,1,0,12,mixedType,1
1,8,0,9,mixedType,1
5,3,0,8,mixedType,1
15,1,0,16,mixedType,2
8,2,0,10,mixedType,1
3,6,0,9,mixedType,1
11,2,0,13,mixedType,1
5,2,0,7,mixedType,0
5,2,0,7,mixedType,0
8,2,0,10,mixedType,1
5,1,0,6,mixedType,0
6,4,0,10,mixedType,1
8,1,0,9,mixedType,1
15,1,0,16,mixedType,2
7,2,0,9,mixedType,1
6,6,0,12,mixedType,1
8,1,0,9,mixedType,1
8,1,0,9,mixedType,1
5,4,0,9,mixedType,1
2,6,0,8,mixedType,1
5,2,0,7,mixedType,0
4,2,0,6,mixedType,0
6,1,0,7,mixedType,0
7,3,0,10,mixedType,1
5,3,0,8,mixedType,1
7,1,0,8,mixedType,1
13,3,0,16,mixedType,2
5,4,0,9,mixedType,1
5,3,0,8,mixedType,1
12,3,0,15,mixedType,2
6,3,0,9,mixedType,1
6,4,0,10,mixedType,1
14,2,0,16,mixedType,2
10,10,0,20,mixedType,2
2,6,0,8,mixedType,1
6,3,0,9,mixedType,1
3,5,0,8,mixedType,1
12,4,0,16,mixedType,2
9,1,0,10,mixedType,1
7,3,0,10,mixedType,1
5,8,0,13,mixedType,1
1,8,0,9,mixedType,1
13,3,0,16,mixedType,2
15,1,0,16,mixedType,2
9,1,0,10,mixedType,1
6,2,0,8,mixedType,1
4,4,0,8,mixedType,1
3,8,0,11,mixedType,1
12,4,0,16,mixedType,2
12,3,1,16,mixedType,2
6,4,0,10,mixedType,1
9,1,0,10,mixedType,1
14,2,0,16,mixedType,2
14,2,0,16,mixedType,2
8,2,0,10,mixedType,1
8,2,0,10,mixedType,1
6,2,0,8,mixedType,1
6,1,0,7,mixedType,0
7,3,0,10,mixedType,1
8,1,0,9,mixedType,1
4,4,0,8,mixedType,1
5,1,0,6,mixedType,0
3,8,0,11,mixedType,1
8,1,0,9,mixedType,1
11,3,1,15,mixedType,2
8,2,0,10,mixedType,1
5,4,0,9,mixedType,1
8,2,0,10,mixedType,1
9,1,0,10,mixedType,1
7,2,0,9,mixedType,1
8,1,0,9,mixedType,1
6,3,0,9,mixedType,1
4,4,0,8,mixedType,1
8,4,0,12,mixedType,1
6,2,0,8,mixedType,1
14,2,0,16,mixedType,2
5,7,0,12,mixedType,1
7,4,0,11,mixedType,1
5,4,0,9,mixedType,1
6,3,0,9,mixedType,1
10,2,0,12,mixedType,1
6,4,0,10,mixedType,1
14,2,0,16,mixedType,2
5,2,0,7,mixedType,0
8,2,0,10,mixedType,1
4,6,0,10,mixedType,1
10,2,0,12,mixedType,1
13,1,1,15,mixedType,2
1,7,0,8,mixedType,1
7,3,0,10,mixedType,1
5,2,0,7,mixedType,0
10,4,0,14,mixedType,2
2,6,0,8,mixedType,1
5,3,0,8,mixedType,1
6,3,0,9,mixedType,1
1,6,0,7,mixedType,0
11,3,0,14,mixedType,2
5,5,0,10,mixedType,1
14,2,0,16,mixedType,2
7,1,0,8,mixedType,1
7,2,0,9,mixedType,1
8,2,0,10,mixedType,1
9,4,0,13,mixedType,1
6,3,0,9,mixedType,1
7,3,0,10,mixedType,1
1,9,0,10,mixedType,1
8,1,0,9,mixedType,1
3,6,0,9,mixedType,1
6,3,0,9,mixedType,1
6,3,0,9,mixedType,1
1,8,0,9,mixedType,1
3,5,0,8,mixedType,1
8,1,0,9,mixedType,1
9,0,1,10,mixedType,1
6,3,0,9,mixedType,1
8,1,0,9,mixedType,1
7,1,0,8,mixedType,1
7,2,0,9,mixedType,1
14,2,0,16,mixedType,2
7,3,0,10,mixedType,1
6,1,0,7,mixedType,0
2,7,0,9,mixedType,1
7,3,0,10,mixedType,1
9,0,1,10,mixedType,1
6,1,0,7,mixedType,0
3,6,0,9,mixedType,1
6,2,0,8,mixedType,1
14,2,0,16,mixedType,2
5,4,0,9,mixedType,1
3,6,0,9,mixedType,1
6,4,0,10,mixedType,1
5,9,0,14,mixedType,2
5,2,0,7,mixedType,0
7,3,0,10,mixedType,1
9,1,0,10,mixedType,1
9,3,0,12,mixedType,1
7,2,0,9,mixedType,1
6,2,0,8,mixedType,1
2,4,0,6,mixedType,0
3,3,0,6,mixedType,0
11,3,0,14,mixedType,2
7,1,0,8,mixedType,1
7,2,0,9,mixedType,1
8,3,0,11,mixedType,1
6,2,0,8,mixedType,1
6,2,0,8,mixedType,1
9,2,0,11,mixedType,1
7,4,0,11,mixedType,1
4,2,0,6,mixedType,0
8,1,0,9,mixedType,1
6,3,0,9,mixedType,1
5,2,0,7,mixedType,0
5,3,0,8,mixedType,1
4,8,0,12,mixedType,1
5,4,0,9,mixedType,1
11,1,0,12,mixedType,1
8,5,0,13,mixedType,1
5,4,0,9,mixedType,1
4,2,0,6,mixedType,0
1,9,0,10,mixedType,1
5,3,0,8,mixedType,1
7,3,0,10,mixedType,1
5,6,0,11,mixedType,1
8,1,0,9,mixedType,1
4,2,0,6,mixedType,0
14,2,0,16,mixedType,2
6,2,0,8,mixedType,1
4,4,0,8,mixedType,1
20,2,1,23,mixedType,2
6,1,0,7,mixedType,0
6,2,0,8,mixedType,1
6,3,0,9,mixedType,1
15,1,0,16,mixedType,2
6,3,0,9,mixedType,1
4,4,0,8,mixedType,1
7,2,0,9,mixedType,1
7,3,0,10,mixedType,1
2,6,0,8,mixedType,1
12,4,0,16,mixedType,2
6,4,0,10,mixedType,1
15,1,0,16,mixedType,2
6,3,0,9,mixedType,1
6,3,0,9,mixedType,1
4,2,0,6,mixedType,0
2,8,0,10,mixedType,1
2,6,0,8,mixedType,1
9,4,1,14,mixedType,2
5,3,0,8,mixedType,1
6,3,0,9,mixedType,1
4,2,0,6,mixedType,0
9,1,0,10,mixedType,1
8,1,0,9,mixedType,1
7,2,0,9,mixedType,1
6,4,0,10,mixedType,1
6,4,0,10,mixedType,1
4,4,0,8,mixedType,1
7,2,0,9,mixedType,1
6,3,0,9,mixedType,1
5,2,0,7,mixedType,0
7,3,0,10,mixedType,1
11,5,0,16,mixedType,2
10,3,0,13,mixedType,1
7,3,0,10,mixedType,1
4,9,0,13,mixedType,1
9,3,0,12,mixedType,1
5,1,0,6,mixedType,0
7,3,0,10,mixedType,1
5,3,0,8,mixedType,1
2,6,0,8,mixedType,1
7,3,0,10,mixedType,1
6,2,0,8,mixedType,1
6,3,0,9,mixedType,1
5,1,0,6,mixedType,0
4,4,0,8,mixedType,1
7,4,0,11,mixedType,1
5,5,0,10,mixedType,1
6,1,0,7,mixedType,0
13,3,0,16,mixedType,2
7,9,9,25,mixedType,2
7,1,0,8,mixedType,1
14,2,0,16,mixedType,2
10,1,0,11,mixedType,1
6,4,0,10,mixedType,1
5,5,0,10,mixedType,1
5,4,0,9,mixedType,1
7,6,0,13,mixedType,1
7,1,0,8,mixedType,1
5,3,0,8,mixedType,1
5,4,0,9,mixedType,1
5,2,0,7,mixedType,0
6,3,0,9,mixedType,1
4,5,0,9,mixedType,1
7,2,0,9,mixedType,1
14,2,0,16,mixedType,2
1,8,0,9,mixedType,1
9,1,0,10,mixedType,1
7,3,0,10,mixedType,1
14,2,0,16,mixedType,2
7,2,0,9,mixedType,1
1,8,0,9,mixedType,1
10,2,0,12,mixedType,1
7,4,0,11,mixedType,1
6,3,0,9,mixedType,1
13,3,0,16,mixedType,2
6,4,0,10,mixedType,1
8,6,0,14,mixedType,2
14,2,0,16,mixedType,2
2,8,0,10,mixedType,1
7,4,0,11,mixedType,1
6,3,0,9,mixedType,1
4,6,0,10,mixedType,1
6,3,0,9,mixedType,1
7,1,0,8,mixedType,1
8,1,0,9,mixedType,1
5,4,0,9,mixedType,1
5,4,0,9,mixedType,1
7,1,0,8,mixedType,1
9,3,0,12,mixedType,1
5,3,0,8,mixedType,1
6,3,0,9,mixedType,1
14,2,0,16,mixedType,2
4,4,0,8,mixedType,1
7,3,0,10,mixedType,1
3,3,0,6,mixedType,0
5,3,0,8,mixedType,1
14,2,0,16,mixedType,2
3,6,0,9,mixedType,1
4,2,0,6,mixedType,0
5,8,1,14,mixedType,2
7,1,0,8,mixedType,1
0,6,0,6,sameType,0
15,1,0,16,mixedType,2
8,5,0,13,mixedType,1
9,1,0,10,mixedType,1
7,2,0,9,mixedType,1
7,1,0,8,mixedType,1
9,1,0,10,mixedType,1
1,0,1,2,mixedType,0
4,2,0,6,mixedType,0
1,8,0,9,mixedType,1
6,2,0,8,mixedType,1
9,1,0,10,mixedType,1
9,8,0,17,mixedType,2
6,3,0,9,mixedType,1
4,2,0,6,mixedType,0
7,3,0,10,mixedType,1
7,3,0,10,mixedType,1
7,3,0,10,mixedType,1
9,1,0,10,mixedType,1
5,4,0,9,mixedType,1
1,5,0,6,mixedType,0
7,1,0,8,mixedType,1
15,1,0,16,mixedType,2
10,1,0,11,mixedType,1
8,2,0,10,mixedType,1
5,4,0,9,mixedType,1
5,4,0,9,mixedType,1
7,4,0,11,mixedType,1
16,1,1,18,mixedType,2
3,6,0,9,mixedType,1
15,1,0,16,mixedType,2
4,4,0,8,mixedType,1
3,6,0,9,mixedType,1
1,9,0,10,mixedType,1
8,2,0,10,mixedType,1
6,1,0,7,mixedType,0
13,3,0,16,mixedType,2
7,3,0,10,mixedType,1
4,6,0,10,mixedType,1
3,5,0,8,mixedType,1
1,5,0,6,mixedType,0
14,2,0,16,mixedType,2
11,5,0,16,mixedType,2
7,2,0,9,mixedType,1
9,1,0,10,mixedType,1
7,2,0,9,mixedType,1
10,3,0,13,mixedType,1
7,2,0,9,mixedType,1
12,1,0,13,mixedType,1
9,4,0,13,mixedType,1
6,1,0,7,mixedType,0
7,1,0,8,mixedType,1
7,1,0,8,mixedType,1
8,4,0,12,mixedType,1
6,3,0,9,mixedType,1
2,4,0,6,mixedType,0
3,7,0,10,mixedType,1
11,3,0,14,mixedType,2
14,2,0,16,mixedType,2
2,7,0,9,mixedType,1
8,2,0,10,mixedType,1
6,4,0,10,mixedType,1
7,3,0,10,mixedType,1
13,3,0,16,mixedType,2
12,1,0,13,mixedType,1
7,3,0,10,mixedType,1
8,1,0,9,mixedType,1
9,2,0,11,mixedType,1
7,2,0,9,mixedType,1
11,2,0,13,mixedType,1
6,2,0,8,mixedType,1
1,7,0,8,mixedType,1
4,6,0,10,mixedType,1
11,1,0,12,mixedType,1
4,4,0,8,mixedType,1
6,1,0,7,mixedType,0
6,4,0,10,mixedType,1
2,7,0,9,mixedType,1
4,5,0,9,mixedType,1
7,1,0,8,mixedType,1
7,2,0,9,mixedType,1
10,1,0,11,mixedType,1
5,4,0,9,mixedType,1
10,1,0,11,mixedType,1
4,4,0,8,mixedType,1
4,2,0,6,mixedType,0
6,2,0,8,mixedType,1
6,3,0,9,mixedType,1
7,1,0,8,mixedType,1
9,2,0,11,mixedType,1
7,3,0,10,mixedType,1
6,3,0,9,mixedType,1
6,4,0,10,mixedType,1
7,3,0,10,mixedType,1
7,4,0,11,mixedType,1
10,0,1,11,mixedType,1
13,3,0,16,mixedType,2
1,9,0,10,mixedType,1
9,5,0,14,mixedType,2
5,3,0,8,mixedType,1
8,2,0,10,mixedType,1
6,3,0,9,mixedType,1
3,5,0,8,mixedType,1
12,3,0,15,mixedType,2
9,1,0,10,mixedType,1
7,2,0,9,mixedType,1
5,3,0,8,mixedType,1
1,8,0,9,mixedType,1
7,4,0,11,mixedType,1
6,4,0,10,mixedType,1
4,2,0,6,mixedType,0
6,1,0,7,mixedType,0
3,8,0,11,mixedType,1
10,2,0,12,mixedType,1
7,2,0,9,mixedType,1
9,3,0,12,mixedType,1
6,4,0,10,mixedType,1
8,1,0,9,mixedType,1
6,3,0,9,mixedType,1
8,2,0,10,mixedType,1
8,1,0,9,mixedType,1
6,3,0,9,mixedType,1
5,1,0,6,mixedType,0
5,3,0,8,mixedType,1
11,5,0,16,mixedType,2
7,1,0,8,mixedType,1
2,4,0,6,mixedType,0
6,3,0,9,mixedType,1
5,3,0,8,mixedType,1
9,1,0,10,mixedType,1
10,2,0,12,mixedType,1
14,2,0,16,mixedType,2
7,1,0,8,mixedType,1
5,2,0,7,mixedType,0
6,3,0,9,mixedType,1
9,4,0,13,mixedType,1
16,1,1,18,mixedType,2
6,4,0,10,mixedType,1
5,2,0,7,mixedType,0
6,2,0,8,mixedType,1
8,2,0,10,mixedType,1
15,1,0,16,mixedType,2
3,6,0,9,mixedType,1
5,2,0,7,mixedType,0
5,2,0,7,mixedType,0
6,1,0,7,mixedType,0
1,7,0,8,mixedType,1
7,2,0,9,mixedType,1
7,3,0,10,mixedType,1
9,3,0,12,mixedType,1
7,1,0,8,mixedType,1
6,2,0,8,mixedType,1
15,1,0,16,mixedType,2
5,3,0,8,mixedType,1
7,2,0,9,mixedType,1
1,8,0,9,mixedType,1
2,6,0,8,mixedType,1
16,4,0,20,mixedType,2
7,2,0,9,mixedType,1
15,1,0,16,mixedType,2
7,1,0,8,mixedType,1
3,6,0,9,mixedType,1
2,6,0,8,mixedType,1
8,1,0,9,mixedType,1
5,2,0,7,mixedType,0
14,2,0,16,mixedType,2
6,4,0,10,mixedType,1
6,4,0,10,mixedType,1
6,2,0,8,mixedType,1
6,3,0,9,mixedType,1
7,2,0,9,mixedType,1
11,3,0,14,mixedType,2
8,2,0,10,mixedType,1
6,2,0,8,mixedType,1
1,8,0,9,mixedType,1
4,2,0,6,mixedType,0
5,3,0,8,mixedType,1
1,8,0,9,mixedType,1
10,1,0,11,mixedType,1
2,4,0,6,mixedType,0
7,4,0,11,mixedType,1
1,9,0,10,mixedType,1
7,3,0,10,mixedType,1
4,6,0,10,mixedType,1
8,2,0,10,mixedType,1
7,2,0,9,mixedType,1
10,1,0,11,mixedType,1
9,1,0,10,mixedType,1
6,1,0,7,mixedType,0
5,3,0,8,mixedType,1
2,4,0,6,mixedType,0
14,2,0,16,mixedType,2
1,7,0,8,mixedType,1
6,3,0,9,mixedType,1
6,3,0,9,mixedType,1
15,1,0,16,mixedType,2
8,3,0,11,mixedType,1
2,8,0,10,mixedType,1
4,5,0,9,mixedType,1
4,4,0,8,mixedType,1
6,4,0,10,mixedType,1
3,3,0,6,mixedType,0
5,5,0,10,mixedType,1
6,2,0,8,mixedType,1
9,2,0,11,mixedType,1
6,3,0,9,mixedType,1
5,2,0,7,mixedType,0
8,4,0,12,mixedType,1
7,3,0,10,mixedType,1
5,4,0,9,mixedType,1
5,6,0,11,mixedType,1
8,2,0,10,mixedType,1
1,8,0,9,mixedType,1
7,2,0,9,mixedType,1
7,3,0,10,mixedType,1
6,4,0,10,mixedType,1
9,2,0,11,mixedType,1
3,5,0,8,mixedType,1
6,3,0,9,mixedType,1
2,7,0,9,mixedType,1
12,4,0,16,mixedType,2
7,2,0,9,mixedType,1
8,4,0,12,mixedType,1
2,8,0,10,mixedType,1
9,4,0,13,mixedType,1
15,1,0,16,mixedType,2
3,3,0,6,mixedType,0
5,2,0,7,mixedType,0
5,8,0,13,mixedType,1
8,1,0,9,mixedType,1
9,2,0,11,mixedType,1
2,9,0,11,mixedType,1
10,2,0,12,mixedType,1
9,3,0,12,mixedType,1
10,3,0,13,mixedType,1
13,3,0,16,mixedType,2
8,1,0,9,mixedType,1
5,1,0,6,mixedType,0
10,5,3,18,mixedType,2
7,1,0,8,mixedType,1
8,2,0,10,mixedType,1
4,2,0,6,mixedType,0
6,3,0,9,mixedType,1
8,2,0,10,mixedType,1
11,3,0,14,mixedType,2
6,3,0,9,mixedType,1
7,2,0,9,mixedType,1
6,1,0,7,mixedType,0
9,1,0,10,mixedType,1
1,8,0,9,mixedType,1
11,5,0,16,mixedType,2
10,3,0,13,mixedType,1
4,6,0,10,mixedType,1
4,4,0,8,mixedType,1
6,3,0,9,mixedType,1
7,1,0,8,mixedType,1
3,7,0,10,mixedType,1
6,3,0,9,mixedType,1
3,6,0,9,mixedType,1
9,3,0,12,mixedType,1
6,3,0,9,mixedType,1
14,2,0,16,mixedType,2
1,8,0,9,mixedType,1
8,2,0,10,mixedType,1
6,1,0,7,mixedType,0
5,1,0,6,mixedType,0
6,3,0,9,mixedType,1
5,1,0,6,mixedType,0
6,1,0,7,mixedType,0
3,6,0,9,mixedType,1
4,9,1,14,mixedType,2
14,2,0,16,mixedType,2
6,4,0,10,mixedType,1
8,1,0,9,mixedType,1
8,2,0,10,mixedType,1
15,1,0,16,mixedType,2
8,1,0,9,mixedType,1
6,1,0,7,mixedType,0
0,6,2,8,mixedType,1
7,3,0,10,mixedType,1
5,3,0,8,mixedType,1
6,3,0,9,mixedType,1
5,1,0,6,mixedType,0
6,2,0,8,mixedType,1
7,3,0,10,mixedType,1
9,2,0,11,mixedType,1
7,3,0,10,mixedType,1
5,2,0,7,mixedType,0
5,3,0,8,mixedType,1
6,3,0,9,mixedType,1
8,2,0,10,mixedType,1
11,3,0,14,mixedType,2
6,4,0,10,mixedType,1
5,3,0,8,mixedType,1
4,4,0,8,mixedType,1
8,4,0,12,mixedType,1
6,2,0,8,mixedType,1
5,3,0,8,mixedType,1
13,3,0,16,mixedType,2
8,2,0,10,mixedType,1
7,1,0,8,mixedType,1
6,1,0,7,mixedType,0
2,8,0,10,mixedType,1
2,9,0,11,mixedType,1
9,2,0,11,mixedType,1
7,3,0,10,mixedType,1
6,1,0,7,mixedType,0
6,4,0,10,mixedType,1
7,1,0,8,mixedType,1
7,2,0,9,mixedType,1
14,2,0,16,mixedType,2
3,5,0,8,mixedType,1
7,1,0,8,mixedType,1
9,0,1,10,mixedType,1
12,3,0,15,mixedType,2
4,2,0,6,mixedType,0
2,8,0,10,mixedType,1
6,1,0,7,mixedType,0
6,2,0,8,mixedType,1
7,3,0,10,mixedType,1
9,3,1,13,mixedType,1
6,1,0,7,mixedType,0
5,1,0,6,mixedType,0
6,3,0,9,mixedType,1
7,4,0,11,mixedType,1
1,8,0,9,mixedType,1
5,3,0,8,mixedType,1
5,4,0,9,mixedType,1
7,4,0,11,mixedType,1
13,3,0,16,mixedType,2
5,8,0,13,mixedType,1
7,3,0,10,mixedType,1
5,3,0,8,mixedType,1
13,3,0,16,mixedType,2
8,2,0,10,mixedType,1
5,3,0,8,mixedType,1
6,2,0,8,mixedType,1
9,2,0,11,mixedType,1
6,4,0,10,mixedType,1
7,3,0,10,mixedType,1
9,1,0,10,mixedType,1
5,3,0,8,mixedType,1
8,3,0,11,mixedType,1
6,2,0,8,mixedType,1
9,1,0,10,mixedType,1
8,3,0,11,mixedType,1
9,0,1,10,mixedType,1
6,3,0,9,mixedType,1
6,6,0,12,mixedType,1
5,5,0,10,mixedType,1
6,2,0,8,mixedType,1
6,2,0,8,mixedType,1
12,3,0,15,mixedType,2
6,3,0,9,mixedType,1
6,3,0,9,mixedType,1
6,4,0,10,mixedType,1
4,2,0,6,mixedType,0
7,2,0,9,mixedType,1
6,1,0,7,mixedType,0
1,8,0,9,mixedType,1
7,2,0,9,mixedType,1
4,6,0,10,mixedType,1
8,1,0,9,mixedType,1
6,3,0,9,mixedType,1
7,4,0,11,mixedType,1
4,2,0,6,mixedType,0
7,1,0,8,mixedType,1
7,2,0,9,mixedType,1
3,5,0,8,mixedType,1
8,2,0,10,mixedType,1
13,2,1,16,mixedType,2
6,3,0,9,mixedType,1
1,8,0,9,mixedType,1
5,2,0,7,mixedType,0
5,2,0,7,mixedType,0
7,3,0,10,mixedType,1
14,2,0,16,mixedType,2
7,5,0,12,mixedType,1
1,7,0,8,mixedType,1
6,1,0,7,mixedType,0
6,1,0,7,mixedType,0
8,2,0,10,mixedType,1
7,1,0,8,mixedType,1
15,1,0,16,mixedType,2
6,2,0,8,mixedType,1
7,3,0,10,mixedType,1
4,4,0,8,mixedType,1
6,2,0,8,mixedType,1
4,6,0,10,mixedType,1
5,3,0,8,mixedType,1
6,3,0,9,mixedType,1
5,3,0,8,mixedType,1
1,8,0,9,mixedType,1
4,2,0,6,mixedType,0
1,8,0,9,mixedType,1
10,2,0,12,mixedType,1
6,2,0,8,mixedType,1
4,2,0,6,mixedType,0
6,2,0,8,mixedType,1
8,8,0,16,mixedType,2
5,4,0,9,mixedType,1
6,3,0,9,mixedType,1
14,2,0,16,mixedType,2
7,3,0,10,mixedType,1
5,5,0,10,mixedType,1
10,4,0,14,mixedType,2
8,2,0,10,mixedType,1
8,1,0,9,mixedType,1
6,4,0,10,mixedType,1
4,2,0,6,mixedType,0
3,6,0,9,mixedType,1
1,8,0,9,mixedType,1
8,4,0,12,mixedType,1
2,3,0,5,mixedType,0
2,8,0,10,mixedType,1
15,1,0,16,mixedType,2
5,1,0,6,mixedType,0
8,2,0,10,mixedType,1
6,2,0,8,mixedType,1
8,2,0,10,mixedType,1
5,2,0,7,mixedType,0
7,1,0,8,mixedType,1
6,3,0,9,mixedType,1
7,3,0,10,mixedType,1
3,6,0,9,mixedType,1
2,6,0,8,mixedType,1
13,3,0,16,mixedType,2
6,3,0,9,mixedType,1
5,3,0,8,mixedType,1
1,10,0,11,mixedType,1
4,8,0,12,mixedType,1
14,2,0,16,mixedType,2
7,2,0,9,mixedType,1
4,6,0,10,mixedType,1
8,1,0,9,mixedType,1
7,3,0,10,mixedType,1
6,6,0,12,mixedType,1
15,1,0,16,mixedType,2
14,2,0,16,mixedType,2
4,2,0,6,mixedType,0
5,4,0,9,mixedType,1
1,8,0,9,mixedType,1
7,4,0,11,mixedType,1
5,3,0,8,mixedType,1
6,4,0,10,mixedType,1
5,4,0,9,mixedType,1
8,1,0,9,mixedType,1
2,8,0,10,mixedType,1
9,3,0,12,mixedType,1
5,4,0,9,mixedType,1
4,2,0,6,mixedType,0
6,1,0,7,mixedType,0
7,2,0,9,mixedType,1
7,2,0,9,mixedType,1
5,1,0,6,mixedType,0
15,1,0,16,mixedType,2
11,3,0,14,mixedType,2
14,2,0,16,mixedType,2
5,3,0,8,mixedType,1
8,5,0,13,mixedType,1
7,3,0,10,mixedType,1
1,7,0,8,mixedType,1
10,0,1,11,mixedType,1
8,2,0,10,mixedType,1
15,1,0,16,mixedType,2
7,3,0,10,mixedType,1
7,3,0,10,mixedType,1
6,4,0,10,mixedType,1
7,2,0,9,mixedType,1
7,3,0,10,mixedType,1
8,1,0,9,mixedType,1
3,6,0,9,mixedType,1
3,5,0,8,mixedType,1
9,2,0,11,mixedType,1
9,1,0,10,mixedType,1
1,8,0,9,mixedType,1
5,2,0,7,mixedType,0
5,3,0,8,mixedType,1
7,2,0,9,mixedType,1
6,2,0,8,mixedType,1
8,1,0,9,mixedType,1
4,4,0,8,mixedType,1
12,0,1,13,mixedType,1
6,3,0,9,mixedType,1
1,8,0,9,mixedType,1
15,1,0,16,mixedType,2
8,2,0,10,mixedType,1
6,4,0,10,mixedType,1
7,1,0,8,mixedType,1
12,2,1,15,mixedType,2
6,4,0,10,mixedType,1
7,1,0,8,mixedType,1
15,1,0,16,mixedType,2
3,3,0,6,mixedType,0
13,3,0,16,mixedType,2
6,3,0,9,mixedType,1
9,1,0,10,mixedType,1
9,1,0,10,mixedType,1
8,3,0,11,mixedType,1
6,2,0,8,mixedType,1
9,2,0,11,mixedType,1
3,6,0,9,mixedType,1
6,1,0,7,mixedType,0
7,2,0,9,mixedType,1
10,2,0,12,mixedType,1
4,4,0,8,mixedType,1
5,4,0,9,mixedType,1
6,2,0,8,mixedType,1
8,1,0,9,mixedType,1
9,2,0,11,mixedType,1
7,1,0,8,mixedType,1
8,1,0,9,mixedType,1
3,6,0,9,mixedType,1
7,3,0,10,mixedType,1
5,4,0,9,mixedType,1
4,3,0,7,mixedType,0
8,2,0,10,mixedType,1
6,3,0,9,mixedType,1
6,3,0,9,mixedType,1
15,1,0,16,mixedType,2
9,4,0,13,mixedType,1
5,7,0,12,mixedType,1
7,2,0,9,mixedType,1
2,11,0,13,mixedType,1
1,7,0,8,mixedType,1
3,5,0,8,mixedType,1
6,3,0,9,mixedType,1
7,2,0,9,mixedType,1
3,7,0,10,mixedType,1
6,3,0,9,mixedType,1
13,3,0,16,mixedType,2
5,4,0,9,mixedType,1
5,3,0,8,mixedType,1
1,7,0,8,mixedType,1
9,1,0,10,mixedType,1
5,1,0,6,mixedType,0
9,3,0,12,mixedType,1
8,2,0,10,mixedType,1
4,2,0,6,mixedType,0
6,1,0,7,mixedType,0
8,2,0,10,mixedType,1
6,1,0,7,mixedType,0
7,1,0,8,mixedType,1
5,1,0,6,mixedType,0
8,1,0,9,mixedType,1
5,1,0,6,mixedType,0
11,3,0,14,mixedType,2
3,3,0,6,mixedType,0
11,0,1,12,mixedType,1
5,2,0,7,mixedType,0
7,2,0,9,mixedType,1
8,1,0,9,mixedType,1
9,1,0,10,mixedType,1
4,8,0,12,mixedType,1
15,1,1,17,mixedType,2
6,4,0,10,mixedType,1
8,3,0,11,mixedType,1
6,1,0,7,mixedType,0
7,3,0,10,mixedType,1
5,4,0,9,mixedType,1
3,6,0,9,mixedType,1
4,4,0,8,mixedType,1
7,3,0,10,mixedType,1
3,5,0,8,mixedType,1
7,2,0,9,mixedType,1
7,2,0,9,mixedType,1
7,4,0,11,mixedType,1
1,8,0,9,mixedType,1
6,3,0,9,mixedType,1
4,2,0,6,mixedType,0
7,3,0,10,mixedType,1
6,4,0,10,mixedType,1
3,3,0,6,mixedType,0
15,1,0,16,mixedType,2
6,3,0,9,mixedType,1
1,9,0,10,mixedType,1
4,6,0,10,mixedType,1
6,2,0,8,mixedType,1
8,2,0,10,mixedType,1
4,6,0,10,mixedType,1
2,6,0,8,mixedType,1
1,8,0,9,mixedType,1
14,2,0,16,mixedType,2
12,3,0,15,mixedType,2
3,6,0,9,mixedType,1
15,1,0,16,mixedType,2
1,7,0,8,mixedType,1
11,3,0,14,mixedType,2
8,1,0,9,mixedType,1
15,1,0,16,mixedType,2
14,2,0,16,mixedType,2
6,3,0,9,mixedType,1
6,3,0,9,mixedType,1
11,3,0,14,mixedType,2
15,1,0,16,mixedType,2
5,1,0,6,mixedType,0
7,3,0,10,mixedType,1
8,1,0,9,mixedType,1
6,4,0,10,mixedType,1
5,2,0,7,mixedType,0
5,3,0,8,mixedType,1
13,3,0,16,mixedType,2
5,6,0,11,mixedType,1
4,6,0,10,mixedType,1
2,4,0,6,mixedType,0
4,2,0,6,mixedType,0
1,8,0,9,mixedType,1
8,1,0,9,mixedType,1
14,2,0,16,mixedType,2
5,5,0,10,mixedType,1
5,5,0,10,mixedType,1
8,2,0,10,mixedType,1
15,1,0,16,mixedType,2
6,1,0,7,mixedType,0
6,3,0,9,mixedType,1
13,3,0,16,mixedType,2
6,3,0,9,mixedType,1
7,2,0,9,mixedType,1
5,5,0,10,mixedType,1
6,4,0,10,mixedType,1
5,1,0,6,mixedType,0
4,2,0,6,mixedType,0
4,4,0,8,mixedType,1
1,8,0,9,mixedType,1
7,2,0,9,mixedType,1
11,3,0,14,mixedType,2
8,5,0,13,mixedType,1
3,6,0,9,mixedType,1
5,6,0,11,mixedType,1
6,3,0,9,mixedType,1
13,3,0,16,mixedType,2
12,3,0,15,mixedType,2
6,1,0,7,mixedType,0
6,2,0,8,mixedType,1
6,3,0,9,mixedType,1
1,8,0,9,mixedType,1
1,7,0,8,mixedType,1
4,4,0,8,mixedType,1
15,1,0,16,mixedType,2
6,3,0,9,mixedType,1
9,1,0,10,mixedType,1
6,3,0,9,mixedType,1
1,7,0,8,mixedType,1
12,4,0,16,mixedType,2
7,2,0,9,mixedType,1
4,4,0,8,mixedType,1
8,2,0,10,mixedType,1
12,3,0,15,mixedType,2
7,3,0,10,mixedType,1
6,4,0,10,mixedType,1
6,1,0,7,mixedType,0
6,1,0,7,mixedType,0
4,6,0,10,mixedType,1
2,8,0,10,mixedType,1
3,6,0,9,mixedType,1
13,3,0,16,mixedType,2
9,1,0,10,mixedType,1
5,4,0,9,mixedType,1
13,3,0,16,mixedType,2
5,2,0,7,mixedType,0
8,3,0,11,mixedType,1
9,3,0,12,mixedType,1
2,7,0,9,mixedType,1
5,10,0,15,mixedType,2
6,5,0,11,mixedType,1
12,4,0,16,mixedType,2
7,1,0,8,mixedType,1
5,4,0,9,mixedType,1
3,6,0,9,mixedType,1
13,3,0,16,mixedType,2
8,2,0,10,mixedType,1
7,2,0,9,mixedType,1
6,3,0,9,mixedType,1
5,6,0,11,mixedType,1
4,2,0,6,mixedType,0
14,2,0,16,mixedType,2
9,6,1,16,mixedType,2
15,1,0,16,mixedType,2
11,3,0,14,mixedType,2
6,6,0,12,mixedType,1
6,3,0,9,mixedType,1
7,2,0,9,mixedType,1
4,2,0,6,mixedType,0
7,3,0,10,mixedType,1
7,3,0,10,mixedType,1
15,1,0,16,mixedType,2
8,0,1,9,mixedType,1
8,3,0,11,mixedType,1
6,3,0,9,mixedType,1
4,4,0,8,mixedType,1
7,3,0,10,mixedType,1
4,6,0,10,mixedType,1
6,2,0,8,mixedType,1
3,3,0,6,mixedType,0
4,4,1,9,mixedType,1
5,2,0,7,mixedType,0
8,3,0,11,mixedType,1
3,3,0,6,mixedType,0
7,2,0,9,mixedType,1
9,1,0,10,mixedType,1
4,4,0,8,mixedType,1
8,3,0,11,mixedType,1
3,9,0,12,mixedType,1
6,4,0,10,mixedType,1
7,3,0,10,mixedType,1
10,3,0,13,mixedType,1
9,1,0,10,mixedType,1
6,3,0,9,mixedType,1
7,1,0,8,mixedType,1
6,3,0,9,mixedType,1
6,3,0,9,mixedType,1
6,3,0,9,mixedType,1
8,3,0,11,mixedType,1
7,3,0,10,mixedType,1
8,2,0,10,mixedType,1
4,4,0,8,mixedType,1
6,2,0,8,mixedType,1
8,2,0,10,mixedType,1
7,3,0,10,mixedType,1
8,1,0,9,mixedType,1
10,4,0,14,mixedType,2
6,3,0,9,mixedType,1
8,1,0,9,mixedType,1
2,8,0,10,mixedType,1
4,4,0,8,mixedType,1
8,2,0,10,mixedType,1
5,4,0,9,mixedType,1
6,1,0,7,mixedType,0
13,3,0,16,mixedType,2
3,6,0,9,mixedType,1
14,2,0,16,mixedType,2
8,2,0,10,mixedType,1
5,4,0,9,mixedType,1
6,3,0,9,mixedType,1
6,2,0,8,mixedType,1
8,4,0,12,mixedType,1
12,3,0,15,mixedType,2
5,1,0,6,mixedType,0
7,4,0,11,mixedType,1
6,1,0,7,mixedType,0
6,3,0,9,mixedType,1
7,4,0,11,mixedType,1
1,7,0,8,mixedType,1
9,1,0,10,mixedType,1
3,6,0,9,mixedType,1
7,2,0,9,mixedType,1
4,4,0,8,mixedType,1
7,3,0,10,mixedType,1
12,3,0,15,mixedType,2
8,8,0,16,mixedType,2
8,2,0,10,mixedType,1
8,2,0,10,mixedType,1
6,4,0,10,mixedType,1
11,1,0,12,mixedType,1
6,1,0,7,mixedType,0
5,2,0,7,mixedType,0
4,4,0,8,mixedType,1
5,2,0,7,mixedType,0
7,2,0,9,mixedType,1
2,7,0,9,mixedType,1
5,2,0,7,mixedType,0
8,1,0,9,mixedType,1
5,2,0,7,mixedType,0
10,3,0,13,mixedType,1
9,4,0,13,mixedType,1
7,1,0,8,mixedType,1
2,9,0,11,mixedType,1
7,2,0,9,mixedType,1
7,3,0,10,mixedType,1
6,3,0,9,mixedType,1
8,1,0,9,mixedType,1
4,4,0,8,mixedType,1
8,2,0,10,mixedType,1
7,2,0,9,mixedType,1
6,3,0,9,mixedType,1
7,3,0,10,mixedType,1
8,1,0,9,mixedType,1
4,6,0,10,mixedType,1
6,2,0,8,mixedType,1
5,4,0,9,mixedType,1
10,2,0,12,mixedType,1
15,1,0,16,mixedType,2
5,4,0,9,mixedType,1
6,3,0,9,mixedType,1
5,1,0,6,mixedType,0
5,2,0,7,mixedType,0
2,8,0,10,mixedType,1
6,3,0,9,mixedType,1
5,4,0,9,mixedType,1
6,4,0,10,mixedType,1
14,2,0,16,mixedType,2
8,3,0,11,mixedType,1
1,9,0,10,mixedType,1
6,0,1,7,mixedType,0
6,1,0,7,mixedType,0
3,8,0,11,mixedType,1
9,3,0,12,mixedType,1
13,4,0,17,mixedType,2
4,2,0,6,mixedType,0
8,3,0,11,mixedType,1
4,7,0,11,mixedType,1
4,2,0,6,mixedType,0
8,2,0,10,mixedType,1
7,2,0,9,mixedType,1
9,3,0,12,mixedType,1
4,8,0,12,mixedType,1
15,1,0,16,mixedType,2
6,3,0,9,mixedType,1
4,8,2,14,mixedType,2
2,4,0,6,mixedType,0
6,1,0,7,mixedType,0
6,3,0,9,mixedType,1
6,3,0,9,mixedType,1
13,3,0,16,mixedType,2
12,3,0,15,mixedType,2
3,6,0,9,mixedType,1
7,3,0,10,mixedType,1
6,3,0,9,mixedType,1
12,4,0,16,mixedType,2
8,1,0,9,mixedType,1
4,4,0,8,mixedType,1
4,7,0,11,mixedType,1
7,3,0,10,mixedType,1
6,4,0,10,mixedType,1
1,8,0,9,mixedType,1
1,7,0,8,mixedType,1
6,1,0,7,mixedType,0
5,3,0,8,mixedType,1
9,2,0,11,mixedType,1
6,3,0,9,mixedType,1
3,5,0,8,mixedType,1
10,2,3,15,mixedType,2
5,3,0,8,mixedType,1
7,3,0,10,mixedType,1
8,2,0,10,mixedType,1
9,3,0,12,mixedType,1
8,1,0,9,mixedType,1
3,9,0,12,mixedType,1
5,2,0,7,mixedType,0
6,3,0,9,mixedType,1
11,1,0,12,mixedType,1
6,1,0,7,mixedType,0
6,3,0,9,mixedType,1
7,2,0,9,mixedType,1
8,3,0,11,mixedType,1
7,4,0,11,mixedType,1
4,4,0,8,mixedType,1
5,4,0,9,mixedType,1
4,4,0,8,mixedType,1
6,3,0,9,mixedType,1
6,2,0,8,mixedType,1
7,3,0,10,mixedType,1
5,4,0,9,mixedType,1
6,1,0,7,mixedType,0
7,2,0,9,mixedType,1
8,1,0,9,mixedType,1
1,8,0,9,mixedType,1
7,3,0,10,mixedType,1
3,6,0,9,mixedType,1
7,2,0,9,mixedType,1
1,8,0,9,mixedType,1
10,4,0,14,mixedType,2
7,2,0,9,mixedType,1
9,3,0,12,mixedType,1
5,3,0,8,mixedType,1
6,1,0,7,mixedType,0
8,4,0,12,mixedType,1
6,3,0,9,mixedType,1
6,3,0,9,mixedType,1
7,3,0,10,mixedType,1
7,2,0,9,mixedType,1
11,3,0,14,mixedType,2
7,3,0,10,mixedType,1
5,4,0,9,mixedType,1
8,2,0,10,mixedType,1
6,2,0,8,mixedType,1
5,6,0,11,mixedType,1
5,5,0,10,mixedType,1
8,1,0,9,mixedType,1
8,4,0,12,mixedType,1
8,2,0,10,mixedType,1
8,2,0,10,mixedType,1
5,8,0,13,mixedType,1
7,2,0,9,mixedType,1
6,4,0,10,mixedType,1
10,1,0,11,mixedType,1
1,10,0,11,mixedType,1
5,5,0,10,mixedType,1
7,3,0,10,mixedType,1
6,9,0,15,mixedType,2
8,3,0,11,mixedType,1
8,2,0,10,mixedType,1
5,2,0,7,mixedType,0
12,4,0,16,mixedType,2
4,2,0,6,mixedType,0
9,3,0,12,mixedType,1
9,2,0,11,mixedType,1
7,3,0,10,mixedType,1
11,5,0,16,mixedType,2
6,6,0,12,mixedType,1
8,4,0,12,mixedType,1
10,0,2,12,mixedType,1
7,5,0,12,mixedType,1
11,3,0,14,mixedType,2
6,1,0,7,mixedType,0
10,1,0,11,mixedType,1
5,3,0,8,mixedType,1
11,3,0,14,mixedType,2
5,5,0,10,mixedType,1
12,3,0,15,mixedType,2
10,1,0,11,mixedType,1
5,3,0,8,mixedType,1
5,2,0,7,mixedType,0
12,4,0,16,mixedType,2
8,2,0,10,mixedType,1
7,2,0,9,mixedType,1
1,8,0,9,mixedType,1
5,2,0,7,mixedType,0
8,1,0,9,mixedType,1
2,6,0,8,mixedType,1
14,2,0,16,mixedType,2
10,2,0,12,mixedType,1
7,3,0,10,mixedType,1
14,2,0,16,mixedType,2
10,0,2,12,mixedType,1
4,6,0,10,mixedType,1
6,4,0,10,mixedType,1
5,6,0,11,mixedType,1
3,6,0,9,mixedType,1
5,2,0,7,mixedType,0
3,5,0,8,mixedType,1
7,2,0,9,mixedType,1
6,3,0,9,mixedType,1
5,4,0,9,mixedType,1
6,2,0,8,mixedType,1
14,2,0,16,mixedType,2
5,3,0,8,mixedType,1
13,3,0,16,mixedType,2
20,1,1,22,mixedType,2
8,1,0,9,mixedType,1
8,2,0,10,mixedType,1
8,2,0,10,mixedType,1
4,8,0,12,mixedType,1
9,3,0,12,mixedType,1
6,2,0,8,mixedType,1
9,2,0,11,mixedType,1
8,3,0,11,mixedType,1
4,2,0,6,mixedType,0
7,3,0,10,mixedType,1
5,4,0,9,mixedType,1
3,5,0,8,mixedType,1
6,2,0,8,mixedType,1
1,5,0,6,mixedType,0
7,4,0,11,mixedType,1
5,3,0,8,mixedType,1
4,4,0,8,mixedType,1
7,1,0,8,mixedType,1
14,2,0,16,mixedType,2
7,3,0,10,mixedType,1
13,3,0,16,mixedType,2
6,4,0,10,mixedType,1
7,2,0,9,mixedType,1
1,7,0,8,mixedType,1
8,2,0,10,mixedType,1
6,2,0,8,mixedType,1
2,6,0,8,mixedType,1
2,4,0,6,mixedType,0
6,3,0,9,mixedType,1
8,3,0,11,mixedType,1
7,3,0,10,mixedType,1
9,1,0,10,mixedType,1
6,2,0,8,mixedType,1
1,10,0,11,mixedType,1
5,3,0,8,mixedType,1
8,3,0,11,mixedType,1
5,2,0,7,mixedType,0
12,3,0,15,mixedType,2
6,3,0,9,mixedType,1
5,3,0,8,mixedType,1
9,3,0,12,mixedType,1
7,1,0,8,mixedType,1
15,1,0,16,mixedType,2
7,1,0,8,mixedType,1
5,2,0,7,mixedType,0
6,4,0,10,mixedType,1
9,2,0,11,mixedType,1
6,1,0,7,mixedType,0
7,3,0,10,mixedType,1
9,1,0,10,mixedType,1
3,8,0,11,mixedType,1
11,1,0,12,mixedType,1
7,1,0,8,mixedType,1
6,3,0,9,mixedType,1
14,2,0,16,mixedType,2
8,1,0,9,mixedType,1
6,3,0,9,mixedType,1
6,2,0,8,mixedType,1
8,2,0,10,mixedType,1
5,2,0,7,mixedType,0
8,1,0,9,mixedType,1
14,2,0,16,mixedType,2
14,2,0,16,mixedType,2
7,2,0,9,mixedType,1
3,7,0,10,mixedType,1
7,3,0,10,mixedType,1
7,2,0,9,mixedType,1
4,4,0,8,mixedType,1
8,2,0,10,mixedType,1
6,3,0,9,mixedType,1
12,4,0,16,mixedType,2
6,2,0,8,mixedType,1
4,4,0,8,mixedType,1
7,3,0,10,mixedType,1
4,2,0,6,mixedType,0
6,3,0,9,mixedType,1
8,2,0,10,mixedType,1
9,4,0,13,mixedType,1
6,2,0,8,mixedType,1
9,1,0,10,mixedType,1
8,1,0,9,mixedType,1
6,2,0,8,mixedType,1
3,7,0,10,mixedType,1
8,3,0,11,mixedType,1
10,2,0,12,mixedType,1
7,4,0,11,mixedType,1
9,4,0,13,mixedType,1
8,1,0,9,mixedType,1
4,4,0,8,mixedType,1
2,6,0,8,mixedType,1
6,4,0,10,mixedType,1
6,4,0,10,mixedType,1
6,2,0,8,mixedType,1
2,7,0,9,mixedType,1
15,1,0,16,mixedType,2
0,8,2,10,mixedType,1
6,2,0,8,mixedType,1
6,3,0,9,mixedType,1
7,4,0,11,mixedType,1
7,3,0,10,mixedType,1
7,2,0,9,mixedType,1
8,6,1,15,mixedType,2
5,5,0,10,mixedType,1
4,6,0,10,mixedType,1
11,2,0,13,mixedType,1
7,3,0,10,mixedType,1
6,1,0,7,mixedType,0
6,3,0,9,mixedType,1
3,3,0,6,mixedType,0
4,4,0,8,mixedType,1
7,3,0,10,mixedType,1
8,2,0,10,mixedType,1
8,1,0,9,mixedType,1
11,3,0,14,mixedType,2
7,3,0,10,mixedType,1
7,2,0,9,mixedType,1
4,4,0,8,mixedType,1
5,5,0,10,mixedType,1
5,0,2,7,mixedType,0
8,2,0,10,mixedType,1
1,7,0,8,mixedType,1
8,4,0,12,mixedType,1
7,3,0,10,mixedType,1
10,3,0,13,mixedType,1
6,3,0,9,mixedType,1
6,1,0,7,mixedType,0
9,1,0,10,mixedType,1
14,2,0,16,mixedType,2
8,2,0,10,mixedType,1
7,5,0,12,mixedType,1
15,1,0,16,mixedType,2
2,4,0,6,mixedType,0
4,2,0,6,mixedType,0
10,2,0,12,mixedType,1
8,3,0,11,mixedType,1
9,1,0,10,mixedType,1
5,5,0,10,mixedType,1
5,3,0,8,mixedType,1
2,6,0,8,mixedType,1
6,2,0,8,mixedType,1
15,1,0,16,mixedType,2
12,3,0,15,mixedType,2
7,3,0,10,mixedType,1
2,4,0,6,mixedType,0
5,3,0,8,mixedType,1
1,9,0,10,mixedType,1
7,3,0,10,mixedType,1
13,3,0,16,mixedType,2
5,3,0,8,mixedType,1
4,4,0,8,mixedType,1
6,4,0,10,mixedType,1
7,2,0,9,mixedType,1
8,2,0,10,mixedType,1
7,3,0,10,mixedType,1
13,3,0,16,mixedType,2
6,2,0,8,mixedType,1
7,3,0,10,mixedType,1
3,6,0,9,mixedType,1
8,2,0,10,mixedType,1
9,1,0,10,mixedType,1
8,2,0,10,mixedType,1
6,2,0,8,mixedType,1
14,2,0,16,mixedType,2
5,3,0,8,mixedType,1
4,8,0,12,mixedType,1
13,4,2,19,mixedType,2
8,1,0,9,mixedType,1
7,2,0,9,mixedType,1
4,2,0,6,mixedType,0
14,2,0,16,mixedType,2
5,3,0,8,mixedType,1
9,1,0,10,mixedType,1
9,2,0,11,mixedType,1
7,3,0,10,mixedType,1
6,2,0,8,mixedType,1
5,8,0,13,mixedType,1
9,1,0,10,mixedType,1
5,3,0,8,mixedType,1
6,2,0,8,mixedType,1
12,3,0,15,mixedType,2
6,3,0,9,mixedType,1
7,2,0,9,mixedType,1
7,1,0,8,mixedType,1
2,8,0,10,mixedType,1
2,9,0,11,mixedType,1
4,6,0,10,mixedType,1
6,3,0,9,mixedType,1
7,3,0,10,mixedType,1
5,3,0,8,mixedType,1
7,1,0,8,mixedType,1
6,1,0,7,mixedType,0
8,1,0,9,mixedType,1
6,1,0,7,mixedType,0
6,4,0,10,mixedType,1
9,1,0,10,mixedType,1
7,2,0,9,mixedType,1
5,3,0,8,mixedType,1
7,4,0,11,mixedType,1
14,2,0,16,mixedType,2
8,2,0,10,mixedType,1
6,3,0,9,mixedType,1
3,8,0,11,mixedType,1
4,5,0,9,mixedType,1
9,2,0,11,mixedType,1
7,1,0,8,mixedType,1
5,2,0,7,mixedType,0
8,1,0,9,mixedType,1
6,2,0,8,mixedType,1
13,3,0,16,mixedType,2
5,2,0,7,mixedType,0
8,2,0,10,mixedType,1
5,5,0,10,mixedType,1
9,1,0,10,mixedType,1
2,8,0,10,mixedType,1
8,3,0,11,mixedType,1
8,1,0,9,mixedType,1
2,8,0,10,mixedType,1
6,1,0,7,mixedType,0
5,4,0,9,mixedType,1
11,1,0,12,mixedType,1
5,3,0,8,mixedType,1
6,2,0,8,mixedType,1
9,2,0,11,mixedType,1
3,6,0,9,mixedType,1
4,6,0,10,mixedType,1
4,4,0,8,mixedType,1
11,2,0,13,mixedType,1
13,2,0,15,mixedType,2
5,4,0,9,mixedType,1
11,3,0,14,mixedType,2
3,8,0,11,mixedType,1
9,2,0,11,mixedType,1
8,2,0,10,mixedType,1
11,2,0,13,mixedType,1
2,8,0,10,mixedType,1
3,6,0,9,mixedType,1
4,5,0,9,mixedType,1
5,4,0,9,mixedType,1
10,1,0,11,mixedType,1
9,0,1,10,mixedType,1
11,2,0,13,mixedType,1
13,3,0,16,mixedType,2
4,2,0,6,mixedType,0
6,1,0,7,mixedType,0
4,4,0,8,mixedType,1
15,5,0,20,mixedType,2
9,3,0,12,mixedType,1
6,3,0,9,mixedType,1
5,6,0,11,mixedType,1
6,3,0,9,mixedType,1
5,10,0,15,mixedType,2
8,1,0,9,mixedType,1
6,1,0,7,mixedType,0
8,1,0,9,mixedType,1
7,4,0,11,mixedType,1
4,4,0,8,mixedType,1
8,2,0,10,mixedType,1
15,3,0,18,mixedType,2
5,4,0,9,mixedType,1
5,6,0,11,mixedType,1
2,4,0,6,mixedType,0
3,8,0,11,mixedType,1
5,3,0,8,mixedType,1
13,3,0,16,mixedType,2
5,6,0,11,mixedType,1
8,3,0,11,mixedType,1
7,2,0,9,mixedType,1
10,2,0,12,mixedType,1
4,8,0,12,mixedType,1
9,2,0,11,mixedType,1
7,2,0,9,mixedType,1
5,1,0,6,mixedType,0
7,3,0,10,mixedType,1
10,2,0,12,mixedType,1
2,6,0,8,mixedType,1
4,4,0,8,mixedType,1
4,4,0,8,mixedType,1
3,6,0,9,mixedType,1
11,3,0,14,mixedType,2
6,2,0,8,mixedType,1
9,1,0,10,mixedType,1
8,2,0,10,mixedType,1
5,3,0,8,mixedType,1
6,3,0,9,mixedType,1
5,3,0,8,mixedType,1
8,2,0,10,mixedType,1
5,2,0,7,mixedType,0
6,2,0,8,mixedType,1
6,2,0,8,mixedType,1
2,8,0,10,mixedType,1
5,3,0,8,mixedType,1
7,3,0,10,mixedType,1
5,3,0,8,mixedType,1
6,4,0,10,mixedType,1
5,1,0,6,mixedType,0
6,2,0,8,mixedType,1
2,6,0,8,mixedType,1
5,5,0,10,mixedType,1
7,2,0,9,mixedType,1
5,2,0,7,mixedType,0
6,7,0,13,mixedType,1
1,7,0,8,mixedType,1
11,2,0,13,mixedType,1
9,1,0,10,mixedType,1
7,5,0,12,mixedType,1
6,3,0,9,mixedType,1
5,5,0,10,mixedType,1
5,5,0,10,mixedType,1
9,1,0,10,mixedType,1
8,4,0,12,mixedType,1
4,4,0,8,mixedType,1
7,2,0,9,mixedType,1
6,1,0,7,mixedType,0
2,7,0,9,mixedType,1
4,5,0,9,mixedType,1
5,4,0,9,mixedType,1
8,3,0,11,mixedType,1
7,3,0,10,mixedType,1
5,4,0,9,mixedType,1
6,5,0,11,mixedType,1
2,4,0,6,mixedType,0
13,3,0,16,mixedType,2
15,1,0,16,mixedType,2
6,2,0,8,mixedType,1
6,2,0,8,mixedType,1
2,6,0,8,mixedType,1
9,1,0,10,mixedType,1
7,2,0,9,mixedType,1
6,4,0,10,mixedType,1
23,3,0,26,mixedType,2
7,3,0,10,mixedType,1
4,2,0,6,mixedType,0
6,3,0,9,mixedType,1
3,6,0,9,mixedType,1
12,1,0,13,mixedType,1
5,3,0,8,mixedType,1
4,6,0,10,mixedType,1
7,3,0,10,mixedType,1
6,1,0,7,mixedType,0
5,1,0,6,mixedType,0
6,8,1,15,mixedType,2
4,2,0,6,mixedType,0
4,4,0,8,mixedType,1
10,3,0,13,mixedType,1
10,2,0,12,mixedType,1
10,1,0,11,mixedType,1
6,2,0,8,mixedType,1
4,5,0,9,mixedType,1
6,3,0,9,mixedType,1
8,3,0,11,mixedType,1
1,10,0,11,mixedType,1
9,1,0,10,mixedType,1
14,2,0,16,mixedType,2
8,2,0,10,mixedType,1
8,3,0,11,mixedType,1
9,3,0,12,mixedType,1
8,2,0,10,mixedType,1
6,4,0,10,mixedType,1
9,4,0,13,mixedType,1
10,1,0,11,mixedType,1
4,4,0,8,mixedType,1
5,6,0,11,mixedType,1
14,2,0,16,mixedType,2
8,5,0,13,mixedType,1
5,2,0,7,mixedType,0
7,6,1,14,mixedType,2
7,2,0,9,mixedType,1
5,3,0,8,mixedType,1
7,3,0,10,mixedType,1
8,2,0,10,mixedType,1
6,3,0,9,mixedType,1
11,1,0,12,mixedType,1
7,3,0,10,mixedType,1
12,1,0,13,mixedType,1
8,1,0,9,mixedType,1
5,3,0,8,mixedType,1
6,2,0,8,mixedType,1
2,4,0,6,mixedType,0
3,6,0,9,mixedType,1
9,1,0,10,mixedType,1
6,2,0,8,mixedType,1
8,1,0,9,mixedType,1
6,3,0,9,mixedType,1
10,6,0,16,mixedType,2
11,1,0,12,mixedType,1
1,9,0,10,mixedType,1
6,2,0,8,mixedType,1
4,2,0,6,mixedType,0
7,2,0,9,mixedType,1
15,1,0,16,mixedType,2
8,1,0,9,mixedType,1
7,3,0,10,mixedType,1
1,7,0,8,mixedType,1
5,1,0,6,mixedType,0
5,2,0,7,mixedType,0
11,2,0,13,mixedType,1
5,4,0,9,mixedType,1
6,3,0,9,mixedType,1
7,2,0,9,mixedType,1
5,3,0,8,mixedType,1
4,4,0,8,mixedType,1
9,3,0,12,mixedType,1
9,4,0,13,mixedType,1
9,4,0,13,mixedType,1
2,7,0,9,mixedType,1
13,3,0,16,mixedType,2
5,1,0,6,mixedType,0
2,6,0,8,mixedType,1
14,2,0,16,mixedType,2
7,1,0,8,mixedType,1
1,8,0,9,mixedType,1
10,2,0,12,mixedType,1
6,4,0,10,mixedType,1
9,1,0,10,mixedType,1
6,2,0,8,mixedType,1
7,4,0,11,mixedType,1
5,4,0,9,mixedType,1
6,3,0,9,mixedType,1
6,4,0,10,mixedType,1
5,3,0,8,mixedType,1
5,1,0,6,mixedType,0
9,2,0,11,mixedType,1
8,2,0,10,mixedType,1
9,2,0,11,mixedType,1
5,11,0,16,mixedType,2
5,3,0,8,mixedType,1
6,3,0,9,mixedType,1
7,2,0,9,mixedType,1
9,3,0,12,mixedType,1
5,4,0,9,mixedType,1
4,4,0,8,mixedType,1
4,2,0,6,mixedType,0
8,1,0,9,mixedType,1
6,5,0,11,mixedType,1
1,8,0,9,mixedType,1
8,1,0,9,mixedType,1
5,2,0,7,mixedType,0
7,1,0,8,mixedType,1
2,6,0,8,mixedType,1
5,3,0,8,mixedType,1
4,2,0,6,mixedType,0
6,3,0,9,mixedType,1
16,1,0,17,mixedType,2
12,1,0,13,mixedType,1
10,3,0,13,mixedType,1
6,4,0,10,mixedType,1
12,4,0,16,mixedType,2
7,2,0,9,mixedType,1
5,4,0,9,mixedType,1
6,3,0,9,mixedType,1
7,3,0,10,mixedType,1
14,2,0,16,mixedType,2
8,4,0,12,mixedType,1
7,3,0,10,mixedType,1
4,6,0,10,mixedType,1
5,3,0,8,mixedType,1
6,6,0,12,mixedType,1
3,6,0,9,mixedType,1
7,3,0,10,mixedType,1
3,4,0,7,mixedType,0
5,2,0,7,mixedType,0
6,4,0,10,mixedType,1
7,3,0,10,mixedType,1
6,3,0,9,mixedType,1
6,3,0,9,mixedType,1
6,3,0,9,mixedType,1
12,4,0,16,mixedType,2
4,2,0,6,mixedType,0
9,2,0,11,mixedType,1
1,9,0,10,mixedType,1
6,2,0,8,mixedType,1
8,1,0,9,mixedType,1
4,2,0,6,mixedType,0
8,3,0,11,mixedType,1
6,1,0,7,mixedType,0
5,3,0,8,mixedType,1
8,3,0,11,mixedType,1
8,4,0,12,mixedType,1
5,3,0,8,mixedType,1
9,4,0,13,mixedType,1
5,2,0,7,mixedType,0
9,2,0,11,mixedType,1
6,4,0,10,mixedType,1
9,2,0,11,mixedType,1
5,1,0,6,mixedType,0
7,2,0,9,mixedType,1
9,2,0,11,mixedType,1
7,2,0,9,mixedType,1
3,6,0,9,mixedType,1
2,6,0,8,mixedType,1
7,1,0,8,mixedType,1
6,4,0,10,mixedType,1
6,1,0,7,mixedType,0
8,1,0,9,mixedType,1
5,3,0,8,mixedType,1
3,6,0,9,mixedType,1
6,3,0,9,mixedType,1
6,2,0,8,mixedType,1
5,3,0,8,mixedType,1
11,2,0,13,mixedType,1
7,1,1,9,mixedType,1
7,4,0,11,mixedType,1
4,2,0,6,mixedType,0
7,3,0,10,mixedType,1
7,2,0,9,mixedType,1
6,1,0,7,mixedType,0
5,7,0,12,mixedType,1
11,1,0,12,mixedType,1
7,2,0,9,mixedType,1
5,1,0,6,mixedType,0
5,4,0,9,mixedType,1
5,1,0,6,mixedType,0
6,3,0,9,mixedType,1
6,2,0,8,mixedType,1
5,4,0,9,mixedType,1
6,3,0,9,mixedType,1
7,3,0,10,mixedType,1
7,2,0,9,mixedType,1
8,2,0,10,mixedType,1
8,1,0,9,mixedType,1
10,4,0,14,mixedType,2
5,2,0,7,mixedType,0
14,1,1,16,mixedType,2
3,6,0,9,mixedType,1
10,4,2,16,mixedType,2
7,1,0,8,mixedType,1
9,3,0,12,mixedType,1
7,1,0,8,mixedType,1
7,3,0,10,mixedType,1
9,1,0,10,mixedType,1
14,2,0,16,mixedType,2
5,4,0,9,mixedType,1
5,4,0,9,mixedType,1
8,4,0,12,mixedType,1
7,3,0,10,mixedType,1
2,9,0,11,mixedType,1
7,1,0,8,mixedType,1
8,2,0,10,mixedType,1
6,6,0,12,mixedType,1
6,4,0,10,mixedType,1
6,2,0,8,mixedType,1
1,5,0,6,mixedType,0
7,6,0,13,mixedType,1
8,1,0,9,mixedType,1
5,2,0,7,mixedType,0
14,2,0,16,mixedType,2
6,2,0,8,mixedType,1
14,2,0,16,mixedType,2
10,4,1,15,mixedType,2
6,4,0,10,mixedType,1
4,5,0,9,mixedType,1
12,1,1,14,mixedType,2
7,5,0,12,mixedType,1
8,2,0,10,mixedType,1
14,2,0,16,mixedType,2
8,4,0,12,mixedType,1
13,3,0,16,mixedType,2
7,2,0,9,mixedType,1
5,2,0,7,mixedType,0
7,4,0,11,mixedType,1
14,1,0,15,mixedType,2
9,1,0,10,mixedType,1
7,1,0,8,mixedType,1
7,2,0,9,mixedType,1
9,1,0,10,mixedType,1
6,3,0,9,mixedType,1
7,3,0,10,mixedType,1
6,1,0,7,mixedType,0
8,2,0,10,mixedType,1
17,3,0,20,mixedType,2
6,2,0,8,mixedType,1
6,3,0,9,mixedType,1
4,2,0,6,mixedType,0
15,1,0,16,mixedType,2
7,1,0,8,mixedType,1
9,3,0,12,mixedType,1
6,2,0,8,mixedType,1
6,1,0,7,mixedType,0
6,2,0,8,mixedType,1
6,2,0,8,mixedType,1
2,6,0,8,mixedType,1
5,2,0,7,mixedType,0
9,4,0,13,mixedType,1
12,3,0,15,mixedType,2
8,1,0,9,mixedType,1
8,2,0,10,mixedType,1
4,4,0,8,mixedType,1
5,6,0,11,mixedType,1
6,1,0,7,mixedType,0
10,6,0,16,mixedType,2
8,1,0,9,mixedType,1
5,2,0,7,mixedType,0
7,3,0,10,mixedType,1
6,2,0,8,mixedType,1
3,5,0,8,mixedType,1
7,3,0,10,mixedType,1
14,2,0,16,mixedType,2
2,6,0,8,mixedType,1
5,2,0,7,mixedType,0
3,5,0,8,mixedType,1
7,2,0,9,mixedType,1
5,3,0,8,mixedType,1
1,8,0,9,mixedType,1
8,3,0,11,mixedType,1
9,8,0,17,mixedType,2
6,3,0,9,mixedType,1
13,3,0,16,mixedType,2
6,1,0,7,mixedType,0
8,1,0,9,mixedType,1
6,2,0,8,mixedType,1
12,3,1,16,mixedType,2
11,5,0,16,mixedType,2
6,1,0,7,mixedType,0
3,3,0,6,mixedType,0
4,4,0,8,mixedType,1
7,2,0,9,mixedType,1
13,3,0,16,mixedType,2
8,3,0,11,mixedType,1
13,3,0,16,mixedType,2
5,6,0,11,mixedType,1
6,2,0,8,mixedType,1
8,1,0,9,mixedType,1
3,7,0,10,mixedType,1
8,3,0,11,mixedType,1
5,5,0,10,mixedType,1
5,1,0,6,mixedType,0
8,2,0,10,mixedType,1
14,2,0,16,mixedType,2
4,6,0,10,mixedType,1
5,3,0,8,mixedType,1
9,4,0,13,mixedType,1
11,1,0,12,mixedType,1
7,2,0,9,mixedType,1
9,1,0,10,mixedType,1
7,4,0,11,mixedType,1
6,4,0,10,mixedType,1
1,8,0,9,mixedType,1
6,3,0,9,mixedType,1
6,1,0,7,mixedType,0
10,1,0,11,mixedType,1
5,2,0,7,mixedType,0
10,2,0,12,mixedType,1
7,1,0,8,mixedType,1
5,2,0,7,mixedType,0
15,1,0,16,mixedType,2
4,4,0,8,mixedType,1
7,1,0,8,mixedType,1
7,2,0,9,mixedType,1
6,3,0,9,mixedType,1
3,3,0,6,mixedType,0
9,2,0,11,mixedType,1
8,2,0,10,mixedType,1
9,3,0,12,mixedType,1
0,8,2,10,mixedType,1
5,4,0,9,mixedType,1
3,8,0,11,mixedType,1
8,1,0,9,mixedType,1
6,3,0,9,mixedType,1
6,1,0,7,mixedType,0
6,4,0,10,mixedType,1
3,6,0,9,mixedType,1
5,3,0,8,mixedType,1
6,3,0,9,mixedType,1
4,2,0,6,mixedType,0
7,3,0,10,mixedType,1
6,2,0,8,mixedType,1
6,2,0,8,mixedType,1
4,7,0,11,mixedType,1
7,1,0,8,mixedType,1
8,3,0,11,mixedType,1
6,6,0,12,mixedType,1
6,1,0,7,mixedType,0
15,1,0,16,mixedType,2
7,2,0,9,mixedType,1
7,3,0,10,mixedType,1
5,4,0,9,mixedType,1
7,4,0,11,mixedType,1
6,3,0,9,mixedType,1
7,8,0,15,mixedType,2
9,1,0,10,mixedType,1
12,3,0,15,mixedType,2
14,2,0,16,mixedType,2
6,1,0,7,mixedType,0
7,1,0,8,mixedType,1
2,7,0,9,mixedType,1
6,2,0,8,mixedType,1
4,6,0,10,mixedType,1
7,3,0,10,mixedType,1
8,1,0,9,mixedType,1
7,1,0,8,mixedType,1
1,8,0,9,mixedType,1
5,4,0,9,mixedType,1
15,1,0,16,mixedType,2
5,1,0,6,mixedType,0
3,6,0,9,mixedType,1
4,5,0,9,mixedType,1
8,4,0,12,mixedType,1
4,8,0,12,mixedType,1
6,4,0,10,mixedType,1
11,3,0,14,mixedType,2
15,1,0,16,mixedType,2
6,1,0,7,mixedType,0
6,4,0,10,mixedType,1
5,3,0,8,mixedType,1
13,3,0,16,mixedType,2
7,2,0,9,mixedType,1
1,7,0,8,mixedType,1
14,2,0,16,mixedType,2
5,4,0,9,mixedType,1
3,3,0,6,mixedType,0
8,2,0,10,mixedType,1
7,2,0,9,mixedType,1
7,6,0,13,mixedType,1
5,2,0,7,mixedType,0
3,7,0,10,mixedType,1
14,2,0,16,mixedType,2
7,1,0,8,mixedType,1
2,6,0,8,mixedType,1
8,4,0,12,mixedType,1
13,3,0,16,mixedType,2
15,1,0,16,mixedType,2
7,2,0,9,mixedType,1
9,3,0,12,mixedType,1
7,2,0,9,mixedType,1
10,3,0,13,mixedType,1
7,2,0,9,mixedType,1
6,1,0,7,mixedType,0
8,2,0,10,mixedType,1
4,4,0,8,mixedType,1
2,8,0,10,mixedType,1
4,2,0,6,mixedType,0
5,2,0,7,mixedType,0
13,3,0,16,mixedType,2
9,5,0,14,mixedType,2
6,3,0,9,mixedType,1
8,2,0,10,mixedType,1
1,9,0,10,mixedType,1
11,1,0,12,mixedType,1
4,4,0,8,mixedType,1
7,2,0,9,mixedType,1
8,4,0,12,mixedType,1
7,3,0,10,mixedType,1
6,3,0,9,mixedType,1
8,3,0,11,mixedType,1
14,2,0,16,mixedType,2
8,2,0,10,mixedType,1
8,1,0,9,mixedType,1
6,4,0,10,mixedType,1
13,3,0,16,mixedType,2
5,1,0,6,mixedType,0
6,1,0,7,mixedType,0
6,3,0,9,mixedType,1
6,4,0,10,mixedType,1
7,4,0,11,mixedType,1
7,2,0,9,mixedType,1
8,4,0,12,mixedType,1
4,4,0,8,mixedType,1
14,2,0,16,mixedType,2
7,2,0,9,mixedType,1
13,3,0,16,mixedType,2
8,3,0,11,mixedType,1
12,4,0,16,mixedType,2
5,3,0,8,mixedType,1
12,4,0,16,mixedType,2
5,4,0,9,mixedType,1
7,2,0,9,mixedType,1
9,1,0,10,mixedType,1
12,2,1,15,mixedType,2
5,3,0,8,mixedType,1
6,1,0,7,mixedType,0
7,4,0,11,mixedType,1
6,1,0,7,mixedType,0
5,1,0,6,mixedType,0
7,2,0,9,mixedType,1
3,7,0,10,mixedType,1
10,2,0,12,mixedType,1
10,0,1,11,mixedType,1
6,1,0,7,mixedType,0
7,6,0,13,mixedType,1
7,3,0,10,mixedType,1
11,1,0,12,mixedType,1
15,1,0,16,mixedType,2
15,1,0,16,mixedType,2
4,2,0,6,mixedType,0
15,1,0,16,mixedType,2
10,0,4,14,mixedType,2
2,6,0,8,mixedType,1
5,1,0,6,mixedType,0
7,2,0,9,mixedType,1
6,3,0,9,mixedType,1
3,8,0,11,mixedType,1
6,2,0,8,mixedType,1
2,6,0,8,mixedType,1
4,4,0,8,mixedType,1
8,2,0,10,mixedType,1
9,3,0,12,mixedType,1
14,2,0,16,mixedType,2
6,3,0,9,mixedType,1
7,3,0,10,mixedType,1
6,3,0,9,mixedType,1
9,1,0,10,mixedType,1
10,3,1,14,mixedType,2
6,4,0,10,mixedType,1
5,4,0,9,mixedType,1
7,3,0,10,mixedType,1
7,4,0,11,mixedType,1
6,1,0,7,mixedType,0
6,3,0,9,mixedType,1
6,4,0,10,mixedType,1
8,4,0,12,mixedType,1
9,1,0,10,mixedType,1
8,1,0,9,mixedType,1
3,6,0,9,mixedType,1
3,6,0,9,mixedType,1
7,3,0,10,mixedType,1
7,3,0,10,mixedType,1
5,3,0,8,mixedType,1
6,1,0,7,mixedType,0
6,1,0,7,mixedType,0
15,1,0,16,mixedType,2
7,3,0,10,mixedType,1
7,2,0,9,mixedType,1
6,1,0,7,mixedType,0
1,9,0,10,mixedType,1
2,7,0,9,mixedType,1
1,10,0,11,mixedType,1
7,3,0,10,mixedType,1
5,1,0,6,mixedType,0
5,5,0,10,mixedType,1
6,4,0,10,mixedType,1
6,2,0,8,mixedType,1
10,1,0,11,mixedType,1
9,2,0,11,mixedType,1
15,1,0,16,mixedType,2
7,3,0,10,mixedType,1
7,3,0,10,mixedType,1
15,1,0,16,mixedType,2
6,4,0,10,mixedType,1
9,1,0,10,mixedType,1
5,2,0,7,mixedType,0
5,3,0,8,mixedType,1
5,4,0,9,mixedType,1
6,4,0,10,mixedType,1
7,3,0,10,mixedType,1
8,1,0,9,mixedType,1
6,1,0,7,mixedType,0
4,2,0,6,mixedType,0
5,4,0,9,mixedType,1
9,3,0,12,mixedType,1
2,8,0,10,mixedType,1
4,7,0,11,mixedType,1
7,1,0,8,mixedType,1
4,2,0,6,mixedType,0
8,3,0,11,mixedType,1
7,6,0,13,mixedType,1
8,1,0,9,mixedType,1
8,4,0,12,mixedType,1
6,3,0,9,mixedType,1
6,3,0,9,mixedType,1
9,2,0,11,mixedType,1
3,6,0,9,mixedType,1
5,2,0,7,mixedType,0
8,4,0,12,mixedType,1
5,3,0,8,mixedType,1
6,1,0,7,mixedType,0
2,7,0,9,mixedType,1
9,3,0,12,mixedType,1
10,3,0,13,mixedType,1
5,4,0,9,mixedType,1
8,2,0,10,mixedType,1
6,4,0,10,mixedType,1
5,1,0,6,mixedType,0
5,3,0,8,mixedType,1
7,3,0,10,mixedType,1
4,6,0,10,mixedType,1
6,4,0,10,mixedType,1
8,3,0,11,mixedType,1
6,2,0,8,mixedType,1
7,2,0,9,mixedType,1
12,4,0,16,mixedType,2
6,3,0,9,mixedType,1
7,2,0,9,mixedType,1
3,5,0,8,mixedType,1
7,3,0,10,mixedType,1
5,6,0,11,mixedType,1
8,4,0,12,mixedType,1
6,3,0,9,mixedType,1
7,2,0,9,mixedType,1
8,1,0,9,mixedType,1
7,1,0,8,mixedType,1
5,2,0,7,mixedType,0
8,2,0,10,mixedType,1
7,2,0,9,mixedType,1
6,4,0,10,mixedType,1
6,2,0,8,mixedType,1
6,2,0,8,mixedType,1
6,2,0,8,mixedType,1
13,3,0,16,mixedType,2
9,3,0,12,mixedType,1
0,11,2,13,mixedType,1
7,2,0,9,mixedType,1
9,2,0,11,mixedType,1
7,4,0,11,mixedType,1
9,2,0,11,mixedType,1
8,4,0,12,mixedType,1
4,2,0,6,mixedType,0
7,3,0,10,mixedType,1
7,3,0,10,mixedType,1
7,2,0,9,mixedType,1
5,2,0,7,mixedType,0
1,8,0,9,mixedType,1
1,10,0,11,mixedType,1
6,3,0,9,mixedType,1
8,2,0,10,mixedType,1
7,3,0,10,mixedType,1
6,2,0,8,mixedType,1
6,3,0,9,mixedType,1
7,2,0,9,mixedType,1
4,4,0,8,mixedType,1
4,4,0,8,mixedType,1
7,1,0,8,mixedType,1
2,7,0,9,mixedType,1
8,1,0,9,mixedType,1
8,2,0,10,mixedType,1
12,3,0,15,mixedType,2
7,2,0,9,mixedType,1
14,2,0,16,mixedType,2
3,8,0,11,mixedType,1
9,2,0,11,mixedType,1
8,1,0,9,mixedType,1
6,3,0,9,mixedType,1
6,3,0,9,mixedType,1
7,5,0,12,mixedType,1
8,1,0,9,mixedType,1
7,3,0,10,mixedType,1
7,2,0,9,mixedType,1
11,5,0,16,mixedType,2
6,1,0,7,mixedType,0
5,3,0,8,mixedType,1
8,3,0,11,mixedType,1
8,2,0,10,mixedType,1
5,2,0,7,mixedType,0
8,1,0,9,mixedType,1
7,1,0,8,mixedType,1
15,1,0,16,mixedType,2
5,3,0,8,mixedType,1
5,2,0,7,mixedType,0
5,4,0,9,mixedType,1
10,2,0,12,mixedType,1
9,4,0,13,mixedType,1
7,3,0,10,mixedType,1
14,2,0,16,mixedType,2
4,2,0,6,mixedType,0
13,3,0,16,mixedType,2
4,8,0,12,mixedType,1
9,1,0,10,mixedType,1
8,2,0,10,mixedType,1
7,4,0,11,mixedType,1
15,1,0,16,mixedType,2
9,1,0,10,mixedType,1
6,1,0,7,mixedType,0
7,3,0,10,mixedType,1
5,4,0,9,mixedType,1
3,6,0,9,mixedType,1
6,4,0,10,mixedType,1
7,3,0,10,mixedType,1
3,6,0,9,mixedType,1
7,2,0,9,mixedType,1
6,4,0,10,mixedType,1
8,3,0,11,mixedType,1
7,4,0,11,mixedType,1
3,8,0,11,mixedType,1
6,1,0,7,mixedType,0
4,6,0,10,mixedType,1
7,2,0,9,mixedType,1
3,10,0,13,mixedType,1
9,1,0,10,mixedType,1
5,3,0,8,mixedType,1
7,3,0,10,mixedType,1
6,3,0,9,mixedType,1
6,3,0,9,mixedType,1
7,3,0,10,mixedType,1
3,7,0,10,mixedType,1
6,3,0,9,mixedType,1
6,8,1,15,mixedType,2
10,2,0,12,mixedType,1
3,3,0,6,mixedType,0
4,2,0,6,mixedType,0
5,2,0,7,mixedType,0
7,2,0,9,mixedType,1
4,2,0,6,mixedType,0
8,4,0,12,mixedType,1
6,4,0,10,mixedType,1
6,7,0,13,mixedType,1
13,3,0,16,mixedType,2
8,1,0,9,mixedType,1
3,6,0,9,mixedType,1
7,2,0,9,mixedType,1
6,4,0,10,mixedType,1
7,2,0,9,mixedType,1
12,4,0,16,mixedType,2
7,3,0,10,mixedType,1
7,4,0,11,mixedType,1
7,3,0,10,mixedType,1
6,4,0,10,mixedType,1
5,3,0,8,mixedType,1
5,8,0,13,mixedType,1
7,3,0,10,mixedType,1
5,3,0,8,mixedType,1
13,3,0,16,mixedType,2
6,2,0,8,mixedType,1
15,1,0,16,mixedType,2
1,8,0,9,mixedType,1
6,3,0,9,mixedType,1
7,2,0,9,mixedType,1
3,6,0,9,mixedType,1
12,4,0,16,mixedType,2
5,2,0,7,mixedType,0
5,4,0,9,mixedType,1
8,1,0,9,mixedType,1
8,1,0,9,mixedType,1
6,4,0,10,mixedType,1
7,3,0,10,mixedType,1
5,4,0,9,mixedType,1
13,3,0,16,mixedType,2
7,2,0,9,mixedType,1
5,1,0,6,mixedType,0
8,2,0,10,mixedType,1
6,4,0,10,mixedType,1
6,2,0,8,mixedType,1
7,5,0,12,mixedType,1
5,4,0,9,mixedType,1
6,2,0,8,mixedType,1
7,3,0,10,mixedType,1
10,1,0,11,mixedType,1
8,4,0,12,mixedType,1
15,1,0,16,mixedType,2
10,2,0,12,mixedType,1
7,3,0,10,mixedType,1
6,4,0,10,mixedType,1
5,1,0,6,mixedType,0
6,2,0,8,mixedType,1
3,8,0,11,mixedType,1
9,2,0,11,mixedType,1
8,3,0,11,mixedType,1
2,6,0,8,mixedType,1
5,2,0,7,mixedType,0
4,7,0,11,mixedType,1
7,3,0,10,mixedType,1
15,1,0,16,mixedType,2
5,3,0,8,mixedType,1
7,4,0,11,mixedType,1
13,3,0,16,mixedType,2
5,2,0,7,mixedType,0
6,6,0,12,mixedType,1
5,4,0,9,mixedType,1
6,5,0,11,mixedType,1
4,6,0,10,mixedType,1
3,5,0,8,mixedType,1
7,3,0,10,mixedType,1
6,1,0,7,mixedType,0
7,3,0,10,mixedType,1
2,7,0,9,mixedType,1
15,1,0,16,mixedType,2
8,3,0,11,mixedType,1
8,2,0,10,mixedType,1
7,2,0,9,mixedType,1
3,6,0,9,mixedType,1
10,4,0,14,mixedType,2
5,3,0,8,mixedType,1
7,2,0,9,mixedType,1
6,2,0,8,mixedType,1
2,6,0,8,mixedType,1
5,1,0,6,mixedType,0
5,1,0,6,mixedType,0
5,3,0,8,mixedType,1
14,2,0,16,mixedType,2
12,4,0,16,mixedType,2
6,10,0,16,mixedType,2
3,7,0,10,mixedType,1
9,3,0,12,mixedType,1
5,1,0,6,mixedType,0
3,5,0,8,mixedType,1
12,3,0,15,mixedType,2
6,2,0,8,mixedType,1
9,3,0,12,mixedType,1
5,3,0,8,mixedType,1
5,4,0,9,mixedType,1
5,3,0,8,mixedType,1
5,4,0,9,mixedType,1
8,2,0,10,mixedType,1
4,6,0,10,mixedType,1
4,4,0,8,mixedType,1
3,6,0,9,mixedType,1
8,4,0,12,mixedType,1
7,2,0,9,mixedType,1
7,2,0,9,mixedType,1
13,3,0,16,mixedType,2
5,5,0,10,mixedType,1
6,1,0,7,mixedType,0
4,2,0,6,mixedType,0
7,3,0,10,mixedType,1
14,2,0,16,mixedType,2
8,1,0,9,mixedType,1
2,6,0,8,mixedType,1
2,9,0,11,mixedType,1
9,3,0,12,mixedType,1
4,4,0,8,mixedType,1
8,1,0,9,mixedType,1
9,3,0,12,mixedType,1
5,2,0,7,mixedType,0
4,6,0,10,mixedType,1
6,3,0,9,mixedType,1
7,2,0,9,mixedType,1
6,3,0,9,mixedType,1
7,2,0,9,mixedType,1
8,2,0,10,mixedType,1
3,5,0,8,mixedType,1
4,4,0,8,mixedType,1
8,2,0,10,mixedType,1
9,1,0,10,mixedType,1
7,3,0,10,mixedType,1
8,2,0,10,mixedType,1
3,9,0,12,mixedType,1
7,3,0,10,mixedType,1
7,2,0,9,mixedType,1
6,4,0,10,mixedType,1
5,3,0,8,mixedType,1
8,5,0,13,mixedType,1
14,2,0,16,mixedType,2
6,3,0,9,mixedType,1
6,4,0,10,mixedType,1
5,2,0,7,mixedType,0
7,3,0,10,mixedType,1
10,2,0,12,mixedType,1
5,4,0,9,mixedType,1
6,4,0,10,mixedType,1
6,4,0,10,mixedType,1
0,6,0,6,sameType,0
4,8,0,12,mixedType,1
4,5,0,9,mixedType,1
1,8,0,9,mixedType,1
6,1,0,7,mixedType,0
5,6,0,11,mixedType,1
7,3,0,10,mixedType,1
7,3,0,10,mixedType,1
11,5,0,16,mixedType,2
4,2,0,6,mixedType,0
8,3,0,11,mixedType,1
6,4,0,10,mixedType,1
7,3,0,10,mixedType,1
9,4,0,13,mixedType,1
7,2,0,9,mixedType,1
15,1,0,16,mixedType,2
7,3,0,10,mixedType,1
6,2,0,8,mixedType,1
8,2,0,10,mixedType,1
8,2,0,10,mixedType,1
6,3,0,9,mixedType,1
2,7,0,9,mixedType,1
5,2,0,7,mixedType,0
4,2,0,6,mixedType,0
6,3,0,9,mixedType,1
6,2,0,8,mixedType,1
1,7,0,8,mixedType,1
3,5,0,8,mixedType,1
6,2,0,8,mixedType,1
7,3,0,10,mixedType,1
5,3,0,8,mixedType,1
5,2,0,7,mixedType,0
7,3,0,10,mixedType,1
5,4,0,9,mixedType,1
7,3,0,10,mixedType,1
8,4,0,12,mixedType,1
5,2,0,7,mixedType,0
8,2,0,10,mixedType,1
5,2,0,7,mixedType,0
2,8,0,10,mixedType,1
6,2,0,8,mixedType,1
6,2,0,8,mixedType,1
5,4,0,9,mixedType,1
10,1,0,11,mixedType,1
3,8,0,11,mixedType,1
10,3,0,13,mixedType,1
1,8,0,9,mixedType,1
5,2,0,7,mixedType,0
5,3,0,8,mixedType,1
7,2,0,9,mixedType,1
7,2,0,9,mixedType,1
3,6,0,9,mixedType,1
5,4,0,9,mixedType,1
9,1,0,10,mixedType,1
9,2,0,11,mixedType,1
1,7,0,8,mixedType,1
6,4,0,10,mixedType,1
6,1,0,7,mixedType,0
8,1,0,9,mixedType,1
5,3,0,8,mixedType,1
10,6,0,16,mixedType,2
11,3,0,14,mixedType,2
4,2,0,6,mixedType,0
8,2,0,10,mixedType,1
6,1,0,7,mixedType,0
5,3,0,8,mixedType,1
1,9,0,10,mixedType,1
14,2,0,16,mixedType,2
5,3,0,8,mixedType,1
5,2,0,7,mixedType,0
14,2,0,16,mixedType,2
6,4,0,10,mixedType,1
6,2,0,8,mixedType,1
7,4,0,11,mixedType,1
2,8,0,10,mixedType,1
7,3,0,10,mixedType,1
4,6,0,10,mixedType,1
5,3,0,8,mixedType,1
5,5,0,10,mixedType,1
4,6,0,10,mixedType,1
4,6,0,10,mixedType,1
7,3,0,10,mixedType,1
2,6,0,8,mixedType,1
4,6,0,10,mixedType,1
12,4,0,16,mixedType,2
6,1,0,7,mixedType,0
2,6,0,8,mixedType,1
4,4,0,8,mixedType,1
8,1,0,9,mixedType,1
6,2,0,8,mixedType,1
5,3,0,8,mixedType,1
3,6,0,9,mixedType,1
6,3,0,9,mixedType,1
14,2,0,16,mixedType,2
10,2,2,14,mixedType,2
4,2,0,6,mixedType,0
8,4,0,12,mixedType,1
6,2,0,8,mixedType,1
6,6,0,12,mixedType,1
10,2,0,12,mixedType,1
5,4,0,9,mixedType,1
14,2,0,16,mixedType,2
7,2,0,9,mixedType,1
5,8,0,13,mixedType,1
6,3,0,9,mixedType,1
7,3,0,10,mixedType,1
8,1,0,9,mixedType,1
6,6,0,12,mixedType,1
6,1,0,7,mixedType,0
6,3,0,9,mixedType,1
7,2,0,9,mixedType,1
4,2,0,6,mixedType,0
4,2,0,6,mixedType,0
15,1,0,16,mixedType,2
6,4,0,10,mixedType,1
6,4,0,10,mixedType,1
2,6,0,8,mixedType,1
7,2,0,9,mixedType,1
6,2,0,8,mixedType,1
9,4,0,13,mixedType,1
8,1,0,9,mixedType,1
1,8,0,9,mixedType,1
11,3,0,14,mixedType,2
7,1,0,8,mixedType,1
4,4,0,8,mixedType,1
9,1,0,10,mixedType,1
8,2,0,10,mixedType,1
6,3,0,9,mixedType,1
3,6,0,9,mixedType,1
5,3,0,8,mixedType,1
7,1,0,8,mixedType,1
5,3,0,8,mixedType,1
8,3,0,11,mixedType,1
9,4,0,13,mixedType,1
3,6,0,9,mixedType,1
8,1,0,9,mixedType,1
6,4,0,10,mixedType,1
15,1,0,16,mixedType,2
5,4,0,9,mixedType,1
2,6,0,8,mixedType,1
3,6,0,9,mixedType,1
7,2,0,9,mixedType,1
8,2,0,10,mixedType,1
7,2,0,9,mixedType,1
6,2,0,8,mixedType,1
8,3,0,11,mixedType,1
2,6,0,8,mixedType,1
5,4,0,9,mixedType,1
13,3,0,16,mixedType,2
6,4,0,10,mixedType,1
6,7,0,13,mixedType,1
6,3,0,9,mixedType,1
2,8,0,10,mixedType,1
6,1,0,7,mixedType,0
5,1,0,6,mixedType,0
8,1,0,9,mixedType,1
5,2,0,7,mixedType,0
7,2,0,9,mixedType,1
2,6,0,8,mixedType,1
5,4,0,9,mixedType,1
4,2,0,6,mixedType,0
6,6,0,12,mixedType,1
10,6,0,16,mixedType,2
6,4,0,10,mixedType,1
9,1,0,10,mixedType,1
5,2,0,7,mixedType,0
6,2,0,8,mixedType,1
5,5,0,10,mixedType,1
9,1,0,10,mixedType,1
11,3,0,14,mixedType,2
1,8,0,9,mixedType,1
8,2,0,10,mixedType,1
6,4,0,10,mixedType,1
7,3,0,10,mixedType,1
11,3,0,14,mixedType,2
2,6,0,8,mixedType,1
4,5,0,9,mixedType,1
8,2,0,10,mixedType,1
7,3,0,10,mixedType,1
2,6,0,8,mixedType,1
4,6,0,10,mixedType,1
7,3,0,10,mixedType,1
11,3,0,14,mixedType,2
15,1,0,16,mixedType,2
11,2,0,13,mixedType,1
8,2,0,10,mixedType,1
3,8,0,11,mixedType,1
5,3,0,8,mixedType,1
5,2,0,7,mixedType,0
5,5,0,10,mixedType,1
1,9,0,10,mixedType,1
5,2,0,7,mixedType,0
6,4,0,10,mixedType,1
7,3,0,10,mixedType,1
9,1,0,10,mixedType,1
4,4,0,8,mixedType,1
2,6,0,8,mixedType,1
7,4,0,11,mixedType,1
8,4,0,12,mixedType,1
6,2,0,8,mixedType,1
4,6,0,10,mixedType,1
5,1,0,6,mixedType,0
4,2,0,6,mixedType,0
1,8,0,9,mixedType,1
10,2,0,12,mixedType,1
4,4,0,8,mixedType,1
7,2,0,9,mixedType,1
15,1,0,16,mixedType,2
6,2,0,8,mixedType,1
5,2,0,7,mixedType,0
12,3,0,15,mixedType,2
1,9,0,10,mixedType,1
10,5,0,15,mixedType,2
5,3,0,8,mixedType,1
6,2,0,8,mixedType,1
8,3,0,11,mixedType,1
6,1,0,7,mixedType,0
7,3,0,10,mixedType,1
7,2,0,9,mixedType,1
8,2,0,10,mixedType,1
2,11,0,13,mixedType,1
5,2,0,7,mixedType,0
6,4,0,10,mixedType,1
6,4,0,10,mixedType,1
6,3,0,9,mixedType,1
6,1,0,7,mixedType,0
6,4,0,10,mixedType,1
4,8,0,12,mixedType,1
8,3,0,11,mixedType,1
6,4,0,10,mixedType,1
6,4,0,10,mixedType,1
5,3,0,8,mixedType,1
8,1,0,9,mixedType,1
8,1,0,9,mixedType,1
5,3,0,8,mixedType,1
4,2,0,6,mixedType,0
4,2,0,6,mixedType,0
1,10,0,11,mixedType,1
2,8,6,16,mixedType,2
4,6,0,10,mixedType,1
5,2,0,7,mixedType,0
13,1,2,16,mixedType,2
7,2,0,9,mixedType,1
10,3,0,13,mixedType,1
5,4,0,9,mixedType,1
7,4,0,11,mixedType,1
13,3,0,16,mixedType,2
14,2,0,16,mixedType,2
6,2,0,8,mixedType,1
2,6,0,8,mixedType,1
8,1,0,9,mixedType,1
4,4,0,8,mixedType,1
7,3,0,10,mixedType,1
10,2,0,12,mixedType,1
15,1,0,16,mixedType,2
5,3,0,8,mixedType,1
14,2,0,16,mixedType,2
3,6,0,9,mixedType,1
8,2,0,10,mixedType,1
6,3,0,9,mixedType,1
8,3,0,11,mixedType,1
8,2,0,10,mixedType,1
14,2,0,16,mixedType,2
9,1,0,10,mixedType,1
7,4,0,11,mixedType,1
6,3,0,9,mixedType,1
8,1,0,9,mixedType,1
10,3,0,13,mixedType,1
3,6,0,9,mixedType,1
3,3,0,6,mixedType,0
6,1,0,7,mixedType,0
4,4,0,8,mixedType,1
4,2,0,6,mixedType,0
6,2,0,8,mixedType,1
6,2,0,8,mixedType,1
6,3,0,9,mixedType,1
5,3,0,8,mixedType,1
6,4,0,10,mixedType,1
8,1,0,9,mixedType,1
8,1,0,9,mixedType,1
6,3,0,9,mixedType,1
7,2,0,9,mixedType,1
9,3,0,12,mixedType,1
13,3,0,16,mixedType,2
5,3,0,8,mixedType,1
7,1,0,8,mixedType,1
8,2,0,10,mixedType,1
1,8,0,9,mixedType,1
6,2,0,8,mixedType,1
8,1,0,9,mixedType,1
14,2,0,16,mixedType,2
7,3,0,10,mixedType,1
8,2,0,10,mixedType,1
6,3,0,9,mixedType,1
5,4,0,9,mixedType,1
0,10,0,10,sameType,1
7,3,0,10,mixedType,1
5,1,0,6,mixedType,0
1,8,0,9,mixedType,1
5,1,0,6,mixedType,0
4,4,0,8,mixedType,1
14,2,0,16,mixedType,2
6,4,0,10,mixedType,1
7,4,0,11,mixedType,1
4,4,0,8,mixedType,1
6,1,0,7,mixedType,0
4,6,0,10,mixedType,1
4,4,0,8,mixedType,1
6,3,0,9,mixedType,1
5,2,0,7,mixedType,0
10,3,0,13,mixedType,1
6,1,0,7,mixedType,0
19,1,1,21,mixedType,2
5,4,0,9,mixedType,1
5,2,0,7,mixedType,0
8,1,0,9,mixedType,1
8,2,0,10,mixedType,1
8,2,0,10,mixedType,1
5,1,0,6,mixedType,0
9,3,0,12,mixedType,1
15,1,0,16,mixedType,2
7,5,0,12,mixedType,1
7,3,0,10,mixedType,1
12,4,0,16,mixedType,2
10,3,0,13,mixedType,1
10,2,0,12,mixedType,1
10,2,0,12,mixedType,1
14,2,0,16,mixedType,2
8,3,0,11,mixedType,1
0,6,2,8,mixedType,1
5,1,0,6,mixedType,0
5,3,0,8,mixedType,1
1,5,0,6,mixedType,0
5,3,0,8,mixedType,1
5,2,0,7,mixedType,0
7,3,0,10,mixedType,1
4,6,0,10,mixedType,1
6,3,0,9,mixedType,1
7,5,0,12,mixedType,1
12,4,0,16,mixedType,2
8,2,0,10,mixedType,1
6,3,0,9,mixedType,1
5,3,0,8,mixedType,1
6,3,0,9,mixedType,1
4,6,0,10,mixedType,1
6,3,0,9,mixedType,1
5,5,0,10,mixedType,1
4,4,0,8,mixedType,1
8,3,0,11,mixedType,1
6,3,0,9,mixedType,1
6,3,0,9,mixedType,1
4,9,0,13,mixedType,1
5,3,0,8,mixedType,1
5,3,0,8,mixedType,1
6,3,0,9,mixedType,1
8,2,0,10,mixedType,1
8,1,0,9,mixedType,1
5,2,0,7,mixedType,0
5,4,0,9,mixedType,1
4,4,0,8,mixedType,1
6,4,0,10,mixedType,1
10,5,1,16,mixedType,2
20,0,1,21,mixedType,2
9,1,0,10,mixedType,1
6,6,0,12,mixedType,1
8,3,0,11,mixedType,1
6,5,0,11,mixedType,1
7,3,0,10,mixedType,1
6,1,0,7,mixedType,0
6,4,0,10,mixedType,1
3,9,3,15,mixedType,2
8,3,0,11,mixedType,1
8,3,0,11,mixedType,1
6,4,0,10,mixedType,1
5,2,0,7,mixedType,0
5,2,0,7,mixedType,0
6,3,0,9,mixedType,1
6,1,0,7,mixedType,0
5,3,0,8,mixedType,1
6,3,0,9,mixedType,1
5,1,0,6,mixedType,0
12,4,0,16,mixedType,2
9,4,0,13,mixedType,1
7,2,0,9,mixedType,1
7,2,0,9,mixedType,1
8,3,0,11,mixedType,1
13,3,0,16,mixedType,2
1,8,0,9,mixedType,1
7,3,0,10,mixedType,1
14,2,0,16,mixedType,2
7,4,0,11,mixedType,1
15,1,0,16,mixedType,2
5,3,0,8,mixedType,1
6,3,0,9,mixedType,1
2,6,0,8,mixedType,1
9,3,0,12,mixedType,1
7,3,0,10,mixedType,1
7,2,0,9,mixedType,1
5,1,0,6,mixedType,0
7,2,0,9,mixedType,1
2,8,0,10,mixedType,1
8,2,0,10,mixedType,1
8,2,0,10,mixedType,1
12,4,0,16,mixedType,2
12,1,0,13,mixedType,1
4,4,0,8,mixedType,1
7,2,0,9,mixedType,1
5,4,0,9,mixedType,1
4,2,0,6,mixedType,0
17,3,0,20,mixedType,2
7,2,0,9,mixedType,1
1,10,0,11,mixedType,1
6,4,0,10,mixedType,1
6,2,0,8,mixedType,1
6,1,0,7,mixedType,0
6,1,0,7,mixedType,0
5,3,0,8,mixedType,1
3,5,0,8,mixedType,1
8,5,0,13,mixedType,1
6,2,0,8,mixedType,1
8,2,0,10,mixedType,1
8,2,0,10,mixedType,1
15,1,0,16,mixedType,2
8,2,0,10,mixedType,1
5,3,0,8,mixedType,1
8,3,0,11,mixedType,1
7,3,0,10,mixedType,1
6,6,0,12,mixedType,1
4,6,0,10,mixedType,1
6,3,0,9,mixedType,1
6,2,0,8,mixedType,1
6,2,0,8,mixedType,1
5,2,0,7,mixedType,0
1,8,0,9,mixedType,1
8,4,0,12,mixedType,1
6,4,0,10,mixedType,1
5,2,0,7,mixedType,0
6,3,0,9,mixedType,1
6,2,0,8,mixedType,1
8,4,0,12,mixedType,1
10,1,0,11,mixedType,1
14,2,0,16,mixedType,2
9,1,0,10,mixedType,1
4,4,0,8,mixedType,1
6,3,0,9,mixedType,1
2,8,0,10,mixedType,1
3,6,0,9,mixedType,1
2,9,0,11,mixedType,1
9,1,0,10,mixedType,1
6,3,0,9,mixedType,1
9,1,0,10,mixedType,1
7,1,0,8,mixedType,1
8,2,0,10,mixedType,1
1,6,0,7,mixedType,0
11,1,0,12,mixedType,1
7,3,0,10,mixedType,1
3,6,0,9,mixedType,1
9,3,0,12,mixedType,1
7,2,0,9,mixedType,1
9,3,0,12,mixedType,1
7,3,0,10,mixedType,1
8,1,0,9,mixedType,1
15,1,0,16,mixedType,2
9,3,0,12,mixedType,1
5,5,0,10,mixedType,1
5,4,0,9,mixedType,1
5,2,0,7,mixedType,0
6,3,0,9,mixedType,1
7,2,0,9,mixedType,1
8,1,0,9,mixedType,1
9,1,0,10,mixedType,1
13,3,0,16,mixedType,2
7,3,0,10,mixedType,1
6,1,0,7,mixedType,0
15,1,0,16,mixedType,2
5,3,0,8,mixedType,1
7,2,0,9,mixedType,1
6,4,0,10,mixedType,1
8,1,0,9,mixedType,1
6,1,0,7,mixedType,0
5,4,0,9,mixedType,1
7,2,0,9,mixedType,1
7,2,0,9,mixedType,1
6,1,0,7,mixedType,0
9,2,0,11,mixedType,1
14,2,0,16,mixedType,2
7,2,0,9,mixedType,1
6,3,0,9,mixedType,1
5,3,0,8,mixedType,1
4,2,0,6,mixedType,0
6,4,0,10,mixedType,1
5,3,0,8,mixedType,1
7,3,0,10,mixedType,1
2,6,0,8,mixedType,1
5,4,0,9,mixedType,1
14,2,0,16,mixedType,2
7,3,0,10,mixedType,1
6,3,0,9,mixedType,1
6,1,0,7,mixedType,0
4,4,0,8,mixedType,1
5,2,0,7,mixedType,0
6,3,0,9,mixedType,1
5,3,0,8,mixedType,1
1,9,0,10,mixedType,1
2,8,0,10,mixedType,1
8,3,0,11,mixedType,1
7,2,0,9,mixedType,1
14,2,0,16,mixedType,2
5,2,0,7,mixedType,0
8,2,0,10,mixedType,1
3,6,0,9,mixedType,1
6,3,0,9,mixedType,1
6,3,0,9,mixedType,1
8,2,0,10,mixedType,1
5,3,0,8,mixedType,1
5,2,0,7,mixedType,0
6,4,0,10,mixedType,1
5,1,0,6,mixedType,0
5,3,0,8,mixedType,1
1,9,0,10,mixedType,1
6,1,0,7,mixedType,0
8,1,0,9,mixedType,1
6,3,0,9,mixedType,1
4,2,0,6,mixedType,0
6,2,0,8,mixedType,1
7,2,0,9,mixedType,1
3,6,0,9,mixedType,1
14,2,0,16,mixedType,2
12,3,0,15,mixedType,2
7,2,0,9,mixedType,1
4,4,0,8,mixedType,1
14,2,0,16,mixedType,2
7,3,0,10,mixedType,1
8,1,0,9,mixedType,1
7,3,0,10,mixedType,1
6,4,0,10,mixedType,1
3,6,0,9,mixedType,1
5,5,0,10,mixedType,1
9,1,0,10,mixedType,1
4,4,0,8,mixedType,1
5,4,0,9,mixedType,1
4,4,0,8,mixedType,1
2,7,0,9,mixedType,1
2,4,0,6,mixedType,0
10,2,0,12,mixedType,1
2,6,0,8,mixedType,1
1,8,0,9,mixedType,1
7,3,0,10,mixedType,1
6,4,0,10,mixedType,1
10,1,0,11,mixedType,1
13,3,0,16,mixedType,2
6,2,0,8,mixedType,1
13,3,0,16,mixedType,2
11,3,0,14,mixedType,2
1,8,0,9,mixedType,1
7,3,0,10,mixedType,1
6,3,0,9,mixedType,1
6,3,0,9,mixedType,1
2,4,0,6,mixedType,0
4,2,0,6,mixedType,0
3,6,0,9,mixedType,1
1,8,0,9,mixedType,1
6,0,1,7,mixedType,0
5,2,0,7,mixedType,0
12,4,0,16,mixedType,2
7,2,0,9,mixedType,1
3,9,0,12,mixedType,1
11,3,0,14,mixedType,2
6,3,0,9,mixedType,1
6,1,0,7,mixedType,0
7,3,0,10,mixedType,1
8,2,0,10,mixedType,1
7,3,0,10,mixedType,1
5,2,0,7,mixedType,0
8,4,0,12,mixedType,1
3,8,0,11,mixedType,1
1,7,0,8,mixedType,1
6,0,1,7,mixedType,0
8,2,0,10,mixedType,1
6,2,0,8,mixedType,1
9,4,0,13,mixedType,1
2,6,0,8,mixedType,1
5,2,0,7,mixedType,0
6,1,0,7,mixedType,0
3,5,0,8,mixedType,1
5,2,0,7,mixedType,0
4,6,0,10,mixedType,1
7,1,0,8,mixedType,1
5,4,0,9,mixedType,1
8,1,0,9,mixedType,1
7,3,0,10,mixedType,1
6,3,0,9,mixedType,1
8,1,0,9,mixedType,1
7,2,0,9,mixedType,1
5,6,0,11,mixedType,1
5,2,0,7,mixedType,0
4,6,0,10,mixedType,1
7,1,0,8,mixedType,1
6,3,0,9,mixedType,1
4,8,0,12,mixedType,1
7,3,0,10,mixedType,1
6,5,0,11,mixedType,1
7,2,0,9,mixedType,1
5,3,0,8,mixedType,1
7,2,0,9,mixedType,1
7,3,0,10,mixedType,1
5,1,0,6,mixedType,0
6,1,0,7,mixedType,0
7,4,0,11,mixedType,1
15,4,0,19,mixedType,2
9,1,0,10,mixedType,1
6,1,0,7,mixedType,0
7,3,0,10,mixedType,1
11,1,0,12,mixedType,1
1,8,0,9,mixedType,1
6,3,0,9,mixedType,1
5,8,0,13,mixedType,1
5,1,0,6,mixedType,0
8,1,0,9,mixedType,1
8,2,0,10,mixedType,1
6,2,0,8,mixedType,1
6,1,0,7,mixedType,0
9,2,0,11,mixedType,1
7,1,0,8,mixedType,1
7,2,0,9,mixedType,1
10,2,0,12,mixedType,1
7,1,0,8,mixedType,1
13,3,0,16,mixedType,2
5,4,0,9,mixedType,1
7,4,0,11,mixedType,1
9,1,0,10,mixedType,1
8,2,0,10,mixedType,1
7,1,0,8,mixedType,1
3,7,0,10,mixedType,1
14,3,0,17,mixedType,2
8,2,0,10,mixedType,1
5,2,0,7,mixedType,0
6,2,0,8,mixedType,1
10,1,0,11,mixedType,1
8,3,0,11,mixedType,1
19,1,0,20,mixedType,2
7,3,0,10,mixedType,1
15,3,0,18,mixedType,2
4,4,0,8,mixedType,1
4,4,0,8,mixedType,1
2,8,0,10,mixedType,1
9,1,0,10,mixedType,1
5,4,0,9,mixedType,1
9,1,0,10,mixedType,1
7,3,0,10,mixedType,1
8,3,0,11,mixedType,1
7,3,0,10,mixedType,1
8,2,0,10,mixedType,1
10,2,0,12,mixedType,1
6,1,0,7,mixedType,0
4,5,0,9,mixedType,1
5,4,0,9,mixedType,1
4,4,0,8,mixedType,1
3,3,0,6,mixedType,0
13,3,0,16,mixedType,2
11,3,0,14,mixedType,2
13,2,2,17,mixedType,2
2,6,0,8,mixedType,1
8,1,0,9,mixedType,1
6,2,0,8,mixedType,1
7,3,0,10,mixedType,1
4,6,0,10,mixedType,1
8,1,0,9,mixedType,1
5,3,0,8,mixedType,1
5,4,0,9,mixedType,1
10,3,0,13,mixedType,1
7,3,0,10,mixedType,1
8,2,0,10,mixedType,1
15,1,0,16,mixedType,2
9,4,0,13,mixedType,1
5,7,0,12,mixedType,1
5,2,0,7,mixedType,0
2,10,0,12,mixedType,1
9,1,0,10,mixedType,1
9,1,0,10,mixedType,1
6,2,0,8,mixedType,1
8,3,0,11,mixedType,1
7,2,0,9,mixedType,1
4,2,0,6,mixedType,0
7,1,0,8,mixedType,1
8,2,0,10,mixedType,1
6,3,0,9,mixedType,1
6,6,0,12,mixedType,1
8,2,0,10,mixedType,1
7,4,0,11,mixedType,1
2,7,0,9,mixedType,1
7,2,0,9,mixedType,1
7,3,0,10,mixedType,1
8,2,0,10,mixedType,1
7,3,0,10,mixedType,1
8,2,0,10,mixedType,1
7,3,0,10,mixedType,1
6,6,0,12,mixedType,1
9,4,0,13,mixedType,1
6,2,0,8,mixedType,1
9,1,0,10,mixedType,1
7,3,0,10,mixedType,1
8,4,0,12,mixedType,1
8,3,0,11,mixedType,1
6,2,0,8,mixedType,1
15,1,1,17,mixedType,2
2,4,0,6,mixedType,0
7,3,0,10,mixedType,1
5,1,0,6,mixedType,0
6,0,1,7,mixedType,0
5,8,0,13,mixedType,1
8,2,0,10,mixedType,1
4,5,0,9,mixedType,1
7,2,0,9,mixedType,1
6,2,0,8,mixedType,1
5,2,0,7,mixedType,0
6,1,0,7,mixedType,0
7,3,0,10,mixedType,1
12,3,0,15,mixedType,2
6,1,0,7,mixedType,0
6,4,0,10,mixedType,1
10,3,0,13,mixedType,1
9,2,0,11,mixedType,1
10,1,0,11,mixedType,1
8,3,0,11,mixedType,1
5,5,0,10,mixedType,1
8,4,0,12,mixedType,1
3,5,0,8,mixedType,1
5,4,0,9,mixedType,1
5,8,0,13,mixedType,1
7,3,0,10,mixedType,1
11,5,0,16,mixedType,2
2,6,0,8,mixedType,1
8,2,0,10,mixedType,1
7,2,0,9,mixedType,1
4,4,0,8,mixedType,1
7,2,0,9,mixedType,1
2,7,0,9,mixedType,1
15,1,0,16,mixedType,2
4,4,0,8,mixedType,1
6,2,0,8,mixedType,1
5,1,0,6,mixedType,0
8,2,0,10,mixedType,1
6,3,0,9,mixedType,1
7,2,0,9,mixedType,1
7,2,0,9,mixedType,1
7,3,0,10,mixedType,1
10,1,0,11,mixedType,1
8,3,0,11,mixedType,1
4,2,0,6,mixedType,0
12,4,0,16,mixedType,2
4,7,0,11,mixedType,1
6,3,0,9,mixedType,1
10,4,0,14,mixedType,2
7,1,0,8,mixedType,1
6,1,0,7,mixedType,0
7,4,0,11,mixedType,1
6,2,0,8,mixedType,1
6,3,0,9,mixedType,1
4,7,0,11,mixedType,1
4,6,0,10,mixedType,1
2,11,0,13,mixedType,1
8,3,0,11,mixedType,1
2,4,0,6,mixedType,0
4,4,0,8,mixedType,1
10,1,0,11,mixedType,1
8,1,0,9,mixedType,1
8,2,0,10,mixedType,1
2,6,0,8,mixedType,1
8,3,0,11,mixedType,1
7,2,0,9,mixedType,1
7,4,0,11,mixedType,1
6,3,0,9,mixedType,1
12,1,0,13,mixedType,1
9,1,0,10,mixedType,1
7,3,0,10,mixedType,1
4,2,0,6,mixedType,0
9,1,0,10,mixedType,1
6,5,0,11,mixedType,1
5,1,0,6,mixedType,0
0,7,2,9,mixedType,1
15,1,0,16,mixedType,2
6,3,0,9,mixedType,1
14,2,0,16,mixedType,2
1,8,0,9,mixedType,1
5,2,0,7,mixedType,0
15,1,0,16,mixedType,2
8,2,0,10,mixedType,1
5,2,0,7,mixedType,0
3,1,0,4,mixedType,0
7,2,0,9,mixedType,1
5,3,0,8,mixedType,1
7,2,0,9,mixedType,1
6,4,0,10,mixedType,1
8,1,0,9,mixedType,1
7,3,0,10,mixedType,1
14,1,1,16,mixedType,2
7,3,0,10,mixedType,1
4,2,0,6,mixedType,0
2,4,0,6,mixedType,0
6,3,0,9,mixedType,1
5,2,0,7,mixedType,0
9,1,0,10,mixedType,1
8,3,0,11,mixedType,1
1,8,0,9,mixedType,1
14,2,0,16,mixedType,2
2,6,0,8,mixedType,1
6,2,0,8,mixedType,1
1,8,0,9,mixedType,1
7,3,0,10,mixedType,1
7,2,0,9,mixedType,1
9,3,0,12,mixedType,1
9,1,0,10,mixedType,1
7,3,0,10,mixedType,1
6,4,0,10,mixedType,1
7,3,0,10,mixedType,1
5,3,0,8,mixedType,1
9,1,0,10,mixedType,1
7,5,0,12,mixedType,1
6,3,0,9,mixedType,1
11,3,0,14,mixedType,2
4,2,0,6,mixedType,0
13,3,0,16,mixedType,2
5,3,0,8,mixedType,1
5,2,0,7,mixedType,0
6,2,0,8,mixedType,1
7,2,0,9,mixedType,1
6,4,0,10,mixedType,1
13,3,0,16,mixedType,2
6,2,0,8,mixedType,1
4,5,0,9,mixedType,1
10,3,0,13,mixedType,1
2,6,0,8,mixedType,1
6,4,0,10,mixedType,1
5,3,0,8,mixedType,1
13,3,0,16,mixedType,2
9,1,0,10,mixedType,1
8,1,0,9,mixedType,1
5,8,0,13,mixedType,1
7,2,0,9,mixedType,1
8,2,0,10,mixedType,1
5,3,0,8,mixedType,1
5,3,0,8,mixedType,1
13,3,0,16,mixedType,2
8,5,1,14,mixedType,2
2,6,0,8,mixedType,1
7,3,0,10,mixedType,1
7,3,0,10,mixedType,1
7,3,0,10,mixedType,1
8,2,0,10,mixedType,1
16,1,1,18,mixedType,2
5,2,0,7,mixedType,0
5,1,0,6,mixedType,0
6,1,0,7,mixedType,0
5,4,0,9,mixedType,1
7,2,0,9,mixedType,1
5,3,0,8,mixedType,1
7,1,0,8,mixedType,1
3,9,0,12,mixedType,1
15,1,0,16,mixedType,2
7,3,0,10,mixedType,1
5,4,0,9,mixedType,1
2,6,0,8,mixedType,1
4,2,0,6,mixedType,0
5,7,0,12,mixedType,1
7,9,0,16,mixedType,2
7,4,0,11,mixedType,1
3,5,0,8,mixedType,1
8,2,0,10,mixedType,1
3,5,0,8,mixedType,1
6,1,0,7,mixedType,0
1,5,0,6,mixedType,0
7,4,0,11,mixedType,1
6,3,0,9,mixedType,1
2,8,0,10,mixedType,1
6,2,0,8,mixedType,1
12,1,1,14,mixedType,2
8,3,0,11,mixedType,1
5,2,0,7,mixedType,0
4,2,0,6,mixedType,0
2,8,0,10,mixedType,1
14,2,0,16,mixedType,2
6,1,0,7,mixedType,0
2,6,0,8,mixedType,1
3,10,0,13,mixedType,1
3,5,0,8,mixedType,1
7,3,0,10,mixedType,1
6,10,0,16,mixedType,2
6,3,0,9,mixedType,1
7,3,0,10,mixedType,1
5,2,0,7,mixedType,0
6,3,0,9,mixedType,1
4,0,2,6,mixedType,0
7,3,0,10,mixedType,1
14,1,1,16,mixedType,2
5,1,0,6,mixedType,0
14,2,0,16,mixedType,2
7,2,0,9,mixedType,1
6,2,0,8,mixedType,1
2,7,0,9,mixedType,1
1,5,0,6,mixedType,0
7,3,0,10,mixedType,1
14,2,0,16,mixedType,2
4,4,0,8,mixedType,1
4,4,0,8,mixedType,1
3,8,0,11,mixedType,1
11,2,0,13,mixedType,1
12,3,0,15,mixedType,2
2,8,0,10,mixedType,1
6,1,0,7,mixedType,0
8,1,0,9,mixedType,1
6,3,0,9,mixedType,1
9,1,0,10,mixedType,1
4,2,0,6,mixedType,0
12,4,0,16,mixedType,2
8,2,0,10,mixedType,1
9,1,0,10,mixedType,1
8,5,0,13,mixedType,1
9,5,0,14,mixedType,2
5,6,0,11,mixedType,1
7,2,0,9,mixedType,1
11,3,0,14,mixedType,2
13,3,0,16,mixedType,2
15,1,0,16,mixedType,2
4,4,0,8,mixedType,1
6,3,0,9,mixedType,1
3,6,0,9,mixedType,1
8,8,0,16,mixedType,2
8,2,0,10,mixedType,1
3,8,0,11,mixedType,1
2,6,0,8,mixedType,1
6,2,0,8,mixedType,1
7,2,0,9,mixedType,1
5,2,0,7,mixedType,0
6,4,0,10,mixedType,1
4,2,0,6,mixedType,0
14,2,0,16,mixedType,2
4,6,0,10,mixedType,1
5,2,0,7,mixedType,0
6,2,0,8,mixedType,1
8,2,0,10,mixedType,1
4,2,0,6,mixedType,0
5,5,0,10,mixedType,1
11,1,0,12,mixedType,1
4,6,0,10,mixedType,1
8,3,0,11,mixedType,1
4,7,0,11,mixedType,1
4,0,2,6,mixedType,0
7,4,0,11,mixedType,1
5,1,0,6,mixedType,0
7,2,0,9,mixedType,1
6,1,0,7,mixedType,0
5,3,0,8,mixedType,1
3,6,0,9,mixedType,1
14,2,0,16,mixedType,2
5,2,0,7,mixedType,0
6,2,0,8,mixedType,1
5,4,0,9,mixedType,1
7,3,0,10,mixedType,1
5,1,0,6,mixedType,0
8,2,0,10,mixedType,1
5,3,0,8,mixedType,1
4,6,0,10,mixedType,1
11,2,0,13,mixedType,1
5,1,0,6,mixedType,0
12,3,0,15,mixedType,2
8,2,0,10,mixedType,1
4,2,0,6,mixedType,0
11,1,0,12,mixedType,1
9,4,0,13,mixedType,1
5,2,0,7,mixedType,0
6,4,0,10,mixedType,1
5,2,0,7,mixedType,0
5,4,0,9,mixedType,1
6,1,0,7,mixedType,0
7,2,0,9,mixedType,1
7,2,0,9,mixedType,1
5,1,0,6,mixedType,0
4,2,0,6,mixedType,0
5,2,0,7,mixedType,0
7,1,0,8,mixedType,1
6,1,0,7,mixedType,0
5,4,0,9,mixedType,1
11,2,0,13,mixedType,1
10,3,0,13,mixedType,1
7,3,0,10,mixedType,1
4,2,0,6,mixedType,0
7,2,0,9,mixedType,1
1,7,0,8,mixedType,1
9,2,0,11,mixedType,1
5,3,0,8,mixedType,1
6,3,0,9,mixedType,1
6,2,0,8,mixedType,1
6,4,0,10,mixedType,1
4,2,0,6,mixedType,0
9,2,0,11,mixedType,1
4,2,0,6,mixedType,0
0,8,1,9,mixedType,1
0,8,2,10,mixedType,1
14,2,0,16,mixedType,2
9,1,0,10,mixedType,1
6,2,0,8,mixedType,1
6,2,0,8,mixedType,1
14,2,0,16,mixedType,2
7,4,0,11,mixedType,1
8,1,0,9,mixedType,1
5,1,0,6,mixedType,0
6,2,0,8,mixedType,1
14,2,0,16,mixedType,2
6,2,0,8,mixedType,1
4,2,0,6,mixedType,0
6,2,0,8,mixedType,1
8,1,0,9,mixedType,1
3,5,0,8,mixedType,1
3,8,0,11,mixedType,1
15,1,1,17,mixedType,2
1,8,0,9,mixedType,1
6,3,0,9,mixedType,1
6,1,0,7,mixedType,0
6,1,0,7,mixedType,0
12,4,0,16,mixedType,2
8,2,0,10,mixedType,1
6,2,0,8,mixedType,1
6,3,0,9,mixedType,1
9,1,0,10,mixedType,1
6,1,0,7,mixedType,0
6,1,0,7,mixedType,0
7,4,0,11,mixedType,1
6,3,0,9,mixedType,1
10,1,0,11,mixedType,1
6,8,0,14,mixedType,2
5,4,0,9,mixedType,1
7,3,0,10,mixedType,1
7,3,0,10,mixedType,1
6,6,0,12,mixedType,1
8,2,0,10,mixedType,1
14,2,0,16,mixedType,2
13,3,0,16,mixedType,2
6,2,0,8,mixedType,1
14,2,0,16,mixedType,2
6,4,0,10,mixedType,1
4,4,0,8,mixedType,1
9,4,0,13,mixedType,1
8,1,0,9,mixedType,1
7,2,0,9,mixedType,1
4,4,0,8,mixedType,1
4,4,0,8,mixedType,1
5,2,0,7,mixedType,0
11,3,0,14,mixedType,2
8,1,0,9,mixedType,1
14,2,0,16,mixedType,2
6,3,0,9,mixedType,1
4,4,0,8,mixedType,1
4,4,0,8,mixedType,1
5,2,0,7,mixedType,0
4,6,0,10,mixedType,1
6,4,0,10,mixedType,1
3,8,0,11,mixedType,1
9,3,0,12,mixedType,1
9,3,0,12,mixedType,1
6,4,0,10,mixedType,1
8,5,0,13,mixedType,1
2,7,0,9,mixedType,1
5,2,0,7,mixedType,0
10,2,0,12,mixedType,1
4,4,0,8,mixedType,1
8,6,0,14,mixedType,2
7,3,0,10,mixedType,1
7,3,0,10,mixedType,1
7,3,0,10,mixedType,1
7,3,0,10,mixedType,1
8,2,0,10,mixedType,1
9,2,0,11,mixedType,1
2,4,0,6,mixedType,0
4,4,0,8,mixedType,1
7,2,0,9,mixedType,1
7,3,0,10,mixedType,1
1,8,0,9,mixedType,1
13,3,0,16,mixedType,2
6,1,0,7,mixedType,0
11,3,0,14,mixedType,2
9,1,0,10,mixedType,1
8,2,0,10,mixedType,1
6,3,0,9,mixedType,1
7,3,0,10,mixedType,1
8,2,0,10,mixedType,1
5,1,0,6,mixedType,0
6,4,0,10,mixedType,1
7,1,0,8,mixedType,1
20,5,1,26,mixedType,2
6,3,0,9,mixedType,1
7,2,0,9,mixedType,1
4,10,1,15,mixedType,2
5,10,0,15,mixedType,2
2,8,0,10,mixedType,1
5,2,0,7,mixedType,0
6,3,0,9,mixedType,1
7,3,0,10,mixedType,1
4,6,0,10,mixedType,1
10,2,0,12,mixedType,1
8,1,0,9,mixedType,1
6,2,0,8,mixedType,1
13,3,0,16,mixedType,2
3,6,0,9,mixedType,1
6,3,0,9,mixedType,1
5,3,0,8,mixedType,1
4,6,0,10,mixedType,1
15,1,0,16,mixedType,2
7,2,0,9,mixedType,1
1,8,0,9,mixedType,1
5,1,0,6,mixedType,0
8,1,0,9,mixedType,1
6,3,0,9,mixedType,1
4,4,0,8,mixedType,1
8,3,0,11,mixedType,1
7,2,0,9,mixedType,1
14,2,0,16,mixedType,2
9,4,0,13,mixedType,1
2,8,0,10,mixedType,1
11,3,0,14,mixedType,2
6,2,0,8,mixedType,1
5,5,0,10,mixedType,1
8,2,0,10,mixedType,1
7,2,0,9,mixedType,1
2,7,0,9,mixedType,1
7,1,0,8,mixedType,1
6,2,0,8,mixedType,1
7,5,0,12,mixedType,1
5,2,0,7,mixedType,0
5,2,0,7,mixedType,0
11,3,0,14,mixedType,2
7,1,0,8,mixedType,1
11,3,0,14,mixedType,2
6,3,0,9,mixedType,1
14,2,0,16,mixedType,2
7,3,0,10,mixedType,1
12,4,0,16,mixedType,2
4,6,0,10,mixedType,1
5,3,0,8,mixedType,1
9,4,0,13,mixedType,1
5,5,0,10,mixedType,1
9,1,0,10,mixedType,1
6,4,0,10,mixedType,1
6,2,0,8,mixedType,1
8,1,0,9,mixedType,1
0,8,1,9,mixedType,1
3,5,0,8,mixedType,1
5,1,0,6,mixedType,0
6,10,0,16,mixedType,2
8,1,0,9,mixedType,1
1,5,0,6,mixedType,0
7,2,0,9,mixedType,1
1,9,0,10,mixedType,1
14,2,0,16,mixedType,2
9,4,0,13,mixedType,1
9,1,0,10,mixedType,1
5,2,0,7,mixedType,0
6,4,0,10,mixedType,1
9,1,0,10,mixedType,1
6,4,0,10,mixedType,1
8,3,0,11,mixedType,1
14,2,0,16,mixedType,2
7,3,0,10,mixedType,1
14,2,0,16,mixedType,2
6,4,0,10,mixedType,1
9,3,0,12,mixedType,1
3,10,0,13,mixedType,1
9,3,0,12,mixedType,1
9,1,0,10,mixedType,1
10,2,0,12,mixedType,1
6,1,0,7,mixedType,0
6,2,0,8,mixedType,1
7,1,0,8,mixedType,1
10,1,0,11,mixedType,1
7,3,0,10,mixedType,1
2,6,0,8,mixedType,1
5,1,0,6,mixedType,0
5,2,0,7,mixedType,0
7,3,0,10,mixedType,1
1,10,0,11,mixedType,1
9,2,0,11,mixedType,1
4,6,0,10,mixedType,1
4,6,0,10,mixedType,1
4,4,0,8,mixedType,1
14,2,0,16,mixedType,2
4,2,0,6,mixedType,0
7,1,0,8,mixedType,1
6,4,0,10,mixedType,1
12,3,0,15,mixedType,2
6,4,0,10,mixedType,1
5,3,0,8,mixedType,1
13,3,0,16,mixedType,2
12,4,0,16,mixedType,2
4,2,0,6,mixedType,0
7,7,0,14,mixedType,2
9,2,0,11,mixedType,1
4,2,0,6,mixedType,0
5,3,0,8,mixedType,1
10,2,0,12,mixedType,1
5,2,0,7,mixedType,0
5,3,0,8,mixedType,1
6,1,0,7,mixedType,0
6,3,0,9,mixedType,1
2,7,0,9,mixedType,1
4,4,0,8,mixedType,1
12,3,0,15,mixedType,2
8,1,0,9,mixedType,1
4,2,0,6,mixedType,0
7,2,0,9,mixedType,1
7,3,0,10,mixedType,1
7,2,0,9,mixedType,1
9,1,0,10,mixedType,1
8,2,0,10,mixedType,1
6,9,0,15,mixedType,2
9,1,0,10,mixedType,1
8,2,0,10,mixedType,1
6,4,0,10,mixedType,1
6,4,0,10,mixedType,1
4,7,0,11,mixedType,1
7,2,0,9,mixedType,1
3,5,0,8,mixedType,1
3,8,0,11,mixedType,1
8,4,0,12,mixedType,1
8,1,0,9,mixedType,1
6,1,0,7,mixedType,0
15,1,0,16,mixedType,2
9,1,0,10,mixedType,1
6,2,0,8,mixedType,1
4,4,0,8,mixedType,1
5,3,0,8,mixedType,1
1,8,0,9,mixedType,1
15,1,0,16,mixedType,2
4,4,0,8,mixedType,1
5,3,0,8,mixedType,1
2,11,0,13,mixedType,1
6,4,0,10,mixedType,1
8,2,0,10,mixedType,1
8,2,0,10,mixedType,1
9,2,0,11,mixedType,1
4,7,0,11,mixedType,1
6,3,0,9,mixedType,1
7,2,0,9,mixedType,1
6,4,0,10,mixedType,1
6,6,0,12,mixedType,1
6,2,0,8,mixedType,1
1,6,0,7,mixedType,0
7,2,0,9,mixedType,1
5,4,0,9,mixedType,1
7,2,0,9,mixedType,1
6,3,0,9,mixedType,1
5,6,0,11,mixedType,1
2,8,0,10,mixedType,1
15,1,0,16,mixedType,2
6,4,0,10,mixedType,1
5,4,0,9,mixedType,1
6,2,0,8,mixedType,1
2,8,0,10,mixedType,1
8,4,0,12,mixedType,1
3,8,0,11,mixedType,1
6,2,0,8,mixedType,1
7,1,0,8,mixedType,1
4,2,0,6,mixedType,0
7,2,0,9,mixedType,1
12,3,0,15,mixedType,2
7,3,0,10,mixedType,1
5,1,0,6,mixedType,0
4,2,0,6,mixedType,0
12,4,0,16,mixedType,2
1,8,0,9,mixedType,1
6,3,0,9,mixedType,1
5,1,0,6,mixedType,0
1,8,0,9,mixedType,1
3,3,0,6,mixedType,0
6,4,0,10,mixedType,1
3,7,0,10,mixedType,1
6,2,0,8,mixedType,1
9,2,0,11,mixedType,1
9,1,0,10,mixedType,1
11,5,0,16,mixedType,2
7,4,0,11,mixedType,1
3,6,0,9,mixedType,1
6,4,0,10,mixedType,1
7,3,0,10,mixedType,1
5,0,0,5,sameType,0
12,3,0,15,mixedType,2
5,5,0,10,mixedType,1
5,2,0,7,mixedType,0
3,7,0,10,mixedType,1
10,1,0,11,mixedType,1
3,6,0,9,mixedType,1
4,6,0,10,mixedType,1
15,1,0,16,mixedType,2
4,6,0,10,mixedType,1
9,1,0,10,mixedType,1
9,1,0,10,mixedType,1
7,3,0,10,mixedType,1
6,4,0,10,mixedType,1
8,1,0,9,mixedType,1
9,0,2,11,mixedType,1
2,4,0,6,mixedType,0
4,4,0,8,mixedType,1
9,4,0,13,mixedType,1
8,2,0,10,mixedType,1
11,4,1,16,mixedType,2
6,2,0,8,mixedType,1
6,4,0,10,mixedType,1
4,2,0,6,mixedType,0
9,4,0,13,mixedType,1
5,2,0,7,mixedType,0
7,2,0,9,mixedType,1
4,8,0,12,mixedType,1
11,2,0,13,mixedType,1
8,2,0,10,mixedType,1
1,8,0,9,mixedType,1
5,2,0,7,mixedType,0
8,4,0,12,mixedType,1
7,1,0,8,mixedType,1
15,1,0,16,mixedType,2
12,3,0,15,mixedType,2
3,3,0,6,mixedType,0
9,1,0,10,mixedType,1
7,1,0,8,mixedType,1
7,3,0,10,mixedType,1
6,2,0,8,mixedType,1
1,8,0,9,mixedType,1
5,3,0,8,mixedType,1
5,3,0,8,mixedType,1
6,4,0,10,mixedType,1
11,3,0,14,mixedType,2
6,2,0,8,mixedType,1
4,6,0,10,mixedType,1
15,1,0,16,mixedType,2
13,3,0,16,mixedType,2
8,2,0,10,mixedType,1
8,3,4,15,mixedType,2
6,3,0,9,mixedType,1
7,6,0,13,mixedType,1
9,3,0,12,mixedType,1
5,6,0,11,mixedType,1
8,1,0,9,mixedType,1
8,1,0,9,mixedType,1
6,4,0,10,mixedType,1
9,1,0,10,mixedType,1
3,6,0,9,mixedType,1
9,2,0,11,mixedType,1
1,8,0,9,mixedType,1
8,1,0,9,mixedType,1
8,1,0,9,mixedType,1
8,2,0,10,mixedType,1
9,1,0,10,mixedType,1
8,3,0,11,mixedType,1
6,1,0,7,mixedType,0
8,4,0,12,mixedType,1
3,6,0,9,mixedType,1
3,8,0,11,mixedType,1
13,3,0,16,mixedType,2
15,1,0,16,mixedType,2
7,2,0,9,mixedType,1
7,2,0,9,mixedType,1
5,1,0,6,mixedType,0
8,2,0,10,mixedType,1
4,4,0,8,mixedType,1
4,4,0,8,mixedType,1
6,2,0,8,mixedType,1
4,2,0,6,mixedType,0
14,2,0,16,mixedType,2
4,4,0,8,mixedType,1
13,3,0,16,mixedType,2
3,5,0,8,mixedType,1
12,4,0,16,mixedType,2
5,6,0,11,mixedType,1
2,6,0,8,mixedType,1
6,1,0,7,mixedType,0
7,3,0,10,mixedType,1
5,4,0,9,mixedType,1
7,2,0,9,mixedType,1
9,2,0,11,mixedType,1
7,3,0,10,mixedType,1
6,2,0,8,mixedType,1
9,3,0,12,mixedType,1
6,1,0,7,mixedType,0
6,7,0,13,mixedType,1
15,1,0,16,mixedType,2
5,1,0,6,mixedType,0
5,2,0,7,mixedType,0
10,2,0,12,mixedType,1
6,2,0,8,mixedType,1
13,3,0,16,mixedType,2
4,6,0,10,mixedType,1
7,3,0,10,mixedType,1
6,6,0,12,mixedType,1
6,2,0,8,mixedType,1
15,1,0,16,mixedType,2
6,1,0,7,mixedType,0
8,5,0,13,mixedType,1
11,3,0,14,mixedType,2
7,3,0,10,mixedType,1
5,3,0,8,mixedType,1
0,6,0,6,sameType,0
7,4,0,11,mixedType,1
8,3,0,11,mixedType,1
6,3,0,9,mixedType,1
3,5,0,8,mixedType,1
4,2,0,6,mixedType,0
8,1,0,9,mixedType,1
6,6,0,12,mixedType,1
5,2,0,7,mixedType,0
4,4,0,8,mixedType,1
7,1,0,8,mixedType,1
7,3,0,10,mixedType,1
8,2,0,10,mixedType,1
4,2,0,6,mixedType,0
8,2,0,10,mixedType,1
7,1,0,8,mixedType,1
6,2,0,8,mixedType,1
1,8,0,9,mixedType,1
6,3,0,9,mixedType,1
14,2,0,16,mixedType,2
5,2,0,7,mixedType,0
6,3,0,9,mixedType,1
7,2,0,9,mixedType,1
2,9,0,11,mixedType,1
5,2,0,7,mixedType,0
3,7,0,10,mixedType,1
6,3,0,9,mixedType,1
7,1,0,8,mixedType,1
10,3,0,13,mixedType,1
9,3,0,12,mixedType,1
5,4,0,9,mixedType,1
3,6,0,9,mixedType,1
13,3,0,16,mixedType,2
12,2,2,16,mixedType,2
6,2,0,8,mixedType,1
15,1,0,16,mixedType,2
7,3,0,10,mixedType,1
12,1,0,13,mixedType,1
6,4,0,10,mixedType,1
7,2,0,9,mixedType,1
6,3,0,9,mixedType,1
8,1,0,9,mixedType,1
3,6,0,9,mixedType,1
6,6,3,15,mixedType,2
4,4,0,8,mixedType,1
8,3,0,11,mixedType,1
4,2,0,6,mixedType,0
6,1,0,7,mixedType,0
7,1,0,8,mixedType,1
6,4,0,10,mixedType,1
8,1,0,9,mixedType,1
4,4,0,8,mixedType,1
6,1,0,7,mixedType,0
8,4,0,12,mixedType,1
1,8,0,9,mixedType,1
4,2,0,6,mixedType,0
5,1,0,6,mixedType,0
4,4,0,8,mixedType,1
8,4,0,12,mixedType,1
5,6,0,11,mixedType,1
8,2,0,10,mixedType,1
6,1,0,7,mixedType,0
5,3,0,8,mixedType,1
15,1,0,16,mixedType,2
6,2,0,8,mixedType,1
8,2,0,10,mixedType,1
5,3,0,8,mixedType,1
14,2,0,16,mixedType,2
6,2,0,8,mixedType,1
5,4,0,9,mixedType,1
4,8,0,12,mixedType,1
5,2,0,7,mixedType,0
6,3,0,9,mixedType,1
5,2,0,7,mixedType,0
7,6,0,13,mixedType,1
6,2,0,8,mixedType,1
5,2,0,7,mixedType,0
5,3,0,8,mixedType,1
7,3,0,10,mixedType,1
5,3,0,8,mixedType,1
8,1,0,9,mixedType,1
11,3,0,14,mixedType,2
6,3,0,9,mixedType,1
1,9,0,10,mixedType,1
3,6,0,9,mixedType,1
2,4,0,6,mixedType,0
5,3,0,8,mixedType,1
6,4,0,10,mixedType,1
5,2,0,7,mixedType,0
5,3,0,8,mixedType,1
7,3,0,10,mixedType,1
6,1,0,7,mixedType,0
8,1,0,9,mixedType,1
5,8,0,13,mixedType,1
8,2,0,10,mixedType,1
16,3,0,19,mixedType,2
9,1,0,10,mixedType,1
7,2,0,9,mixedType,1
7,4,0,11,mixedType,1
12,4,0,16,mixedType,2
10,1,0,11,mixedType,1
13,3,0,16,mixedType,2
8,4,0,12,mixedType,1
12,4,0,16,mixedType,2
10,3,0,13,mixedType,1
2,6,0,8,mixedType,1
4,4,0,8,mixedType,1
8,2,0,10,mixedType,1
5,7,0,12,mixedType,1
6,4,0,10,mixedType,1
8,2,0,10,mixedType,1
6,3,0,9,mixedType,1
4,4,0,8,mixedType,1
4,4,0,8,mixedType,1
2,6,0,8,mixedType,1
3,6,0,9,mixedType,1
3,7,0,10,mixedType,1
6,1,0,7,mixedType,0
9,1,0,10,mixedType,1
2,6,0,8,mixedType,1
4,6,0,10,mixedType,1
2,7,0,9,mixedType,1
8,2,0,10,mixedType,1
6,3,0,9,mixedType,1
7,2,0,9,mixedType,1
8,2,0,10,mixedType,1
8,2,0,10,mixedType,1
6,2,0,8,mixedType,1
6,3,0,9,mixedType,1
6,1,0,7,mixedType,0
2,6,0,8,mixedType,1
5,3,0,8,mixedType,1
4,4,0,8,mixedType,1
7,1,0,8,mixedType,1
5,3,0,8,mixedType,1
5,2,0,7,mixedType,0
9,4,0,13,mixedType,1
4,4,0,8,mixedType,1
7,2,0,9,mixedType,1
1,7,0,8,mixedType,1
12,3,0,15,mixedType,2
3,6,0,9,mixedType,1
5,5,0,10,mixedType,1
6,1,0,7,mixedType,0
15,1,0,16,mixedType,2
5,3,0,8,mixedType,1
9,3,0,12,mixedType,1
2,10,0,12,mixedType,1
9,2,0,11,mixedType,1
6,1,0,7,mixedType,0
7,3,0,10,mixedType,1
8,3,0,11,mixedType,1
5,4,0,9,mixedType,1
6,3,0,9,mixedType,1
6,4,0,10,mixedType,1
5,3,0,8,mixedType,1
5,2,0,7,mixedType,0
6,3,0,9,mixedType,1
1,8,0,9,mixedType,1
5,3,0,8,mixedType,1
2,7,0,9,mixedType,1
9,1,0,10,mixedType,1
10,3,0,13,mixedType,1
13,3,0,16,mixedType,2
9,3,0,12,mixedType,1
6,3,0,9,mixedType,1
6,1,0,7,mixedType,0
7,3,0,10,mixedType,1
6,3,0,9,mixedType,1
6,1,0,7,mixedType,0
2,4,0,6,mixedType,0
2,6,0,8,mixedType,1
8,4,0,12,mixedType,1
6,3,0,9,mixedType,1
8,1,0,9,mixedType,1
13,3,0,16,mixedType,2
4,4,0,8,mixedType,1
6,3,0,9,mixedType,1
6,1,0,7,mixedType,0
5,4,0,9,mixedType,1
6,2,0,8,mixedType,1
9,1,0,10,mixedType,1
6,3,0,9,mixedType,1
5,2,0,7,mixedType,0
5,1,0,6,mixedType,0
6,1,0,7,mixedType,0
7,3,0,10,mixedType,1
4,4,0,8,mixedType,1
7,5,0,12,mixedType,1
10,3,0,13,mixedType,1
6,2,0,8,mixedType,1
6,3,0,9,mixedType,1
11,3,0,14,mixedType,2
14,2,0,16,mixedType,2
10,5,0,15,mixedType,2
12,3,0,15,mixedType,2
6,3,0,9,mixedType,1
5,4,0,9,mixedType,1
6,1,0,7,mixedType,0
5,3,0,8,mixedType,1
5,4,0,9,mixedType,1
3,10,0,13,mixedType,1
3,5,0,8,mixedType,1
14,2,0,16,mixedType,2
4,4,0,8,mixedType,1
9,1,0,10,mixedType,1
7,2,0,9,mixedType,1
5,1,0,6,mixedType,0
6,1,0,7,mixedType,0
9,1,0,10,mixedType,1
7,2,0,9,mixedType,1
3,7,0,10,mixedType,1
7,2,0,9,mixedType,1
2,8,0,10,mixedType,1
14,2,0,16,mixedType,2
1,10,0,11,mixedType,1
4,7,0,11,mixedType,1
7,2,0,9,mixedType,1
5,7,0,12,mixedType,1
5,3,0,8,mixedType,1
5,2,0,7,mixedType,0
9,1,0,10,mixedType,1
4,9,0,13,mixedType,1
2,6,0,8,mixedType,1
14,2,0,16,mixedType,2
5,4,0,9,mixedType,1
5,9,1,15,mixedType,2
5,6,0,11,mixedType,1
2,8,0,10,mixedType,1
9,2,0,11,mixedType,1
11,2,0,13,mixedType,1
4,8,0,12,mixedType,1
4,5,0,9,mixedType,1
12,3,0,15,mixedType,2
6,2,0,8,mixedType,1
5,2,0,7,mixedType,0
7,3,0,10,mixedType,1
7,2,0,9,mixedType,1
13,3,0,16,mixedType,2
4,2,0,6,mixedType,0
6,1,0,7,mixedType,0
5,6,0,11,mixedType,1
8,1,0,9,mixedType,1
2,7,0,9,mixedType,1
7,2,0,9,mixedType,1
7,2,0,9,mixedType,1
8,2,0,10,mixedType,1
5,3,0,8,mixedType,1
6,1,0,7,mixedType,0
6,1,0,7,mixedType,0
5,4,0,9,mixedType,1
1,7,0,8,mixedType,1
7,1,0,8,mixedType,1
14,2,0,16,mixedType,2
11,3,0,14,mixedType,2
9,3,0,12,mixedType,1
7,5,0,12,mixedType,1
9,1,0,10,mixedType,1
4,8,0,12,mixedType,1
7,3,0,10,mixedType,1
5,1,0,6,mixedType,0
6,0,1,7,mixedType,0
1,8,0,9,mixedType,1
8,1,0,9,mixedType,1
5,3,0,8,mixedType,1
1,8,0,9,mixedType,1
5,1,0,6,mixedType,0
8,4,0,12,mixedType,1
3,6,0,9,mixedType,1
5,4,0,9,mixedType,1
9,3,0,12,mixedType,1
4,2,0,6,mixedType,0
10,4,2,16,mixedType,2
8,1,0,9,mixedType,1
10,2,0,12,mixedType,1
14,2,0,16,mixedType,2
5,1,0,6,mixedType,0
6,1,0,7,mixedType,0
7,3,0,10,mixedType,1
6,2,0,8,mixedType,1
3,3,0,6,mixedType,0
2,7,0,9,mixedType,1
5,8,0,13,mixedType,1
5,4,0,9,mixedType,1
10,2,0,12,mixedType,1
9,2,0,11,mixedType,1
5,2,0,7,mixedType,0
5,4,0,9,mixedType,1
10,4,0,14,mixedType,2
6,3,0,9,mixedType,1
7,3,0,10,mixedType,1
6,1,0,7,mixedType,0
5,3,0,8,mixedType,1
11,3,0,14,mixedType,2
2,9,0,11,mixedType,1
6,1,0,7,mixedType,0
4,8,0,12,mixedType,1
7,2,0,9,mixedType,1
7,3,0,10,mixedType,1
3,3,0,6,mixedType,0
1,7,0,8,mixedType,1
7,3,0,10,mixedType,1
6,1,0,7,mixedType,0
6,2,0,8,mixedType,1
4,6,0,10,mixedType,1
9,2,0,11,mixedType,1
14,2,0,16,mixedType,2
10,6,0,16,mixedType,2
6,2,0,8,mixedType,1
6,4,0,10,mixedType,1
9,1,0,10,mixedType,1
7,2,0,9,mixedType,1
5,1,0,6,mixedType,0
5,4,0,9,mixedType,1
4,4,0,8,mixedType,1
7,2,0,9,mixedType,1
10,3,0,13,mixedType,1
12,4,0,16,mixedType,2
7,3,0,10,mixedType,1
5,3,0,8,mixedType,1
12,4,0,16,mixedType,2
5,3,0,8,mixedType,1
5,4,0,9,mixedType,1
9,4,0,13,mixedType,1
5,3,0,8,mixedType,1
7,2,0,9,mixedType,1
4,4,0,8,mixedType,1
8,2,0,10,mixedType,1
8,4,0,12,mixedType,1
8,1,0,9,mixedType,1
4,8,0,12,mixedType,1
8,2,4,14,mixedType,2
11,2,0,13,mixedType,1
14,2,0,16,mixedType,2
6,2,0,8,mixedType,1
5,4,0,9,mixedType,1
2,6,0,8,mixedType,1
6,4,0,10,mixedType,1
5,1,0,6,mixedType,0
8,2,0,10,mixedType,1
2,6,0,8,mixedType,1
3,5,0,8,mixedType,1
7,1,0,8,mixedType,1
6,3,0,9,mixedType,1
8,1,0,9,mixedType,1
13,3,0,16,mixedType,2
5,2,0,7,mixedType,0
6,3,0,9,mixedType,1
13,3,0,16,mixedType,2
1,10,0,11,mixedType,1
8,2,0,10,mixedType,1
13,1,1,15,mixedType,2
6,4,0,10,mixedType,1
7,1,0,8,mixedType,1
15,1,0,16,mixedType,2
7,1,0,8,mixedType,1
4,6,0,10,mixedType,1
6,6,0,12,mixedType,1
6,4,0,10,mixedType,1
7,3,0,10,mixedType,1
6,1,0,7,mixedType,0
7,2,0,9,mixedType,1
4,4,0,8,mixedType,1
4,2,0,6,mixedType,0
6,3,0,9,mixedType,1
1,7,0,8,mixedType,1
5,3,0,8,mixedType,1
8,2,0,10,mixedType,1
6,4,0,10,mixedType,1
5,4,0,9,mixedType,1
14,2,0,16,mixedType,2
14,2,0,16,mixedType,2
6,3,0,9,mixedType,1
10,3,0,13,mixedType,1
7,3,0,10,mixedType,1
5,4,0,9,mixedType,1
8,2,0,10,mixedType,1
7,2,0,9,mixedType,1
6,1,0,7,mixedType,0
5,2,0,7,mixedType,0
8,2,0,10,mixedType,1
7,1,0,8,mixedType,1
5,4,0,9,mixedType,1
9,2,0,11,mixedType,1
12,4,0,16,mixedType,2
6,4,0,10,mixedType,1
6,2,0,8,mixedType,1
12,4,0,16,mixedType,2
6,3,0,9,mixedType,1
7,1,0,8,mixedType,1
8,1,0,9,mixedType,1
2,6,0,8,mixedType,1
13,1,1,15,mixedType,2
6,4,0,10,mixedType,1
8,2,0,10,mixedType,1
8,5,0,13,mixedType,1
5,3,0,8,mixedType,1
5,4,0,9,mixedType,1
6,1,0,7,mixedType,0
6,4,0,10,mixedType,1
1,8,0,9,mixedType,1
5,2,0,7,mixedType,0
7,3,0,10,mixedType,1
12,3,0,15,mixedType,2
7,4,0,11,mixedType,1
5,2,0,7,mixedType,0
9,4,0,13,mixedType,1
2,4,0,6,mixedType,0
7,2,0,9,mixedType,1
3,6,0,9,mixedType,1
6,3,0,9,mixedType,1
9,2,0,11,mixedType,1
12,3,0,15,mixedType,2
9,1,0,10,mixedType,1
7,3,0,10,mixedType,1
7,4,0,11,mixedType,1
4,4,0,8,mixedType,1
8,2,0,10,mixedType,1
14,2,0,16,mixedType,2
3,5,0,8,mixedType,1
8,1,0,9,mixedType,1
14,2,0,16,mixedType,2
3,7,0,10,mixedType,1
3,6,0,9,mixedType,1
5,1,0,6,mixedType,0
6,1,0,7,mixedType,0
9,1,0,10,mixedType,1
7,2,0,9,mixedType,1
9,4,1,14,mixedType,2
6,4,0,10,mixedType,1
4,9,0,13,mixedType,1
7,3,0,10,mixedType,1
7,3,0,10,mixedType,1
14,2,0,16,mixedType,2
6,3,0,9,mixedType,1
7,3,0,10,mixedType,1
8,2,0,10,mixedType,1
7,3,0,10,mixedType,1
6,3,0,9,mixedType,1
9,4,0,13,mixedType,1
7,2,0,9,mixedType,1
5,4,0,9,mixedType,1
8,2,0,10,mixedType,1
2,4,0,6,mixedType,0
7,3,0,10,mixedType,1
2,8,0,10,mixedType,1
6,1,0,7,mixedType,0
9,4,0,13,mixedType,1
14,2,0,16,mixedType,2
8,2,0,10,mixedType,1
2,7,0,9,mixedType,1
9,1,0,10,mixedType,1
9,3,0,12,mixedType,1
14,2,0,16,mixedType,2
0,9,2,11,mixedType,1
5,3,0,8,mixedType,1
6,4,0,10,mixedType,1
1,10,0,11,mixedType,1
4,4,0,8,mixedType,1
7,3,0,10,mixedType,1
8,2,0,10,mixedType,1
5,2,0,7,mixedType,0
6,3,0,9,mixedType,1
3,5,0,8,mixedType,1
14,2,0,16,mixedType,2
13,3,0,16,mixedType,2
0,10,1,11,mixedType,1
6,3,0,9,mixedType,1
6,3,0,9,mixedType,1
5,1,0,6,mixedType,0
5,3,0,8,mixedType,1
5,4,0,9,mixedType,1
7,2,0,9,mixedType,1
8,4,0,12,mixedType,1
5,2,0,7,mixedType,0
2,11,0,13,mixedType,1
7,3,0,10,mixedType,1
7,2,0,9,mixedType,1
6,3,0,9,mixedType,1
14,2,0,16,mixedType,2
6,1,0,7,mixedType,0
8,4,0,12,mixedType,1
4,4,0,8,mixedType,1
7,3,0,10,mixedType,1
6,6,0,12,mixedType,1
4,2,0,6,mixedType,0
9,2,0,11,mixedType,1
5,8,0,13,mixedType,1
9,2,0,11,mixedType,1
7,4,0,11,mixedType,1
1,7,0,8,mixedType,1
1,10,0,11,mixedType,1
5,4,0,9,mixedType,1
6,1,0,7,mixedType,0
14,2,0,16,mixedType,2
8,4,0,12,mixedType,1
12,4,0,16,mixedType,2
14,2,0,16,mixedType,2
15,1,0,16,mixedType,2
6,2,0,8,mixedType,1
7,3,0,10,mixedType,1
5,3,0,8,mixedType,1
6,1,0,7,mixedType,0
3,7,0,10,mixedType,1
6,2,0,8,mixedType,1
12,4,0,16,mixedType,2
7,2,0,9,mixedType,1
6,2,0,8,mixedType,1
1,9,0,10,mixedType,1
7,3,0,10,mixedType,1
5,2,0,7,mixedType,0
12,4,0,16,mixedType,2
1,9,0,10,mixedType,1
9,2,0,11,mixedType,1
5,4,0,9,mixedType,1
8,2,0,10,mixedType,1
9,2,0,11,mixedType,1
1,8,0,9,mixedType,1
3,6,0,9,mixedType,1
10,2,0,12,mixedType,1
7,4,0,11,mixedType,1
5,2,0,7,mixedType,0
14,2,0,16,mixedType,2
9,2,0,11,mixedType,1
8,2,0,10,mixedType,1
7,3,0,10,mixedType,1
4,6,0,10,mixedType,1
6,1,0,7,mixedType,0
8,3,0,11,mixedType,1
7,3,0,10,mixedType,1
6,2,0,8,mixedType,1
6,1,0,7,mixedType,0
7,3,0,10,mixedType,1
9,1,0,10,mixedType,1
7,2,0,9,mixedType,1
1,8,0,9,mixedType,1
11,3,0,14,mixedType,2
3,5,0,8,mixedType,1
9,1,0,10,mixedType,1
4,6,0,10,mixedType,1
8,4,0,12,mixedType,1
5,3,0,8,mixedType,1
4,6,0,10,mixedType,1
6,1,0,7,mixedType,0
8,2,0,10,mixedType,1
5,2,0,7,mixedType,0
5,5,0,10,mixedType,1
8,3,0,11,mixedType,1
6,3,0,9,mixedType,1
14,3,0,17,mixedType,2
5,1,0,6,mixedType,0
5,3,0,8,mixedType,1
4,5,0,9,mixedType,1
2,6,0,8,mixedType,1
9,2,0,11,mixedType,1
8,2,0,10,mixedType,1
3,6,0,9,mixedType,1
8,1,0,9,mixedType,1
14,2,0,16,mixedType,2
3,7,0,10,mixedType,1
8,3,0,11,mixedType,1
10,2,0,12,mixedType,1
5,4,0,9,mixedType,1
8,1,0,9,mixedType,1
14,1,1,16,mixedType,2
9,2,0,11,mixedType,1
4,6,0,10,mixedType,1
12,4,0,16,mixedType,2
7,2,0,9,mixedType,1
6,3,0,9,mixedType,1
7,1,0,8,mixedType,1
4,6,0,10,mixedType,1
9,4,0,13,mixedType,1
13,3,0,16,mixedType,2
12,4,0,16,mixedType,2
5,3,0,8,mixedType,1
4,2,0,6,mixedType,0
7,1,0,8,mixedType,1
9,3,0,12,mixedType,1
6,3,0,9,mixedType,1
4,2,0,6,mixedType,0
9,2,0,11,mixedType,1
13,3,0,16,mixedType,2
8,2,0,10,mixedType,1
10,6,0,16,mixedType,2
5,3,0,8,mixedType,1
9,3,0,12,mixedType,1
10,3,0,13,mixedType,1
5,2,0,7,mixedType,0
7,3,0,10,mixedType,1
4,2,0,6,mixedType,0
10,2,0,12,mixedType,1
7,3,0,10,mixedType,1
6,1,0,7,mixedType,0
9,3,0,12,mixedType,1
14,2,0,16,mixedType,2
5,5,0,10,mixedType,1
5,3,0,8,mixedType,1
6,3,0,9,mixedType,1
8,2,0,10,mixedType,1
6,2,0,8,mixedType,1
11,2,0,13,mixedType,1
6,2,0,8,mixedType,1
3,5,0,8,mixedType,1
6,3,0,9,mixedType,1
9,2,0,11,mixedType,1
5,3,0,8,mixedType,1
9,1,0,10,mixedType,1
5,2,0,7,mixedType,0
6,4,0,10,mixedType,1
10,3,0,13,mixedType,1
6,3,0,9,mixedType,1
4,9,0,13,mixedType,1
11,3,0,14,mixedType,2
8,2,0,10,mixedType,1
12,3,0,15,mixedType,2
6,3,0,9,mixedType,1
6,4,0,10,mixedType,1
5,5,0,10,mixedType,1
12,1,0,13,mixedType,1
6,2,0,8,mixedType,1
8,3,0,11,mixedType,1
14,2,0,16,mixedType,2
6,4,0,10,mixedType,1
13,3,0,16,mixedType,2
5,2,0,7,mixedType,0
5,1,0,6,mixedType,0
1,8,0,9,mixedType,1
5,3,0,8,mixedType,1
8,4,0,12,mixedType,1
7,2,0,9,mixedType,1
6,3,0,9,mixedType,1
7,4,0,11,mixedType,1
4,2,0,6,mixedType,0
8,2,3,13,mixedType,1
7,3,0,10,mixedType,1
4,4,0,8,mixedType,1
13,3,0,16,mixedType,2
6,1,0,7,mixedType,0
7,1,0,8,mixedType,1
6,2,0,8,mixedType,1
9,2,0,11,mixedType,1
6,3,0,9,mixedType,1
3,8,0,11,mixedType,1
3,5,0,8,mixedType,1
6,3,0,9,mixedType,1
6,3,0,9,mixedType,1
13,3,0,16,mixedType,2
10,1,0,11,mixedType,1
14,2,0,16,mixedType,2
5,3,0,8,mixedType,1
2,6,0,8,mixedType,1
14,2,0,16,mixedType,2
6,2,0,8,mixedType,1
2,10,0,12,mixedType,1
6,2,0,8,mixedType,1
14,2,0,16,mixedType,2
7,3,0,10,mixedType,1
4,2,0,6,mixedType,0
7,3,0,10,mixedType,1
6,3,0,9,mixedType,1
10,2,0,12,mixedType,1
13,3,0,16,mixedType,2
6,1,0,7,mixedType,0
6,2,0,8,mixedType,1
5,3,0,8,mixedType,1
5,1,0,6,mixedType,0
6,4,0,10,mixedType,1
4,2,0,6,mixedType,0
6,5,0,11,mixedType,1
4,9,0,13,mixedType,1
13,3,0,16,mixedType,2
5,2,0,7,mixedType,0
12,1,0,13,mixedType,1
8,2,0,10,mixedType,1
6,2,0,8,mixedType,1
5,2,0,7,mixedType,0
5,3,0,8,mixedType,1
14,2,0,16,mixedType,2
4,2,0,6,mixedType,0
9,1,0,10,mixedType,1
1,8,0,9,mixedType,1
8,2,0,10,mixedType,1
6,1,0,7,mixedType,0
6,3,0,9,mixedType,1
6,1,0,7,mixedType,0
12,3,0,15,mixedType,2
15,1,0,16,mixedType,2
7,3,0,10,mixedType,1
6,6,0,12,mixedType,1
6,3,0,9,mixedType,1
6,4,0,10,mixedType,1
5,2,0,7,mixedType,0
7,3,0,10,mixedType,1
2,6,0,8,mixedType,1
7,2,0,9,mixedType,1
6,3,0,9,mixedType,1
6,3,0,9,mixedType,1
8,2,0,10,mixedType,1
5,4,0,9,mixedType,1
7,2,0,9,mixedType,1
9,1,0,10,mixedType,1
5,4,0,9,mixedType,1
7,2,0,9,mixedType,1
7,3,0,10,mixedType,1
6,3,0,9,mixedType,1
7,3,0,10,mixedType,1
7,1,0,8,mixedType,1
5,3,0,8,mixedType,1
8,2,0,10,mixedType,1
5,7,0,12,mixedType,1
8,2,0,10,mixedType,1
6,4,0,10,mixedType,1
5,3,0,8,mixedType,1
7,2,0,9,mixedType,1
5,3,0,8,mixedType,1
4,2,0,6,mixedType,0
7,3,0,10,mixedType,1
7,1,0,8,mixedType,1
6,3,0,9,mixedType,1
6,1,0,7,mixedType,0
9,1,0,10,mixedType,1
6,2,0,8,mixedType,1
6,1,0,7,mixedType,0
5,2,0,7,mixedType,0
2,8,0,10,mixedType,1
4,6,0,10,mixedType,1
7,1,0,8,mixedType,1
6,2,0,8,mixedType,1
6,4,0,10,mixedType,1
7,1,0,8,mixedType,1
5,4,0,9,mixedType,1
11,5,0,16,mixedType,2
5,1,0,6,mixedType,0
13,3,0,16,mixedType,2
0,3,0,3,sameType,0
7,3,0,10,mixedType,1
9,1,0,10,mixedType,1
5,2,0,7,mixedType,0
9,2,0,11,mixedType,1
6,4,0,10,mixedType,1
7,2,0,9,mixedType,1
2,6,0,8,mixedType,1
14,2,0,16,mixedType,2
8,1,0,9,mixedType,1
5,3,0,8,mixedType,1
3,7,0,10,mixedType,1
13,3,0,16,mixedType,2
6,3,0,9,mixedType,1
4,4,0,8,mixedType,1
12,3,0,15,mixedType,2
8,1,0,9,mixedType,1
1,8,0,9,mixedType,1
5,4,0,9,mixedType,1
8,1,0,9,mixedType,1
7,3,0,10,mixedType,1
5,2,0,7,mixedType,0
8,2,0,10,mixedType,1
6,3,0,9,mixedType,1
8,2,0,10,mixedType,1
5,2,0,7,mixedType,0
5,2,0,7,mixedType,0
5,3,0,8,mixedType,1
4,2,0,6,mixedType,0
6,2,0,8,mixedType,1
8,4,0,12,mixedType,1
5,4,0,9,mixedType,1
15,1,0,16,mixedType,2
6,2,0,8,mixedType,1
5,6,0,11,mixedType,1
7,2,0,9,mixedType,1
9,3,0,12,mixedType,1
7,2,0,9,mixedType,1
2,9,0,11,mixedType,1
6,3,0,9,mixedType,1
8,1,0,9,mixedType,1
8,1,0,9,mixedType,1
6,2,0,8,mixedType,1
4,7,0,11,mixedType,1
3,6,0,9,mixedType,1
8,2,0,10,mixedType,1
9,3,0,12,mixedType,1
7,3,0,10,mixedType,1
6,5,0,11,mixedType,1
6,4,0,10,mixedType,1
6,3,0,9,mixedType,1
6,1,0,7,mixedType,0
3,6,0,9,mixedType,1
5,4,0,9,mixedType,1
6,1,0,7,mixedType,0
7,1,0,8,mixedType,1
5,2,0,7,mixedType,0
2,6,0,8,mixedType,1
6,1,0,7,mixedType,0
7,1,0,8,mixedType,1
13,3,0,16,mixedType,2
6,3,0,9,mixedType,1
2,7,0,9,mixedType,1
7,3,0,10,mixedType,1
6,3,0,9,mixedType,1
5,4,0,9,mixedType,1
13,3,0,16,mixedType,2
6,4,0,10,mixedType,1
8,4,0,12,mixedType,1
8,2,0,10,mixedType,1
9,3,0,12,mixedType,1
6,2,0,8,mixedType,1
5,3,0,8,mixedType,1
9,2,0,11,mixedType,1
2,6,0,8,mixedType,1
7,1,0,8,mixedType,1
4,4,0,8,mixedType,1
2,8,0,10,mixedType,1
8,3,0,11,mixedType,1
6,3,0,9,mixedType,1
6,2,0,8,mixedType,1
9,2,0,11,mixedType,1
8,2,0,10,mixedType,1
8,1,0,9,mixedType,1
6,2,0,8,mixedType,1
10,1,0,11,mixedType,1
12,3,0,15,mixedType,2
7,3,0,10,mixedType,1
7,2,0,9,mixedType,1
4,6,0,10,mixedType,1
6,3,0,9,mixedType,1
6,3,0,9,mixedType,1
4,2,0,6,mixedType,0
5,1,0,6,mixedType,0
5,3,0,8,mixedType,1
0,8,1,9,mixedType,1
9,1,0,10,mixedType,1
8,4,0,12,mixedType,1
8,3,0,11,mixedType,1
5,3,0,8,mixedType,1
5,4,0,9,mixedType,1
5,6,0,11,mixedType,1
11,2,0,13,mixedType,1
6,2,0,8,mixedType,1
14,1,0,15,mixedType,2
5,2,0,7,mixedType,0
9,3,0,12,mixedType,1
8,2,0,10,mixedType,1
5,2,0,7,mixedType,0
5,3,0,8,mixedType,1
2,8,0,10,mixedType,1
2,6,0,8,mixedType,1
2,8,0,10,mixedType,1
8,4,0,12,mixedType,1
6,3,0,9,mixedType,1
3,5,0,8,mixedType,1
15,1,0,16,mixedType,2
14,2,0,16,mixedType,2
6,4,0,10,mixedType,1
7,3,0,10,mixedType,1
7,2,0,9,mixedType,1
7,3,0,10,mixedType,1
5,2,0,7,mixedType,0
6,1,0,7,mixedType,0
6,3,0,9,mixedType,1
3,6,0,9,mixedType,1
6,5,0,11,mixedType,1
8,1,0,9,mixedType,1
7,2,0,9,mixedType,1
8,2,0,10,mixedType,1
15,3,0,18,mixedType,2
3,6,0,9,mixedType,1
6,2,2,10,mixedType,1
7,2,0,9,mixedType,1
5,3,0,8,mixedType,1
3,6,0,9,mixedType,1
8,3,0,11,mixedType,1
12,3,0,15,mixedType,2
5,5,0,10,mixedType,1
6,1,0,7,mixedType,0
12,4,0,16,mixedType,2
4,4,0,8,mixedType,1
5,1,0,6,mixedType,0
6,3,0,9,mixedType,1
6,1,0,7,mixedType,0
10,1,0,11,mixedType,1
8,2,0,10,mixedType,1
8,4,0,12,mixedType,1
5,5,0,10,mixedType,1
6,3,0,9,mixedType,1
8,1,0,9,mixedType,1
2,8,0,10,mixedType,1
5,3,0,8,mixedType,1
5,2,0,7,mixedType,0
7,0,0,7,sameType,0
8,4,0,12,mixedType,1
5,3,0,8,mixedType,1
8,1,0,9,mixedType,1
2,4,0,6,mixedType,0
7,3,0,10,mixedType,1
9,2,0,11,mixedType,1
7,6,0,13,mixedType,1
5,4,0,9,mixedType,1
12,4,0,16,mixedType,2
3,6,0,9,mixedType,1
5,2,0,7,mixedType,0
6,1,0,7,mixedType,0
4,2,0,6,mixedType,0
5,1,0,6,mixedType,0
8,1,0,9,mixedType,1
9,2,0,11,mixedType,1
6,2,0,8,mixedType,1
8,4,0,12,mixedType,1
5,6,0,11,mixedType,1
4,2,0,6,mixedType,0
7,1,0,8,mixedType,1
2,6,0,8,mixedType,1
11,5,0,16,mixedType,2
8,2,0,10,mixedType,1
13,3,0,16,mixedType,2
12,4,0,16,mixedType,2
6,5,0,11,mixedType,1
5,3,0,8,mixedType,1
7,1,0,8,mixedType,1
7,2,0,9,mixedType,1
2,6,0,8,mixedType,1
4,6,0,10,mixedType,1
15,1,0,16,mixedType,2
8,1,0,9,mixedType,1
5,4,0,9,mixedType,1
4,5,0,9,mixedType,1
12,4,0,16,mixedType,2
6,3,0,9,mixedType,1
7,2,0,9,mixedType,1
7,2,0,9,mixedType,1
8,3,0,11,mixedType,1
3,8,0,11,mixedType,1
5,4,0,9,mixedType,1
13,3,0,16,mixedType,2
6,3,0,9,mixedType,1
7,3,0,10,mixedType,1
5,3,0,8,mixedType,1
8,2,0,10,mixedType,1
5,2,0,7,mixedType,0
8,4,0,12,mixedType,1
13,3,0,16,mixedType,2
5,3,0,8,mixedType,1
4,5,0,9,mixedType,1
4,2,0,6,mixedType,0
5,2,0,7,mixedType,0
11,3,0,14,mixedType,2
4,4,0,8,mixedType,1
2,6,0,8,mixedType,1
5,6,0,11,mixedType,1
6,2,0,8,mixedType,1
7,1,0,8,mixedType,1
5,3,0,8,mixedType,1
7,3,0,10,mixedType,1
8,2,0,10,mixedType,1
9,3,0,12,mixedType,1
9,1,0,10,mixedType,1
7,1,0,8,mixedType,1
8,1,0,9,mixedType,1
3,7,0,10,mixedType,1
2,7,0,9,mixedType,1
3,6,0,9,mixedType,1
6,3,0,9,mixedType,1
4,6,0,10,mixedType,1
6,2,0,8,mixedType,1
9,2,0,11,mixedType,1
9,1,0,10,mixedType,1
1,9,0,10,mixedType,1
9,2,0,11,mixedType,1
10,6,0,16,mixedType,2
7,2,0,9,mixedType,1
6,0,3,9,mixedType,1
5,3,0,8,mixedType,1
10,2,0,12,mixedType,1
2,7,0,9,mixedType,1
1,8,0,9,mixedType,1
9,2,0,11,mixedType,1
11,4,0,15,mixedType,2
2,7,0,9,mixedType,1
5,2,0,7,mixedType,0
5,1,0,6,mixedType,0
5,3,0,8,mixedType,1
14,2,0,16,mixedType,2
7,2,0,9,mixedType,1
2,7,0,9,mixedType,1
7,4,0,11,mixedType,1
3,8,0,11,mixedType,1
7,1,0,8,mixedType,1
10,1,0,11,mixedType,1
4,2,0,6,mixedType,0
3,5,0,8,mixedType,1
6,3,0,9,mixedType,1
7,3,0,10,mixedType,1
6,3,0,9,mixedType,1
14,2,0,16,mixedType,2
6,2,0,8,mixedType,1
6,6,0,12,mixedType,1
9,2,0,11,mixedType,1
9,3,0,12,mixedType,1
7,3,0,10,mixedType,1
6,3,0,9,mixedType,1
7,3,0,10,mixedType,1
5,2,0,7,mixedType,0
5,3,0,8,mixedType,1
5,3,0,8,mixedType,1
4,4,0,8,mixedType,1
5,3,0,8,mixedType,1
6,1,0,7,mixedType,0
8,1,0,9,mixedType,1
9,1,0,10,mixedType,1
14,2,0,16,mixedType,2
10,1,0,11,mixedType,1
6,3,0,9,mixedType,1
6,2,0,8,mixedType,1
3,6,0,9,mixedType,1
7,2,0,9,mixedType,1
8,2,0,10,mixedType,1
1,8,0,9,mixedType,1
5,2,0,7,mixedType,0
12,4,1,17,mixedType,2
12,3,0,15,mixedType,2
7,1,0,8,mixedType,1
14,2,0,16,mixedType,2
13,3,0,16,mixedType,2
8,1,0,9,mixedType,1
6,4,0,10,mixedType,1
6,3,0,9,mixedType,1
8,2,0,10,mixedType,1
5,4,0,9,mixedType,1
8,1,0,9,mixedType,1
12,3,0,15,mixedType,2
7,2,0,9,mixedType,1
9,2,0,11,mixedType,1
6,3,0,9,mixedType,1
9,1,0,10,mixedType,1
9,4,0,13,mixedType,1
12,4,0,16,mixedType,2
10,2,0,12,mixedType,1
7,1,0,8,mixedType,1
6,2,0,8,mixedType,1
8,4,0,12,mixedType,1
7,2,0,9,mixedType,1
5,4,0,9,mixedType,1
4,5,0,9,mixedType,1
6,3,0,9,mixedType,1
2,6,0,8,mixedType,1
7,3,0,10,mixedType,1
6,6,0,12,mixedType,1
6,4,0,10,mixedType,1
6,3,0,9,mixedType,1
5,2,0,7,mixedType,0
7,3,0,10,mixedType,1
9,3,0,12,mixedType,1
5,3,0,8,mixedType,1
7,2,0,9,mixedType,1
7,3,0,10,mixedType,1
8,1,0,9,mixedType,1
9,1,0,10,mixedType,1
8,1,0,9,mixedType,1
7,2,0,9,mixedType,1
7,2,0,9,mixedType,1
14,2,0,16,mixedType,2
6,3,0,9,mixedType,1
7,3,0,10,mixedType,1
5,3,0,8,mixedType,1
11,3,1,15,mixedType,2
5,5,0,10,mixedType,1
12,3,0,15,mixedType,2
5,3,0,8,mixedType,1
6,3,0,9,mixedType,1
5,3,0,8,mixedType,1
4,6,0,10,mixedType,1
4,2,0,6,mixedType,0
11,1,0,12,mixedType,1
6,3,0,9,mixedType,1
2,4,0,6,mixedType,0
5,4,0,9,mixedType,1
5,2,0,7,mixedType,0
7,1,0,8,mixedType,1
7,2,0,9,mixedType,1
7,2,0,9,mixedType,1
11,3,0,14,mixedType,2
6,4,0,10,mixedType,1
4,2,0,6,mixedType,0
7,4,0,11,mixedType,1
1,8,0,9,mixedType,1
12,3,0,15,mixedType,2
8,3,0,11,mixedType,1
8,2,0,10,mixedType,1
9,1,0,10,mixedType,1
13,3,0,16,mixedType,2
8,1,0,9,mixedType,1
0,4,2,6,mixedType,0
6,3,0,9,mixedType,1
5,4,0,9,mixedType,1
4,2,0,6,mixedType,0
6,2,0,8,mixedType,1
2,6,0,8,mixedType,1
4,6,0,10,mixedType,1
6,1,0,7,mixedType,0
8,1,0,9,mixedType,1
6,2,0,8,mixedType,1
8,4,0,12,mixedType,1
6,1,0,7,mixedType,0
6,3,0,9,mixedType,1
6,4,0,10,mixedType,1
7,3,0,10,mixedType,1
7,3,0,10,mixedType,1
2,7,0,9,mixedType,1
8,4,0,12,mixedType,1
7,2,0,9,mixedType,1
8,2,0,10,mixedType,1
8,3,0,11,mixedType,1
7,2,0,9,mixedType,1
9,3,0,12,mixedType,1
6,3,0,9,mixedType,1
7,2,0,9,mixedType,1
1,8,0,9,mixedType,1
4,6,0,10,mixedType,1
8,3,0,11,mixedType,1
5,4,0,9,mixedType,1
6,5,0,11,mixedType,1
5,2,0,7,mixedType,0
7,3,0,10,mixedType,1
11,6,1,18,mixedType,2
5,5,0,10,mixedType,1
5,5,0,10,mixedType,1
5,1,0,6,mixedType,0
1,8,0,9,mixedType,1
9,2,0,11,mixedType,1
8,3,0,11,mixedType,1
6,1,0,7,mixedType,0
5,4,0,9,mixedType,1
11,1,0,12,mixedType,1
7,3,0,10,mixedType,1
8,5,0,13,mixedType,1
5,2,0,7,mixedType,0
4,4,0,8,mixedType,1
6,2,0,8,mixedType,1
5,2,0,7,mixedType,0
1,8,0,9,mixedType,1
6,4,0,10,mixedType,1
2,6,0,8,mixedType,1
5,4,0,9,mixedType,1
2,6,0,8,mixedType,1
6,4,0,10,mixedType,1
2,8,0,10,mixedType,1
5,2,0,7,mixedType,0
3,7,0,10,mixedType,1
14,2,0,16,mixedType,2
11,1,0,12,mixedType,1
6,3,0,9,mixedType,1
5,7,0,12,mixedType,1
6,4,0,10,mixedType,1
3,6,0,9,mixedType,1
4,6,0,10,mixedType,1
2,4,0,6,mixedType,0
6,2,0,8,mixedType,1
6,3,0,9,mixedType,1
5,2,0,7,mixedType,0
3,6,0,9,mixedType,1
2,6,0,8,mixedType,1
15,1,0,16,mixedType,2
15,1,1,17,mixedType,2
4,2,0,6,mixedType,0
10,0,1,11,mixedType,1
6,1,0,7,mixedType,0
5,4,0,9,mixedType,1
5,4,0,9,mixedType,1
7,2,0,9,mixedType,1
3,6,0,9,mixedType,1
7,3,0,10,mixedType,1
7,2,0,9,mixedType,1
6,2,0,8,mixedType,1
6,3,0,9,mixedType,1
6,1,0,7,mixedType,0
8,3,0,11,mixedType,1
5,2,0,7,mixedType,0
9,3,0,12,mixedType,1
3,3,0,6,mixedType,0
5,2,0,7,mixedType,0
4,4,0,8,mixedType,1
8,2,0,10,mixedType,1
3,7,0,10,mixedType,1
6,3,0,9,mixedType,1
6,1,0,7,mixedType,0
8,1,0,9,mixedType,1
3,7,0,10,mixedType,1
11,3,0,14,mixedType,2
0,8,2,10,mixedType,1
5,1,0,6,mixedType,0
4,4,0,8,mixedType,1
5,2,0,7,mixedType,0
7,1,0,8,mixedType,1
5,1,0,6,mixedType,0
5,1,0,6,mixedType,0
8,2,0,10,mixedType,1
7,3,0,10,mixedType,1
8,3,0,11,mixedType,1
8,2,0,10,mixedType,1
6,2,0,8,mixedType,1
2,8,0,10,mixedType,1
11,5,0,16,mixedType,2
13,3,0,16,mixedType,2
7,3,0,10,mixedType,1
7,3,0,10,mixedType,1
6,1,0,7,mixedType,0
3,6,0,9,mixedType,1
1,7,0,8,mixedType,1
7,3,0,10,mixedType,1
7,3,0,10,mixedType,1
7,2,0,9,mixedType,1
6,3,0,9,mixedType,1
6,4,0,10,mixedType,1
7,1,0,8,mixedType,1
4,4,0,8,mixedType,1
7,3,0,10,mixedType,1
5,2,0,7,mixedType,0
2,4,0,6,mixedType,0
8,3,0,11,mixedType,1
6,5,0,11,mixedType,1
6,3,0,9,mixedType,1
7,3,0,10,mixedType,1
7,1,0,8,mixedType,1
3,7,0,10,mixedType,1
5,4,0,9,mixedType,1
4,4,0,8,mixedType,1
6,1,0,7,mixedType,0
4,2,0,6,mixedType,0
6,3,0,9,mixedType,1
6,3,0,9,mixedType,1
9,4,0,13,mixedType,1
6,4,0,10,mixedType,1
6,6,0,12,mixedType,1
8,4,0,12,mixedType,1
4,4,0,8,mixedType,1
8,3,0,11,mixedType,1
8,3,0,11,mixedType,1
7,3,0,10,mixedType,1
15,1,0,16,mixedType,2
10,6,1,17,mixedType,2
7,3,0,10,mixedType,1
7,3,0,10,mixedType,1
8,1,0,9,mixedType,1
8,4,0,12,mixedType,1
6,1,0,7,mixedType,0
6,4,0,10,mixedType,1
5,6,0,11,mixedType,1
5,3,0,8,mixedType,1
12,3,0,15,mixedType,2
13,3,0,16,mixedType,2
5,4,0,9,mixedType,1
15,1,0,16,mixedType,2
9,1,0,10,mixedType,1
5,2,0,7,mixedType,0
11,3,0,14,mixedType,2
13,3,0,16,mixedType,2
4,2,0,6,mixedType,0
5,2,0,7,mixedType,0
8,1,0,9,mixedType,1
5,3,0,8,mixedType,1
5,3,0,8,mixedType,1
4,0,3,7,mixedType,0
7,3,0,10,mixedType,1
7,1,0,8,mixedType,1
5,3,0,8,mixedType,1
5,3,0,8,mixedType,1
11,2,0,13,mixedType,1
4,2,0,6,mixedType,0
6,2,0,8,mixedType,1
13,3,0,16,mixedType,2
8,2,0,10,mixedType,1
6,6,0,12,mixedType,1
9,1,0,10,mixedType,1
8,1,0,9,mixedType,1
7,2,0,9,mixedType,1
4,4,0,8,mixedType,1
7,6,0,13,mixedType,1
12,4,0,16,mixedType,2
4,4,0,8,mixedType,1
5,1,0,6,mixedType,0
3,8,0,11,mixedType,1
15,1,0,16,mixedType,2
5,3,0,8,mixedType,1
12,1,0,13,mixedType,1
8,2,0,10,mixedType,1
6,4,0,10,mixedType,1
12,3,0,15,mixedType,2
8,2,0,10,mixedType,1
7,4,0,11,mixedType,1
8,2,0,10,mixedType,1
4,6,0,10,mixedType,1
13,3,0,16,mixedType,2
8,2,0,10,mixedType,1
14,2,0,16,mixedType,2
6,3,0,9,mixedType,1
3,3,0,6,mixedType,0
14,1,1,16,mixedType,2
13,3,0,16,mixedType,2
5,4,0,9,mixedType,1
10,3,0,13,mixedType,1
5,3,0,8,mixedType,1
7,4,0,11,mixedType,1
7,3,0,10,mixedType,1
8,3,0,11,mixedType,1
7,1,0,8,mixedType,1
14,2,0,16,mixedType,2
4,7,0,11,mixedType,1
5,1,0,6,mixedType,0
6,2,0,8,mixedType,1
8,2,0,10,mixedType,1
5,4,0,9,mixedType,1
6,2,0,8,mixedType,1
9,1,0,10,mixedType,1
3,6,0,9,mixedType,1
6,1,0,7,mixedType,0
10,3,0,13,mixedType,1
6,5,0,11,mixedType,1
15,1,0,16,mixedType,2
1,9,0,10,mixedType,1
5,3,0,8,mixedType,1
11,1,0,12,mixedType,1
5,2,0,7,mixedType,0
1,7,0,8,mixedType,1
6,2,0,8,mixedType,1
8,2,0,10,mixedType,1
4,4,0,8,mixedType,1
14,2,0,16,mixedType,2
6,3,0,9,mixedType,1
8,1,0,9,mixedType,1
7,3,0,10,mixedType,1
6,3,0,9,mixedType,1
6,1,0,7,mixedType,0
8,3,0,11,mixedType,1
5,2,0,7,mixedType,0
5,2,0,7,mixedType,0
5,1,0,6,mixedType,0
2,7,0,9,mixedType,1
6,4,0,10,mixedType,1
6,3,0,9,mixedType,1
5,2,0,7,mixedType,0
1,5,0,6,mixedType,0
5,3,0,8,mixedType,1
6,2,0,8,mixedType,1
2,6,0,8,mixedType,1
8,2,0,10,mixedType,1
0,7,2,9,mixedType,1
6,2,0,8,mixedType,1
7,5,0,12,mixedType,1
7,2,0,9,mixedType,1
9,1,0,10,mixedType,1
8,2,0,10,mixedType,1
14,2,0,16,mixedType,2
5,3,0,8,mixedType,1
8,2,0,10,mixedType,1
13,3,0,16,mixedType,2
6,3,0,9,mixedType,1
0,8,1,9,mixedType,1
8,1,0,9,mixedType,1
4,5,0,9,mixedType,1
3,7,0,10,mixedType,1
5,4,0,9,mixedType,1
6,2,0,8,mixedType,1
6,3,0,9,mixedType,1
6,4,0,10,mixedType,1
9,3,0,12,mixedType,1
9,4,0,13,mixedType,1
5,3,0,8,mixedType,1
7,2,0,9,mixedType,1
4,4,0,8,mixedType,1
8,2,0,10,mixedType,1
8,1,0,9,mixedType,1
3,9,0,12,mixedType,1
4,2,0,6,mixedType,0
5,1,0,6,mixedType,0
5,3,0,8,mixedType,1
1,10,0,11,mixedType,1
5,3,0,8,mixedType,1
3,6,0,9,mixedType,1
9,2,0,11,mixedType,1
1,5,0,6,mixedType,0
14,2,0,16,mixedType,2
8,1,0,9,mixedType,1
8,1,0,9,mixedType,1
7,3,0,10,mixedType,1
7,2,0,9,mixedType,1
7,3,0,10,mixedType,1
5,2,0,7,mixedType,0
7,3,0,10,mixedType,1
2,6,0,8,mixedType,1
4,2,0,6,mixedType,0
3,6,0,9,mixedType,1
14,2,0,16,mixedType,2
6,3,0,9,mixedType,1
6,2,0,8,mixedType,1
5,3,0,8,mixedType,1
7,2,0,9,mixedType,1
9,1,0,10,mixedType,1
8,2,0,10,mixedType,1
13,3,0,16,mixedType,2
14,2,0,16,mixedType,2
7,2,0,9,mixedType,1
7,3,0,10,mixedType,1
8,1,0,9,mixedType,1
15,1,0,16,mixedType,2
7,2,0,9,mixedType,1
13,3,0,16,mixedType,2
3,7,0,10,mixedType,1
1,8,0,9,mixedType,1
14,2,0,16,mixedType,2
5,3,0,8,mixedType,1
7,0,1,8,mixedType,1
9,2,0,11,mixedType,1
10,6,0,16,mixedType,2
4,6,0,10,mixedType,1
6,3,0,9,mixedType,1
4,6,0,10,mixedType,1
5,2,0,7,mixedType,0
4,4,0,8,mixedType,1
8,2,0,10,mixedType,1
6,3,0,9,mixedType,1
5,4,0,9,mixedType,1
6,2,0,8,mixedType,1
5,2,0,7,mixedType,0
2,4,0,6,mixedType,0
6,1,0,7,mixedType,0
7,3,0,10,mixedType,1
9,4,0,13,mixedType,1
6,3,0,9,mixedType,1
8,2,0,10,mixedType,1
11,3,0,14,mixedType,2
11,2,0,13,mixedType,1
5,3,0,8,mixedType,1
7,3,0,10,mixedType,1
9,2,0,11,mixedType,1
3,6,0,9,mixedType,1
8,2,0,10,mixedType,1
5,2,0,7,mixedType,0
7,2,0,9,mixedType,1
9,1,0,10,mixedType,1
6,2,0,8,mixedType,1
8,4,0,12,mixedType,1
6,1,0,7,mixedType,0
9,3,0,12,mixedType,1
5,3,0,8,mixedType,1
1,9,0,10,mixedType,1
2,6,0,8,mixedType,1
7,2,0,9,mixedType,1
4,2,0,6,mixedType,0
6,2,0,8,mixedType,1
15,7,0,22,mixedType,2
5,3,0,8,mixedType,1
7,2,0,9,mixedType,1
7,4,0,11,mixedType,1
8,3,0,11,mixedType,1
1,8,0,9,mixedType,1
9,1,0,10,mixedType,1
7,1,0,8,mixedType,1
5,2,0,7,mixedType,0
9,2,0,11,mixedType,1
6,4,0,10,mixedType,1
6,2,0,8,mixedType,1
2,6,0,8,mixedType,1
8,1,0,9,mixedType,1
12,4,0,16,mixedType,2
7,3,0,10,mixedType,1
7,3,0,10,mixedType,1
4,4,0,8,mixedType,1
6,2,0,8,mixedType,1
7,3,0,10,mixedType,1
5,4,0,9,mixedType,1
3,6,0,9,mixedType,1
14,2,0,16,mixedType,2
9,3,0,12,mixedType,1
14,2,0,16,mixedType,2
10,2,0,12,mixedType,1
3,7,0,10,mixedType,1
1,10,0,11,mixedType,1
6,3,0,9,mixedType,1
5,3,0,8,mixedType,1
6,4,0,10,mixedType,1
6,1,0,7,mixedType,0
6,3,0,9,mixedType,1
4,6,0,10,mixedType,1
8,2,0,10,mixedType,1
5,3,0,8,mixedType,1
7,2,0,9,mixedType,1
15,1,0,16,mixedType,2
7,1,0,8,mixedType,1
5,1,0,6,mixedType,0
7,1,0,8,mixedType,1
12,4,0,16,mixedType,2
4,4,0,8,mixedType,1
9,2,0,11,mixedType,1
1,8,0,9,mixedType,1
7,3,0,10,mixedType,1
5,2,0,7,mixedType,0
4,2,0,6,mixedType,0
8,3,0,11,mixedType,1
6,3,0,9,mixedType,1
3,9,0,12,mixedType,1
28,8,0,36,mixedType,2
5,3,0,8,mixedType,1
4,8,0,12,mixedType,1
4,2,0,6,mixedType,0
10,3,0,13,mixedType,1
14,2,0,16,mixedType,2
8,2,0,10,mixedType,1
2,4,0,6,mixedType,0
6,3,0,9,mixedType,1
8,2,0,10,mixedType,1
6,4,0,10,mixedType,1
8,1,0,9,mixedType,1
9,1,0,10,mixedType,1
12,3,0,15,mixedType,2
5,5,0,10,mixedType,1
5,3,0,8,mixedType,1
11,2,0,13,mixedType,1
4,4,0,8,mixedType,1
2,7,0,9,mixedType,1
13,3,0,16,mixedType,2
7,3,0,10,mixedType,1
8,2,0,10,mixedType,1
7,1,0,8,mixedType,1
7,4,0,11,mixedType,1
6,4,0,10,mixedType,1
6,3,0,9,mixedType,1
6,1,0,7,mixedType,0
13,2,0,15,mixedType,2
5,2,0,7,mixedType,0
9,1,0,10,mixedType,1
4,2,0,6,mixedType,0
7,1,0,8,mixedType,1
5,3,0,8,mixedType,1
4,2,0,6,mixedType,0
6,6,0,12,mixedType,1
7,2,0,9,mixedType,1
7,2,0,9,mixedType,1
4,2,0,6,mixedType,0
11,4,1,16,mixedType,2
7,1,0,8,mixedType,1
5,6,0,11,mixedType,1
7,1,0,8,mixedType,1
6,1,0,7,mixedType,0
7,2,0,9,mixedType,1
6,3,0,9,mixedType,1
4,4,0,8,mixedType,1
7,2,0,9,mixedType,1
7,1,0,8,mixedType,1
9,3,0,12,mixedType,1
13,1,1,15,mixedType,2
6,3,0,9,mixedType,1
7,4,0,11,mixedType,1
6,3,0,9,mixedType,1
7,3,0,10,mixedType,1
6,2,0,8,mixedType,1
6,1,0,7,mixedType,0
6,1,0,7,mixedType,0
10,2,0,12,mixedType,1
5,4,0,9,mixedType,1
15,1,0,16,mixedType,2
7,3,0,10,mixedType,1
1,8,0,9,mixedType,1
2,7,0,9,mixedType,1
6,4,0,10,mixedType,1
6,3,0,9,mixedType,1
4,5,0,9,mixedType,1
5,3,0,8,mixedType,1
6,3,0,9,mixedType,1
4,4,0,8,mixedType,1
5,4,0,9,mixedType,1
6,3,0,9,mixedType,1
7,2,0,9,mixedType,1
15,1,0,16,mixedType,2
0,8,1,9,mixedType,1
6,2,0,8,mixedType,1
8,2,0,10,mixedType,1
8,4,0,12,mixedType,1
5,3,0,8,mixedType,1
13,3,0,16,mixedType,2
6,1,0,7,mixedType,0
8,2,0,10,mixedType,1
5,2,0,7,mixedType,0
7,6,0,13,mixedType,1
6,2,0,8,mixedType,1
8,1,0,9,mixedType,1
5,2,0,7,mixedType,0
8,2,0,10,mixedType,1
5,3,0,8,mixedType,1
5,2,0,7,mixedType,0
8,2,0,10,mixedType,1
1,7,0,8,mixedType,1
14,2,0,16,mixedType,2
6,3,0,9,mixedType,1
6,2,0,8,mixedType,1
6,2,0,8,mixedType,1
7,2,0,9,mixedType,1
7,1,0,8,mixedType,1
6,1,0,7,mixedType,0
10,2,0,12,mixedType,1
3,5,0,8,mixedType,1
4,4,0,8,mixedType,1
10,2,0,12,mixedType,1
14,2,0,16,mixedType,2
9,1,0,10,mixedType,1
9,1,0,10,mixedType,1
8,1,0,9,mixedType,1
13,3,0,16,mixedType,2
9,3,0,12,mixedType,1
7,3,0,10,mixedType,1
6,1,0,7,mixedType,0
7,10,0,17,mixedType,2
3,6,0,9,mixedType,1
5,4,0,9,mixedType,1
6,2,0,8,mixedType,1
6,4,0,10,mixedType,1
7,1,0,8,mixedType,1
6,2,0,8,mixedType,1
8,2,0,10,mixedType,1
6,4,0,10,mixedType,1
1,7,0,8,mixedType,1
4,2,0,6,mixedType,0
1,8,0,9,mixedType,1
8,1,0,9,mixedType,1
6,4,0,10,mixedType,1
6,6,0,12,mixedType,1
7,3,0,10,mixedType,1
4,2,0,6,mixedType,0
7,3,0,10,mixedType,1
3,6,0,9,mixedType,1
6,3,0,9,mixedType,1
7,4,0,11,mixedType,1
4,6,0,10,mixedType,1
5,1,0,6,mixedType,0
8,1,0,9,mixedType,1
8,4,0,12,mixedType,1
6,6,0,12,mixedType,1
13,2,1,16,mixedType,2
3,7,0,10,mixedType,1
12,4,0,16,mixedType,2
2,8,0,10,mixedType,1
15,1,0,16,mixedType,2
9,1,0,10,mixedType,1
8,1,0,9,mixedType,1
10,3,0,13,mixedType,1
8,1,0,9,mixedType,1
9,1,0,10,mixedType,1
8,2,0,10,mixedType,1
6,1,0,7,mixedType,0
5,3,0,8,mixedType,1
5,4,0,9,mixedType,1
8,1,0,9,mixedType,1
1,9,0,10,mixedType,1
5,2,0,7,mixedType,0
11,1,0,12,mixedType,1
7,1,0,8,mixedType,1
14,2,0,16,mixedType,2
6,3,0,9,mixedType,1
7,3,0,10,mixedType,1
6,4,0,10,mixedType,1
9,2,0,11,mixedType,1
6,4,0,10,mixedType,1
9,4,0,13,mixedType,1
8,1,0,9,mixedType,1
7,5,0,12,mixedType,1
8,2,0,10,mixedType,1
14,2,0,16,mixedType,2
5,1,0,6,mixedType,0
10,3,0,13,mixedType,1
14,2,0,16,mixedType,2
7,4,0,11,mixedType,1
5,2,0,7,mixedType,0
2,8,0,10,mixedType,1
9,1,0,10,mixedType,1
12,1,0,13,mixedType,1
5,2,0,7,mixedType,0
7,2,0,9,mixedType,1
13,3,0,16,mixedType,2
5,2,0,7,mixedType,0
8,1,0,9,mixedType,1
15,1,0,16,mixedType,2
5,1,0,6,mixedType,0
3,10,0,13,mixedType,1
6,2,0,8,mixedType,1
7,3,0,10,mixedType,1
4,2,0,6,mixedType,0
5,3,0,8,mixedType,1
8,2,0,10,mixedType,1
12,1,0,13,mixedType,1
4,6,0,10,mixedType,1
5,1,0,6,mixedType,0
9,3,0,12,mixedType,1
13,3,0,16,mixedType,2
8,1,0,9,mixedType,1
6,4,0,10,mixedType,1
14,2,0,16,mixedType,2
6,6,0,12,mixedType,1
6,0,1,7,mixedType,0
7,2,0,9,mixedType,1
7,3,0,10,mixedType,1
7,1,0,8,mixedType,1
8,2,0,10,mixedType,1
8,3,0,11,mixedType,1
5,3,0,8,mixedType,1
6,4,0,10,mixedType,1
12,3,0,15,mixedType,2
6,2,0,8,mixedType,1
2,6,0,8,mixedType,1
12,1,0,13,mixedType,1
4,8,0,12,mixedType,1
5,6,0,11,mixedType,1
8,2,0,10,mixedType,1
5,4,0,9,mixedType,1
12,3,0,15,mixedType,2
6,1,0,7,mixedType,0
5,3,0,8,mixedType,1
7,3,0,10,mixedType,1
4,2,0,6,mixedType,0
2,8,0,10,mixedType,1
14,2,0,16,mixedType,2
5,2,0,7,mixedType,0
8,2,0,10,mixedType,1
6,1,0,7,mixedType,0
6,1,0,7,mixedType,0
3,5,0,8,mixedType,1
4,4,0,8,mixedType,1
6,4,0,10,mixedType,1
2,7,0,9,mixedType,1
6,4,0,10,mixedType,1
1,7,0,8,mixedType,1
5,1,0,6,mixedType,0
7,3,0,10,mixedType,1
13,3,0,16,mixedType,2
15,1,0,16,mixedType,2
6,2,0,8,mixedType,1
1,9,0,10,mixedType,1
15,1,0,16,mixedType,2
11,2,0,13,mixedType,1
9,6,0,15,mixedType,2
13,3,0,16,mixedType,2
6,4,0,10,mixedType,1
2,8,0,10,mixedType,1
5,4,0,9,mixedType,1
1,8,0,9,mixedType,1
15,1,0,16,mixedType,2
6,4,0,10,mixedType,1
6,4,0,10,mixedType,1
5,2,0,7,mixedType,0
4,9,0,13,mixedType,1
2,5,0,7,mixedType,0
11,2,0,13,mixedType,1
8,1,0,9,mixedType,1
5,2,0,7,mixedType,0
15,1,0,16,mixedType,2
7,1,0,8,mixedType,1
5,2,0,7,mixedType,0
7,4,0,11,mixedType,1
4,2,0,6,mixedType,0
9,3,0,12,mixedType,1
8,2,0,10,mixedType,1
6,6,0,12,mixedType,1
5,3,0,8,mixedType,1
7,1,0,8,mixedType,1
4,6,0,10,mixedType,1
6,3,0,9,mixedType,1
5,2,0,7,mixedType,0
8,1,0,9,mixedType,1
6,4,0,10,mixedType,1
6,3,0,9,mixedType,1
2,6,0,8,mixedType,1
6,2,0,8,mixedType,1
15,1,0,16,mixedType,2
7,4,0,11,mixedType,1
8,5,0,13,mixedType,1
9,1,0,10,mixedType,1
1,8,0,9,mixedType,1
5,7,0,12,mixedType,1
14,2,0,16,mixedType,2
7,3,0,10,mixedType,1
6,1,0,7,mixedType,0
6,4,0,10,mixedType,1
8,1,0,9,mixedType,1
5,1,0,6,mixedType,0
4,2,0,6,mixedType,0
14,2,0,16,mixedType,2
15,1,0,16,mixedType,2
2,7,0,9,mixedType,1
5,2,0,7,mixedType,0
7,3,0,10,mixedType,1
6,1,0,7,mixedType,0
9,2,0,11,mixedType,1
6,1,0,7,mixedType,0
5,4,0,9,mixedType,1
7,2,0,9,mixedType,1
8,4,0,12,mixedType,1
8,5,0,13,mixedType,1
8,2,0,10,mixedType,1
6,3,0,9,mixedType,1
4,4,0,8,mixedType,1
9,2,0,11,mixedType,1
14,2,0,16,mixedType,2
6,4,0,10,mixedType,1
6,2,0,8,mixedType,1
5,3,0,8,mixedType,1
5,5,0,10,mixedType,1
2,10,0,12,mixedType,1
8,4,0,12,mixedType,1
15,1,0,16,mixedType,2
6,1,0,7,mixedType,0
9,3,0,12,mixedType,1
3,8,0,11,mixedType,1
5,1,0,6,mixedType,0
1,9,0,10,mixedType,1
3,6,0,9,mixedType,1
8,4,0,12,mixedType,1
1,8,0,9,mixedType,1
6,1,0,7,mixedType,0
5,3,0,8,mixedType,1
3,3,0,6,mixedType,0
9,1,0,10,mixedType,1
6,4,0,10,mixedType,1
6,3,0,9,mixedType,1
7,2,0,9,mixedType,1
7,3,0,10,mixedType,1
7,1,0,8,mixedType,1
6,3,0,9,mixedType,1
9,3,0,12,mixedType,1
15,1,0,16,mixedType,2
6,1,0,7,mixedType,0
7,1,0,8,mixedType,1
7,2,0,9,mixedType,1
4,5,0,9,mixedType,1
5,4,0,9,mixedType,1
6,1,0,7,mixedType,0
7,3,0,10,mixedType,1
5,2,0,7,mixedType,0
1,9,0,10,mixedType,1
9,3,0,12,mixedType,1
6,3,0,9,mixedType,1
14,1,1,16,mixedType,2
1,10,0,11,mixedType,1
7,2,0,9,mixedType,1
7,3,0,10,mixedType,1
8,2,0,10,mixedType,1
8,2,0,10,mixedType,1
10,1,0,11,mixedType,1
4,4,0,8,mixedType,1
8,3,0,11,mixedType,1
5,3,0,8,mixedType,1
16,1,0,17,mixedType,2
10,1,0,11,mixedType,1
7,1,0,8,mixedType,1
14,2,0,16,mixedType,2
3,10,0,13,mixedType,1
11,2,0,13,mixedType,1
7,2,0,9,mixedType,1
6,3,0,9,mixedType,1
5,3,0,8,mixedType,1
7,3,0,10,mixedType,1
6,4,0,10,mixedType,1
4,2,0,6,mixedType,0
14,2,0,16,mixedType,2
5,3,0,8,mixedType,1
6,2,0,8,mixedType,1
4,8,0,12,mixedType,1
15,1,0,16,mixedType,2
8,3,0,11,mixedType,1
3,7,0,10,mixedType,1
5,1,0,6,mixedType,0
12,4,0,16,mixedType,2
6,1,0,7,mixedType,0
10,1,0,11,mixedType,1
7,3,0,10,mixedType,1
2,4,0,6,mixedType,0
11,2,0,13,mixedType,1
6,3,0,9,mixedType,1
6,2,0,8,mixedType,1
7,4,0,11,mixedType,1
7,3,0,10,mixedType,1
14,2,0,16,mixedType,2
6,4,0,10,mixedType,1
5,3,0,8,mixedType,1
6,2,0,8,mixedType,1
7,3,0,10,mixedType,1
9,1,0,10,mixedType,1
8,2,0,10,mixedType,1
1,8,0,9,mixedType,1
5,4,0,9,mixedType,1
5,4,0,9,mixedType,1
6,2,0,8,mixedType,1
6,3,0,9,mixedType,1
8,2,0,10,mixedType,1
9,1,0,10,mixedType,1
6,2,0,8,mixedType,1
2,6,0,8,mixedType,1
7,1,0,8,mixedType,1
4,2,0,6,mixedType,0
5,3,0,8,mixedType,1
7,2,0,9,mixedType,1
4,2,0,6,mixedType,0
1,5,0,6,mixedType,0
6,2,0,8,mixedType,1
7,3,0,10,mixedType,1
7,3,0,10,mixedType,1
7,2,0,9,mixedType,1
8,2,0,10,mixedType,1
3,7,0,10,mixedType,1
6,2,0,8,mixedType,1
10,1,0,11,mixedType,1
5,3,0,8,mixedType,1
6,3,0,9,mixedType,1
7,3,0,10,mixedType,1
3,5,0,8,mixedType,1
5,6,0,11,mixedType,1
9,1,0,10,mixedType,1
8,4,0,12,mixedType,1
11,5,0,16,mixedType,2
8,2,0,10,mixedType,1
15,1,0,16,mixedType,2
15,1,0,16,mixedType,2
6,2,0,8,mixedType,1
5,3,0,8,mixedType,1
5,4,0,9,mixedType,1
14,2,0,16,mixedType,2
3,8,0,11,mixedType,1
6,1,0,7,mixedType,0
5,2,0,7,mixedType,0
1,8,0,9,mixedType,1
6,4,0,10,mixedType,1
6,4,0,10,mixedType,1
4,9,0,13,mixedType,1
5,3,0,8,mixedType,1
15,1,0,16,mixedType,2
7,2,0,9,mixedType,1
4,2,0,6,mixedType,0
7,1,0,8,mixedType,1
1,10,0,11,mixedType,1
6,2,0,8,mixedType,1
4,2,0,6,mixedType,0
6,6,0,12,mixedType,1
14,2,0,16,mixedType,2
6,2,0,8,mixedType,1
8,3,0,11,mixedType,1
5,4,0,9,mixedType,1
13,3,0,16,mixedType,2
5,1,0,6,mixedType,0
4,4,0,8,mixedType,1
6,4,0,10,mixedType,1
14,2,0,16,mixedType,2
11,5,0,16,mixedType,2
6,3,0,9,mixedType,1
6,1,0,7,mixedType,0
11,3,0,14,mixedType,2
5,6,0,11,mixedType,1
6,4,0,10,mixedType,1
5,2,0,7,mixedType,0
8,4,0,12,mixedType,1
8,1,0,9,mixedType,1
7,4,0,11,mixedType,1
4,2,0,6,mixedType,0
8,3,0,11,mixedType,1
3,6,0,9,mixedType,1
2,7,0,9,mixedType,1
4,4,0,8,mixedType,1
12,1,1,14,mixedType,2
8,2,0,10,mixedType,1
5,2,0,7,mixedType,0
7,2,0,9,mixedType,1
7,3,0,10,mixedType,1
7,3,0,10,mixedType,1
4,2,0,6,mixedType,0
4,6,0,10,mixedType,1
13,3,0,16,mixedType,2
12,4,0,16,mixedType,2
3,6,0,9,mixedType,1
7,3,0,10,mixedType,1
12,1,0,13,mixedType,1
7,2,0,9,mixedType,1
8,2,0,10,mixedType,1
8,1,0,9,mixedType,1
7,2,0,9,mixedType,1
2,10,0,12,mixedType,1
7,4,0,11,mixedType,1
6,3,0,9,mixedType,1
5,2,0,7,mixedType,0
5,3,0,8,mixedType,1
14,2,0,16,mixedType,2
8,3,0,11,mixedType,1
5,3,0,8,mixedType,1
4,5,0,9,mixedType,1
6,3,0,9,mixedType,1
5,2,0,7,mixedType,0
7,2,0,9,mixedType,1
6,6,0,12,mixedType,1
9,2,0,11,mixedType,1
1,7,0,8,mixedType,1
9,2,0,11,mixedType,1
6,2,0,8,mixedType,1
7,4,0,11,mixedType,1
5,2,0,7,mixedType,0
6,4,0,10,mixedType,1
7,3,0,10,mixedType,1
5,2,0,7,mixedType,0
3,8,0,11,mixedType,1
5,3,0,8,mixedType,1
7,3,0,10,mixedType,1
1,9,0,10,mixedType,1
8,2,0,10,mixedType,1
2,7,0,9,mixedType,1
8,3,0,11,mixedType,1
7,3,0,10,mixedType,1
5,4,0,9,mixedType,1
6,3,0,9,mixedType,1
5,2,0,7,mixedType,0
7,2,0,9,mixedType,1
5,1,0,6,mixedType,0
7,3,0,10,mixedType,1
6,3,0,9,mixedType,1
8,2,0,10,mixedType,1
0,6,1,7,mixedType,0
12,4,0,16,mixedType,2
7,3,0,10,mixedType,1
3,6,0,9,mixedType,1
2,4,0,6,mixedType,0
6,2,0,8,mixedType,1
2,6,0,8,mixedType,1
5,5,0,10,mixedType,1
5,7,0,12,mixedType,1
6,3,0,9,mixedType,1
4,4,0,8,mixedType,1
8,2,0,10,mixedType,1
6,3,0,9,mixedType,1
8,2,0,10,mixedType,1
1,9,0,10,mixedType,1
6,2,0,8,mixedType,1
6,6,0,12,mixedType,1
5,2,0,7,mixedType,0
7,3,0,10,mixedType,1
6,1,0,7,mixedType,0
6,2,0,8,mixedType,1
7,1,0,8,mixedType,1
8,2,0,10,mixedType,1
6,4,0,10,mixedType,1
7,3,0,10,mixedType,1
5,1,0,6,mixedType,0
7,1,0,8,mixedType,1
4,4,0,8,mixedType,1
4,4,0,8,mixedType,1
3,9,0,12,mixedType,1
7,1,0,8,mixedType,1
1,8,0,9,mixedType,1
6,4,0,10,mixedType,1
3,8,0,11,mixedType,1
9,1,0,10,mixedType,1
6,4,0,10,mixedType,1
14,2,0,16,mixedType,2
11,3,0,14,mixedType,2
8,2,0,10,mixedType,1
7,2,0,9,mixedType,1
4,7,0,11,mixedType,1
13,3,0,16,mixedType,2
7,2,0,9,mixedType,1
6,1,0,7,mixedType,0
5,2,0,7,mixedType,0
4,2,0,6,mixedType,0
15,1,0,16,mixedType,2
7,3,0,10,mixedType,1
9,2,0,11,mixedType,1
6,4,0,10,mixedType,1
5,3,0,8,mixedType,1
4,2,0,6,mixedType,0
6,6,2,14,mixedType,2
14,2,0,16,mixedType,2
13,3,0,16,mixedType,2
3,8,0,11,mixedType,1
4,4,0,8,mixedType,1
12,4,0,16,mixedType,2
6,3,0,9,mixedType,1
14,4,0,18,mixedType,2
1,10,0,11,mixedType,1
6,4,0,10,mixedType,1
14,2,0,16,mixedType,2
7,3,0,10,mixedType,1
11,1,0,12,mixedType,1
3,7,0,10,mixedType,1
4,2,0,6,mixedType,0
7,2,0,9,mixedType,1
10,2,2,14,mixedType,2
7,2,0,9,mixedType,1
7,3,0,10,mixedType,1
7,3,0,10,mixedType,1
2,7,0,9,mixedType,1
11,5,0,16,mixedType,2
7,4,0,11,mixedType,1
4,4,0,8,mixedType,1
5,3,0,8,mixedType,1
8,2,0,10,mixedType,1
7,1,0,8,mixedType,1
5,4,0,9,mixedType,1
7,2,0,9,mixedType,1
8,3,0,11,mixedType,1
9,3,0,12,mixedType,1
14,2,0,16,mixedType,2
6,3,0,9,mixedType,1
6,3,0,9,mixedType,1
3,5,0,8,mixedType,1
8,1,0,9,mixedType,1
10,2,0,12,mixedType,1
12,4,0,16,mixedType,2
6,3,0,9,mixedType,1
7,2,0,9,mixedType,1
10,3,0,13,mixedType,1
6,2,0,8,mixedType,1
7,3,0,10,mixedType,1
10,11,0,21,mixedType,2
8,2,0,10,mixedType,1
11,5,0,16,mixedType,2
5,3,0,8,mixedType,1
6,4,0,10,mixedType,1
8,3,0,11,mixedType,1
11,1,0,12,mixedType,1
8,4,0,12,mixedType,1
6,3,0,9,mixedType,1
4,5,0,9,mixedType,1
7,3,0,10,mixedType,1
4,4,0,8,mixedType,1
7,3,0,10,mixedType,1
5,1,0,6,mixedType,0
2,6,0,8,mixedType,1
7,1,0,8,mixedType,1
5,2,0,7,mixedType,0
4,6,0,10,mixedType,1
6,3,0,9,mixedType,1
5,4,0,9,mixedType,1
7,2,0,9,mixedType,1
5,3,0,8,mixedType,1
1,8,0,9,mixedType,1
15,1,0,16,mixedType,2
4,2,0,6,mixedType,0
10,1,0,11,mixedType,1
3,6,0,9,mixedType,1
7,3,0,10,mixedType,1
3,7,0,10,mixedType,1
13,3,0,16,mixedType,2
5,4,0,9,mixedType,1
14,2,0,16,mixedType,2
8,2,0,10,mixedType,1
6,4,0,10,mixedType,1
8,2,0,10,mixedType,1
8,2,0,10,mixedType,1
5,2,0,7,mixedType,0
9,9,2,20,mixedType,2
4,6,0,10,mixedType,1
6,1,0,7,mixedType,0
6,1,0,7,mixedType,0
10,2,0,12,mixedType,1
4,2,0,6,mixedType,0
3,3,0,6,mixedType,0
14,2,0,16,mixedType,2
7,1,0,8,mixedType,1
4,6,0,10,mixedType,1
7,3,0,10,mixedType,1
3,7,0,10,mixedType,1
7,4,0,11,mixedType,1
8,1,0,9,mixedType,1
14,2,0,16,mixedType,2
14,2,0,16,mixedType,2
8,3,0,11,mixedType,1
7,2,0,9,mixedType,1
7,3,0,10,mixedType,1
8,5,0,13,mixedType,1
6,2,0,8,mixedType,1
7,2,0,9,mixedType,1
7,3,0,10,mixedType,1
7,2,0,9,mixedType,1
6,1,0,7,mixedType,0
5,2,0,7,mixedType,0
8,1,0,9,mixedType,1
1,7,0,8,mixedType,1
10,2,0,12,mixedType,1
8,3,0,11,mixedType,1
7,2,0,9,mixedType,1
7,1,0,8,mixedType,1
8,2,0,10,mixedType,1
7,2,0,9,mixedType,1
5,3,0,8,mixedType,1
7,3,0,10,mixedType,1
6,2,0,8,mixedType,1
4,4,0,8,mixedType,1
5,6,0,11,mixedType,1
6,1,0,7,mixedType,0
1,11,0,12,mixedType,1
7,2,0,9,mixedType,1
7,2,0,9,mixedType,1
7,1,0,8,mixedType,1
13,3,0,16,mixedType,2
6,3,0,9,mixedType,1
3,9,0,12,mixedType,1
6,4,0,10,mixedType,1
9,2,0,11,mixedType,1
4,4,0,8,mixedType,1
10,4,0,14,mixedType,2
7,3,0,10,mixedType,1
2,10,0,12,mixedType,1
6,3,0,9,mixedType,1
5,3,0,8,mixedType,1
6,1,0,7,mixedType,0
7,2,0,9,mixedType,1
7,2,0,9,mixedType,1
5,2,0,7,mixedType,0
8,1,0,9,mixedType,1
1,7,0,8,mixedType,1
10,4,0,14,mixedType,2
8,2,0,10,mixedType,1
9,1,0,10,mixedType,1
14,2,0,16,mixedType,2
12,4,0,16,mixedType,2
8,2,0,10,mixedType,1
5,1,0,6,mixedType,0
6,3,0,9,mixedType,1
6,2,0,8,mixedType,1
8,1,0,9,mixedType,1
7,1,0,8,mixedType,1
4,4,0,8,mixedType,1
11,5,0,16,mixedType,2
2,8,0,10,mixedType,1
8,1,0,9,mixedType,1
5,3,0,8,mixedType,1
1,5,0,6,mixedType,0
11,3,0,14,mixedType,2
5,5,0,10,mixedType,1
5,6,0,11,mixedType,1
13,3,0,16,mixedType,2
5,4,0,9,mixedType,1
5,1,0,6,mixedType,0
10,3,0,13,mixedType,1
4,5,0,9,mixedType,1
4,6,0,10,mixedType,1
5,8,0,13,mixedType,1
6,2,0,8,mixedType,1
5,3,0,8,mixedType,1
9,4,0,13,mixedType,1
6,4,0,10,mixedType,1
6,3,0,9,mixedType,1
13,3,0,16,mixedType,2
4,6,0,10,mixedType,1
6,4,0,10,mixedType,1
6,2,0,8,mixedType,1
5,4,0,9,mixedType,1
6,2,0,8,mixedType,1
13,3,0,16,mixedType,2
7,2,0,9,mixedType,1
5,7,0,12,mixedType,1
8,1,0,9,mixedType,1
3,3,0,6,mixedType,0
6,3,0,9,mixedType,1
7,1,0,8,mixedType,1
8,2,0,10,mixedType,1
6,1,0,7,mixedType,0
7,2,0,9,mixedType,1
1,8,0,9,mixedType,1
8,5,0,13,mixedType,1
9,2,0,11,mixedType,1
6,2,0,8,mixedType,1
5,3,0,8,mixedType,1
5,2,0,7,mixedType,0
8,3,0,11,mixedType,1
11,4,1,16,mixedType,2
7,3,0,10,mixedType,1
5,4,0,9,mixedType,1
5,2,0,7,mixedType,0
7,3,0,10,mixedType,1
7,6,0,13,mixedType,1
7,1,0,8,mixedType,1
2,4,0,6,mixedType,0
4,8,0,12,mixedType,1
15,1,0,16,mixedType,2
6,2,0,8,mixedType,1
6,2,0,8,mixedType,1
11,2,1,14,mixedType,2
1,9,0,10,mixedType,1
5,4,0,9,mixedType,1
14,2,0,16,mixedType,2
7,2,0,9,mixedType,1
7,3,0,10,mixedType,1
4,2,0,6,mixedType,0
5,1,0,6,mixedType,0
6,1,0,7,mixedType,0
5,2,0,7,mixedType,0
13,3,0,16,mixedType,2
4,2,0,6,mixedType,0
6,6,0,12,mixedType,1
10,1,0,11,mixedType,1
12,4,0,16,mixedType,2
8,2,0,10,mixedType,1
14,2,0,16,mixedType,2
7,1,0,8,mixedType,1
4,4,0,8,mixedType,1
1,8,0,9,mixedType,1
5,1,0,6,mixedType,0
5,4,0,9,mixedType,1
7,2,0,9,mixedType,1
5,5,0,10,mixedType,1
6,4,0,10,mixedType,1
8,2,0,10,mixedType,1
8,1,0,9,mixedType,1
5,4,0,9,mixedType,1
7,2,0,9,mixedType,1
2,6,0,8,mixedType,1
15,1,0,16,mixedType,2
8,1,0,9,mixedType,1
5,2,0,7,mixedType,0
6,1,0,7,mixedType,0
7,2,0,9,mixedType,1
5,4,0,9,mixedType,1
6,4,0,10,mixedType,1
2,8,0,10,mixedType,1
2,4,0,6,mixedType,0
9,3,0,12,mixedType,1
3,6,0,9,mixedType,1
11,2,1,14,mixedType,2
3,10,0,13,mixedType,1
5,3,0,8,mixedType,1
6,1,0,7,mixedType,0
4,6,0,10,mixedType,1
6,3,0,9,mixedType,1
8,3,0,11,mixedType,1
6,2,0,8,mixedType,1
4,7,0,11,mixedType,1
9,2,0,11,mixedType,1
6,1,0,7,mixedType,0
9,2,0,11,mixedType,1
3,7,0,10,mixedType,1
5,3,0,8,mixedType,1
3,6,0,9,mixedType,1
2,6,0,8,mixedType,1
13,3,0,16,mixedType,2
7,3,0,10,mixedType,1
1,9,0,10,mixedType,1
13,3,0,16,mixedType,2
1,8,0,9,mixedType,1
4,4,0,8,mixedType,1
8,1,0,9,mixedType,1
5,6,0,11,mixedType,1
3,7,0,10,mixedType,1
5,4,0,9,mixedType,1
5,6,0,11,mixedType,1
2,6,0,8,mixedType,1
4,2,0,6,mixedType,0
4,2,0,6,mixedType,0
1,5,0,6,mixedType,0
4,2,0,6,mixedType,0
7,3,0,10,mixedType,1
5,1,0,6,mixedType,0
3,9,0,12,mixedType,1
6,4,0,10,mixedType,1
4,2,0,6,mixedType,0
6,2,0,8,mixedType,1
4,4,0,8,mixedType,1
12,3,0,15,mixedType,2
5,6,0,11,mixedType,1
7,1,0,8,mixedType,1
12,3,0,15,mixedType,2
8,1,0,9,mixedType,1
5,3,0,8,mixedType,1
4,4,0,8,mixedType,1
8,3,0,11,mixedType,1
5,2,0,7,mixedType,0
4,2,0,6,mixedType,0
7,2,0,9,mixedType,1
7,1,0,8,mixedType,1
7,1,0,8,mixedType,1
7,2,0,9,mixedType,1
5,3,0,8,mixedType,1
8,1,0,9,mixedType,1
7,3,0,10,mixedType,1
8,1,0,9,mixedType,1
14,2,0,16,mixedType,2
6,1,0,7,mixedType,0
7,1,0,8,mixedType,1
7,3,0,10,mixedType,1
8,1,0,9,mixedType,1
0,9,1,10,mixedType,1
7,2,0,9,mixedType,1
12,4,0,16,mixedType,2
4,6,0,10,mixedType,1
5,2,0,7,mixedType,0
19,1,1,21,mixedType,2
7,3,0,10,mixedType,1
7,3,0,10,mixedType,1
5,3,0,8,mixedType,1
14,2,0,16,mixedType,2
7,6,0,13,mixedType,1
7,3,0,10,mixedType,1
6,1,0,7,mixedType,0
9,1,0,10,mixedType,1
2,8,0,10,mixedType,1
8,1,0,9,mixedType,1
6,1,0,7,mixedType,0
14,2,0,16,mixedType,2
7,3,0,10,mixedType,1
6,4,0,10,mixedType,1
1,12,0,13,mixedType,1
4,4,0,8,mixedType,1
7,3,0,10,mixedType,1
1,7,0,8,mixedType,1
5,3,0,8,mixedType,1
5,3,0,8,mixedType,1
5,3,0,8,mixedType,1
5,2,0,7,mixedType,0
14,1,1,16,mixedType,2
3,9,0,12,mixedType,1
17,1,1,19,mixedType,2
5,4,0,9,mixedType,1
7,3,0,10,mixedType,1
14,2,0,16,mixedType,2
7,2,0,9,mixedType,1
2,6,0,8,mixedType,1
7,3,0,10,mixedType,1
5,3,0,8,mixedType,1
11,1,0,12,mixedType,1
8,2,0,10,mixedType,1
8,2,0,10,mixedType,1
8,3,0,11,mixedType,1
15,1,0,16,mixedType,2
2,6,0,8,mixedType,1
8,1,0,9,mixedType,1
5,4,0,9,mixedType,1
3,2,0,5,mixedType,0
7,2,0,9,mixedType,1
11,3,0,14,mixedType,2
5,4,0,9,mixedType,1
7,4,0,11,mixedType,1
2,8,0,10,mixedType,1
4,4,0,8,mixedType,1
5,3,0,8,mixedType,1
8,2,0,10,mixedType,1
6,3,0,9,mixedType,1
5,4,0,9,mixedType,1
7,3,0,10,mixedType,1
7,2,0,9,mixedType,1
8,2,0,10,mixedType,1
9,1,0,10,mixedType,1
6,1,0,7,mixedType,0
8,2,0,10,mixedType,1
4,4,0,8,mixedType,1
7,3,0,10,mixedType,1
5,3,0,8,mixedType,1
6,3,0,9,mixedType,1
9,1,0,10,mixedType,1
14,2,0,16,mixedType,2
8,1,0,9,mixedType,1
7,4,0,11,mixedType,1
15,1,0,16,mixedType,2
6,4,0,10,mixedType,1
4,2,0,6,mixedType,0
6,3,0,9,mixedType,1
10,3,0,13,mixedType,1
14,2,0,16,mixedType,2
15,1,0,16,mixedType,2
3,6,0,9,mixedType,1
15,1,0,16,mixedType,2
5,2,0,7,mixedType,0
7,2,0,9,mixedType,1
6,2,0,8,mixedType,1
8,2,0,10,mixedType,1
6,1,0,7,mixedType,0
7,4,0,11,mixedType,1
4,2,0,6,mixedType,0
5,5,0,10,mixedType,1
7,3,0,10,mixedType,1
6,2,0,8,mixedType,1
7,3,0,10,mixedType,1
7,3,0,10,mixedType,1
5,2,0,7,mixedType,0
6,2,0,8,mixedType,1
4,2,0,6,mixedType,0
5,4,0,9,mixedType,1
2,8,0,10,mixedType,1
14,3,0,17,mixedType,2
7,3,0,10,mixedType,1
6,3,0,9,mixedType,1
12,3,0,15,mixedType,2
4,5,0,9,mixedType,1
5,3,0,8,mixedType,1
5,5,0,10,mixedType,1
5,4,0,9,mixedType,1
4,2,0,6,mixedType,0
9,2,0,11,mixedType,1
5,4,0,9,mixedType,1
6,4,0,10,mixedType,1
6,4,0,10,mixedType,1
6,4,0,10,mixedType,1
5,1,0,6,mixedType,0
2,10,0,12,mixedType,1
6,3,0,9,mixedType,1
4,6,0,10,mixedType,1
4,5,0,9,mixedType,1
4,6,0,10,mixedType,1
8,4,0,12,mixedType,1
8,1,0,9,mixedType,1
5,0,1,6,mixedType,0
9,3,0,12,mixedType,1
6,4,0,10,mixedType,1
5,1,0,6,mixedType,0
8,3,0,11,mixedType,1
6,4,0,10,mixedType,1
6,3,0,9,mixedType,1
4,6,0,10,mixedType,1
8,2,0,10,mixedType,1
7,3,0,10,mixedType,1
6,3,0,9,mixedType,1
14,2,0,16,mixedType,2
6,1,0,7,mixedType,0
9,2,0,11,mixedType,1
7,2,0,9,mixedType,1
6,3,0,9,mixedType,1
2,9,0,11,mixedType,1
7,5,0,12,mixedType,1
8,1,0,9,mixedType,1
2,9,0,11,mixedType,1
8,4,0,12,mixedType,1
6,3,0,9,mixedType,1
8,2,0,10,mixedType,1
13,3,0,16,mixedType,2
5,4,0,9,mixedType,1
8,3,0,11,mixedType,1
9,1,0,10,mixedType,1
6,2,0,8,mixedType,1
8,1,0,9,mixedType,1
4,6,0,10,mixedType,1
6,1,0,7,mixedType,0
11,2,0,13,mixedType,1
5,2,0,7,mixedType,0
6,3,0,9,mixedType,1
5,2,0,7,mixedType,0
8,2,0,10,mixedType,1
5,2,0,7,mixedType,0
6,3,0,9,mixedType,1
2,6,0,8,mixedType,1
5,5,0,10,mixedType,1
6,1,0,7,mixedType,0
7,2,0,9,mixedType,1
8,1,0,9,mixedType,1
5,2,0,7,mixedType,0
8,1,0,9,mixedType,1
4,2,0,6,mixedType,0
8,1,0,9,mixedType,1
5,4,0,9,mixedType,1
6,1,0,7,mixedType,0
10,2,0,12,mixedType,1
6,1,0,7,mixedType,0
3,7,0,10,mixedType,1
7,3,0,10,mixedType,1
1,7,0,8,mixedType,1
6,4,0,10,mixedType,1
7,2,0,9,mixedType,1
7,3,0,10,mixedType,1
5,3,0,8,mixedType,1
13,3,0,16,mixedType,2
6,3,0,9,mixedType,1
6,4,0,10,mixedType,1
5,3,0,8,mixedType,1
13,3,0,16,mixedType,2
3,5,0,8,mixedType,1
2,4,0,6,mixedType,0
11,5,0,16,mixedType,2
5,2,0,7,mixedType,0
8,5,0,13,mixedType,1
8,1,0,9,mixedType,1
7,0,1,8,mixedType,1
7,1,0,8,mixedType,1
7,1,0,8,mixedType,1
5,2,0,7,mixedType,0
8,2,0,10,mixedType,1
7,2,0,9,mixedType,1
5,8,2,15,mixedType,2
4,2,0,6,mixedType,0
6,2,0,8,mixedType,1
5,3,0,8,mixedType,1
4,4,0,8,mixedType,1
6,4,0,10,mixedType,1
6,1,0,7,mixedType,0
2,8,0,10,mixedType,1
7,3,0,10,mixedType,1
5,2,0,7,mixedType,0
13,3,0,16,mixedType,2
8,1,0,9,mixedType,1
6,2,0,8,mixedType,1
6,2,0,8,mixedType,1
9,4,0,13,mixedType,1
3,7,0,10,mixedType,1
7,2,0,9,mixedType,1
9,3,0,12,mixedType,1
7,1,0,8,mixedType,1
2,8,0,10,mixedType,1
5,3,0,8,mixedType,1
3,5,0,8,mixedType,1
6,0,1,7,mixedType,0
7,3,0,10,mixedType,1
5,4,0,9,mixedType,1
6,3,0,9,mixedType,1
5,3,0,8,mixedType,1
11,5,0,16,mixedType,2
5,4,0,9,mixedType,1
6,4,0,10,mixedType,1
4,4,0,8,mixedType,1
6,2,0,8,mixedType,1
3,9,0,12,mixedType,1
4,2,0,6,mixedType,0
6,3,0,9,mixedType,1
6,3,0,9,mixedType,1
9,3,0,12,mixedType,1
5,7,0,12,mixedType,1
1,9,0,10,mixedType,1
5,3,0,8,mixedType,1
5,2,0,7,mixedType,0
2,4,0,6,mixedType,0
9,1,0,10,mixedType,1
6,3,0,9,mixedType,1
6,0,1,7,mixedType,0
4,2,0,6,mixedType,0
6,3,0,9,mixedType,1
3,6,0,9,mixedType,1
4,4,0,8,mixedType,1
4,9,0,13,mixedType,1
5,3,0,8,mixedType,1
6,3,0,9,mixedType,1
1,8,0,9,mixedType,1
5,2,0,7,mixedType,0
9,2,0,11,mixedType,1
6,3,0,9,mixedType,1
5,2,0,7,mixedType,0
4,4,0,8,mixedType,1
7,1,0,8,mixedType,1
7,2,0,9,mixedType,1
3,5,0,8,mixedType,1
9,1,0,10,mixedType,1
7,3,0,10,mixedType,1
6,3,0,9,mixedType,1
6,3,0,9,mixedType,1
6,3,0,9,mixedType,1
5,3,0,8,mixedType,1
11,3,0,14,mixedType,2
6,4,0,10,mixedType,1
31,0,9,40,mixedType,2
6,4,0,10,mixedType,1
7,3,0,10,mixedType,1
4,4,0,8,mixedType,1
6,3,0,9,mixedType,1
10,1,0,11,mixedType,1
6,4,0,10,mixedType,1
6,2,0,8,mixedType,1
7,3,0,10,mixedType,1
7,1,0,8,mixedType,1
6,2,0,8,mixedType,1
6,3,0,9,mixedType,1
5,3,0,8,mixedType,1
8,2,0,10,mixedType,1
6,3,0,9,mixedType,1
6,2,0,8,mixedType,1
8,3,0,11,mixedType,1
6,4,0,10,mixedType,1
6,0,1,7,mixedType,0
6,6,0,12,mixedType,1
7,3,0,10,mixedType,1
4,2,0,6,mixedType,0
6,4,0,10,mixedType,1
13,3,0,16,mixedType,2
8,2,0,10,mixedType,1
6,3,0,9,mixedType,1
6,3,0,9,mixedType,1
4,4,0,8,mixedType,1
3,3,0,6,mixedType,0
9,3,0,12,mixedType,1
7,3,0,10,mixedType,1
12,3,0,15,mixedType,2
6,2,0,8,mixedType,1
6,3,0,9,mixedType,1
4,4,0,8,mixedType,1
3,6,0,9,mixedType,1
6,3,0,9,mixedType,1
5,2,0,7,mixedType,0
11,1,0,12,mixedType,1
6,3,0,9,mixedType,1
8,2,0,10,mixedType,1
15,1,0,16,mixedType,2
4,2,0,6,mixedType,0
4,4,0,8,mixedType,1
9,4,0,13,mixedType,1
7,3,0,10,mixedType,1
4,8,0,12,mixedType,1
3,3,0,6,mixedType,0
5,3,0,8,mixedType,1
8,1,0,9,mixedType,1
6,3,0,9,mixedType,1
8,4,0,12,mixedType,1
9,1,0,10,mixedType,1
9,1,0,10,mixedType,1
6,4,0,10,mixedType,1
6,3,0,9,mixedType,1
9,3,0,12,mixedType,1
13,3,0,16,mixedType,2
6,1,0,7,mixedType,0
9,1,0,10,mixedType,1
2,8,0,10,mixedType,1
3,8,0,11,mixedType,1
5,2,0,7,mixedType,0
7,1,0,8,mixedType,1
9,3,0,12,mixedType,1
6,2,0,8,mixedType,1
7,3,0,10,mixedType,1
7,3,0,10,mixedType,1
13,3,0,16,mixedType,2
7,2,0,9,mixedType,1
14,2,0,16,mixedType,2
5,4,0,9,mixedType,1
5,8,0,13,mixedType,1
7,9,0,16,mixedType,2
13,3,0,16,mixedType,2
11,5,0,16,mixedType,2
6,1,0,7,mixedType,0
5,6,0,11,mixedType,1
5,3,0,8,mixedType,1
7,2,0,9,mixedType,1
8,1,0,9,mixedType,1
2,8,0,10,mixedType,1
6,3,0,9,mixedType,1
7,2,0,9,mixedType,1
5,1,0,6,mixedType,0
7,3,0,10,mixedType,1
7,3,0,10,mixedType,1
5,3,0,8,mixedType,1
7,3,0,10,mixedType,1
7,3,0,10,mixedType,1
10,4,0,14,mixedType,2
6,4,0,10,mixedType,1
14,2,0,16,mixedType,2
10,6,0,16,mixedType,2
2,8,0,10,mixedType,1
10,3,0,13,mixedType,1
11,5,0,16,mixedType,2
8,3,0,11,mixedType,1
15,1,0,16,mixedType,2
3,6,0,9,mixedType,1
7,2,0,9,mixedType,1
8,3,0,11,mixedType,1
1,7,0,8,mixedType,1
0,8,1,9,mixedType,1
13,3,0,16,mixedType,2
6,2,0,8,mixedType,1
14,2,0,16,mixedType,2
5,4,0,9,mixedType,1
4,2,0,6,mixedType,0
8,2,0,10,mixedType,1
1,8,0,9,mixedType,1
13,3,0,16,mixedType,2
9,1,0,10,mixedType,1
4,6,0,10,mixedType,1
5,9,0,14,mixedType,2
4,5,0,9,mixedType,1
9,6,0,15,mixedType,2
9,1,0,10,mixedType,1
7,3,0,10,mixedType,1
2,7,0,9,mixedType,1
6,3,0,9,mixedType,1
7,2,0,9,mixedType,1
7,3,0,10,mixedType,1
13,3,0,16,mixedType,2
11,1,0,12,mixedType,1
11,3,0,14,mixedType,2
6,3,0,9,mixedType,1
12,4,0,16,mixedType,2
6,3,0,9,mixedType,1
5,8,0,13,mixedType,1
6,3,0,9,mixedType,1
6,3,0,9,mixedType,1
6,2,0,8,mixedType,1
6,1,0,7,mixedType,0
8,1,0,9,mixedType,1
1,10,0,11,mixedType,1
1,8,0,9,mixedType,1
8,1,0,9,mixedType,1
8,2,0,10,mixedType,1
9,1,0,10,mixedType,1
9,4,0,13,mixedType,1
5,1,0,6,mixedType,0
11,3,0,14,mixedType,2
13,3,0,16,mixedType,2
15,1,0,16,mixedType,2
6,4,0,10,mixedType,1
3,6,0,9,mixedType,1
6,2,0,8,mixedType,1
6,3,0,9,mixedType,1
12,4,0,16,mixedType,2
5,4,0,9,mixedType,1
0,8,2,10,mixedType,1
7,2,0,9,mixedType,1
6,3,0,9,mixedType,1
15,1,0,16,mixedType,2
5,3,0,8,mixedType,1
7,2,0,9,mixedType,1
8,4,0,12,mixedType,1
12,1,0,13,mixedType,1
7,3,0,10,mixedType,1
4,6,0,10,mixedType,1
6,3,0,9,mixedType,1
7,2,0,9,mixedType,1
15,1,0,16,mixedType,2
1,8,0,9,mixedType,1
4,8,0,12,mixedType,1
7,0,1,8,mixedType,1
6,3,0,9,mixedType,1
5,5,0,10,mixedType,1
3,8,0,11,mixedType,1
7,2,0,9,mixedType,1
5,8,0,13,mixedType,1
7,2,0,9,mixedType,1
5,2,0,7,mixedType,0
14,2,0,16,mixedType,2
7,1,0,8,mixedType,1
8,3,0,11,mixedType,1
7,2,0,9,mixedType,1
8,3,0,11,mixedType,1
7,3,0,10,mixedType,1
5,3,0,8,mixedType,1
6,2,0,8,mixedType,1
11,5,0,16,mixedType,2
8,4,0,12,mixedType,1
7,2,0,9,mixedType,1
7,4,0,11,mixedType,1
6,6,0,12,mixedType,1
7,0,1,8,mixedType,1
10,3,0,13,mixedType,1
7,3,0,10,mixedType,1
7,2,0,9,mixedType,1
12,4,0,16,mixedType,2
8,2,0,10,mixedType,1
6,4,0,10,mixedType,1
2,6,0,8,mixedType,1
7,1,0,8,mixedType,1
13,3,0,16,mixedType,2
4,4,0,8,mixedType,1
9,2,0,11,mixedType,1
11,1,0,12,mixedType,1
4,4,0,8,mixedType,1
13,3,0,16,mixedType,2
9,1,0,10,mixedType,1
4,4,0,8,mixedType,1
7,3,0,10,mixedType,1
12,4,0,16,mixedType,2
5,4,0,9,mixedType,1
13,3,0,16,mixedType,2
12,3,0,15,mixedType,2
5,6,0,11,mixedType,1
6,3,0,9,mixedType,1
3,10,0,13,mixedType,1
7,2,0,9,mixedType,1
14,2,0,16,mixedType,2
8,2,0,10,mixedType,1
9,3,4,16,mixedType,2
14,2,0,16,mixedType,2
10,1,0,11,mixedType,1
7,3,0,10,mixedType,1
7,3,0,10,mixedType,1
8,1,0,9,mixedType,1
2,8,0,10,mixedType,1
6,6,0,12,mixedType,1
5,1,0,6,mixedType,0
4,9,0,13,mixedType,1
5,3,0,8,mixedType,1
5,1,0,6,mixedType,0
15,1,0,16,mixedType,2
12,4,0,16,mixedType,2
11,3,0,14,mixedType,2
10,3,0,13,mixedType,1
6,2,0,8,mixedType,1
5,2,0,7,mixedType,0
6,4,0,10,mixedType,1
4,2,0,6,mixedType,0
15,1,0,16,mixedType,2
7,2,0,9,mixedType,1
11,3,0,14,mixedType,2
11,2,0,13,mixedType,1
6,4,0,10,mixedType,1
6,2,0,8,mixedType,1
7,1,0,8,mixedType,1
6,2,0,8,mixedType,1
5,1,0,6,mixedType,0
5,2,0,7,mixedType,0
2,7,0,9,mixedType,1
5,1,0,6,mixedType,0
7,4,0,11,mixedType,1
6,2,0,8,mixedType,1
4,4,0,8,mixedType,1
9,2,0,11,mixedType,1
8,1,0,9,mixedType,1
14,2,0,16,mixedType,2
8,1,0,9,mixedType,1
6,3,0,9,mixedType,1
7,3,0,10,mixedType,1
6,1,0,7,mixedType,0
10,2,0,12,mixedType,1
9,1,0,10,mixedType,1
6,4,0,10,mixedType,1
8,1,0,9,mixedType,1
6,3,0,9,mixedType,1
7,1,0,8,mixedType,1
11,1,0,12,mixedType,1
7,3,0,10,mixedType,1
6,4,0,10,mixedType,1
10,6,0,16,mixedType,2
8,2,0,10,mixedType,1
6,4,0,10,mixedType,1
6,4,0,10,mixedType,1
6,7,0,13,mixedType,1
5,1,0,6,mixedType,0
4,4,0,8,mixedType,1
6,2,0,8,mixedType,1
13,3,0,16,mixedType,2
12,3,1,16,mixedType,2
6,3,0,9,mixedType,1
2,4,0,6,mixedType,0
1,7,0,8,mixedType,1
10,1,0,11,mixedType,1
4,2,0,6,mixedType,0
3,6,0,9,mixedType,1
4,2,0,6,mixedType,0
12,3,0,15,mixedType,2
5,5,0,10,mixedType,1
4,7,0,11,mixedType,1
9,1,0,10,mixedType,1
6,3,0,9,mixedType,1
5,2,0,7,mixedType,0
5,2,0,7,mixedType,0
6,1,0,7,mixedType,0
4,6,0,10,mixedType,1
5,2,0,7,mixedType,0
8,4,0,12,mixedType,1
2,7,0,9,mixedType,1
4,2,0,6,mixedType,0
8,2,0,10,mixedType,1
7,2,0,9,mixedType,1
6,2,0,8,mixedType,1
11,3,0,14,mixedType,2
7,2,0,9,mixedType,1
5,2,0,7,mixedType,0
7,2,0,9,mixedType,1
3,5,0,8,mixedType,1
7,4,0,11,mixedType,1
8,2,0,10,mixedType,1
5,2,0,7,mixedType,0
7,2,0,9,mixedType,1
9,1,0,10,mixedType,1
6,4,0,10,mixedType,1
6,4,0,10,mixedType,1
5,4,0,9,mixedType,1
12,4,0,16,mixedType,2
3,6,0,9,mixedType,1
5,2,0,7,mixedType,0
8,4,0,12,mixedType,1
11,3,0,14,mixedType,2
6,2,0,8,mixedType,1
5,2,0,7,mixedType,0
4,2,0,6,mixedType,0
3,9,0,12,mixedType,1
6,1,0,7,mixedType,0
7,2,0,9,mixedType,1
8,2,0,10,mixedType,1
9,2,0,11,mixedType,1
7,1,0,8,mixedType,1
8,5,0,13,mixedType,1
15,1,0,16,mixedType,2
4,2,0,6,mixedType,0
4,6,0,10,mixedType,1
10,4,0,14,mixedType,2
7,3,0,10,mixedType,1
5,4,0,9,mixedType,1
7,3,0,10,mixedType,1
2,6,0,8,mixedType,1
13,3,0,16,mixedType,2
9,1,0,10,mixedType,1
6,6,0,12,mixedType,1
5,4,0,9,mixedType,1
4,6,0,10,mixedType,1
5,8,0,13,mixedType,1
2,8,0,10,mixedType,1
10,1,0,11,mixedType,1
6,2,0,8,mixedType,1
7,4,0,11,mixedType,1
4,6,0,10,mixedType,1
6,4,0,10,mixedType,1
5,2,0,7,mixedType,0
5,2,0,7,mixedType,0
8,3,0,11,mixedType,1
3,6,0,9,mixedType,1
6,2,0,8,mixedType,1
5,3,0,8,mixedType,1
6,1,0,7,mixedType,0
8,2,0,10,mixedType,1
5,4,0,9,mixedType,1
9,2,0,11,mixedType,1
8,3,0,11,mixedType,1
5,4,0,9,mixedType,1
7,3,0,10,mixedType,1
2,7,0,9,mixedType,1
6,4,0,10,mixedType,1
5,4,0,9,mixedType,1
7,4,0,11,mixedType,1
1,7,0,8,mixedType,1
7,2,0,9,mixedType,1
8,1,0,9,mixedType,1
5,5,0,10,mixedType,1
3,9,0,12,mixedType,1
4,6,0,10,mixedType,1
8,2,0,10,mixedType,1
8,2,0,10,mixedType,1
5,2,0,7,mixedType,0
9,1,0,10,mixedType,1
6,3,0,9,mixedType,1
3,7,0,10,mixedType,1
5,1,0,6,mixedType,0
8,3,0,11,mixedType,1
6,3,0,9,mixedType,1
4,2,0,6,mixedType,0
6,4,0,10,mixedType,1
5,3,0,8,mixedType,1
11,3,0,14,mixedType,2
13,3,0,16,mixedType,2
6,1,0,7,mixedType,0
5,3,0,8,mixedType,1
15,1,0,16,mixedType,2
6,3,0,9,mixedType,1
6,3,0,9,mixedType,1
5,4,0,9,mixedType,1
6,4,0,10,mixedType,1
3,3,0,6,mixedType,0
5,2,0,7,mixedType,0
8,1,0,9,mixedType,1
9,11,3,23,mixedType,2
6,1,0,7,mixedType,0
3,6,0,9,mixedType,1
5,2,0,7,mixedType,0
8,2,0,10,mixedType,1
8,2,0,10,mixedType,1
7,3,0,10,mixedType,1
6,3,0,9,mixedType,1
7,2,0,9,mixedType,1
6,3,0,9,mixedType,1
5,2,0,7,mixedType,0
5,2,0,7,mixedType,0
4,4,0,8,mixedType,1
4,8,0,12,mixedType,1
2,4,0,6,mixedType,0
5,4,0,9,mixedType,1
6,3,0,9,mixedType,1
5,3,0,8,mixedType,1
4,2,0,6,mixedType,0
10,2,0,12,mixedType,1
7,6,0,13,mixedType,1
8,2,0,10,mixedType,1
6,2,0,8,mixedType,1
8,2,0,10,mixedType,1
15,1,0,16,mixedType,2
14,2,0,16,mixedType,2
7,3,0,10,mixedType,1
8,2,0,10,mixedType,1
8,1,0,9,mixedType,1
8,3,0,11,mixedType,1
11,2,0,13,mixedType,1
6,1,0,7,mixedType,0
3,6,0,9,mixedType,1
9,2,0,11,mixedType,1
5,6,0,11,mixedType,1
5,8,0,13,mixedType,1
8,1,0,9,mixedType,1
14,2,0,16,mixedType,2
5,6,0,11,mixedType,1
5,2,0,7,mixedType,0
7,3,0,10,mixedType,1
4,4,0,8,mixedType,1
9,3,0,12,mixedType,1
8,3,0,11,mixedType,1
5,4,0,9,mixedType,1
5,4,0,9,mixedType,1
8,2,0,10,mixedType,1
7,3,0,10,mixedType,1
11,5,0,16,mixedType,2
10,4,0,14,mixedType,2
6,2,0,8,mixedType,1
13,3,0,16,mixedType,2
4,6,0,10,mixedType,1
8,1,0,9,mixedType,1
7,1,0,8,mixedType,1
7,2,0,9,mixedType,1
5,4,0,9,mixedType,1
5,3,0,8,mixedType,1
6,4,0,10,mixedType,1
11,2,0,13,mixedType,1
5,2,0,7,mixedType,0
15,1,0,16,mixedType,2
11,2,0,13,mixedType,1
14,2,0,16,mixedType,2
5,2,0,7,mixedType,0
2,6,0,8,mixedType,1
6,4,0,10,mixedType,1
8,2,0,10,mixedType,1
7,2,0,9,mixedType,1
7,6,0,13,mixedType,1
4,2,0,6,mixedType,0
5,6,0,11,mixedType,1
11,2,0,13,mixedType,1
7,3,0,10,mixedType,1
8,2,0,10,mixedType,1
6,4,0,10,mixedType,1
7,1,0,8,mixedType,1
7,2,0,9,mixedType,1
9,1,0,10,mixedType,1
10,2,0,12,mixedType,1
7,3,0,10,mixedType,1
6,2,0,8,mixedType,1
5,2,0,7,mixedType,0
4,5,0,9,mixedType,1
3,5,0,8,mixedType,1
9,1,0,10,mixedType,1
5,3,0,8,mixedType,1
5,3,0,8,mixedType,1
5,2,0,7,mixedType,0
6,2,0,8,mixedType,1
3,7,0,10,mixedType,1
7,3,0,10,mixedType,1
6,1,0,7,mixedType,0
10,3,0,13,mixedType,1
9,1,0,10,mixedType,1
4,4,0,8,mixedType,1
14,2,0,16,mixedType,2
13,3,0,16,mixedType,2
2,8,0,10,mixedType,1
7,4,0,11,mixedType,1
10,4,0,14,mixedType,2
7,2,0,9,mixedType,1
7,3,0,10,mixedType,1
6,3,0,9,mixedType,1
7,4,0,11,mixedType,1
5,2,0,7,mixedType,0
3,8,0,11,mixedType,1
6,2,0,8,mixedType,1
8,3,0,11,mixedType,1
4,4,0,8,mixedType,1
3,5,0,8,mixedType,1
11,1,0,12,mixedType,1
7,2,0,9,mixedType,1
9,2,0,11,mixedType,1
6,2,0,8,mixedType,1
7,3,0,10,mixedType,1
14,2,0,16,mixedType,2
12,1,0,13,mixedType,1
8,3,0,11,mixedType,1
8,3,0,11,mixedType,1
6,7,0,13,mixedType,1
7,2,0,9,mixedType,1
5,2,0,7,mixedType,0
7,2,0,9,mixedType,1
8,1,0,9,mixedType,1
5,4,0,9,mixedType,1
14,2,0,16,mixedType,2
3,5,0,8,mixedType,1
0,8,1,9,mixedType,1
5,6,0,11,mixedType,1
7,1,0,8,mixedType,1
2,6,0,8,mixedType,1
6,6,0,12,mixedType,1
13,2,1,16,mixedType,2
7,2,0,9,mixedType,1
15,1,0,16,mixedType,2
4,6,0,10,mixedType,1
3,6,0,9,mixedType,1
6,2,0,8,mixedType,1
9,1,0,10,mixedType,1
6,6,0,12,mixedType,1
6,4,0,10,mixedType,1
5,2,0,7,mixedType,0
2,6,0,8,mixedType,1
2,6,0,8,mixedType,1
11,1,0,12,mixedType,1
0,7,1,8,mixedType,1
4,4,0,8,mixedType,1
4,5,0,9,mixedType,1
7,2,0,9,mixedType,1
7,5,0,12,mixedType,1
11,5,0,16,mixedType,2
5,3,0,8,mixedType,1
6,3,0,9,mixedType,1
14,2,0,16,mixedType,2
2,10,0,12,mixedType,1
7,3,0,10,mixedType,1
6,4,0,10,mixedType,1
14,2,0,16,mixedType,2
4,2,0,6,mixedType,0
13,1,1,15,mixedType,2
9,4,0,13,mixedType,1
1,5,0,6,mixedType,0
7,3,0,10,mixedType,1
6,4,0,10,mixedType,1
4,2,0,6,mixedType,0
12,1,0,13,mixedType,1
9,1,0,10,mixedType,1
3,6,0,9,mixedType,1
6,4,0,10,mixedType,1
13,2,0,15,mixedType,2
4,2,0,6,mixedType,0
6,1,0,7,mixedType,0
5,3,0,8,mixedType,1
11,3,0,14,mixedType,2
4,4,0,8,mixedType,1
9,1,0,10,mixedType,1
5,2,0,7,mixedType,0
15,1,0,16,mixedType,2
4,2,0,6,mixedType,0
5,3,0,8,mixedType,1
5,4,0,9,mixedType,1
3,5,0,8,mixedType,1
12,4,0,16,mixedType,2
5,4,0,9,mixedType,1
5,3,0,8,mixedType,1
6,2,0,8,mixedType,1
5,3,0,8,mixedType,1
2,6,0,8,mixedType,1
14,2,0,16,mixedType,2
5,2,0,7,mixedType,0
8,3,0,11,mixedType,1
7,6,0,13,mixedType,1
7,2,0,9,mixedType,1
3,6,0,9,mixedType,1
6,2,0,8,mixedType,1
4,4,0,8,mixedType,1
6,3,0,9,mixedType,1
2,7,0,9,mixedType,1
7,3,0,10,mixedType,1
5,2,0,7,mixedType,0
6,2,0,8,mixedType,1
7,3,0,10,mixedType,1
5,4,0,9,mixedType,1
6,3,0,9,mixedType,1
5,5,0,10,mixedType,1
1,8,0,9,mixedType,1
7,3,0,10,mixedType,1
5,3,0,8,mixedType,1
5,1,0,6,mixedType,0
4,2,0,6,mixedType,0
14,2,0,16,mixedType,2
8,2,0,10,mixedType,1
7,1,0,8,mixedType,1
5,3,0,8,mixedType,1
5,2,0,7,mixedType,0
3,3,0,6,mixedType,0
14,2,0,16,mixedType,2
6,2,0,8,mixedType,1
9,2,0,11,mixedType,1
7,3,0,10,mixedType,1
2,6,0,8,mixedType,1
9,3,0,12,mixedType,1
4,6,0,10,mixedType,1
7,3,0,10,mixedType,1
14,2,0,16,mixedType,2
5,4,0,9,mixedType,1
7,2,0,9,mixedType,1
9,2,0,11,mixedType,1
6,3,0,9,mixedType,1
5,4,0,9,mixedType,1
5,2,0,7,mixedType,0
6,4,0,10,mixedType,1
7,4,0,11,mixedType,1
4,2,0,6,mixedType,0
6,4,0,10,mixedType,1
6,1,0,7,mixedType,0
6,2,0,8,mixedType,1
8,4,0,12,mixedType,1
9,1,0,10,mixedType,1
6,3,0,9,mixedType,1
12,4,0,16,mixedType,2
12,4,0,16,mixedType,2
7,2,0,9,mixedType,1
19,4,0,23,mixedType,2
3,6,0,9,mixedType,1
15,1,0,16,mixedType,2
6,4,0,10,mixedType,1
7,3,0,10,mixedType,1
5,2,0,7,mixedType,0
4,7,0,11,mixedType,1
7,2,0,9,mixedType,1
8,3,0,11,mixedType,1
5,3,0,8,mixedType,1
6,1,0,7,mixedType,0
9,2,0,11,mixedType,1
7,3,0,10,mixedType,1
2,6,0,8,mixedType,1
9,4,0,13,mixedType,1
10,1,0,11,mixedType,1
6,7,0,13,mixedType,1
8,1,0,9,mixedType,1
4,6,0,10,mixedType,1
12,4,0,16,mixedType,2
3,3,0,6,mixedType,0
7,2,0,9,mixedType,1
5,2,0,7,mixedType,0
4,4,0,8,mixedType,1
10,1,0,11,mixedType,1
8,1,0,9,mixedType,1
7,1,0,8,mixedType,1
12,4,0,16,mixedType,2
6,3,0,9,mixedType,1
7,3,0,10,mixedType,1
4,4,0,8,mixedType,1
7,1,0,8,mixedType,1
6,3,0,9,mixedType,1
11,5,0,16,mixedType,2
13,3,0,16,mixedType,2
5,3,0,8,mixedType,1
5,3,0,8,mixedType,1
2,7,0,9,mixedType,1
6,3,0,9,mixedType,1
7,4,0,11,mixedType,1
3,7,0,10,mixedType,1
7,3,0,10,mixedType,1
12,1,0,13,mixedType,1
7,2,0,9,mixedType,1
2,8,0,10,mixedType,1
8,4,0,12,mixedType,1
9,2,0,11,mixedType,1
14,2,0,16,mixedType,2
1,11,0,12,mixedType,1
7,3,0,10,mixedType,1
15,1,0,16,mixedType,2
14,2,0,16,mixedType,2
8,2,0,10,mixedType,1
5,3,0,8,mixedType,1
12,4,0,16,mixedType,2
11,3,0,14,mixedType,2
5,2,0,7,mixedType,0
3,8,0,11,mixedType,1
6,4,0,10,mixedType,1
3,6,0,9,mixedType,1
5,4,0,9,mixedType,1
11,2,0,13,mixedType,1
6,3,0,9,mixedType,1
9,4,0,13,mixedType,1
5,4,0,9,mixedType,1
6,1,0,7,mixedType,0
5,3,0,8,mixedType,1
9,2,0,11,mixedType,1
7,4,0,11,mixedType,1
7,3,0,10,mixedType,1
5,3,0,8,mixedType,1
2,6,0,8,mixedType,1
6,1,0,7,mixedType,0
2,7,0,9,mixedType,1
9,1,0,10,mixedType,1
3,10,0,13,mixedType,1
8,2,0,10,mixedType,1
6,2,0,8,mixedType,1
8,2,0,10,mixedType,1
1,10,0,11,mixedType,1
11,3,0,14,mixedType,2
5,3,0,8,mixedType,1
8,1,0,9,mixedType,1
5,2,0,7,mixedType,0
9,0,1,10,mixedType,1
6,4,0,10,mixedType,1
4,6,0,10,mixedType,1
7,2,0,9,mixedType,1
9,3,0,12,mixedType,1
6,3,0,9,mixedType,1
10,4,0,14,mixedType,2
12,4,0,16,mixedType,2
11,2,0,13,mixedType,1
15,1,0,16,mixedType,2
7,3,0,10,mixedType,1
9,2,0,11,mixedType,1
1,7,0,8,mixedType,1
3,9,0,12,mixedType,1
6,1,0,7,mixedType,0
10,2,0,12,mixedType,1
7,3,0,10,mixedType,1
9,1,0,10,mixedType,1
3,6,0,9,mixedType,1
5,4,0,9,mixedType,1
8,2,0,10,mixedType,1
3,7,0,10,mixedType,1
9,1,0,10,mixedType,1
6,3,0,9,mixedType,1
6,4,0,10,mixedType,1
8,2,0,10,mixedType,1
8,2,0,10,mixedType,1
6,1,0,7,mixedType,0
6,1,0,7,mixedType,0
15,3,0,18,mixedType,2
5,2,0,7,mixedType,0
11,3,0,14,mixedType,2
6,6,0,12,mixedType,1
8,3,0,11,mixedType,1
2,6,0,8,mixedType,1
6,10,1,17,mixedType,2
5,3,0,8,mixedType,1
3,8,0,11,mixedType,1
6,4,0,10,mixedType,1
12,4,0,16,mixedType,2
7,1,0,8,mixedType,1
1,7,0,8,mixedType,1
4,2,0,6,mixedType,0
5,2,0,7,mixedType,0
5,4,0,9,mixedType,1
6,4,0,10,mixedType,1
7,5,0,12,mixedType,1
5,2,0,7,mixedType,0
5,3,0,8,mixedType,1
4,2,0,6,mixedType,0
13,3,0,16,mixedType,2
7,2,0,9,mixedType,1
6,1,0,7,mixedType,0
15,1,0,16,mixedType,2
11,1,0,12,mixedType,1
7,2,0,9,mixedType,1
9,2,0,11,mixedType,1
6,3,0,9,mixedType,1
9,3,0,12,mixedType,1
11,5,0,16,mixedType,2
9,4,0,13,mixedType,1
10,1,0,11,mixedType,1
11,3,0,14,mixedType,2
6,6,0,12,mixedType,1
8,4,0,12,mixedType,1
6,1,0,7,mixedType,0
4,7,0,11,mixedType,1
1,8,0,9,mixedType,1
13,3,0,16,mixedType,2
15,1,0,16,mixedType,2
6,3,0,9,mixedType,1
7,3,0,10,mixedType,1
5,3,0,8,mixedType,1
12,4,0,16,mixedType,2
9,3,0,12,mixedType,1
6,2,0,8,mixedType,1
5,3,0,8,mixedType,1
9,1,0,10,mixedType,1
5,1,0,6,mixedType,0
6,0,8,14,mixedType,2
8,4,0,12,mixedType,1
2,8,0,10,mixedType,1
2,8,0,10,mixedType,1
8,2,0,10,mixedType,1
7,3,0,10,mixedType,1
15,1,0,16,mixedType,2
4,2,0,6,mixedType,0
5,4,0,9,mixedType,1
7,3,0,10,mixedType,1
7,4,0,11,mixedType,1
7,3,0,10,mixedType,1
4,4,0,8,mixedType,1
9,3,4,16,mixedType,2
5,3,0,8,mixedType,1
4,5,0,9,mixedType,1
2,4,0,6,mixedType,0
2,4,0,6,mixedType,0
9,3,0,12,mixedType,1
7,3,0,10,mixedType,1
8,3,0,11,mixedType,1
10,3,2,15,mixedType,2
7,3,0,10,mixedType,1
3,6,0,9,mixedType,1
5,4,0,9,mixedType,1
6,2,0,8,mixedType,1
12,4,0,16,mixedType,2
9,1,0,10,mixedType,1
7,2,0,9,mixedType,1
7,3,0,10,mixedType,1
5,3,0,8,mixedType,1
15,1,0,16,mixedType,2
3,8,0,11,mixedType,1
9,4,0,13,mixedType,1
9,1,0,10,mixedType,1
6,4,0,10,mixedType,1
8,1,0,9,mixedType,1
6,4,0,10,mixedType,1
6,1,0,7,mixedType,0
7,3,0,10,mixedType,1
9,4,0,13,mixedType,1
4,2,0,6,mixedType,0
6,2,0,8,mixedType,1
5,3,0,8,mixedType,1
9,1,0,10,mixedType,1
7,2,0,9,mixedType,1
6,1,0,7,mixedType,0
4,4,0,8,mixedType,1
8,1,0,9,mixedType,1
3,3,0,6,mixedType,0
5,2,0,7,mixedType,0
5,5,0,10,mixedType,1
7,3,0,10,mixedType,1
5,3,0,8,mixedType,1
7,6,0,13,mixedType,1
12,4,0,16,mixedType,2
9,3,0,12,mixedType,1
9,1,0,10,mixedType,1
6,2,0,8,mixedType,1
14,2,0,16,mixedType,2
10,2,0,12,mixedType,1
1,10,0,11,mixedType,1
8,3,0,11,mixedType,1
1,8,0,9,mixedType,1
8,2,0,10,mixedType,1
6,1,0,7,mixedType,0
6,5,0,11,mixedType,1
10,2,0,12,mixedType,1
13,3,0,16,mixedType,2
7,1,0,8,mixedType,1
8,2,0,10,mixedType,1
11,3,0,14,mixedType,2
8,3,0,11,mixedType,1
1,8,0,9,mixedType,1
7,4,0,11,mixedType,1
3,8,0,11,mixedType,1
7,1,0,8,mixedType,1
8,4,0,12,mixedType,1
5,2,0,7,mixedType,0
5,4,0,9,mixedType,1
7,3,0,10,mixedType,1
5,2,0,7,mixedType,0
5,1,0,6,mixedType,0
6,3,0,9,mixedType,1
9,2,0,11,mixedType,1
5,4,0,9,mixedType,1
7,2,0,9,mixedType,1
8,2,0,10,mixedType,1
14,2,0,16,mixedType,2
6,3,0,9,mixedType,1
13,3,0,16,mixedType,2
7,3,0,10,mixedType,1
6,1,0,7,mixedType,0
6,1,0,7,mixedType,0
5,4,0,9,mixedType,1
15,1,0,16,mixedType,2
4,4,0,8,mixedType,1
8,2,0,10,mixedType,1
6,2,0,8,mixedType,1
5,2,0,7,mixedType,0
9,1,0,10,mixedType,1
6,3,0,9,mixedType,1
7,2,0,9,mixedType,1
13,2,0,15,mixedType,2
3,7,0,10,mixedType,1
6,4,0,10,mixedType,1
8,2,0,10,mixedType,1
8,2,0,10,mixedType,1
5,3,0,8,mixedType,1
6,2,0,8,mixedType,1
10,2,0,12,mixedType,1
6,2,0,8,mixedType,1
7,3,0,10,mixedType,1
7,4,0,11,mixedType,1
6,3,0,9,mixedType,1
15,1,0,16,mixedType,2
5,3,0,8,mixedType,1
8,1,0,9,mixedType,1
4,8,0,12,mixedType,1
12,3,0,15,mixedType,2
6,4,0,10,mixedType,1
8,4,0,12,mixedType,1
14,2,0,16,mixedType,2
13,2,0,15,mixedType,2
9,2,0,11,mixedType,1
2,8,0,10,mixedType,1
9,2,0,11,mixedType,1
7,3,0,10,mixedType,1
6,6,0,12,mixedType,1
2,6,0,8,mixedType,1
1,9,0,10,mixedType,1
7,2,0,9,mixedType,1
6,3,0,9,mixedType,1
11,3,0,14,mixedType,2
7,3,0,10,mixedType,1
5,6,0,11,mixedType,1
9,2,0,11,mixedType,1
5,8,1,14,mixedType,2
8,1,0,9,mixedType,1
9,1,0,10,mixedType,1
6,2,0,8,mixedType,1
13,2,1,16,mixedType,2
6,3,0,9,mixedType,1
9,3,0,12,mixedType,1
5,3,0,8,mixedType,1
4,6,0,10,mixedType,1
12,1,0,13,mixedType,1
7,3,0,10,mixedType,1
10,3,0,13,mixedType,1
6,3,0,9,mixedType,1
6,4,0,10,mixedType,1
12,4,0,16,mixedType,2
3,6,0,9,mixedType,1
1,7,0,8,mixedType,1
10,2,0,12,mixedType,1
6,3,0,9,mixedType,1
7,3,0,10,mixedType,1
7,2,0,9,mixedType,1
6,1,0,7,mixedType,0
7,2,0,9,mixedType,1
5,3,0,8,mixedType,1
7,1,0,8,mixedType,1
15,1,0,16,mixedType,2
9,3,0,12,mixedType,1
5,2,0,7,mixedType,0
3,3,0,6,mixedType,0
4,4,0,8,mixedType,1
4,2,0,6,mixedType,0
6,1,0,7,mixedType,0
8,1,0,9,mixedType,1
11,3,0,14,mixedType,2
12,3,0,15,mixedType,2
7,3,0,10,mixedType,1
5,4,0,9,mixedType,1
13,1,1,15,mixedType,2
9,2,0,11,mixedType,1
13,3,0,16,mixedType,2
8,1,0,9,mixedType,1
9,1,0,10,mixedType,1
6,2,0,8,mixedType,1
6,1,0,7,mixedType,0
8,5,0,13,mixedType,1
9,3,0,12,mixedType,1
12,4,0,16,mixedType,2
3,3,0,6,mixedType,0
2,8,0,10,mixedType,1
8,1,0,9,mixedType,1
6,6,0,12,mixedType,1
7,5,0,12,mixedType,1
8,2,0,10,mixedType,1
7,1,0,8,mixedType,1
2,4,0,6,mixedType,0
6,1,0,7,mixedType,0
14,2,0,16,mixedType,2
6,1,0,7,mixedType,0
5,3,0,8,mixedType,1
9,4,0,13,mixedType,1
5,1,0,6,mixedType,0
8,2,0,10,mixedType,1
7,1,0,8,mixedType,1
6,2,0,8,mixedType,1
3,3,0,6,mixedType,0
1,8,0,9,mixedType,1
8,3,0,11,mixedType,1
12,1,1,14,mixedType,2
8,2,0,10,mixedType,1
14,2,0,16,mixedType,2
7,6,0,13,mixedType,1
7,2,0,9,mixedType,1
7,3,0,10,mixedType,1
7,3,0,10,mixedType,1
3,6,0,9,mixedType,1
5,3,0,8,mixedType,1
5,2,0,7,mixedType,0
8,2,0,10,mixedType,1
6,0,1,7,mixedType,0
7,3,0,10,mixedType,1
14,2,0,16,mixedType,2
15,1,0,16,mixedType,2
5,2,0,7,mixedType,0
12,4,0,16,mixedType,2
14,2,0,16,mixedType,2
9,3,0,12,mixedType,1
4,6,0,10,mixedType,1
6,6,0,12,mixedType,1
7,5,0,12,mixedType,1
7,3,0,10,mixedType,1
8,3,0,11,mixedType,1
6,3,0,9,mixedType,1
9,1,0,10,mixedType,1
7,3,0,10,mixedType,1
5,1,0,6,mixedType,0
9,1,0,10,mixedType,1
9,3,0,12,mixedType,1
6,3,0,9,mixedType,1
3,6,0,9,mixedType,1
8,5,0,13,mixedType,1
7,2,0,9,mixedType,1
8,1,0,9,mixedType,1
7,2,0,9,mixedType,1
6,3,0,9,mixedType,1
3,6,0,9,mixedType,1
3,6,0,9,mixedType,1
15,1,0,16,mixedType,2
7,2,0,9,mixedType,1
10,2,0,12,mixedType,1
6,3,0,9,mixedType,1
7,1,0,8,mixedType,1
10,3,1,14,mixedType,2
15,1,0,16,mixedType,2
15,1,1,17,mixedType,2
5,4,0,9,mixedType,1
8,3,0,11,mixedType,1
7,3,0,10,mixedType,1
5,3,0,8,mixedType,1
5,4,0,9,mixedType,1
6,2,0,8,mixedType,1
6,4,0,10,mixedType,1
6,1,0,7,mixedType,0
5,3,0,8,mixedType,1
14,2,0,16,mixedType,2
7,4,0,11,mixedType,1
1,10,0,11,mixedType,1
4,4,0,8,mixedType,1
8,1,0,9,mixedType,1
5,3,0,8,mixedType,1
5,3,0,8,mixedType,1
5,2,0,7,mixedType,0
7,3,0,10,mixedType,1
11,5,0,16,mixedType,2
5,2,0,7,mixedType,0
3,6,0,9,mixedType,1
11,5,0,16,mixedType,2
7,1,0,8,mixedType,1
2,9,0,11,mixedType,1
7,4,0,11,mixedType,1
6,3,0,9,mixedType,1
3,5,0,8,mixedType,1
4,5,0,9,mixedType,1
8,2,0,10,mixedType,1
8,1,0,9,mixedType,1
5,2,0,7,mixedType,0
14,2,0,16,mixedType,2
12,4,0,16,mixedType,2
5,1,0,6,mixedType,0
6,4,0,10,mixedType,1
6,6,0,12,mixedType,1
9,3,0,12,mixedType,1
6,4,0,10,mixedType,1
4,4,0,8,mixedType,1
3,6,0,9,mixedType,1
5,3,0,8,mixedType,1
6,4,0,10,mixedType,1
7,2,0,9,mixedType,1
13,3,0,16,mixedType,2
5,2,0,7,mixedType,0
1,8,0,9,mixedType,1
2,8,0,10,mixedType,1
5,4,0,9,mixedType,1
7,4,0,11,mixedType,1
5,3,0,8,mixedType,1
2,7,0,9,mixedType,1
3,6,0,9,mixedType,1
15,1,0,16,mixedType,2
7,4,0,11,mixedType,1
13,3,0,16,mixedType,2
8,1,0,9,mixedType,1
10,3,2,15,mixedType,2
4,4,0,8,mixedType,1
7,1,0,8,mixedType,1
6,2,0,8,mixedType,1
10,2,0,12,mixedType,1
10,1,0,11,mixedType,1
6,3,0,9,mixedType,1
8,2,0,10,mixedType,1
9,1,0,10,mixedType,1
5,1,0,6,mixedType,0
3,6,0,9,mixedType,1
6,2,0,8,mixedType,1
8,1,0,9,mixedType,1
5,2,0,7,mixedType,0
9,1,0,10,mixedType,1
5,5,0,10,mixedType,1
7,3,0,10,mixedType,1
1,7,0,8,mixedType,1
5,3,0,8,mixedType,1
8,3,0,11,mixedType,1
5,3,0,8,mixedType,1
5,2,0,7,mixedType,0
11,5,0,16,mixedType,2
12,4,0,16,mixedType,2
8,4,0,12,mixedType,1
12,3,0,15,mixedType,2
5,6,0,11,mixedType,1
5,3,0,8,mixedType,1
6,4,0,10,mixedType,1
4,4,0,8,mixedType,1
12,3,0,15,mixedType,2
6,3,0,9,mixedType,1
4,6,0,10,mixedType,1
2,8,0,10,mixedType,1
14,2,0,16,mixedType,2
6,3,0,9,mixedType,1
8,4,0,12,mixedType,1
14,2,0,16,mixedType,2
4,2,0,6,mixedType,0
6,3,0,9,mixedType,1
8,1,0,9,mixedType,1
9,3,0,12,mixedType,1
10,3,0,13,mixedType,1
6,4,0,10,mixedType,1
7,2,0,9,mixedType,1
7,2,0,9,mixedType,1
6,3,0,9,mixedType,1
14,1,1,16,mixedType,2
7,3,0,10,mixedType,1
14,2,0,16,mixedType,2
14,2,0,16,mixedType,2
11,5,0,16,mixedType,2
4,4,0,8,mixedType,1
6,4,0,10,mixedType,1
8,2,0,10,mixedType,1
8,2,0,10,mixedType,1
3,6,0,9,mixedType,1
6,2,0,8,mixedType,1
4,4,0,8,mixedType,1
5,1,0,6,mixedType,0
15,1,0,16,mixedType,2
1,9,0,10,mixedType,1
9,2,0,11,mixedType,1
18,1,0,19,mixedType,2
9,3,0,12,mixedType,1
3,11,0,14,mixedType,2
7,3,0,10,mixedType,1
7,3,0,10,mixedType,1
8,2,0,10,mixedType,1
7,1,0,8,mixedType,1
5,4,0,9,mixedType,1
6,4,0,10,mixedType,1
14,2,0,16,mixedType,2
6,3,0,9,mixedType,1
2,7,0,9,mixedType,1
3,5,0,8,mixedType,1
5,1,0,6,mixedType,0
5,1,0,6,mixedType,0
6,3,0,9,mixedType,1
4,4,0,8,mixedType,1
6,2,0,8,mixedType,1
4,2,0,6,mixedType,0
2,9,0,11,mixedType,1
15,1,0,16,mixedType,2
2,8,0,10,mixedType,1
14,2,0,16,mixedType,2
9,2,0,11,mixedType,1
1,8,0,9,mixedType,1
13,3,0,16,mixedType,2
10,2,0,12,mixedType,1
8,1,0,9,mixedType,1
6,2,0,8,mixedType,1
5,3,0,8,mixedType,1
16,4,0,20,mixedType,2
15,1,0,16,mixedType,2
2,6,0,8,mixedType,1
4,2,0,6,mixedType,0
7,3,0,10,mixedType,1
12,1,0,13,mixedType,1
6,2,0,8,mixedType,1
3,3,0,6,mixedType,0
5,1,0,6,mixedType,0
6,1,0,7,mixedType,0
10,2,0,12,mixedType,1
8,4,0,12,mixedType,1
9,3,0,12,mixedType,1
6,1,0,7,mixedType,0
5,2,0,7,mixedType,0
8,2,0,10,mixedType,1
7,3,0,10,mixedType,1
4,2,0,6,mixedType,0
5,3,0,8,mixedType,1
5,3,0,8,mixedType,1
15,1,0,16,mixedType,2
8,3,0,11,mixedType,1
14,2,0,16,mixedType,2
15,1,0,16,mixedType,2
7,1,0,8,mixedType,1
8,2,0,10,mixedType,1
7,3,0,10,mixedType,1
15,1,0,16,mixedType,2
6,1,0,7,mixedType,0
1,8,0,9,mixedType,1
13,3,0,16,mixedType,2
5,2,0,7,mixedType,0
7,3,0,10,mixedType,1
1,8,0,9,mixedType,1
4,2,0,6,mixedType,0
5,3,0,8,mixedType,1
14,2,0,16,mixedType,2
6,3,0,9,mixedType,1
6,6,2,14,mixedType,2
7,4,0,11,mixedType,1
2,6,0,8,mixedType,1
10,1,0,11,mixedType,1
16,2,1,19,mixedType,2
5,3,0,8,mixedType,1
6,1,0,7,mixedType,0
0,9,1,10,mixedType,1
2,7,0,9,mixedType,1
4,2,0,6,mixedType,0
4,4,0,8,mixedType,1
5,2,0,7,mixedType,0
2,7,0,9,mixedType,1
8,4,0,12,mixedType,1
13,2,1,16,mixedType,2
5,6,0,11,mixedType,1
4,4,0,8,mixedType,1
14,3,1,18,mixedType,2
7,3,0,10,mixedType,1
5,3,0,8,mixedType,1
4,2,0,6,mixedType,0
14,2,0,16,mixedType,2
6,3,0,9,mixedType,1
7,3,0,10,mixedType,1
8,3,0,11,mixedType,1
2,7,0,9,mixedType,1
14,2,0,16,mixedType,2
3,6,0,9,mixedType,1
7,2,0,9,mixedType,1
4,4,0,8,mixedType,1
8,2,0,10,mixedType,1
1,8,0,9,mixedType,1
5,3,0,8,mixedType,1
5,4,0,9,mixedType,1
3,6,0,9,mixedType,1
5,2,0,7,mixedType,0
6,1,0,7,mixedType,0
5,3,0,8,mixedType,1
11,3,0,14,mixedType,2
14,2,0,16,mixedType,2
6,2,0,8,mixedType,1
5,3,0,8,mixedType,1
15,1,0,16,mixedType,2
8,2,0,10,mixedType,1
5,4,0,9,mixedType,1
4,6,0,10,mixedType,1
5,5,0,10,mixedType,1
6,3,0,9,mixedType,1
7,1,0,8,mixedType,1
8,5,0,13,mixedType,1
2,7,0,9,mixedType,1
5,6,0,11,mixedType,1
10,3,0,13,mixedType,1
2,6,0,8,mixedType,1
5,2,0,7,mixedType,0
14,2,0,16,mixedType,2
5,3,0,8,mixedType,1
9,1,0,10,mixedType,1
5,4,0,9,mixedType,1
8,1,0,9,mixedType,1
5,3,0,8,mixedType,1
6,4,0,10,mixedType,1
6,2,0,8,mixedType,1
6,1,0,7,mixedType,0
5,3,0,8,mixedType,1
6,3,0,9,mixedType,1
8,2,0,10,mixedType,1
2,6,0,8,mixedType,1
6,4,0,10,mixedType,1
11,3,0,14,mixedType,2
4,6,0,10,mixedType,1
8,3,0,11,mixedType,1
5,1,0,6,mixedType,0
6,4,0,10,mixedType,1
5,3,0,8,mixedType,1
2,9,0,11,mixedType,1
6,4,0,10,mixedType,1
6,4,0,10,mixedType,1
6,2,0,8,mixedType,1
5,2,0,7,mixedType,0
5,3,0,8,mixedType,1
5,2,0,7,mixedType,0
6,2,0,8,mixedType,1
5,3,0,8,mixedType,1
4,9,0,13,mixedType,1
2,6,0,8,mixedType,1
14,2,0,16,mixedType,2
6,3,0,9,mixedType,1
9,4,0,13,mixedType,1
7,3,0,10,mixedType,1
6,3,0,9,mixedType,1
8,4,0,12,mixedType,1
14,2,0,16,mixedType,2
7,4,0,11,mixedType,1
6,2,0,8,mixedType,1
6,3,0,9,mixedType,1
7,3,0,10,mixedType,1
7,2,0,9,mixedType,1
4,2,0,6,mixedType,0
7,3,0,10,mixedType,1
4,2,0,6,mixedType,0
8,2,0,10,mixedType,1
6,3,0,9,mixedType,1
5,4,0,9,mixedType,1
10,3,0,13,mixedType,1
5,6,0,11,mixedType,1
4,9,0,13,mixedType,1
10,2,0,12,mixedType,1
7,3,0,10,mixedType,1
6,4,0,10,mixedType,1
4,5,0,9,mixedType,1
6,3,0,9,mixedType,1
5,3,0,8,mixedType,1
5,4,0,9,mixedType,1
11,3,1,15,mixedType,2
5,5,0,10,mixedType,1
5,1,0,6,mixedType,0
3,11,2,16,mixedType,2
4,4,0,8,mixedType,1
9,1,0,10,mixedType,1
6,1,0,7,mixedType,0
6,1,0,7,mixedType,0
1,7,0,8,mixedType,1
3,3,0,6,mixedType,0
3,6,0,9,mixedType,1
9,3,0,12,mixedType,1
5,3,0,8,mixedType,1
6,3,0,9,mixedType,1
8,2,0,10,mixedType,1
6,1,0,7,mixedType,0
14,2,0,16,mixedType,2
4,4,0,8,mixedType,1
6,3,0,9,mixedType,1
8,4,0,12,mixedType,1
12,4,0,16,mixedType,2
9,1,0,10,mixedType,1
5,1,0,6,mixedType,0
8,1,0,9,mixedType,1
6,1,0,7,mixedType,0
8,1,0,9,mixedType,1
5,4,0,9,mixedType,1
6,1,0,7,mixedType,0
14,2,0,16,mixedType,2
6,1,0,7,mixedType,0
6,2,0,8,mixedType,1
6,3,0,9,mixedType,1
2,8,0,10,mixedType,1
5,3,0,8,mixedType,1
10,2,0,12,mixedType,1
7,2,0,9,mixedType,1
11,4,1,16,mixedType,2
8,3,0,11,mixedType,1
7,3,0,10,mixedType,1
7,2,0,9,mixedType,1
2,8,0,10,mixedType,1
6,4,0,10,mixedType,1
7,1,0,8,mixedType,1
12,4,0,16,mixedType,2
8,2,0,10,mixedType,1
1,11,0,12,mixedType,1
3,6,0,9,mixedType,1
7,2,0,9,mixedType,1
13,3,0,16,mixedType,2
8,1,0,9,mixedType,1
6,4,0,10,mixedType,1
1,9,0,10,mixedType,1
11,2,2,15,mixedType,2
5,4,0,9,mixedType,1
5,4,0,9,mixedType,1
7,3,0,10,mixedType,1
9,1,0,10,mixedType,1
4,4,0,8,mixedType,1
13,3,0,16,mixedType,2
6,2,0,8,mixedType,1
8,2,0,10,mixedType,1
6,4,0,10,mixedType,1
5,2,0,7,mixedType,0
6,2,0,8,mixedType,1
3,7,0,10,mixedType,1
7,4,0,11,mixedType,1
11,3,0,14,mixedType,2
6,2,0,8,mixedType,1
4,4,0,8,mixedType,1
10,1,0,11,mixedType,1
5,3,0,8,mixedType,1
14,2,0,16,mixedType,2
13,3,0,16,mixedType,2
8,2,0,10,mixedType,1
7,3,0,10,mixedType,1
7,3,0,10,mixedType,1
5,2,0,7,mixedType,0
7,1,0,8,mixedType,1
6,3,0,9,mixedType,1
7,2,0,9,mixedType,1
5,4,0,9,mixedType,1
2,8,0,10,mixedType,1
5,3,0,8,mixedType,1
5,3,0,8,mixedType,1
6,3,0,9,mixedType,1
5,4,0,9,mixedType,1
5,2,0,7,mixedType,0
15,1,0,16,mixedType,2
7,4,0,11,mixedType,1
2,4,0,6,mixedType,0
15,1,0,16,mixedType,2
1,7,0,8,mixedType,1
4,2,0,6,mixedType,0
6,1,0,7,mixedType,0
8,4,0,12,mixedType,1
11,3,1,15,mixedType,2
8,2,0,10,mixedType,1
4,2,0,6,mixedType,0
7,1,0,8,mixedType,1
5,3,0,8,mixedType,1
9,1,0,10,mixedType,1
6,1,0,7,mixedType,0
8,4,0,12,mixedType,1
7,4,0,11,mixedType,1
6,3,0,9,mixedType,1
6,1,0,7,mixedType,0
7,3,0,10,mixedType,1
6,4,0,10,mixedType,1
5,3,0,8,mixedType,1
8,2,0,10,mixedType,1
14,2,0,16,mixedType,2
7,3,0,10,mixedType,1
4,5,0,9,mixedType,1
7,4,0,11,mixedType,1
9,3,0,12,mixedType,1
15,1,0,16,mixedType,2
5,1,0,6,mixedType,0
3,6,0,9,mixedType,1
6,1,0,7,mixedType,0
16,1,0,17,mixedType,2
5,3,0,8,mixedType,1
11,3,0,14,mixedType,2
7,2,0,9,mixedType,1
8,1,0,9,mixedType,1
6,3,0,9,mixedType,1
6,1,0,7,mixedType,0
7,1,0,8,mixedType,1
4,4,0,8,mixedType,1
5,3,0,8,mixedType,1
8,1,0,9,mixedType,1
7,3,0,10,mixedType,1
12,2,1,15,mixedType,2
4,7,0,11,mixedType,1
7,3,0,10,mixedType,1
4,2,0,6,mixedType,0
5,3,0,8,mixedType,1
7,1,0,8,mixedType,1
13,3,0,16,mixedType,2
7,3,0,10,mixedType,1
6,8,0,14,mixedType,2
12,1,0,13,mixedType,1
8,0,1,9,mixedType,1
4,2,0,6,mixedType,0
5,2,0,7,mixedType,0
6,3,0,9,mixedType,1
9,2,0,11,mixedType,1
5,4,0,9,mixedType,1
6,4,0,10,mixedType,1
5,2,0,7,mixedType,0
10,4,0,14,mixedType,2
6,3,0,9,mixedType,1
6,4,0,10,mixedType,1
7,4,0,11,mixedType,1
4,2,0,6,mixedType,0
6,3,0,9,mixedType,1
14,2,0,16,mixedType,2
3,5,0,8,mixedType,1
3,0,3,6,mixedType,0
8,2,0,10,mixedType,1
4,5,0,9,mixedType,1
6,2,0,8,mixedType,1
5,2,0,7,mixedType,0
8,2,0,10,mixedType,1
8,2,0,10,mixedType,1
7,3,0,10,mixedType,1
2,4,0,6,mixedType,0
2,6,0,8,mixedType,1
5,3,0,8,mixedType,1
8,3,0,11,mixedType,1
4,4,0,8,mixedType,1
4,4,0,8,mixedType,1
6,3,0,9,mixedType,1
7,3,0,10,mixedType,1
6,3,0,9,mixedType,1
1,8,0,9,mixedType,1
6,3,0,9,mixedType,1
5,4,0,9,mixedType,1
4,2,0,6,mixedType,0
5,8,0,13,mixedType,1
2,4,0,6,mixedType,0
1,6,0,7,mixedType,0
5,2,0,7,mixedType,0
1,9,0,10,mixedType,1
2,6,0,8,mixedType,1
6,3,0,9,mixedType,1
14,2,0,16,mixedType,2
5,3,0,8,mixedType,1
2,8,0,10,mixedType,1
7,4,0,11,mixedType,1
8,3,0,11,mixedType,1
6,6,0,12,mixedType,1
5,2,0,7,mixedType,0
7,3,0,10,mixedType,1
3,3,0,6,mixedType,0
12,1,1,14,mixedType,2
6,2,0,8,mixedType,1
2,6,0,8,mixedType,1
6,1,0,7,mixedType,0
8,3,0,11,mixedType,1
6,1,0,7,mixedType,0
14,4,0,18,mixedType,2
3,11,1,15,mixedType,2
9,3,0,12,mixedType,1
7,1,0,8,mixedType,1
8,3,0,11,mixedType,1
14,2,0,16,mixedType,2
5,2,0,7,mixedType,0
15,1,0,16,mixedType,2
5,5,0,10,mixedType,1
5,2,0,7,mixedType,0
1,7,0,8,mixedType,1
11,4,1,16,mixedType,2
7,3,0,10,mixedType,1
8,4,0,12,mixedType,1
7,2,0,9,mixedType,1
14,2,0,16,mixedType,2
4,4,0,8,mixedType,1
6,3,0,9,mixedType,1
7,3,0,10,mixedType,1
6,2,0,8,mixedType,1
6,1,0,7,mixedType,0
1,10,0,11,mixedType,1
3,5,0,8,mixedType,1
7,2,0,9,mixedType,1
4,4,0,8,mixedType,1
7,2,0,9,mixedType,1
7,3,0,10,mixedType,1
6,1,0,7,mixedType,0
7,2,0,9,mixedType,1
8,2,0,10,mixedType,1
6,1,0,7,mixedType,0
12,4,0,16,mixedType,2
5,3,0,8,mixedType,1
11,5,0,16,mixedType,2
3,3,0,6,mixedType,0
4,2,0,6,mixedType,0
4,2,0,6,mixedType,0
6,3,0,9,mixedType,1
9,3,0,12,mixedType,1
3,6,0,9,mixedType,1
6,3,0,9,mixedType,1
5,3,0,8,mixedType,1
4,2,0,6,mixedType,0
8,3,0,11,mixedType,1
3,3,0,6,mixedType,0
8,2,0,10,mixedType,1
2,6,0,8,mixedType,1
9,3,0,12,mixedType,1
6,10,0,16,mixedType,2
3,8,0,11,mixedType,1
5,3,0,8,mixedType,1
6,1,0,7,mixedType,0
7,2,0,9,mixedType,1
9,2,0,11,mixedType,1
7,3,0,10,mixedType,1
8,1,0,9,mixedType,1
6,2,0,8,mixedType,1
2,7,0,9,mixedType,1
10,2,0,12,mixedType,1
10,1,0,11,mixedType,1
6,3,0,9,mixedType,1
7,3,0,10,mixedType,1
3,8,3,14,mixedType,2
6,1,0,7,mixedType,0
1,10,0,11,mixedType,1
7,1,0,8,mixedType,1
9,1,0,10,mixedType,1
5,2,0,7,mixedType,0
7,2,0,9,mixedType,1
6,4,0,10,mixedType,1
6,1,0,7,mixedType,0
3,6,0,9,mixedType,1
9,2,0,11,mixedType,1
10,2,0,12,mixedType,1
7,3,0,10,mixedType,1
7,2,0,9,mixedType,1
7,4,0,11,mixedType,1
1,10,0,11,mixedType,1
5,3,0,8,mixedType,1
12,3,1,16,mixedType,2
7,3,0,10,mixedType,1
8,2,0,10,mixedType,1
9,3,0,12,mixedType,1
5,3,0,8,mixedType,1
4,2,0,6,mixedType,0
7,2,0,9,mixedType,1
7,3,0,10,mixedType,1
4,6,0,10,mixedType,1
8,0,1,9,mixedType,1
1,7,0,8,mixedType,1
8,2,0,10,mixedType,1
11,5,0,16,mixedType,2
9,3,0,12,mixedType,1
9,4,0,13,mixedType,1
4,5,0,9,mixedType,1
6,2,0,8,mixedType,1
8,1,0,9,mixedType,1
4,4,0,8,mixedType,1
6,3,0,9,mixedType,1
7,3,0,10,mixedType,1
7,1,0,8,mixedType,1
7,3,0,10,mixedType,1
4,6,0,10,mixedType,1
12,4,1,17,mixedType,2
6,3,0,9,mixedType,1
8,4,0,12,mixedType,1
8,1,0,9,mixedType,1
9,4,0,13,mixedType,1
9,1,0,10,mixedType,1
7,2,0,9,mixedType,1
8,1,0,9,mixedType,1
3,3,0,6,mixedType,0
10,3,0,13,mixedType,1
7,2,0,9,mixedType,1
9,5,0,14,mixedType,2
5,3,0,8,mixedType,1
6,1,0,7,mixedType,0
6,1,0,7,mixedType,0
5,2,0,7,mixedType,0
6,4,0,10,mixedType,1
3,8,0,11,mixedType,1
10,2,0,12,mixedType,1
9,1,0,10,mixedType,1
9,2,0,11,mixedType,1
9,2,0,11,mixedType,1
7,1,0,8,mixedType,1
6,3,0,9,mixedType,1
11,2,0,13,mixedType,1
6,5,0,11,mixedType,1
8,1,0,9,mixedType,1
4,2,0,6,mixedType,0
6,3,0,9,mixedType,1
5,3,0,8,mixedType,1
5,1,0,6,mixedType,0
4,2,0,6,mixedType,0
7,3,0,10,mixedType,1
7,4,0,11,mixedType,1
9,2,0,11,mixedType,1
4,4,0,8,mixedType,1
3,6,0,9,mixedType,1
6,1,0,7,mixedType,0
2,7,0,9,mixedType,1
11,5,0,16,mixedType,2
5,3,0,8,mixedType,1
6,1,0,7,mixedType,0
8,4,0,12,mixedType,1
5,2,0,7,mixedType,0
8,2,0,10,mixedType,1
4,2,0,6,mixedType,0
6,4,0,10,mixedType,1
5,2,0,7,mixedType,0
7,3,0,10,mixedType,1
1,8,0,9,mixedType,1
11,4,1,16,mixedType,2
9,3,0,12,mixedType,1
5,3,0,8,mixedType,1
7,3,0,10,mixedType,1
5,3,0,8,mixedType,1
7,4,0,11,mixedType,1
1,7,0,8,mixedType,1
7,4,0,11,mixedType,1
6,3,0,9,mixedType,1
6,2,0,8,mixedType,1
4,6,0,10,mixedType,1
4,6,0,10,mixedType,1
10,3,0,13,mixedType,1
4,4,0,8,mixedType,1
11,1,0,12,mixedType,1
14,2,0,16,mixedType,2
6,4,0,10,mixedType,1
9,2,0,11,mixedType,1
7,3,0,10,mixedType,1
5,1,0,6,mixedType,0
7,3,0,10,mixedType,1
7,4,0,11,mixedType,1
8,1,0,9,mixedType,1
7,2,0,9,mixedType,1
7,3,0,10,mixedType,1
6,4,0,10,mixedType,1
5,1,0,6,mixedType,0
6,4,0,10,mixedType,1
4,2,0,6,mixedType,0
9,3,0,12,mixedType,1
6,2,0,8,mixedType,1
6,3,0,9,mixedType,1
7,1,0,8,mixedType,1
22,5,1,28,mixedType,2
3,5,0,8,mixedType,1
6,4,0,10,mixedType,1
4,4,0,8,mixedType,1
6,4,0,10,mixedType,1
6,3,0,9,mixedType,1
7,2,0,9,mixedType,1
8,1,0,9,mixedType,1
6,3,0,9,mixedType,1
6,4,0,10,mixedType,1
6,1,0,7,mixedType,0
4,4,0,8,mixedType,1
6,4,0,10,mixedType,1
8,2,0,10,mixedType,1
6,3,0,9,mixedType,1
6,6,0,12,mixedType,1
4,4,0,8,mixedType,1
6,3,0,9,mixedType,1
9,1,0,10,mixedType,1
6,1,0,7,mixedType,0
6,3,0,9,mixedType,1
10,10,0,20,mixedType,2
4,4,0,8,mixedType,1
5,4,0,9,mixedType,1
5,3,0,8,mixedType,1
7,3,0,10,mixedType,1
7,1,0,8,mixedType,1
13,2,0,15,mixedType,2
6,3,0,9,mixedType,1
3,6,0,9,mixedType,1
8,2,0,10,mixedType,1
15,1,0,16,mixedType,2
2,4,0,6,mixedType,0
5,4,0,9,mixedType,1
5,2,0,7,mixedType,0
6,8,0,14,mixedType,2
7,4,0,11,mixedType,1
6,0,2,8,mixedType,1
5,2,0,7,mixedType,0
6,4,0,10,mixedType,1
8,1,0,9,mixedType,1
1,9,0,10,mixedType,1
5,1,0,6,mixedType,0
5,3,0,8,mixedType,1
10,1,0,11,mixedType,1
2,4,0,6,mixedType,0
5,1,0,6,mixedType,0
12,1,0,13,mixedType,1
3,6,0,9,mixedType,1
8,4,0,12,mixedType,1
7,2,0,9,mixedType,1
5,1,0,6,mixedType,0
6,6,0,12,mixedType,1
7,1,0,8,mixedType,1
15,1,0,16,mixedType,2
14,2,1,17,mixedType,2
1,8,0,9,mixedType,1
2,8,0,10,mixedType,1
14,2,0,16,mixedType,2
7,3,0,10,mixedType,1
8,2,0,10,mixedType,1
7,3,0,10,mixedType,1
4,2,0,6,mixedType,0
14,2,0,16,mixedType,2
5,4,0,9,mixedType,1
2,7,0,9,mixedType,1
3,3,0,6,mixedType,0
6,2,0,8,mixedType,1
7,3,0,10,mixedType,1
6,4,0,10,mixedType,1
4,9,0,13,mixedType,1
8,2,0,10,mixedType,1
15,1,0,16,mixedType,2
6,4,0,10,mixedType,1
4,2,0,6,mixedType,0
8,2,0,10,mixedType,1
7,3,0,10,mixedType,1
8,1,0,9,mixedType,1
5,1,0,6,mixedType,0
5,4,0,9,mixedType,1
7,2,0,9,mixedType,1
6,2,0,8,mixedType,1
15,1,0,16,mixedType,2
6,4,0,10,mixedType,1
6,1,0,7,mixedType,0
7,3,0,10,mixedType,1
6,3,0,9,mixedType,1
7,3,0,10,mixedType,1
7,2,0,9,mixedType,1
8,2,0,10,mixedType,1
7,2,0,9,mixedType,1
12,3,0,15,mixedType,2
7,3,0,10,mixedType,1
8,6,2,16,mixedType,2
1,11,0,12,mixedType,1
5,2,0,7,mixedType,0
5,4,0,9,mixedType,1
3,3,0,6,mixedType,0
8,7,0,15,mixedType,2
6,2,0,8,mixedType,1
8,1,0,9,mixedType,1
5,3,0,8,mixedType,1
6,3,0,9,mixedType,1
4,4,0,8,mixedType,1
7,6,0,13,mixedType,1
5,4,0,9,mixedType,1
8,4,0,12,mixedType,1
7,4,0,11,mixedType,1
1,6,0,7,mixedType,0
6,4,0,10,mixedType,1
7,3,0,10,mixedType,1
4,4,0,8,mixedType,1
7,3,0,10,mixedType,1
1,9,0,10,mixedType,1
5,3,0,8,mixedType,1
15,1,0,16,mixedType,2
5,2,0,7,mixedType,0
6,2,0,8,mixedType,1
6,4,0,10,mixedType,1
9,2,0,11,mixedType,1
8,2,0,10,mixedType,1
6,4,0,10,mixedType,1
5,2,0,7,mixedType,0
6,3,0,9,mixedType,1
2,8,0,10,mixedType,1
8,4,0,12,mixedType,1
9,1,0,10,mixedType,1
5,3,0,8,mixedType,1
4,6,0,10,mixedType,1
6,2,0,8,mixedType,1
6,3,0,9,mixedType,1
8,4,0,12,mixedType,1
13,3,0,16,mixedType,2
5,2,0,7,mixedType,0
10,2,0,12,mixedType,1
7,3,0,10,mixedType,1
9,4,0,13,mixedType,1
4,2,0,6,mixedType,0
7,1,0,8,mixedType,1
4,4,0,8,mixedType,1
5,1,0,6,mixedType,0
1,8,0,9,mixedType,1
8,2,0,10,mixedType,1
6,1,0,7,mixedType,0
2,6,0,8,mixedType,1
8,1,0,9,mixedType,1
8,2,0,10,mixedType,1
5,7,0,12,mixedType,1
7,3,0,10,mixedType,1
5,3,0,8,mixedType,1
7,2,0,9,mixedType,1
6,4,0,10,mixedType,1
3,7,0,10,mixedType,1
6,1,0,7,mixedType,0
4,2,0,6,mixedType,0
7,2,0,9,mixedType,1
5,2,0,7,mixedType,0
11,3,0,14,mixedType,2
5,3,0,8,mixedType,1
4,8,0,12,mixedType,1
6,4,0,10,mixedType,1
6,4,0,10,mixedType,1
4,4,0,8,mixedType,1
7,2,0,9,mixedType,1
6,2,0,8,mixedType,1
6,2,0,8,mixedType,1
4,2,0,6,mixedType,0
2,4,0,6,mixedType,0
6,2,0,8,mixedType,1
7,3,0,10,mixedType,1
6,1,0,7,mixedType,0
7,6,0,13,mixedType,1
5,3,0,8,mixedType,1
3,6,0,9,mixedType,1
5,3,0,8,mixedType,1
14,2,0,16,mixedType,2
5,2,0,7,mixedType,0
6,4,0,10,mixedType,1
8,3,0,11,mixedType,1
6,3,0,9,mixedType,1
9,2,0,11,mixedType,1
9,1,0,10,mixedType,1
8,2,0,10,mixedType,1
7,2,0,9,mixedType,1
5,2,0,7,mixedType,0
5,8,0,13,mixedType,1
5,3,0,8,mixedType,1
2,11,1,14,mixedType,2
11,3,0,14,mixedType,2
3,5,0,8,mixedType,1
7,3,0,10,mixedType,1
9,4,0,13,mixedType,1
9,4,0,13,mixedType,1
6,3,0,9,mixedType,1
5,8,0,13,mixedType,1
9,2,0,11,mixedType,1
9,2,0,11,mixedType,1
6,4,0,10,mixedType,1
7,3,0,10,mixedType,1
5,1,0,6,mixedType,0
8,2,0,10,mixedType,1
5,6,0,11,mixedType,1
14,2,0,16,mixedType,2
7,3,0,10,mixedType,1
3,5,0,8,mixedType,1
13,3,0,16,mixedType,2
3,9,0,12,mixedType,1
7,2,0,9,mixedType,1
5,1,0,6,mixedType,0
6,2,0,8,mixedType,1
3,7,0,10,mixedType,1
4,5,0,9,mixedType,1
8,2,0,10,mixedType,1
7,2,0,9,mixedType,1
4,2,0,6,mixedType,0
10,1,0,11,mixedType,1
7,2,0,9,mixedType,1
9,1,0,10,mixedType,1
6,3,0,9,mixedType,1
6,1,0,7,mixedType,0
4,5,0,9,mixedType,1
9,2,0,11,mixedType,1
9,1,0,10,mixedType,1
3,3,0,6,mixedType,0
6,3,0,9,mixedType,1
6,2,0,8,mixedType,1
4,4,0,8,mixedType,1
7,3,0,10,mixedType,1
6,4,0,10,mixedType,1
5,8,0,13,mixedType,1
6,2,0,8,mixedType,1
1,8,0,9,mixedType,1
8,2,0,10,mixedType,1
6,3,0,9,mixedType,1
9,4,0,13,mixedType,1
1,8,0,9,mixedType,1
5,2,0,7,mixedType,0
4,2,0,6,mixedType,0
3,3,0,6,mixedType,0
15,1,0,16,mixedType,2
2,8,0,10,mixedType,1
6,3,0,9,mixedType,1
2,11,0,13,mixedType,1
3,6,0,9,mixedType,1
13,3,0,16,mixedType,2
3,6,0,9,mixedType,1
4,2,0,6,mixedType,0
6,3,0,9,mixedType,1
7,2,0,9,mixedType,1
7,1,0,8,mixedType,1
1,8,0,9,mixedType,1
6,1,0,7,mixedType,0
15,1,0,16,mixedType,2
8,2,0,10,mixedType,1
11,5,0,16,mixedType,2
6,1,0,7,mixedType,0
6,3,0,9,mixedType,1
6,3,0,9,mixedType,1
8,1,0,9,mixedType,1
1,7,0,8,mixedType,1
7,3,0,10,mixedType,1
6,3,0,9,mixedType,1
6,6,0,12,mixedType,1
15,1,0,16,mixedType,2
4,6,0,10,mixedType,1
1,11,0,12,mixedType,1
7,4,0,11,mixedType,1
10,1,0,11,mixedType,1
5,2,0,7,mixedType,0
12,3,0,15,mixedType,2
6,3,0,9,mixedType,1
4,4,0,8,mixedType,1
9,3,0,12,mixedType,1
7,2,0,9,mixedType,1
6,2,0,8,mixedType,1
11,3,0,14,mixedType,2
7,3,0,10,mixedType,1
6,2,0,8,mixedType,1
3,6,0,9,mixedType,1
6,1,0,7,mixedType,0
6,3,0,9,mixedType,1
6,1,0,7,mixedType,0
4,4,0,8,mixedType,1
5,4,0,9,mixedType,1
5,3,0,8,mixedType,1
8,5,1,14,mixedType,2
4,2,0,6,mixedType,0
6,1,0,7,mixedType,0
6,4,0,10,mixedType,1
5,8,0,13,mixedType,1
13,3,0,16,mixedType,2
7,2,0,9,mixedType,1
6,2,0,8,mixedType,1
7,5,3,15,mixedType,2
3,6,0,9,mixedType,1
7,1,0,8,mixedType,1
4,4,0,8,mixedType,1
5,3,0,8,mixedType,1
5,3,0,8,mixedType,1
8,2,0,10,mixedType,1
7,1,0,8,mixedType,1
9,1,0,10,mixedType,1
8,1,0,9,mixedType,1
4,6,0,10,mixedType,1
4,4,0,8,mixedType,1
5,1,0,6,mixedType,0
6,6,0,12,mixedType,1
13,3,0,16,mixedType,2
4,4,0,8,mixedType,1
8,1,0,9,mixedType,1
6,4,0,10,mixedType,1
8,2,0,10,mixedType,1
6,4,0,10,mixedType,1
5,2,0,7,mixedType,0
4,5,0,9,mixedType,1
7,1,0,8,mixedType,1
4,5,0,9,mixedType,1
6,3,0,9,mixedType,1
8,2,0,10,mixedType,1
7,2,0,9,mixedType,1
10,1,0,11,mixedType,1
9,1,0,10,mixedType,1
7,3,0,10,mixedType,1
7,3,0,10,mixedType,1
6,3,0,9,mixedType,1
5,2,0,7,mixedType,0
5,2,0,7,mixedType,0
9,3,0,12,mixedType,1
6,2,0,8,mixedType,1
6,4,0,10,mixedType,1
6,4,0,10,mixedType,1
11,5,0,16,mixedType,2
6,2,0,8,mixedType,1
7,5,0,12,mixedType,1
5,3,0,8,mixedType,1
6,2,0,8,mixedType,1
4,7,0,11,mixedType,1
3,5,0,8,mixedType,1
5,3,0,8,mixedType,1
7,1,0,8,mixedType,1
4,6,0,10,mixedType,1
6,4,0,10,mixedType,1
6,3,0,9,mixedType,1
5,3,0,8,mixedType,1
1,9,0,10,mixedType,1
5,6,0,11,mixedType,1
7,1,0,8,mixedType,1
12,4,0,16,mixedType,2
7,4,0,11,mixedType,1
1,10,0,11,mixedType,1
6,3,0,9,mixedType,1
5,4,0,9,mixedType,1
6,3,0,9,mixedType,1
6,3,0,9,mixedType,1
5,4,0,9,mixedType,1
8,1,0,9,mixedType,1
8,2,0,10,mixedType,1
6,2,0,8,mixedType,1
5,2,0,7,mixedType,0
5,1,0,6,mixedType,0
12,3,0,15,mixedType,2
9,1,0,10,mixedType,1
2,8,0,10,mixedType,1
7,2,0,9,mixedType,1
13,3,0,16,mixedType,2
6,2,0,8,mixedType,1
4,6,0,10,mixedType,1
6,3,0,9,mixedType,1
7,2,0,9,mixedType,1
6,4,0,10,mixedType,1
4,4,0,8,mixedType,1
1,7,0,8,mixedType,1
2,4,0,6,mixedType,0
5,2,0,7,mixedType,0
6,2,0,8,mixedType,1
5,3,0,8,mixedType,1
5,4,0,9,mixedType,1
6,4,0,10,mixedType,1
6,2,0,8,mixedType,1
4,2,0,6,mixedType,0
9,4,0,13,mixedType,1
5,4,0,9,mixedType,1
6,2,0,8,mixedType,1
6,1,0,7,mixedType,0
5,2,0,7,mixedType,0
7,2,0,9,mixedType,1
6,2,0,8,mixedType,1
5,6,0,11,mixedType,1
6,3,0,9,mixedType,1
7,2,0,9,mixedType,1
0,9,1,10,mixedType,1
4,9,0,13,mixedType,1
5,4,0,9,mixedType,1
7,1,0,8,mixedType,1
5,4,0,9,mixedType,1
9,1,0,10,mixedType,1
9,2,0,11,mixedType,1
4,4,0,8,mixedType,1
2,6,0,8,mixedType,1
18,2,0,20,mixedType,2
7,1,0,8,mixedType,1
10,1,0,11,mixedType,1
0,6,3,9,mixedType,1
7,1,0,8,mixedType,1
6,1,0,7,mixedType,0
8,2,0,10,mixedType,1
6,1,0,7,mixedType,0
11,3,0,14,mixedType,2
6,3,0,9,mixedType,1
7,2,0,9,mixedType,1
9,1,0,10,mixedType,1
9,1,0,10,mixedType,1
8,3,0,11,mixedType,1
4,5,0,9,mixedType,1
8,2,0,10,mixedType,1
5,3,0,8,mixedType,1
3,6,0,9,mixedType,1
2,8,0,10,mixedType,1
9,1,0,10,mixedType,1
14,2,0,16,mixedType,2
8,2,0,10,mixedType,1
11,3,0,14,mixedType,2
9,1,0,10,mixedType,1
15,1,0,16,mixedType,2
8,4,0,12,mixedType,1
7,3,0,10,mixedType,1
2,6,0,8,mixedType,1
3,10,0,13,mixedType,1
6,1,0,7,mixedType,0
4,4,0,8,mixedType,1
5,2,0,7,mixedType,0
6,3,0,9,mixedType,1
8,4,0,12,mixedType,1
6,4,0,10,mixedType,1
6,3,0,9,mixedType,1
2,6,0,8,mixedType,1
15,1,0,16,mixedType,2
4,2,0,6,mixedType,0
6,3,0,9,mixedType,1
7,2,0,9,mixedType,1
4,8,0,12,mixedType,1
7,3,0,10,mixedType,1
6,3,0,9,mixedType,1
6,2,0,8,mixedType,1
6,4,0,10,mixedType,1
9,1,0,10,mixedType,1
7,1,0,8,mixedType,1
5,4,0,9,mixedType,1
8,2,0,10,mixedType,1
3,6,0,9,mixedType,1
9,1,0,10,mixedType,1
8,1,0,9,mixedType,1
7,2,0,9,mixedType,1
5,5,0,10,mixedType,1
7,3,0,10,mixedType,1
8,2,0,10,mixedType,1
5,2,0,7,mixedType,0
10,2,0,12,mixedType,1
1,7,0,8,mixedType,1
6,2,0,8,mixedType,1
10,1,0,11,mixedType,1
5,8,0,13,mixedType,1
12,4,0,16,mixedType,2
6,3,0,9,mixedType,1
6,4,0,10,mixedType,1
10,2,0,12,mixedType,1
2,7,0,9,mixedType,1
5,2,0,7,mixedType,0
3,6,0,9,mixedType,1
5,1,0,6,mixedType,0
4,4,0,8,mixedType,1
15,1,0,16,mixedType,2
7,1,0,8,mixedType,1
5,1,0,6,mixedType,0
2,9,0,11,mixedType,1
6,1,0,7,mixedType,0
6,3,0,9,mixedType,1
5,4,0,9,mixedType,1
6,1,0,7,mixedType,0
8,2,0,10,mixedType,1
3,6,0,9,mixedType,1
5,4,0,9,mixedType,1
8,1,0,9,mixedType,1
14,2,0,16,mixedType,2
7,3,0,10,mixedType,1
5,3,0,8,mixedType,1
9,2,0,11,mixedType,1
6,3,0,9,mixedType,1
3,9,0,12,mixedType,1
7,3,0,10,mixedType,1
7,3,0,10,mixedType,1
5,4,0,9,mixedType,1
6,2,0,8,mixedType,1
7,2,0,9,mixedType,1
9,1,0,10,mixedType,1
5,2,0,7,mixedType,0
8,2,0,10,mixedType,1
6,2,0,8,mixedType,1
6,1,0,7,mixedType,0
5,2,0,7,mixedType,0
5,3,0,8,mixedType,1
8,1,0,9,mixedType,1
5,3,0,8,mixedType,1
8,1,0,9,mixedType,1
5,3,0,8,mixedType,1
4,2,0,6,mixedType,0
4,6,0,10,mixedType,1
9,9,1,19,mixedType,2
3,3,0,6,mixedType,0
7,5,0,12,mixedType,1
14,2,0,16,mixedType,2
1,8,0,9,mixedType,1
14,2,0,16,mixedType,2
7,3,0,10,mixedType,1
1,8,0,9,mixedType,1
2,8,0,10,mixedType,1
5,2,0,7,mixedType,0
2,6,0,8,mixedType,1
5,4,0,9,mixedType,1
6,2,0,8,mixedType,1
1,7,0,8,mixedType,1
11,3,0,14,mixedType,2
7,2,0,9,mixedType,1
7,3,0,10,mixedType,1
7,1,0,8,mixedType,1
7,1,0,8,mixedType,1
7,3,0,10,mixedType,1
6,3,0,9,mixedType,1
7,2,0,9,mixedType,1
5,3,0,8,mixedType,1
7,1,0,8,mixedType,1
6,3,0,9,mixedType,1
9,3,0,12,mixedType,1
8,1,0,9,mixedType,1
10,3,0,13,mixedType,1
5,4,0,9,mixedType,1
6,2,0,8,mixedType,1
10,3,0,13,mixedType,1
7,3,0,10,mixedType,1
4,5,0,9,mixedType,1
6,3,0,9,mixedType,1
4,6,0,10,mixedType,1
5,2,0,7,mixedType,0
9,1,0,10,mixedType,1
4,7,0,11,mixedType,1
4,4,0,8,mixedType,1
6,1,0,7,mixedType,0
2,10,0,12,mixedType,1
5,3,0,8,mixedType,1
4,2,0,6,mixedType,0
7,2,0,9,mixedType,1
8,3,0,11,mixedType,1
6,3,0,9,mixedType,1
12,4,0,16,mixedType,2
6,3,0,9,mixedType,1
1,8,0,9,mixedType,1
4,4,0,8,mixedType,1
5,8,0,13,mixedType,1
7,3,0,10,mixedType,1
10,1,0,11,mixedType,1
7,3,0,10,mixedType,1
6,2,0,8,mixedType,1
11,1,0,12,mixedType,1
9,2,0,11,mixedType,1
12,3,0,15,mixedType,2
7,2,0,9,mixedType,1
7,3,0,10,mixedType,1
1,8,0,9,mixedType,1
4,4,0,8,mixedType,1
3,6,0,9,mixedType,1
8,3,0,11,mixedType,1
6,1,0,7,mixedType,0
5,4,0,9,mixedType,1
7,3,0,10,mixedType,1
6,1,0,7,mixedType,0
4,4,0,8,mixedType,1
11,5,0,16,mixedType,2
5,2,0,7,mixedType,0
4,4,0,8,mixedType,1
3,5,0,8,mixedType,1
8,1,0,9,mixedType,1
8,4,0,12,mixedType,1
13,3,0,16,mixedType,2
5,6,0,11,mixedType,1
4,6,0,10,mixedType,1
11,3,0,14,mixedType,2
8,1,0,9,mixedType,1
6,4,0,10,mixedType,1
14,2,0,16,mixedType,2
6,2,0,8,mixedType,1
6,2,0,8,mixedType,1
12,4,0,16,mixedType,2
9,3,0,12,mixedType,1
5,4,0,9,mixedType,1
7,6,0,13,mixedType,1
8,1,0,9,mixedType,1
9,2,0,11,mixedType,1
3,7,0,10,mixedType,1
5,1,0,6,mixedType,0
4,2,0,6,mixedType,0
5,2,0,7,mixedType,0
6,1,0,7,mixedType,0
9,2,0,11,mixedType,1
5,2,0,7,mixedType,0
6,2,0,8,mixedType,1
3,6,0,9,mixedType,1
6,3,0,9,mixedType,1
7,2,0,9,mixedType,1
6,1,0,7,mixedType,0
4,4,0,8,mixedType,1
5,1,0,6,mixedType,0
9,3,0,12,mixedType,1
6,6,0,12,mixedType,1
7,3,0,10,mixedType,1
8,1,0,9,mixedType,1
6,3,0,9,mixedType,1
14,2,0,16,mixedType,2
4,2,0,6,mixedType,0
6,1,0,7,mixedType,0
9,2,0,11,mixedType,1
9,1,0,10,mixedType,1
5,4,0,9,mixedType,1
6,3,0,9,mixedType,1
7,2,0,9,mixedType,1
7,2,0,9,mixedType,1
5,3,0,8,mixedType,1
4,6,0,10,mixedType,1
8,1,0,9,mixedType,1
3,6,0,9,mixedType,1
6,4,0,10,mixedType,1
9,2,0,11,mixedType,1
4,4,0,8,mixedType,1
13,3,0,16,mixedType,2
3,8,0,11,mixedType,1
4,5,0,9,mixedType,1
8,2,0,10,mixedType,1
4,2,0,6,mixedType,0
11,1,0,12,mixedType,1
8,1,0,9,mixedType,1
4,7,0,11,mixedType,1
6,3,0,9,mixedType,1
14,2,0,16,mixedType,2
7,3,0,10,mixedType,1
5,1,0,6,mixedType,0
9,3,0,12,mixedType,1
9,2,0,11,mixedType,1
1,8,0,9,mixedType,1
3,6,0,9,mixedType,1
5,3,0,8,mixedType,1
5,1,0,6,mixedType,0
5,3,0,8,mixedType,1
7,4,0,11,mixedType,1
8,2,0,10,mixedType,1
7,3,0,10,mixedType,1
8,2,0,10,mixedType,1
6,3,0,9,mixedType,1
1,9,0,10,mixedType,1
4,4,0,8,mixedType,1
14,2,0,16,mixedType,2
2,6,0,8,mixedType,1
6,7,0,13,mixedType,1
3,10,0,13,mixedType,1
6,3,0,9,mixedType,1
9,4,0,13,mixedType,1
1,8,0,9,mixedType,1
6,3,0,9,mixedType,1
8,1,0,9,mixedType,1
8,1,0,9,mixedType,1
5,1,0,6,mixedType,0
6,1,0,7,mixedType,0
5,1,0,6,mixedType,0
6,1,0,7,mixedType,0
7,3,0,10,mixedType,1
1,10,0,11,mixedType,1
8,3,0,11,mixedType,1
6,4,0,10,mixedType,1
7,3,0,10,mixedType,1
1,8,0,9,mixedType,1
5,2,0,7,mixedType,0
5,1,0,6,mixedType,0
8,4,0,12,mixedType,1
8,2,0,10,mixedType,1
4,2,0,6,mixedType,0
4,4,0,8,mixedType,1
5,3,0,8,mixedType,1
4,6,0,10,mixedType,1
13,3,0,16,mixedType,2
6,1,0,7,mixedType,0
4,4,0,8,mixedType,1
15,1,0,16,mixedType,2
2,4,0,6,mixedType,0
9,4,0,13,mixedType,1
11,2,0,13,mixedType,1
5,4,0,9,mixedType,1
6,4,0,10,mixedType,1
7,1,0,8,mixedType,1
6,4,0,10,mixedType,1
9,1,0,10,mixedType,1
4,2,0,6,mixedType,0
9,4,0,13,mixedType,1
8,1,0,9,mixedType,1
7,2,0,9,mixedType,1
5,4,0,9,mixedType,1
13,3,0,16,mixedType,2
5,2,0,7,mixedType,0
1,8,0,9,mixedType,1
5,2,0,7,mixedType,0
5,1,0,6,mixedType,0
6,1,0,7,mixedType,0
6,3,0,9,mixedType,1
4,4,0,8,mixedType,1
6,3,0,9,mixedType,1
14,2,0,16,mixedType,2
5,5,0,10,mixedType,1
7,3,0,10,mixedType,1
2,6,0,8,mixedType,1
2,4,0,6,mixedType,0
9,3,0,12,mixedType,1
9,1,0,10,mixedType,1
6,3,0,9,mixedType,1
8,4,0,12,mixedType,1
5,3,0,8,mixedType,1
5,8,0,13,mixedType,1
2,8,0,10,mixedType,1
6,2,0,8,mixedType,1
5,5,0,10,mixedType,1
14,2,0,16,mixedType,2
4,8,3,15,mixedType,2
0,8,1,9,mixedType,1
7,5,0,12,mixedType,1
4,4,0,8,mixedType,1
6,1,0,7,mixedType,0
6,2,0,8,mixedType,1
11,3,0,14,mixedType,2
4,4,0,8,mixedType,1
6,1,0,7,mixedType,0
6,3,0,9,mixedType,1
6,5,0,11,mixedType,1
10,6,0,16,mixedType,2
15,1,0,16,mixedType,2
1,8,0,9,mixedType,1
8,1,0,9,mixedType,1
13,3,0,16,mixedType,2
14,2,0,16,mixedType,2
3,10,0,13,mixedType,1
7,6,0,13,mixedType,1
5,6,0,11,mixedType,1
8,3,0,11,mixedType,1
10,1,0,11,mixedType,1
5,4,0,9,mixedType,1
14,2,0,16,mixedType,2
7,3,0,10,mixedType,1
6,2,0,8,mixedType,1
6,4,0,10,mixedType,1
6,2,0,8,mixedType,1
5,2,0,7,mixedType,0
8,1,0,9,mixedType,1
6,3,0,9,mixedType,1
5,4,0,9,mixedType,1
14,2,0,16,mixedType,2
1,7,0,8,mixedType,1
9,3,3,15,mixedType,2
2,7,0,9,mixedType,1
2,8,0,10,mixedType,1
6,6,0,12,mixedType,1
6,3,0,9,mixedType,1
8,1,0,9,mixedType,1
4,2,0,6,mixedType,0
11,3,0,14,mixedType,2
4,2,0,6,mixedType,0
11,5,0,16,mixedType,2
12,4,0,16,mixedType,2
6,1,0,7,mixedType,0
12,3,0,15,mixedType,2
5,2,0,7,mixedType,0
5,2,0,7,mixedType,0
5,3,0,8,mixedType,1
4,4,0,8,mixedType,1
6,3,0,9,mixedType,1
8,3,0,11,mixedType,1
7,1,0,8,mixedType,1
4,4,0,8,mixedType,1
9,1,0,10,mixedType,1
1,9,0,10,mixedType,1
6,1,0,7,mixedType,0
5,6,0,11,mixedType,1
13,3,0,16,mixedType,2
13,4,0,17,mixedType,2
5,4,0,9,mixedType,1
3,3,0,6,mixedType,0
15,1,0,16,mixedType,2
7,4,0,11,mixedType,1
13,3,0,16,mixedType,2
7,3,0,10,mixedType,1
3,5,0,8,mixedType,1
5,3,0,8,mixedType,1
1,7,0,8,mixedType,1
5,3,0,8,mixedType,1
7,2,0,9,mixedType,1
7,3,0,10,mixedType,1
12,4,0,16,mixedType,2
7,3,0,10,mixedType,1
9,3,0,12,mixedType,1
10,2,0,12,mixedType,1
3,6,0,9,mixedType,1
3,6,0,9,mixedType,1
3,8,0,11,mixedType,1
7,2,0,9,mixedType,1
4,4,0,8,mixedType,1
6,3,0,9,mixedType,1
6,3,0,9,mixedType,1
6,3,0,9,mixedType,1
7,2,0,9,mixedType,1
7,1,0,8,mixedType,1
2,9,0,11,mixedType,1
6,2,0,8,mixedType,1
5,4,0,9,mixedType,1
6,2,0,8,mixedType,1
8,1,0,9,mixedType,1
7,3,0,10,mixedType,1
3,5,0,8,mixedType,1
8,2,0,10,mixedType,1
6,4,0,10,mixedType,1
11,3,0,14,mixedType,2
7,1,0,8,mixedType,1
5,2,0,7,mixedType,0
15,1,0,16,mixedType,2
7,3,0,10,mixedType,1
13,3,0,16,mixedType,2
7,1,0,8,mixedType,1
6,3,0,9,mixedType,1
1,8,0,9,mixedType,1
13,3,0,16,mixedType,2
3,5,0,8,mixedType,1
7,3,0,10,mixedType,1
9,4,0,13,mixedType,1
9,3,0,12,mixedType,1
8,2,0,10,mixedType,1
6,3,0,9,mixedType,1
6,2,0,8,mixedType,1
1,9,0,10,mixedType,1
15,1,0,16,mixedType,2
8,1,0,9,mixedType,1
3,3,0,6,mixedType,0
9,2,0,11,mixedType,1
8,2,0,10,mixedType,1
8,1,0,9,mixedType,1
5,3,0,8,mixedType,1
14,2,0,16,mixedType,2
5,1,0,6,mixedType,0
14,2,0,16,mixedType,2
6,2,0,8,mixedType,1
6,1,0,7,mixedType,0
4,2,0,6,mixedType,0
10,1,0,11,mixedType,1
14,2,0,16,mixedType,2
6,3,0,9,mixedType,1
14,2,0,16,mixedType,2
2,9,0,11,mixedType,1
6,2,0,8,mixedType,1
13,3,0,16,mixedType,2
4,4,0,8,mixedType,1
5,4,0,9,mixedType,1
7,3,0,10,mixedType,1
5,2,0,7,mixedType,0
4,5,0,9,mixedType,1
14,2,0,16,mixedType,2
6,2,0,8,mixedType,1
5,2,0,7,mixedType,0
9,3,0,12,mixedType,1
5,4,0,9,mixedType,1
3,6,0,9,mixedType,1
6,2,0,8,mixedType,1
5,2,0,7,mixedType,0
6,3,0,9,mixedType,1
8,2,0,10,mixedType,1
8,5,0,13,mixedType,1
8,2,0,10,mixedType,1
8,1,0,9,mixedType,1
7,2,0,9,mixedType,1
15,1,0,16,mixedType,2
1,7,0,8,mixedType,1
5,1,0,6,mixedType,0
4,2,0,6,mixedType,0
7,4,0,11,mixedType,1
3,5,0,8,mixedType,1
5,4,0,9,mixedType,1
9,1,0,10,mixedType,1
2,8,0,10,mixedType,1
3,8,0,11,mixedType,1
6,3,0,9,mixedType,1
4,4,0,8,mixedType,1
5,2,0,7,mixedType,0
6,1,0,7,mixedType,0
14,2,0,16,mixedType,2
6,1,0,7,mixedType,0
7,3,0,10,mixedType,1
8,1,0,9,mixedType,1
8,2,0,10,mixedType,1
16,0,2,18,mixedType,2
6,2,0,8,mixedType,1
6,3,0,9,mixedType,1
5,3,0,8,mixedType,1
7,3,0,10,mixedType,1
3,6,0,9,mixedType,1
9,1,0,10,mixedType,1
7,4,0,11,mixedType,1
8,2,0,10,mixedType,1
5,4,0,9,mixedType,1
5,1,0,6,mixedType,0
8,5,0,13,mixedType,1
7,1,0,8,mixedType,1
6,1,0,7,mixedType,0
6,3,0,9,mixedType,1
8,3,0,11,mixedType,1
6,1,0,7,mixedType,0
13,3,0,16,mixedType,2
1,5,0,6,mixedType,0
5,1,0,6,mixedType,0
10,2,0,12,mixedType,1
6,2,0,8,mixedType,1
9,2,0,11,mixedType,1
12,4,0,16,mixedType,2
6,1,0,7,mixedType,0
5,0,1,6,mixedType,0
8,2,0,10,mixedType,1
5,2,0,7,mixedType,0
8,3,0,11,mixedType,1
5,2,0,7,mixedType,0
7,2,0,9,mixedType,1
8,1,0,9,mixedType,1
8,2,0,10,mixedType,1
7,5,0,12,mixedType,1
13,3,0,16,mixedType,2
7,4,0,11,mixedType,1
0,6,1,7,mixedType,0
8,1,0,9,mixedType,1
7,3,0,10,mixedType,1
4,4,0,8,mixedType,1
8,4,0,12,mixedType,1
7,2,0,9,mixedType,1
8,2,0,10,mixedType,1
7,3,0,10,mixedType,1
7,4,0,11,mixedType,1
6,2,0,8,mixedType,1
7,2,0,9,mixedType,1
6,1,0,7,mixedType,0
13,3,0,16,mixedType,2
3,6,0,9,mixedType,1
4,8,0,12,mixedType,1
4,2,0,6,mixedType,0
8,2,0,10,mixedType,1
5,1,0,6,mixedType,0
13,3,0,16,mixedType,2
6,4,0,10,mixedType,1
6,2,0,8,mixedType,1
11,1,0,12,mixedType,1
3,5,0,8,mixedType,1
3,3,0,6,mixedType,0
4,6,0,10,mixedType,1
6,3,0,9,mixedType,1
6,3,0,9,mixedType,1
3,8,0,11,mixedType,1
6,2,0,8,mixedType,1
5,2,0,7,mixedType,0
10,3,0,13,mixedType,1
11,3,0,14,mixedType,2
7,3,0,10,mixedType,1
7,3,0,10,mixedType,1
9,1,0,10,mixedType,1
5,3,0,8,mixedType,1
5,8,0,13,mixedType,1
5,3,0,8,mixedType,1
6,3,0,9,mixedType,1
4,2,0,6,mixedType,0
11,3,0,14,mixedType,2
11,3,0,14,mixedType,2
15,1,0,16,mixedType,2
5,3,0,8,mixedType,1
5,3,0,8,mixedType,1
8,1,0,9,mixedType,1
0,11,2,13,mixedType,1
5,2,0,7,mixedType,0
5,2,0,7,mixedType,0
7,3,0,10,mixedType,1
3,7,0,10,mixedType,1
6,4,0,10,mixedType,1
5,3,0,8,mixedType,1
7,3,0,10,mixedType,1
5,4,0,9,mixedType,1
7,3,0,10,mixedType,1
6,2,0,8,mixedType,1
3,5,0,8,mixedType,1
14,2,0,16,mixedType,2
13,3,0,16,mixedType,2
7,3,0,10,mixedType,1
15,1,0,16,mixedType,2
9,1,0,10,mixedType,1
8,1,0,9,mixedType,1
15,1,0,16,mixedType,2
5,2,0,7,mixedType,0
7,2,0,9,mixedType,1
8,1,0,9,mixedType,1
6,4,0,10,mixedType,1
8,1,0,9,mixedType,1
10,3,0,13,mixedType,1
6,2,0,8,mixedType,1
7,3,0,10,mixedType,1
7,4,0,11,mixedType,1
4,2,0,6,mixedType,0
7,4,0,11,mixedType,1
9,1,0,10,mixedType,1
6,3,0,9,mixedType,1
7,3,0,10,mixedType,1
1,11,0,12,mixedType,1
6,3,0,9,mixedType,1
6,1,0,7,mixedType,0
7,2,0,9,mixedType,1
5,3,0,8,mixedType,1
4,4,0,8,mixedType,1
9,4,0,13,mixedType,1
7,5,0,12,mixedType,1
7,1,0,8,mixedType,1
14,2,0,16,mixedType,2
7,2,0,9,mixedType,1
3,5,0,8,mixedType,1
6,1,0,7,mixedType,0
6,1,0,7,mixedType,0
4,2,0,6,mixedType,0
11,3,0,14,mixedType,2
6,2,0,8,mixedType,1
11,3,0,14,mixedType,2
3,6,0,9,mixedType,1
7,3,0,10,mixedType,1
6,2,0,8,mixedType,1
8,2,0,10,mixedType,1
7,1,0,8,mixedType,1
13,3,0,16,mixedType,2
7,3,0,10,mixedType,1
2,8,0,10,mixedType,1
7,1,0,8,mixedType,1
5,3,0,8,mixedType,1
3,6,0,9,mixedType,1
9,1,0,10,mixedType,1
7,2,0,9,mixedType,1
5,1,0,6,mixedType,0
8,4,0,12,mixedType,1
6,3,0,9,mixedType,1
9,3,0,12,mixedType,1
6,3,0,9,mixedType,1
7,3,0,10,mixedType,1
6,4,0,10,mixedType,1
14,2,0,16,mixedType,2
7,3,0,10,mixedType,1
9,2,0,11,mixedType,1
8,2,0,10,mixedType,1
7,3,0,10,mixedType,1
7,3,0,10,mixedType,1
5,4,0,9,mixedType,1
6,2,0,8,mixedType,1
22,2,0,24,mixedType,2
6,2,0,8,mixedType,1
5,2,0,7,mixedType,0
9,4,0,13,mixedType,1
7,3,0,10,mixedType,1
5,6,0,11,mixedType,1
13,3,0,16,mixedType,2
9,2,0,11,mixedType,1
9,2,0,11,mixedType,1
8,2,0,10,mixedType,1
5,2,0,7,mixedType,0
11,3,0,14,mixedType,2
1,11,0,12,mixedType,1
5,3,0,8,mixedType,1
5,3,0,8,mixedType,1
9,4,0,13,mixedType,1
7,3,0,10,mixedType,1
6,2,0,8,mixedType,1
3,8,0,11,mixedType,1
2,4,0,6,mixedType,0
4,4,0,8,mixedType,1
4,4,0,8,mixedType,1
10,0,1,11,mixedType,1
5,4,0,9,mixedType,1
5,2,0,7,mixedType,0
7,3,0,10,mixedType,1
7,3,0,10,mixedType,1
13,3,0,16,mixedType,2
5,3,0,8,mixedType,1
7,3,0,10,mixedType,1
8,4,0,12,mixedType,1
4,6,0,10,mixedType,1
4,4,0,8,mixedType,1
7,2,0,9,mixedType,1
8,5,0,13,mixedType,1
5,3,0,8,mixedType,1
5,3,0,8,mixedType,1
5,3,0,8,mixedType,1
5,3,0,8,mixedType,1
8,3,0,11,mixedType,1
10,1,0,11,mixedType,1
6,2,0,8,mixedType,1
6,4,0,10,mixedType,1
5,3,0,8,mixedType,1
10,2,0,12,mixedType,1
7,3,0,10,mixedType,1
11,3,0,14,mixedType,2
3,10,2,15,mixedType,2
13,3,0,16,mixedType,2
8,1,0,9,mixedType,1
12,3,0,15,mixedType,2
1,8,0,9,mixedType,1
7,2,0,9,mixedType,1
11,3,0,14,mixedType,2
10,1,0,11,mixedType,1
13,3,0,16,mixedType,2
7,3,0,10,mixedType,1
6,3,0,9,mixedType,1
3,8,0,11,mixedType,1
12,3,0,15,mixedType,2
5,2,0,7,mixedType,0
5,6,0,11,mixedType,1
3,10,1,14,mixedType,2
5,5,0,10,mixedType,1
6,3,0,9,mixedType,1
15,1,0,16,mixedType,2
6,2,0,8,mixedType,1
4,6,0,10,mixedType,1
4,2,0,6,mixedType,0
14,2,0,16,mixedType,2
3,7,0,10,mixedType,1
6,0,1,7,mixedType,0
10,2,0,12,mixedType,1
6,3,0,9,mixedType,1
5,2,0,7,mixedType,0
8,3,0,11,mixedType,1
9,2,0,11,mixedType,1
4,2,0,6,mixedType,0
8,2,0,10,mixedType,1
6,2,0,8,mixedType,1
8,2,0,10,mixedType,1
8,1,0,9,mixedType,1
14,2,0,16,mixedType,2
2,7,0,9,mixedType,1
15,1,0,16,mixedType,2
9,1,0,10,mixedType,1
4,6,0,10,mixedType,1
7,2,0,9,mixedType,1
3,6,0,9,mixedType,1
6,3,0,9,mixedType,1
7,1,0,8,mixedType,1
7,1,0,8,mixedType,1
2,7,0,9,mixedType,1
9,2,0,11,mixedType,1
3,6,0,9,mixedType,1
9,2,0,11,mixedType,1
8,2,0,10,mixedType,1
5,4,0,9,mixedType,1
5,6,0,11,mixedType,1
6,3,0,9,mixedType,1
5,7,0,12,mixedType,1
5,3,0,8,mixedType,1
8,1,0,9,mixedType,1
5,4,0,9,mixedType,1
1,8,0,9,mixedType,1
8,1,0,9,mixedType,1
3,6,0,9,mixedType,1
9,2,0,11,mixedType,1
8,2,0,10,mixedType,1
1,7,0,8,mixedType,1
15,1,0,16,mixedType,2
8,2,0,10,mixedType,1
7,2,0,9,mixedType,1
7,2,0,9,mixedType,1
1,9,0,10,mixedType,1
6,3,0,9,mixedType,1
4,2,0,6,mixedType,0
7,3,0,10,mixedType,1
5,3,0,8,mixedType,1
2,6,0,8,mixedType,1
9,1,0,10,mixedType,1
4,2,0,6,mixedType,0
8,2,0,10,mixedType,1
4,6,0,10,mixedType,1
9,4,0,13,mixedType,1
8,1,0,9,mixedType,1
8,0,1,9,mixedType,1
5,3,0,8,mixedType,1
5,1,0,6,mixedType,0
5,2,0,7,mixedType,0
6,3,0,9,mixedType,1
13,3,0,16,mixedType,2
5,6,0,11,mixedType,1
4,4,0,8,mixedType,1
7,3,0,10,mixedType,1
7,3,0,10,mixedType,1
11,3,0,14,mixedType,2
14,2,0,16,mixedType,2
4,2,0,6,mixedType,0
7,4,0,11,mixedType,1
2,8,0,10,mixedType,1
3,5,0,8,mixedType,1
8,3,0,11,mixedType,1
4,6,0,10,mixedType,1
6,2,0,8,mixedType,1
1,9,0,10,mixedType,1
4,5,0,9,mixedType,1
7,3,0,10,mixedType,1
6,3,0,9,mixedType,1
7,3,0,10,mixedType,1
4,5,0,9,mixedType,1
6,6,0,12,mixedType,1
6,3,0,9,mixedType,1
7,3,0,10,mixedType,1
10,2,0,12,mixedType,1
7,3,0,10,mixedType,1
1,8,0,9,mixedType,1
3,3,0,6,mixedType,0
6,2,0,8,mixedType,1
5,3,0,8,mixedType,1
15,1,0,16,mixedType,2
8,2,0,10,mixedType,1
8,2,0,10,mixedType,1
6,3,0,9,mixedType,1
6,2,0,8,mixedType,1
4,6,0,10,mixedType,1
6,1,0,7,mixedType,0
4,4,0,8,mixedType,1
10,2,0,12,mixedType,1
5,2,0,7,mixedType,0
6,4,0,10,mixedType,1
6,3,0,9,mixedType,1
6,4,0,10,mixedType,1
15,1,0,16,mixedType,2
5,4,0,9,mixedType,1
7,2,0,9,mixedType,1
5,1,0,6,mixedType,0
8,1,0,9,mixedType,1
11,3,0,14,mixedType,2
6,3,0,9,mixedType,1
14,2,0,16,mixedType,2
14,2,0,16,mixedType,2
5,3,0,8,mixedType,1
4,2,0,6,mixedType,0
6,3,0,9,mixedType,1
3,3,0,6,mixedType,0
10,2,0,12,mixedType,1
14,2,0,16,mixedType,2
5,4,0,9,mixedType,1
3,6,0,9,mixedType,1
7,3,0,10,mixedType,1
5,2,0,7,mixedType,0
2,11,0,13,mixedType,1
13,3,0,16,mixedType,2
7,1,0,8,mixedType,1
3,6,0,9,mixedType,1
8,4,0,12,mixedType,1
4,2,0,6,mixedType,0
5,3,0,8,mixedType,1
7,3,0,10,mixedType,1
7,1,0,8,mixedType,1
6,3,0,9,mixedType,1
9,1,0,10,mixedType,1
3,7,0,10,mixedType,1
4,2,0,6,mixedType,0
7,1,0,8,mixedType,1
1,8,0,9,mixedType,1
8,1,0,9,mixedType,1
9,1,0,10,mixedType,1
13,3,0,16,mixedType,2
7,1,0,8,mixedType,1
4,2,0,6,mixedType,0
12,3,0,15,mixedType,2
7,6,0,13,mixedType,1
13,3,0,16,mixedType,2
2,6,0,8,mixedType,1
8,1,0,9,mixedType,1
6,2,0,8,mixedType,1
3,6,0,9,mixedType,1
7,1,0,8,mixedType,1
5,2,0,7,mixedType,0
4,2,0,6,mixedType,0
5,3,0,8,mixedType,1
6,2,0,8,mixedType,1
7,4,0,11,mixedType,1
8,2,0,10,mixedType,1
1,9,0,10,mixedType,1
7,2,0,9,mixedType,1
9,2,0,11,mixedType,1
4,2,0,6,mixedType,0
11,2,0,13,mixedType,1
9,1,0,10,mixedType,1
3,8,0,11,mixedType,1
4,2,0,6,mixedType,0
10,2,0,12,mixedType,1
6,3,0,9,mixedType,1
6,4,0,10,mixedType,1
4,6,0,10,mixedType,1
13,3,0,16,mixedType,2
3,3,0,6,mixedType,0
4,4,0,8,mixedType,1
6,3,0,9,mixedType,1
5,2,0,7,mixedType,0
2,8,0,10,mixedType,1
7,3,0,10,mixedType,1
9,1,0,10,mixedType,1
10,6,0,16,mixedType,2
15,1,0,16,mixedType,2
5,2,0,7,mixedType,0
4,2,0,6,mixedType,0
6,3,0,9,mixedType,1
10,3,0,13,mixedType,1
7,3,0,10,mixedType,1
8,2,0,10,mixedType,1
5,3,0,8,mixedType,1
8,3,0,11,mixedType,1
9,3,0,12,mixedType,1
9,2,0,11,mixedType,1
5,3,0,8,mixedType,1
7,1,0,8,mixedType,1
7,2,0,9,mixedType,1
6,3,0,9,mixedType,1
6,3,0,9,mixedType,1
5,2,0,7,mixedType,0
12,3,0,15,mixedType,2
6,6,0,12,mixedType,1
8,4,0,12,mixedType,1
5,1,0,6,mixedType,0
19,4,1,24,mixedType,2
8,3,0,11,mixedType,1
7,3,0,10,mixedType,1
3,6,0,9,mixedType,1
9,1,0,10,mixedType,1
6,2,0,8,mixedType,1
8,1,0,9,mixedType,1
9,1,0,10,mixedType,1
4,5,0,9,mixedType,1
5,7,0,12,mixedType,1
12,3,0,15,mixedType,2
5,4,0,9,mixedType,1
7,2,0,9,mixedType,1
5,3,0,8,mixedType,1
5,1,0,6,mixedType,0
8,2,0,10,mixedType,1
2,6,0,8,mixedType,1
7,3,0,10,mixedType,1
7,3,0,10,mixedType,1
9,6,0,15,mixedType,2
9,3,0,12,mixedType,1
5,1,0,6,mixedType,0
12,3,0,15,mixedType,2
8,3,0,11,mixedType,1
9,4,0,13,mixedType,1
4,4,0,8,mixedType,1
6,3,0,9,mixedType,1
6,3,0,9,mixedType,1
9,3,0,12,mixedType,1
6,1,0,7,mixedType,0
2,4,0,6,mixedType,0
5,2,0,7,mixedType,0
7,3,0,10,mixedType,1
5,6,0,11,mixedType,1
6,2,0,8,mixedType,1
2,6,0,8,mixedType,1
6,4,0,10,mixedType,1
7,1,0,8,mixedType,1
5,4,0,9,mixedType,1
5,3,0,8,mixedType,1
14,8,0,22,mixedType,2
4,2,0,6,mixedType,0
1,11,0,12,mixedType,1
4,4,0,8,mixedType,1
6,2,0,8,mixedType,1
9,1,0,10,mixedType,1
9,1,0,10,mixedType,1
7,1,0,8,mixedType,1
7,3,0,10,mixedType,1
4,5,0,9,mixedType,1
4,9,0,13,mixedType,1
7,4,0,11,mixedType,1
10,1,0,11,mixedType,1
3,6,0,9,mixedType,1
7,11,0,18,mixedType,2
8,2,0,10,mixedType,1
10,2,0,12,mixedType,1
7,2,0,9,mixedType,1
2,9,0,11,mixedType,1
2,7,0,9,mixedType,1
1,8,0,9,mixedType,1
4,2,0,6,mixedType,0
15,1,0,16,mixedType,2
6,3,0,9,mixedType,1
13,3,0,16,mixedType,2
1,10,0,11,mixedType,1
7,3,0,10,mixedType,1
6,5,0,11,mixedType,1
7,3,0,10,mixedType,1
7,3,0,10,mixedType,1
5,3,0,8,mixedType,1
4,4,0,8,mixedType,1
15,1,0,16,mixedType,2
3,6,0,9,mixedType,1
14,2,0,16,mixedType,2
7,3,0,10,mixedType,1
8,4,0,12,mixedType,1
11,3,0,14,mixedType,2
6,1,0,7,mixedType,0
14,1,0,15,mixedType,2
3,7,0,10,mixedType,1
6,1,0,7,mixedType,0
6,6,0,12,mixedType,1
10,1,0,11,mixedType,1
7,3,0,10,mixedType,1
5,3,0,8,mixedType,1
7,3,0,10,mixedType,1
7,3,0,10,mixedType,1
5,2,0,7,mixedType,0
7,2,0,9,mixedType,1
14,2,0,16,mixedType,2
3,6,0,9,mixedType,1
2,7,0,9,mixedType,1
4,2,0,6,mixedType,0
9,2,0,11,mixedType,1
3,6,0,9,mixedType,1
13,3,0,16,mixedType,2
7,2,0,9,mixedType,1
4,2,0,6,mixedType,0
12,1,0,13,mixedType,1
5,2,0,7,mixedType,0
4,2,0,6,mixedType,0
6,3,0,9,mixedType,1
8,1,0,9,mixedType,1
5,2,0,7,mixedType,0
14,2,0,16,mixedType,2
8,2,0,10,mixedType,1
6,3,0,9,mixedType,1
5,2,0,7,mixedType,0
6,7,0,13,mixedType,1
4,2,0,6,mixedType,0
1,8,0,9,mixedType,1
4,2,0,6,mixedType,0
11,5,0,16,mixedType,2
8,1,0,9,mixedType,1
4,2,0,6,mixedType,0
7,4,0,11,mixedType,1
8,1,0,9,mixedType,1
2,8,0,10,mixedType,1
7,1,0,8,mixedType,1
15,1,0,16,mixedType,2
18,1,1,20,mixedType,2
6,3,0,9,mixedType,1
5,8,0,13,mixedType,1
4,4,0,8,mixedType,1
6,2,0,8,mixedType,1
6,3,0,9,mixedType,1
7,3,0,10,mixedType,1
7,2,0,9,mixedType,1
6,1,0,7,mixedType,0
2,7,0,9,mixedType,1
5,4,0,9,mixedType,1
1,7,0,8,mixedType,1
6,2,0,8,mixedType,1
5,3,0,8,mixedType,1
8,2,0,10,mixedType,1
6,1,0,7,mixedType,0
8,2,0,10,mixedType,1
5,3,0,8,mixedType,1
7,4,0,11,mixedType,1
5,2,0,7,mixedType,0
3,6,0,9,mixedType,1
2,6,0,8,mixedType,1
10,3,0,13,mixedType,1
16,4,0,20,mixedType,2
7,4,0,11,mixedType,1
11,2,0,13,mixedType,1
7,2,0,9,mixedType,1
12,4,0,16,mixedType,2
6,2,0,8,mixedType,1
3,6,0,9,mixedType,1
15,1,0,16,mixedType,2
7,2,0,9,mixedType,1
6,3,0,9,mixedType,1
7,1,0,8,mixedType,1
7,2,0,9,mixedType,1
4,6,0,10,mixedType,1
8,1,0,9,mixedType,1
5,5,0,10,mixedType,1
6,4,0,10,mixedType,1
11,3,0,14,mixedType,2
14,2,0,16,mixedType,2
8,1,0,9,mixedType,1
6,3,0,9,mixedType,1
8,1,0,9,mixedType,1
2,4,0,6,mixedType,0
5,3,0,8,mixedType,1
13,3,0,16,mixedType,2
8,2,0,10,mixedType,1
5,3,0,8,mixedType,1
4,2,0,6,mixedType,0
5,3,0,8,mixedType,1
8,3,0,11,mixedType,1
8,2,0,10,mixedType,1
8,1,0,9,mixedType,1
2,6,0,8,mixedType,1
4,2,0,6,mixedType,0
7,1,0,8,mixedType,1
13,3,0,16,mixedType,2
4,6,0,10,mixedType,1
4,6,0,10,mixedType,1
3,7,0,10,mixedType,1
8,1,0,9,mixedType,1
9,2,0,11,mixedType,1
5,1,0,6,mixedType,0
11,3,0,14,mixedType,2
4,6,0,10,mixedType,1
4,4,0,8,mixedType,1
12,4,0,16,mixedType,2
7,2,0,9,mixedType,1
9,1,0,10,mixedType,1
13,3,0,16,mixedType,2
5,2,0,7,mixedType,0
5,6,0,11,mixedType,1
8,2,0,10,mixedType,1
7,2,0,9,mixedType,1
13,3,0,16,mixedType,2
7,1,0,8,mixedType,1
9,4,0,13,mixedType,1
2,6,0,8,mixedType,1
6,4,0,10,mixedType,1
9,2,0,11,mixedType,1
6,3,0,9,mixedType,1
5,3,0,8,mixedType,1
7,4,0,11,mixedType,1
5,2,0,7,mixedType,0
6,3,0,9,mixedType,1
8,3,0,11,mixedType,1
3,6,0,9,mixedType,1
4,2,0,6,mixedType,0
2,6,0,8,mixedType,1
9,1,0,10,mixedType,1
5,3,0,8,mixedType,1
6,3,0,9,mixedType,1
7,2,0,9,mixedType,1
9,1,0,10,mixedType,1
8,0,3,11,mixedType,1
1,9,0,10,mixedType,1
1,8,0,9,mixedType,1
13,3,0,16,mixedType,2
6,3,0,9,mixedType,1
6,2,0,8,mixedType,1
7,3,0,10,mixedType,1
6,3,0,9,mixedType,1
5,1,0,6,mixedType,0
9,2,0,11,mixedType,1
12,4,0,16,mixedType,2
4,2,0,6,mixedType,0
7,3,0,10,mixedType,1
7,2,0,9,mixedType,1
1,7,0,8,mixedType,1
9,3,0,12,mixedType,1
7,2,0,9,mixedType,1
5,2,0,7,mixedType,0
7,1,0,8,mixedType,1
6,3,0,9,mixedType,1
6,1,0,7,mixedType,0
6,6,0,12,mixedType,1
6,1,0,7,mixedType,0
6,7,0,13,mixedType,1
7,3,0,10,mixedType,1
7,2,0,9,mixedType,1
13,3,0,16,mixedType,2
7,3,0,10,mixedType,1
19,2,0,21,mixedType,2
14,2,0,16,mixedType,2
6,1,0,7,mixedType,0
8,2,0,10,mixedType,1
1,8,0,9,mixedType,1
3,7,0,10,mixedType,1
2,8,0,10,mixedType,1
7,3,0,10,mixedType,1
14,2,0,16,mixedType,2
7,2,0,9,mixedType,1
6,4,0,10,mixedType,1
9,2,0,11,mixedType,1
5,3,0,8,mixedType,1
6,3,0,9,mixedType,1
6,4,0,10,mixedType,1
2,6,0,8,mixedType,1
10,3,0,13,mixedType,1
6,3,0,9,mixedType,1
8,3,0,11,mixedType,1
5,1,0,6,mixedType,0
10,3,1,14,mixedType,2
5,3,0,8,mixedType,1
6,6,0,12,mixedType,1
8,2,0,10,mixedType,1
4,7,0,11,mixedType,1
1,8,0,9,mixedType,1
9,1,0,10,mixedType,1
6,2,0,8,mixedType,1
8,1,0,9,mixedType,1
8,2,0,10,mixedType,1
3,10,0,13,mixedType,1
7,3,0,10,mixedType,1
5,6,0,11,mixedType,1
4,2,0,6,mixedType,0
7,3,0,10,mixedType,1
5,3,0,8,mixedType,1
3,6,0,9,mixedType,1
4,6,0,10,mixedType,1
6,3,0,9,mixedType,1
6,2,0,8,mixedType,1
5,3,0,8,mixedType,1
7,3,0,10,mixedType,1
5,2,0,7,mixedType,0
7,3,0,10,mixedType,1
5,2,0,7,mixedType,0
6,6,0,12,mixedType,1
5,1,0,6,mixedType,0
11,5,0,16,mixedType,2
5,4,0,9,mixedType,1
10,2,0,12,mixedType,1
6,1,0,7,mixedType,0
5,3,0,8,mixedType,1
6,3,0,9,mixedType,1
6,4,0,10,mixedType,1
6,1,0,7,mixedType,0
8,1,0,9,mixedType,1
9,2,0,11,mixedType,1
3,5,0,8,mixedType,1
6,3,0,9,mixedType,1
6,1,0,7,mixedType,0
7,2,0,9,mixedType,1
7,2,0,9,mixedType,1
8,4,0,12,mixedType,1
5,2,0,7,mixedType,0
1,8,0,9,mixedType,1
4,6,0,10,mixedType,1
4,2,0,6,mixedType,0
6,4,0,10,mixedType,1
6,3,0,9,mixedType,1
7,2,0,9,mixedType,1
8,1,0,9,mixedType,1
6,3,0,9,mixedType,1
12,4,0,16,mixedType,2
12,3,0,15,mixedType,2
5,2,0,7,mixedType,0
1,8,0,9,mixedType,1
5,4,0,9,mixedType,1
6,1,0,7,mixedType,0
3,6,0,9,mixedType,1
6,3,0,9,mixedType,1
14,2,0,16,mixedType,2
7,3,0,10,mixedType,1
14,2,0,16,mixedType,2
6,3,0,9,mixedType,1
4,4,0,8,mixedType,1
6,2,0,8,mixedType,1
6,3,0,9,mixedType,1
4,4,0,8,mixedType,1
6,1,0,7,mixedType,0
7,4,0,11,mixedType,1
6,3,0,9,mixedType,1
9,3,0,12,mixedType,1
6,2,0,8,mixedType,1
5,4,0,9,mixedType,1
4,2,0,6,mixedType,0
13,3,0,16,mixedType,2
2,8,0,10,mixedType,1
5,4,0,9,mixedType,1
5,4,0,9,mixedType,1
2,6,0,8,mixedType,1
6,2,0,8,mixedType,1
6,2,0,8,mixedType,1
6,4,0,10,mixedType,1
6,1,0,7,mixedType,0
5,4,0,9,mixedType,1
9,1,0,10,mixedType,1
1,10,0,11,mixedType,1
7,3,0,10,mixedType,1
1,7,0,8,mixedType,1
3,9,0,12,mixedType,1
12,0,1,13,mixedType,1
3,9,0,12,mixedType,1
5,3,0,8,mixedType,1
15,1,0,16,mixedType,2
9,3,0,12,mixedType,1
9,1,0,10,mixedType,1
7,1,0,8,mixedType,1
8,2,0,10,mixedType,1
4,2,0,6,mixedType,0
6,1,0,7,mixedType,0
6,4,0,10,mixedType,1
6,2,0,8,mixedType,1
12,4,0,16,mixedType,2
3,9,0,12,mixedType,1
4,4,0,8,mixedType,1
6,3,0,9,mixedType,1
6,4,0,10,mixedType,1
6,4,0,10,mixedType,1
9,1,0,10,mixedType,1
8,0,1,9,mixedType,1
6,3,0,9,mixedType,1
6,3,0,9,mixedType,1
12,4,0,16,mixedType,2
7,2,0,9,mixedType,1
6,2,0,8,mixedType,1
9,0,1,10,mixedType,1
16,1,1,18,mixedType,2
8,4,0,12,mixedType,1
6,1,0,7,mixedType,0
2,10,0,12,mixedType,1
8,3,0,11,mixedType,1
11,2,0,13,mixedType,1
13,3,0,16,mixedType,2
6,6,0,12,mixedType,1
15,1,0,16,mixedType,2
8,2,0,10,mixedType,1
2,4,0,6,mixedType,0
8,3,0,11,mixedType,1
14,4,1,19,mixedType,2
8,1,0,9,mixedType,1
8,1,0,9,mixedType,1
5,1,0,6,mixedType,0
8,6,0,14,mixedType,2
5,4,0,9,mixedType,1
1,8,0,9,mixedType,1
8,3,0,11,mixedType,1
5,4,0,9,mixedType,1
8,2,0,10,mixedType,1
13,3,0,16,mixedType,2
4,4,0,8,mixedType,1
3,8,0,11,mixedType,1
3,5,0,8,mixedType,1
13,3,0,16,mixedType,2
3,7,0,10,mixedType,1
6,2,0,8,mixedType,1
8,4,0,12,mixedType,1
4,4,0,8,mixedType,1
2,6,0,8,mixedType,1
1,8,0,9,mixedType,1
6,3,0,9,mixedType,1
7,4,0,11,mixedType,1
5,2,0,7,mixedType,0
6,2,0,8,mixedType,1
6,2,0,8,mixedType,1
6,4,0,10,mixedType,1
5,2,0,7,mixedType,0
7,2,0,9,mixedType,1
9,1,0,10,mixedType,1
5,3,0,8,mixedType,1
4,4,0,8,mixedType,1
11,5,0,16,mixedType,2
3,7,0,10,mixedType,1
4,4,0,8,mixedType,1
5,2,0,7,mixedType,0
7,2,0,9,mixedType,1
8,1,0,9,mixedType,1
6,3,0,9,mixedType,1
9,1,0,10,mixedType,1
15,1,0,16,mixedType,2
5,2,0,7,mixedType,0
6,3,0,9,mixedType,1
7,2,0,9,mixedType,1
4,2,0,6,mixedType,0
1,8,0,9,mixedType,1
10,4,0,14,mixedType,2
14,2,0,16,mixedType,2
8,2,0,10,mixedType,1
4,2,0,6,mixedType,0
6,1,0,7,mixedType,0
6,3,0,9,mixedType,1
10,2,0,12,mixedType,1
9,2,0,11,mixedType,1
3,6,0,9,mixedType,1
5,3,0,8,mixedType,1
6,6,0,12,mixedType,1
9,1,0,10,mixedType,1
8,3,0,11,mixedType,1
8,1,0,9,mixedType,1
5,2,0,7,mixedType,0
6,5,0,11,mixedType,1
5,1,0,6,mixedType,0
4,4,0,8,mixedType,1
8,2,0,10,mixedType,1
6,1,0,7,mixedType,0
7,1,0,8,mixedType,1
7,2,0,9,mixedType,1
4,2,0,6,mixedType,0
6,3,0,9,mixedType,1
5,1,0,6,mixedType,0
6,1,0,7,mixedType,0
7,2,0,9,mixedType,1
15,1,0,16,mixedType,2
6,3,0,9,mixedType,1
7,2,0,9,mixedType,1
3,7,0,10,mixedType,1
7,1,0,8,mixedType,1
7,3,0,10,mixedType,1
6,7,0,13,mixedType,1
7,3,0,10,mixedType,1
9,2,0,11,mixedType,1
6,1,0,7,mixedType,0
3,3,0,6,mixedType,0
6,4,0,10,mixedType,1
7,2,0,9,mixedType,1
7,1,0,8,mixedType,1
5,4,0,9,mixedType,1
8,2,0,10,mixedType,1
6,1,0,7,mixedType,0
1,8,0,9,mixedType,1
10,2,0,12,mixedType,1
9,3,0,12,mixedType,1
7,1,0,8,mixedType,1
12,4,0,16,mixedType,2
6,3,0,9,mixedType,1
8,4,0,12,mixedType,1
6,3,0,9,mixedType,1
8,1,0,9,mixedType,1
6,3,0,9,mixedType,1
5,4,0,9,mixedType,1
5,4,0,9,mixedType,1
8,4,0,12,mixedType,1
6,6,2,14,mixedType,2
15,1,0,16,mixedType,2
5,3,0,8,mixedType,1
13,3,0,16,mixedType,2
9,0,1,10,mixedType,1
8,1,0,9,mixedType,1
3,8,0,11,mixedType,1
6,1,0,7,mixedType,0
9,1,0,10,mixedType,1
4,4,0,8,mixedType,1
5,3,0,8,mixedType,1
8,2,0,10,mixedType,1
12,1,0,13,mixedType,1
3,6,0,9,mixedType,1
9,3,0,12,mixedType,1
7,3,0,10,mixedType,1
1,8,0,9,mixedType,1
6,4,0,10,mixedType,1
6,3,0,9,mixedType,1
4,2,0,6,mixedType,0
2,7,0,9,mixedType,1
13,3,0,16,mixedType,2
13,3,0,16,mixedType,2
5,2,0,7,mixedType,0
8,4,0,12,mixedType,1
8,2,0,10,mixedType,1
5,3,0,8,mixedType,1
11,5,0,16,mixedType,2
6,1,0,7,mixedType,0
5,3,0,8,mixedType,1
2,6,0,8,mixedType,1
9,2,0,11,mixedType,1
4,6,0,10,mixedType,1
7,2,0,9,mixedType,1
5,2,0,7,mixedType,0
14,2,0,16,mixedType,2
6,3,0,9,mixedType,1
8,4,0,12,mixedType,1
1,8,0,9,mixedType,1
1,9,0,10,mixedType,1
8,2,0,10,mixedType,1
6,2,0,8,mixedType,1
7,3,0,10,mixedType,1
5,3,0,8,mixedType,1
12,4,0,16,mixedType,2
5,3,0,8,mixedType,1
6,2,0,8,mixedType,1
8,3,0,11,mixedType,1
8,1,0,9,mixedType,1
8,1,0,9,mixedType,1
5,3,0,8,mixedType,1
4,2,0,6,mixedType,0
5,2,0,7,mixedType,0
4,4,0,8,mixedType,1
9,1,0,10,mixedType,1
4,5,0,9,mixedType,1
5,4,0,9,mixedType,1
13,3,0,16,mixedType,2
7,4,0,11,mixedType,1
6,2,0,8,mixedType,1
14,2,1,17,mixedType,2
7,3,0,10,mixedType,1
13,3,0,16,mixedType,2
1,6,0,7,mixedType,0
6,3,0,9,mixedType,1
7,3,0,10,mixedType,1
6,1,0,7,mixedType,0
1,10,0,11,mixedType,1
7,2,0,9,mixedType,1
9,1,0,10,mixedType,1
2,6,0,8,mixedType,1
5,1,0,6,mixedType,0
5,2,0,7,mixedType,0
1,8,0,9,mixedType,1
8,2,0,10,mixedType,1
7,2,0,9,mixedType,1
4,5,0,9,mixedType,1
6,3,0,9,mixedType,1
2,4,0,6,mixedType,0
7,3,0,10,mixedType,1
11,3,0,14,mixedType,2
7,1,0,8,mixedType,1
11,5,0,16,mixedType,2
6,2,0,8,mixedType,1
5,4,0,9,mixedType,1
5,4,0,9,mixedType,1
5,4,0,9,mixedType,1
4,5,0,9,mixedType,1
6,3,0,9,mixedType,1
5,2,0,7,mixedType,0
9,2,0,11,mixedType,1
5,2,0,7,mixedType,0
8,4,0,12,mixedType,1
6,3,0,9,mixedType,1
6,5,0,11,mixedType,1
7,3,0,10,mixedType,1
9,1,0,10,mixedType,1
11,5,0,16,mixedType,2
15,1,0,16,mixedType,2
4,6,0,10,mixedType,1
7,2,0,9,mixedType,1
7,2,0,9,mixedType,1
6,3,0,9,mixedType,1
5,2,0,7,mixedType,0
5,2,0,7,mixedType,0
8,4,0,12,mixedType,1
5,1,0,6,mixedType,0
2,4,0,6,mixedType,0
5,2,0,7,mixedType,0
4,6,0,10,mixedType,1
6,2,0,8,mixedType,1
7,3,0,10,mixedType,1
8,4,0,12,mixedType,1
3,6,0,9,mixedType,1
10,1,0,11,mixedType,1
2,10,0,12,mixedType,1
4,4,0,8,mixedType,1
6,6,0,12,mixedType,1
6,1,0,7,mixedType,0
5,6,0,11,mixedType,1
7,2,0,9,mixedType,1
6,4,0,10,mixedType,1
8,1,0,9,mixedType,1
4,4,0,8,mixedType,1
8,3,0,11,mixedType,1
6,2,0,8,mixedType,1
9,1,0,10,mixedType,1
4,2,0,6,mixedType,0
8,1,0,9,mixedType,1
9,4,0,13,mixedType,1
14,2,0,16,mixedType,2
7,1,0,8,mixedType,1
8,1,0,9,mixedType,1
6,3,0,9,mixedType,1
5,3,0,8,mixedType,1
8,2,0,10,mixedType,1
1,9,0,10,mixedType,1
8,1,0,9,mixedType,1
5,3,0,8,mixedType,1
8,1,0,9,mixedType,1
12,4,0,16,mixedType,2
13,3,0,16,mixedType,2
2,4,0,6,mixedType,0
7,1,0,8,mixedType,1
6,4,0,10,mixedType,1
6,1,0,7,mixedType,0
5,5,0,10,mixedType,1
7,3,0,10,mixedType,1
5,3,0,8,mixedType,1
9,2,0,11,mixedType,1
4,4,0,8,mixedType,1
15,1,0,16,mixedType,2
9,3,0,12,mixedType,1
2,8,0,10,mixedType,1
6,3,0,9,mixedType,1
6,3,0,9,mixedType,1
10,1,0,11,mixedType,1
4,2,0,6,mixedType,0
6,4,0,10,mixedType,1
3,6,0,9,mixedType,1
7,3,0,10,mixedType,1
7,3,0,10,mixedType,1
3,6,0,9,mixedType,1
6,1,0,7,mixedType,0
4,4,0,8,mixedType,1
7,3,0,10,mixedType,1
5,3,0,8,mixedType,1
8,2,0,10,mixedType,1
2,11,0,13,mixedType,1
9,1,0,10,mixedType,1
6,1,0,7,mixedType,0
6,4,0,10,mixedType,1
2,8,0,10,mixedType,1
3,5,0,8,mixedType,1
5,8,2,15,mixedType,2
2,8,0,10,mixedType,1
10,3,0,13,mixedType,1
8,1,0,9,mixedType,1
9,1,0,10,mixedType,1
5,3,0,8,mixedType,1
9,1,0,10,mixedType,1
6,3,0,9,mixedType,1
9,4,1,14,mixedType,2
6,2,0,8,mixedType,1
7,8,1,16,mixedType,2
7,0,0,7,sameType,0
8,3,0,11,mixedType,1
6,7,0,13,mixedType,1
13,3,0,16,mixedType,2
4,2,0,6,mixedType,0
8,3,0,11,mixedType,1
9,2,0,11,mixedType,1
7,2,0,9,mixedType,1
5,1,0,6,mixedType,0
4,6,0,10,mixedType,1
3,3,0,6,mixedType,0
3,3,0,6,mixedType,0
6,2,0,8,mixedType,1
5,2,0,7,mixedType,0
6,2,0,8,mixedType,1
7,2,0,9,mixedType,1
4,2,0,6,mixedType,0
7,1,0,8,mixedType,1
7,3,0,10,mixedType,1
1,8,0,9,mixedType,1
14,2,0,16,mixedType,2
7,1,0,8,mixedType,1
6,4,0,10,mixedType,1
6,2,0,8,mixedType,1
6,3,0,9,mixedType,1
4,2,0,6,mixedType,0
6,3,0,9,mixedType,1
6,7,0,13,mixedType,1
8,1,0,9,mixedType,1
6,3,0,9,mixedType,1
13,3,0,16,mixedType,2
7,2,0,9,mixedType,1
8,2,0,10,mixedType,1
8,1,0,9,mixedType,1
7,4,0,11,mixedType,1
15,1,0,16,mixedType,2
6,4,0,10,mixedType,1
5,1,0,6,mixedType,0
5,7,0,12,mixedType,1
5,4,0,9,mixedType,1
5,4,0,9,mixedType,1
4,4,0,8,mixedType,1
3,9,0,12,mixedType,1
8,1,0,9,mixedType,1
5,2,0,7,mixedType,0
9,1,0,10,mixedType,1
6,1,0,7,mixedType,0
5,3,0,8,mixedType,1
9,5,1,15,mixedType,2
8,2,0,10,mixedType,1
16,1,0,17,mixedType,2
8,2,0,10,mixedType,1
8,5,0,13,mixedType,1
6,4,0,10,mixedType,1
9,1,0,10,mixedType,1
12,3,0,15,mixedType,2
6,4,0,10,mixedType,1
7,3,0,10,mixedType,1
6,1,0,7,mixedType,0
1,8,0,9,mixedType,1
6,3,0,9,mixedType,1
7,3,0,10,mixedType,1
6,4,0,10,mixedType,1
8,2,0,10,mixedType,1
5,2,0,7,mixedType,0
7,2,0,9,mixedType,1
6,5,0,11,mixedType,1
11,3,0,14,mixedType,2
8,2,0,10,mixedType,1
6,3,0,9,mixedType,1
6,6,0,12,mixedType,1
10,1,0,11,mixedType,1
6,4,0,10,mixedType,1
6,1,0,7,mixedType,0
7,3,0,10,mixedType,1
4,6,0,10,mixedType,1
7,1,0,8,mixedType,1
6,1,0,7,mixedType,0
9,1,0,10,mixedType,1
4,2,0,6,mixedType,0
5,2,0,7,mixedType,0
6,3,0,9,mixedType,1
9,1,0,10,mixedType,1
5,4,0,9,mixedType,1
4,2,0,6,mixedType,0
9,1,0,10,mixedType,1
9,1,0,10,mixedType,1
15,1,0,16,mixedType,2
8,2,0,10,mixedType,1
7,3,0,10,mixedType,1
14,2,0,16,mixedType,2
4,0,3,7,mixedType,0
7,2,0,9,mixedType,1
8,4,0,12,mixedType,1
7,3,0,10,mixedType,1
6,3,0,9,mixedType,1
5,2,0,7,mixedType,0
7,4,0,11,mixedType,1
11,1,0,12,mixedType,1
7,4,0,11,mixedType,1
6,2,0,8,mixedType,1
14,2,0,16,mixedType,2
8,2,0,10,mixedType,1
8,2,0,10,mixedType,1
8,3,0,11,mixedType,1
13,3,0,16,mixedType,2
14,2,0,16,mixedType,2
5,2,0,7,mixedType,0
9,0,1,10,mixedType,1
14,2,0,16,mixedType,2
9,1,0,10,mixedType,1
5,2,0,7,mixedType,0
4,2,0,6,mixedType,0
5,2,0,7,mixedType,0
5,6,0,11,mixedType,1
14,2,0,16,mixedType,2
1,8,0,9,mixedType,1
7,1,0,8,mixedType,1
11,2,0,13,mixedType,1
6,1,0,7,mixedType,0
6,1,0,7,mixedType,0
7,3,0,10,mixedType,1
5,1,0,6,mixedType,0
4,6,0,10,mixedType,1
6,1,0,7,mixedType,0
7,3,0,10,mixedType,1
8,2,0,10,mixedType,1
12,3,0,15,mixedType,2
7,3,0,10,mixedType,1
1,7,0,8,mixedType,1
9,5,0,14,mixedType,2
4,7,0,11,mixedType,1
7,3,0,10,mixedType,1
6,3,0,9,mixedType,1
5,1,0,6,mixedType,0
12,4,0,16,mixedType,2
9,3,0,12,mixedType,1
7,3,0,10,mixedType,1
6,1,0,7,mixedType,0
4,6,0,10,mixedType,1
4,2,0,6,mixedType,0
11,4,0,15,mixedType,2
5,3,0,8,mixedType,1
1,7,0,8,mixedType,1
4,6,0,10,mixedType,1
8,1,0,9,mixedType,1
10,1,0,11,mixedType,1
5,3,0,8,mixedType,1
2,7,0,9,mixedType,1
2,10,0,12,mixedType,1
5,3,0,8,mixedType,1
5,4,0,9,mixedType,1
2,7,0,9,mixedType,1
6,3,0,9,mixedType,1
9,3,0,12,mixedType,1
2,6,0,8,mixedType,1
2,6,0,8,mixedType,1
6,3,0,9,mixedType,1
11,5,0,16,mixedType,2
14,2,0,16,mixedType,2
8,2,0,10,mixedType,1
9,3,0,12,mixedType,1
6,3,0,9,mixedType,1
6,1,0,7,mixedType,0
11,2,0,13,mixedType,1
6,3,0,9,mixedType,1
7,2,0,9,mixedType,1
2,8,0,10,mixedType,1
5,2,0,7,mixedType,0
5,3,0,8,mixedType,1
5,3,0,8,mixedType,1
5,2,0,7,mixedType,0
8,1,0,9,mixedType,1
9,1,0,10,mixedType,1
9,3,0,12,mixedType,1
10,4,0,14,mixedType,2
4,6,0,10,mixedType,1
11,0,1,12,mixedType,1
11,5,0,16,mixedType,2
12,4,0,16,mixedType,2
2,6,0,8,mixedType,1
7,3,0,10,mixedType,1
8,2,0,10,mixedType,1
9,2,0,11,mixedType,1
1,11,0,12,mixedType,1
8,2,0,10,mixedType,1
7,3,0,10,mixedType,1
5,3,0,8,mixedType,1
7,2,0,9,mixedType,1
1,8,0,9,mixedType,1
13,3,0,16,mixedType,2
4,6,0,10,mixedType,1
5,4,0,9,mixedType,1
13,3,0,16,mixedType,2
7,3,0,10,mixedType,1
4,4,0,8,mixedType,1
11,5,0,16,mixedType,2
4,4,0,8,mixedType,1
7,3,0,10,mixedType,1
5,4,0,9,mixedType,1
11,5,0,16,mixedType,2
14,2,0,16,mixedType,2
14,2,0,16,mixedType,2
3,3,0,6,mixedType,0
6,5,0,11,mixedType,1
5,0,1,6,mixedType,0
9,2,0,11,mixedType,1
6,2,0,8,mixedType,1
9,2,0,11,mixedType,1
6,3,0,9,mixedType,1
5,3,0,8,mixedType,1
7,3,0,10,mixedType,1
4,2,0,6,mixedType,0
8,2,0,10,mixedType,1
15,1,0,16,mixedType,2
7,3,0,10,mixedType,1
13,3,0,16,mixedType,2
7,4,0,11,mixedType,1
7,3,0,10,mixedType,1
5,4,0,9,mixedType,1
5,3,0,8,mixedType,1
10,3,0,13,mixedType,1
1,8,0,9,mixedType,1
3,6,0,9,mixedType,1
4,2,0,6,mixedType,0
13,2,2,17,mixedType,2
6,2,0,8,mixedType,1
10,3,0,13,mixedType,1
8,3,0,11,mixedType,1
5,7,0,12,mixedType,1
6,4,0,10,mixedType,1
6,1,0,7,mixedType,0
13,3,0,16,mixedType,2
2,4,0,6,mixedType,0
15,1,0,16,mixedType,2
7,1,0,8,mixedType,1
7,2,0,9,mixedType,1
5,3,0,8,mixedType,1
9,2,0,11,mixedType,1
15,1,0,16,mixedType,2
6,1,0,7,mixedType,0
5,4,0,9,mixedType,1
15,1,0,16,mixedType,2
4,2,0,6,mixedType,0
7,1,0,8,mixedType,1
9,3,0,12,mixedType,1
10,3,0,13,mixedType,1
6,3,0,9,mixedType,1
2,7,0,9,mixedType,1
9,3,3,15,mixedType,2
5,2,0,7,mixedType,0
9,3,0,12,mixedType,1
8,2,0,10,mixedType,1
5,4,0,9,mixedType,1
6,2,0,8,mixedType,1
7,1,0,8,mixedType,1
6,1,0,7,mixedType,0
6,4,0,10,mixedType,1
6,3,0,9,mixedType,1
6,3,0,9,mixedType,1
6,4,0,10,mixedType,1
7,4,0,11,mixedType,1
6,4,0,10,mixedType,1
6,3,0,9,mixedType,1
4,11,1,16,mixedType,2
1,9,0,10,mixedType,1
7,4,0,11,mixedType,1
6,2,0,8,mixedType,1
6,3,0,9,mixedType,1
4,5,0,9,mixedType,1
12,4,0,16,mixedType,2
14,2,0,16,mixedType,2
5,2,0,7,mixedType,0
7,2,0,9,mixedType,1
4,4,0,8,mixedType,1
2,6,0,8,mixedType,1
8,4,0,12,mixedType,1
5,2,0,7,mixedType,0
6,1,0,7,mixedType,0
2,8,0,10,mixedType,1
4,6,0,10,mixedType,1
3,5,0,8,mixedType,1
6,4,0,10,mixedType,1
5,3,0,8,mixedType,1
6,3,0,9,mixedType,1
6,4,0,10,mixedType,1
5,3,0,8,mixedType,1
6,3,0,9,mixedType,1
5,1,0,6,mixedType,0
6,1,0,7,mixedType,0
5,4,0,9,mixedType,1
15,1,0,16,mixedType,2
6,3,0,9,mixedType,1
4,4,0,8,mixedType,1
7,2,0,9,mixedType,1
4,4,0,8,mixedType,1
4,4,0,8,mixedType,1
7,2,0,9,mixedType,1
3,8,0,11,mixedType,1
8,2,0,10,mixedType,1
5,1,0,6,mixedType,0
6,2,0,8,mixedType,1
9,1,0,10,mixedType,1
11,3,0,14,mixedType,2
12,4,0,16,mixedType,2
5,2,0,7,mixedType,0
10,3,0,13,mixedType,1
6,4,0,10,mixedType,1
6,1,0,7,mixedType,0
12,4,0,16,mixedType,2
6,2,0,8,mixedType,1
5,4,0,9,mixedType,1
6,1,0,7,mixedType,0
12,4,0,16,mixedType,2
6,2,0,8,mixedType,1
5,4,0,9,mixedType,1
15,1,0,16,mixedType,2
8,1,0,9,mixedType,1
5,3,0,8,mixedType,1
8,4,0,12,mixedType,1
2,8,0,10,mixedType,1
5,4,0,9,mixedType,1
5,3,0,8,mixedType,1
14,2,0,16,mixedType,2
9,4,0,13,mixedType,1
2,6,0,8,mixedType,1
2,6,0,8,mixedType,1
6,2,0,8,mixedType,1
14,2,0,16,mixedType,2
4,2,0,6,mixedType,0
5,2,0,7,mixedType,0
6,3,0,9,mixedType,1
7,4,0,11,mixedType,1
5,3,0,8,mixedType,1
1,7,0,8,mixedType,1
8,2,0,10,mixedType,1
7,3,0,10,mixedType,1
5,4,0,9,mixedType,1
8,1,0,9,mixedType,1
7,1,0,8,mixedType,1
8,4,0,12,mixedType,1
3,6,0,9,mixedType,1
7,1,0,8,mixedType,1
6,1,0,7,mixedType,0
2,4,0,6,mixedType,0
10,4,0,14,mixedType,2
4,2,0,6,mixedType,0
11,2,0,13,mixedType,1
11,3,0,14,mixedType,2
5,4,0,9,mixedType,1
8,10,0,18,mixedType,2
7,2,0,9,mixedType,1
7,3,0,10,mixedType,1
1,8,0,9,mixedType,1
5,4,0,9,mixedType,1
14,2,0,16,mixedType,2
5,2,0,7,mixedType,0
4,4,0,8,mixedType,1
3,6,0,9,mixedType,1
7,3,0,10,mixedType,1
2,10,0,12,mixedType,1
5,2,0,7,mixedType,0
1,8,0,9,mixedType,1
4,3,0,7,mixedType,0
5,3,0,8,mixedType,1
7,1,0,8,mixedType,1
13,3,0,16,mixedType,2
5,2,0,7,mixedType,0
6,2,0,8,mixedType,1
6,4,0,10,mixedType,1
8,2,0,10,mixedType,1
4,6,0,10,mixedType,1
5,1,0,6,mixedType,0
9,2,0,11,mixedType,1
8,3,0,11,mixedType,1
6,2,0,8,mixedType,1
3,5,0,8,mixedType,1
6,4,0,10,mixedType,1
4,2,0,6,mixedType,0
15,1,1,17,mixedType,2
8,3,0,11,mixedType,1
12,1,0,13,mixedType,1
7,3,0,10,mixedType,1
8,3,0,11,mixedType,1
9,2,0,11,mixedType,1
5,3,0,8,mixedType,1
6,3,0,9,mixedType,1
4,2,0,6,mixedType,0
4,6,0,10,mixedType,1
2,4,0,6,mixedType,0
6,3,0,9,mixedType,1
4,4,0,8,mixedType,1
12,4,0,16,mixedType,2
4,2,0,6,mixedType,0
7,3,0,10,mixedType,1
7,2,0,9,mixedType,1
7,3,0,10,mixedType,1
2,7,0,9,mixedType,1
7,1,0,8,mixedType,1
4,2,0,6,mixedType,0
7,3,0,10,mixedType,1
8,1,0,9,mixedType,1
5,4,0,9,mixedType,1
1,7,0,8,mixedType,1
4,4,0,8,mixedType,1
8,1,0,9,mixedType,1
10,3,0,13,mixedType,1
4,2,0,6,mixedType,0
4,4,0,8,mixedType,1
7,1,0,8,mixedType,1
5,2,0,7,mixedType,0
3,7,0,10,mixedType,1
9,1,0,10,mixedType,1
9,3,0,12,mixedType,1
9,2,0,11,mixedType,1
6,4,0,10,mixedType,1
8,1,0,9,mixedType,1
15,1,0,16,mixedType,2
7,3,0,10,mixedType,1
8,2,0,10,mixedType,1
6,2,0,8,mixedType,1
9,2,0,11,mixedType,1
7,6,0,13,mixedType,1
8,1,0,9,mixedType,1
6,3,0,9,mixedType,1
9,2,0,11,mixedType,1
8,2,0,10,mixedType,1
2,9,0,11,mixedType,1
8,0,1,9,mixedType,1
0,9,1,10,mixedType,1
6,3,0,9,mixedType,1
7,3,0,10,mixedType,1
7,4,0,11,mixedType,1
7,2,0,9,mixedType,1
3,5,0,8,mixedType,1
2,8,0,10,mixedType,1
5,3,0,8,mixedType,1
8,1,0,9,mixedType,1
8,1,0,9,mixedType,1
3,6,0,9,mixedType,1
4,5,0,9,mixedType,1
6,1,0,7,mixedType,0
7,2,0,9,mixedType,1
7,4,0,11,mixedType,1
15,1,0,16,mixedType,2
7,2,0,9,mixedType,1
6,2,0,8,mixedType,1
6,3,0,9,mixedType,1
15,1,0,16,mixedType,2
4,2,0,6,mixedType,0
11,2,1,14,mixedType,2
6,1,0,7,mixedType,0
9,4,0,13,mixedType,1
11,3,0,14,mixedType,2
6,2,0,8,mixedType,1
6,2,0,8,mixedType,1
9,2,0,11,mixedType,1
7,3,0,10,mixedType,1
8,1,0,9,mixedType,1
5,3,0,8,mixedType,1
9,1,0,10,mixedType,1
14,2,0,16,mixedType,2
6,1,0,7,mixedType,0
9,4,0,13,mixedType,1
4,2,0,6,mixedType,0
10,2,0,12,mixedType,1
5,2,0,7,mixedType,0
9,4,0,13,mixedType,1
12,2,1,15,mixedType,2
10,3,0,13,mixedType,1
5,4,0,9,mixedType,1
11,4,0,15,mixedType,2
6,2,0,8,mixedType,1
14,1,0,15,mixedType,2
5,2,0,7,mixedType,0
6,3,0,9,mixedType,1
5,2,0,7,mixedType,0
7,3,0,10,mixedType,1
5,3,0,8,mixedType,1
7,2,0,9,mixedType,1
8,2,0,10,mixedType,1
8,1,0,9,mixedType,1
8,2,0,10,mixedType,1
6,3,0,9,mixedType,1
7,3,0,10,mixedType,1
5,5,0,10,mixedType,1
1,8,0,9,mixedType,1
6,1,0,7,mixedType,0
5,1,0,6,mixedType,0
8,2,0,10,mixedType,1
7,6,0,13,mixedType,1
7,2,0,9,mixedType,1
3,8,0,11,mixedType,1
4,6,0,10,mixedType,1
9,4,0,13,mixedType,1
13,3,0,16,mixedType,2
6,2,0,8,mixedType,1
8,4,0,12,mixedType,1
6,3,0,9,mixedType,1
5,3,0,8,mixedType,1
8,3,0,11,mixedType,1
3,6,0,9,mixedType,1
2,6,0,8,mixedType,1
4,2,0,6,mixedType,0
9,2,0,11,mixedType,1
6,4,0,10,mixedType,1
5,3,0,8,mixedType,1
13,3,0,16,mixedType,2
4,2,0,6,mixedType,0
2,6,0,8,mixedType,1
5,4,0,9,mixedType,1
6,3,0,9,mixedType,1
8,2,0,10,mixedType,1
5,5,0,10,mixedType,1
7,4,0,11,mixedType,1
5,2,0,7,mixedType,0
8,1,0,9,mixedType,1
3,3,0,6,mixedType,0
9,1,0,10,mixedType,1
4,2,0,6,mixedType,0
10,3,0,13,mixedType,1
7,3,0,10,mixedType,1
4,9,0,13,mixedType,1
4,6,0,10,mixedType,1
15,1,0,16,mixedType,2
13,3,0,16,mixedType,2
7,3,0,10,mixedType,1
15,1,0,16,mixedType,2
4,4,0,8,mixedType,1
2,8,0,10,mixedType,1
7,4,0,11,mixedType,1
7,2,0,9,mixedType,1
9,2,0,11,mixedType,1
5,2,0,7,mixedType,0
7,1,0,8,mixedType,1
7,3,0,10,mixedType,1
5,3,0,8,mixedType,1
6,3,0,9,mixedType,1
8,1,0,9,mixedType,1
5,4,0,9,mixedType,1
8,1,0,9,mixedType,1
7,4,0,11,mixedType,1
8,4,0,12,mixedType,1
6,2,0,8,mixedType,1
5,3,0,8,mixedType,1
6,6,0,12,mixedType,1
3,3,0,6,mixedType,0
4,5,0,9,mixedType,1
6,2,0,8,mixedType,1
9,4,0,13,mixedType,1
4,2,0,6,mixedType,0
7,3,0,10,mixedType,1
6,3,0,9,mixedType,1
6,1,0,7,mixedType,0
10,2,0,12,mixedType,1
5,3,0,8,mixedType,1
6,3,0,9,mixedType,1
8,1,0,9,mixedType,1
6,1,0,7,mixedType,0
5,1,0,6,mixedType,0
8,2,0,10,mixedType,1
9,1,0,10,mixedType,1
6,4,0,10,mixedType,1
6,2,0,8,mixedType,1
4,4,0,8,mixedType,1
6,2,0,8,mixedType,1
8,1,0,9,mixedType,1
13,3,0,16,mixedType,2
2,8,0,10,mixedType,1
14,2,0,16,mixedType,2
14,2,0,16,mixedType,2
6,1,0,7,mixedType,0
7,3,0,10,mixedType,1
8,1,0,9,mixedType,1
6,1,0,7,mixedType,0
5,5,0,10,mixedType,1
4,5,0,9,mixedType,1
7,3,0,10,mixedType,1
7,3,0,10,mixedType,1
6,4,0,10,mixedType,1
4,6,0,10,mixedType,1
3,8,0,11,mixedType,1
9,4,0,13,mixedType,1
14,2,0,16,mixedType,2
5,5,0,10,mixedType,1
3,6,0,9,mixedType,1
9,1,0,10,mixedType,1
14,2,0,16,mixedType,2
18,5,0,23,mixedType,2
7,3,0,10,mixedType,1
6,3,0,9,mixedType,1
6,2,0,8,mixedType,1
7,2,0,9,mixedType,1
8,2,0,10,mixedType,1
9,2,0,11,mixedType,1
5,1,0,6,mixedType,0
8,1,0,9,mixedType,1
5,2,0,7,mixedType,0
7,2,0,9,mixedType,1
7,1,0,8,mixedType,1
8,1,0,9,mixedType,1
7,3,0,10,mixedType,1
6,4,0,10,mixedType,1
6,2,0,8,mixedType,1
7,3,0,10,mixedType,1
8,1,0,9,mixedType,1
8,2,0,10,mixedType,1
9,3,0,12,mixedType,1
7,1,0,8,mixedType,1
4,6,0,10,mixedType,1
5,3,0,8,mixedType,1
6,3,0,9,mixedType,1
9,3,0,12,mixedType,1
7,1,0,8,mixedType,1
5,4,0,9,mixedType,1
10,0,1,11,mixedType,1
6,3,0,9,mixedType,1
5,3,0,8,mixedType,1
6,1,0,7,mixedType,0
5,1,0,6,mixedType,0
9,4,0,13,mixedType,1
3,7,0,10,mixedType,1
7,2,0,9,mixedType,1
6,6,0,12,mixedType,1
6,4,0,10,mixedType,1
7,1,0,8,mixedType,1
6,4,0,10,mixedType,1
7,1,0,8,mixedType,1
8,2,0,10,mixedType,1
6,3,0,9,mixedType,1
5,3,0,8,mixedType,1
15,1,0,16,mixedType,2
6,4,0,10,mixedType,1
6,6,0,12,mixedType,1
4,4,0,8,mixedType,1
1,9,0,10,mixedType,1
2,7,0,9,mixedType,1
8,2,0,10,mixedType,1
12,8,0,20,mixedType,2
5,2,0,7,mixedType,0
4,2,0,6,mixedType,0
6,4,0,10,mixedType,1
9,1,0,10,mixedType,1
2,8,0,10,mixedType,1
7,3,0,10,mixedType,1
15,1,0,16,mixedType,2
5,1,0,6,mixedType,0
5,2,0,7,mixedType,0
6,6,0,12,mixedType,1
6,5,0,11,mixedType,1
3,6,0,9,mixedType,1
7,3,1,11,mixedType,1
10,1,0,11,mixedType,1
12,1,0,13,mixedType,1
5,3,0,8,mixedType,1
12,3,0,15,mixedType,2
5,5,0,10,mixedType,1
9,4,0,13,mixedType,1
5,2,0,7,mixedType,0
8,1,0,9,mixedType,1
6,3,0,9,mixedType,1
4,2,0,6,mixedType,0
6,1,0,7,mixedType,0
7,2,0,9,mixedType,1
2,6,0,8,mixedType,1
8,1,0,9,mixedType,1
6,4,0,10,mixedType,1
5,3,0,8,mixedType,1
7,3,0,10,mixedType,1
7,2,0,9,mixedType,1
10,4,0,14,mixedType,2
3,7,0,10,mixedType,1
7,4,0,11,mixedType,1
10,2,0,12,mixedType,1
9,1,0,10,mixedType,1
6,4,0,10,mixedType,1
5,3,0,8,mixedType,1
7,2,0,9,mixedType,1
8,2,0,10,mixedType,1
5,1,0,6,mixedType,0
4,2,0,6,mixedType,0
7,2,0,9,mixedType,1
8,4,0,12,mixedType,1
6,5,0,11,mixedType,1
5,2,0,7,mixedType,0
7,1,0,8,mixedType,1
7,2,0,9,mixedType,1
12,2,1,15,mixedType,2
7,2,0,9,mixedType,1
8,3,0,11,mixedType,1
3,3,0,6,mixedType,0
2,6,0,8,mixedType,1
5,2,0,7,mixedType,0
1,8,0,9,mixedType,1
8,2,0,10,mixedType,1
10,2,0,12,mixedType,1
6,1,0,7,mixedType,0
9,2,0,11,mixedType,1
8,1,0,9,mixedType,1
6,3,0,9,mixedType,1
6,3,0,9,mixedType,1
2,8,0,10,mixedType,1
6,3,0,9,mixedType,1
8,1,0,9,mixedType,1
6,3,0,9,mixedType,1
6,3,0,9,mixedType,1
8,1,0,9,mixedType,1
9,2,0,11,mixedType,1
1,10,0,11,mixedType,1
9,4,0,13,mixedType,1
4,4,0,8,mixedType,1
7,2,0,9,mixedType,1
3,6,0,9,mixedType,1
7,1,0,8,mixedType,1
5,4,0,9,mixedType,1
5,0,1,6,mixedType,0
13,3,0,16,mixedType,2
7,2,0,9,mixedType,1
5,1,0,6,mixedType,0
11,1,0,12,mixedType,1
5,1,0,6,mixedType,0
13,3,0,16,mixedType,2
5,2,0,7,mixedType,0
6,3,0,9,mixedType,1
2,6,0,8,mixedType,1
18,3,2,23,mixedType,2
12,4,0,16,mixedType,2
3,7,0,10,mixedType,1
8,2,0,10,mixedType,1
5,7,0,12,mixedType,1
7,3,0,10,mixedType,1
5,1,0,6,mixedType,0
5,2,0,7,mixedType,0
8,6,0,14,mixedType,2
5,1,0,6,mixedType,0
5,5,0,10,mixedType,1
6,3,0,9,mixedType,1
9,4,2,15,mixedType,2
8,4,0,12,mixedType,1
4,8,0,12,mixedType,1
8,3,0,11,mixedType,1
5,1,0,6,mixedType,0
5,3,0,8,mixedType,1
5,1,0,6,mixedType,0
7,4,0,11,mixedType,1
7,2,0,9,mixedType,1
6,2,0,8,mixedType,1
6,3,0,9,mixedType,1
3,6,0,9,mixedType,1
11,2,0,13,mixedType,1
12,3,0,15,mixedType,2
6,2,0,8,mixedType,1
4,2,0,6,mixedType,0
9,1,0,10,mixedType,1
6,2,0,8,mixedType,1
5,7,0,12,mixedType,1
7,4,0,11,mixedType,1
4,4,0,8,mixedType,1
6,3,0,9,mixedType,1
7,1,0,8,mixedType,1
7,3,0,10,mixedType,1
8,2,0,10,mixedType,1
7,2,0,9,mixedType,1
14,2,0,16,mixedType,2
10,2,0,12,mixedType,1
5,4,0,9,mixedType,1
5,2,0,7,mixedType,0
13,3,0,16,mixedType,2
6,1,0,7,mixedType,0
4,2,0,6,mixedType,0
3,8,0,11,mixedType,1
9,1,0,10,mixedType,1
7,1,0,8,mixedType,1
7,2,0,9,mixedType,1
6,6,0,12,mixedType,1
0,6,2,8,mixedType,1
5,2,0,7,mixedType,0
7,4,0,11,mixedType,1
5,3,0,8,mixedType,1
4,2,0,6,mixedType,0
7,2,0,9,mixedType,1
6,3,0,9,mixedType,1
3,3,0,6,mixedType,0
6,4,0,10,mixedType,1
10,4,0,14,mixedType,2
3,5,0,8,mixedType,1
5,3,0,8,mixedType,1
10,4,1,15,mixedType,2
5,3,0,8,mixedType,1
10,1,0,11,mixedType,1
5,2,0,7,mixedType,0
8,2,0,10,mixedType,1
3,5,0,8,mixedType,1
7,3,0,10,mixedType,1
7,2,0,9,mixedType,1
14,2,0,16,mixedType,2
6,3,0,9,mixedType,1
5,1,0,6,mixedType,0
8,1,0,9,mixedType,1
5,3,0,8,mixedType,1
6,3,0,9,mixedType,1
4,4,0,8,mixedType,1
8,2,0,10,mixedType,1
10,1,0,11,mixedType,1
7,3,0,10,mixedType,1
8,1,0,9,mixedType,1
13,2,0,15,mixedType,2
9,3,0,12,mixedType,1
3,3,0,6,mixedType,0
8,2,0,10,mixedType,1
1,6,0,7,mixedType,0
14,2,0,16,mixedType,2
7,2,0,9,mixedType,1
12,3,0,15,mixedType,2
12,4,0,16,mixedType,2
5,3,0,8,mixedType,1
5,2,0,7,mixedType,0
4,6,0,10,mixedType,1
6,4,0,10,mixedType,1
5,2,0,7,mixedType,0
13,4,0,17,mixedType,2
4,4,0,8,mixedType,1
5,4,0,9,mixedType,1
12,3,0,15,mixedType,2
8,2,0,10,mixedType,1
6,3,0,9,mixedType,1
7,4,0,11,mixedType,1
6,3,0,9,mixedType,1
7,4,0,11,mixedType,1
7,3,0,10,mixedType,1
6,3,0,9,mixedType,1
3,3,0,6,mixedType,0
1,8,0,9,mixedType,1
7,3,0,10,mixedType,1
7,3,0,10,mixedType,1
14,2,0,16,mixedType,2
7,2,0,9,mixedType,1
7,2,0,9,mixedType,1
7,1,0,8,mixedType,1
8,2,0,10,mixedType,1
9,4,0,13,mixedType,1
5,1,0,6,mixedType,0
9,1,0,10,mixedType,1
4,4,0,8,mixedType,1
7,3,0,10,mixedType,1
5,3,0,8,mixedType,1
3,10,0,13,mixedType,1
5,3,0,8,mixedType,1
6,4,0,10,mixedType,1
5,2,0,7,mixedType,0
6,6,0,12,mixedType,1
13,3,0,16,mixedType,2
7,3,0,10,mixedType,1
7,2,0,9,mixedType,1
1,12,0,13,mixedType,1
3,8,0,11,mixedType,1
5,3,0,8,mixedType,1
1,10,0,11,mixedType,1
8,1,0,9,mixedType,1
5,3,0,8,mixedType,1
15,4,1,20,mixedType,2
4,9,0,13,mixedType,1
6,6,2,14,mixedType,2
14,2,0,16,mixedType,2
5,6,0,11,mixedType,1
6,3,0,9,mixedType,1
6,4,0,10,mixedType,1
1,8,0,9,mixedType,1
5,3,0,8,mixedType,1
4,6,0,10,mixedType,1
9,1,0,10,mixedType,1
2,9,0,11,mixedType,1
7,3,0,10,mixedType,1
6,3,0,9,mixedType,1
6,4,0,10,mixedType,1
8,1,0,9,mixedType,1
7,3,0,10,mixedType,1
4,2,0,6,mixedType,0
4,4,0,8,mixedType,1
9,3,0,12,mixedType,1
10,1,0,11,mixedType,1
5,2,0,7,mixedType,0
9,3,0,12,mixedType,1
1,7,0,8,mixedType,1
6,4,0,10,mixedType,1
8,2,0,10,mixedType,1
5,4,0,9,mixedType,1
5,2,0,7,mixedType,0
5,1,0,6,mixedType,0
7,4,0,11,mixedType,1
5,2,0,7,mixedType,0
6,3,0,9,mixedType,1
5,2,0,7,mixedType,0
5,2,0,7,mixedType,0
11,3,0,14,mixedType,2
5,3,0,8,mixedType,1
7,2,0,9,mixedType,1
8,4,0,12,mixedType,1
4,2,0,6,mixedType,0
6,3,0,9,mixedType,1
4,2,0,6,mixedType,0
5,3,0,8,mixedType,1
10,2,0,12,mixedType,1
8,2,0,10,mixedType,1
2,7,0,9,mixedType,1
2,8,0,10,mixedType,1
7,3,0,10,mixedType,1
6,3,0,9,mixedType,1
12,0,1,13,mixedType,1
6,3,0,9,mixedType,1
6,1,0,7,mixedType,0
7,3,0,10,mixedType,1
7,2,0,9,mixedType,1
13,3,0,16,mixedType,2
6,1,0,7,mixedType,0
5,3,0,8,mixedType,1
9,3,0,12,mixedType,1
4,4,0,8,mixedType,1
4,4,0,8,mixedType,1
4,2,0,6,mixedType,0
6,1,0,7,mixedType,0
6,2,0,8,mixedType,1
6,4,0,10,mixedType,1
8,2,0,10,mixedType,1
8,4,0,12,mixedType,1
7,1,0,8,mixedType,1
5,1,0,6,mixedType,0
4,2,0,6,mixedType,0
6,4,0,10,mixedType,1
3,6,0,9,mixedType,1
5,2,0,7,mixedType,0
9,1,0,10,mixedType,1
4,4,0,8,mixedType,1
7,3,0,10,mixedType,1
4,2,0,6,mixedType,0
6,4,0,10,mixedType,1
5,4,0,9,mixedType,1
12,1,0,13,mixedType,1
7,3,0,10,mixedType,1
8,2,0,10,mixedType,1
5,3,0,8,mixedType,1
6,1,0,7,mixedType,0
6,3,0,9,mixedType,1
6,2,0,8,mixedType,1
7,3,0,10,mixedType,1
9,1,0,10,mixedType,1
14,2,0,16,mixedType,2
13,3,0,16,mixedType,2
8,1,0,9,mixedType,1
5,2,0,7,mixedType,0
6,2,0,8,mixedType,1
8,4,0,12,mixedType,1
8,2,0,10,mixedType,1
5,3,0,8,mixedType,1
7,2,0,9,mixedType,1
6,3,0,9,mixedType,1
6,3,0,9,mixedType,1
5,2,0,7,mixedType,0
4,4,0,8,mixedType,1
7,3,0,10,mixedType,1
5,2,0,7,mixedType,0
6,1,0,7,mixedType,0
6,4,0,10,mixedType,1
6,4,0,10,mixedType,1
1,9,0,10,mixedType,1
7,3,0,10,mixedType,1
4,4,0,8,mixedType,1
6,4,0,10,mixedType,1
7,2,0,9,mixedType,1
6,2,0,8,mixedType,1
6,7,0,13,mixedType,1
7,2,0,9,mixedType,1
2,8,0,10,mixedType,1
4,7,0,11,mixedType,1
3,7,0,10,mixedType,1
7,5,0,12,mixedType,1
6,2,0,8,mixedType,1
8,2,0,10,mixedType,1
6,4,0,10,mixedType,1
3,5,0,8,mixedType,1
7,3,0,10,mixedType,1
12,4,0,16,mixedType,2
15,1,0,16,mixedType,2
8,1,0,9,mixedType,1
10,1,0,11,mixedType,1
9,1,0,10,mixedType,1
6,3,0,9,mixedType,1
7,3,0,10,mixedType,1
8,2,0,10,mixedType,1
7,1,0,8,mixedType,1
5,4,0,9,mixedType,1
5,1,0,6,mixedType,0
7,4,0,11,mixedType,1
7,3,0,10,mixedType,1
16,2,0,18,mixedType,2
2,4,0,6,mixedType,0
3,8,0,11,mixedType,1
8,2,0,10,mixedType,1
6,3,0,9,mixedType,1
5,3,0,8,mixedType,1
6,3,0,9,mixedType,1
6,4,0,10,mixedType,1
14,2,0,16,mixedType,2
4,4,0,8,mixedType,1
7,2,0,9,mixedType,1
2,7,0,9,mixedType,1
10,2,0,12,mixedType,1
7,1,0,8,mixedType,1
6,1,0,7,mixedType,0
4,2,0,6,mixedType,0
14,2,0,16,mixedType,2
8,4,0,12,mixedType,1
9,2,0,11,mixedType,1
7,1,0,8,mixedType,1
6,2,0,8,mixedType,1
4,4,0,8,mixedType,1
9,4,0,13,mixedType,1
6,2,0,8,mixedType,1
3,6,0,9,mixedType,1
9,4,1,14,mixedType,2
5,3,0,8,mixedType,1
12,4,1,17,mixedType,2
4,4,0,8,mixedType,1
7,5,0,12,mixedType,1
10,3,0,13,mixedType,1
4,4,0,8,mixedType,1
6,2,0,8,mixedType,1
7,2,0,9,mixedType,1
6,4,0,10,mixedType,1
5,3,0,8,mixedType,1
7,3,0,10,mixedType,1
16,1,1,18,mixedType,2
7,3,0,10,mixedType,1
10,3,0,13,mixedType,1
8,3,0,11,mixedType,1
13,3,0,16,mixedType,2
6,1,0,7,mixedType,0
8,2,0,10,mixedType,1
1,8,0,9,mixedType,1
6,1,0,7,mixedType,0
4,4,0,8,mixedType,1
13,3,0,16,mixedType,2
7,3,0,10,mixedType,1
6,6,0,12,mixedType,1
3,8,0,11,mixedType,1
9,1,0,10,mixedType,1
12,4,0,16,mixedType,2
4,4,0,8,mixedType,1
8,2,0,10,mixedType,1
9,3,0,12,mixedType,1
7,2,0,9,mixedType,1
8,1,0,9,mixedType,1
8,1,0,9,mixedType,1
6,3,0,9,mixedType,1
5,4,0,9,mixedType,1
6,1,0,7,mixedType,0
5,3,0,8,mixedType,1
8,2,0,10,mixedType,1
7,7,0,14,mixedType,2
6,4,0,10,mixedType,1
2,7,0,9,mixedType,1
6,3,0,9,mixedType,1
4,2,0,6,mixedType,0
5,3,0,8,mixedType,1
6,1,0,7,mixedType,0
4,2,0,6,mixedType,0
6,3,0,9,mixedType,1
6,8,0,14,mixedType,2
5,2,0,7,mixedType,0
10,3,0,13,mixedType,1
4,5,0,9,mixedType,1
5,3,0,8,mixedType,1
14,2,0,16,mixedType,2
6,3,0,9,mixedType,1
5,1,0,6,mixedType,0
6,3,0,9,mixedType,1
3,7,0,10,mixedType,1
4,2,0,6,mixedType,0
3,6,0,9,mixedType,1
1,8,0,9,mixedType,1
5,2,0,7,mixedType,0
6,4,0,10,mixedType,1
8,1,0,9,mixedType,1
5,2,0,7,mixedType,0
5,3,0,8,mixedType,1
6,4,0,10,mixedType,1
6,3,0,9,mixedType,1
13,3,0,16,mixedType,2
5,4,0,9,mixedType,1
6,1,0,7,mixedType,0
10,2,0,12,mixedType,1
1,8,0,9,mixedType,1
7,3,0,10,mixedType,1
13,3,0,16,mixedType,2
14,2,0,16,mixedType,2
7,3,0,10,mixedType,1
4,2,0,6,mixedType,0
7,2,0,9,mixedType,1
6,1,0,7,mixedType,0
6,2,0,8,mixedType,1
8,1,0,9,mixedType,1
5,1,0,6,mixedType,0
4,5,0,9,mixedType,1
5,2,0,7,mixedType,0
6,3,0,9,mixedType,1
5,2,0,7,mixedType,0
6,3,0,9,mixedType,1
5,3,0,8,mixedType,1
6,3,0,9,mixedType,1
10,1,0,11,mixedType,1
4,4,0,8,mixedType,1
9,2,0,11,mixedType,1
9,3,0,12,mixedType,1
4,4,0,8,mixedType,1
7,3,0,10,mixedType,1
4,6,0,10,mixedType,1
4,4,0,8,mixedType,1
6,8,1,15,mixedType,2
7,3,0,10,mixedType,1
8,4,0,12,mixedType,1
9,1,0,10,mixedType,1
6,4,0,10,mixedType,1
9,2,0,11,mixedType,1
4,2,0,6,mixedType,0
6,4,0,10,mixedType,1
6,1,0,7,mixedType,0
5,5,0,10,mixedType,1
7,2,0,9,mixedType,1
13,3,0,16,mixedType,2
9,4,0,13,mixedType,1
9,2,0,11,mixedType,1
4,4,0,8,mixedType,1
8,1,0,9,mixedType,1
5,3,0,8,mixedType,1
8,2,0,10,mixedType,1
12,3,0,15,mixedType,2
5,3,0,8,mixedType,1
8,1,0,9,mixedType,1
8,3,0,11,mixedType,1
4,4,0,8,mixedType,1
4,4,0,8,mixedType,1
9,4,0,13,mixedType,1
7,2,0,9,mixedType,1
5,6,0,11,mixedType,1
5,2,0,7,mixedType,0
3,6,0,9,mixedType,1
7,3,0,10,mixedType,1
1,8,0,9,mixedType,1
9,1,0,10,mixedType,1
13,3,0,16,mixedType,2
7,3,0,10,mixedType,1
7,2,0,9,mixedType,1
6,5,0,11,mixedType,1
7,2,0,9,mixedType,1
3,5,0,8,mixedType,1
1,7,0,8,mixedType,1
7,1,0,8,mixedType,1
8,2,0,10,mixedType,1
4,4,0,8,mixedType,1
13,3,0,16,mixedType,2
6,3,0,9,mixedType,1
4,8,0,12,mixedType,1
5,4,0,9,mixedType,1
10,2,3,15,mixedType,2
6,2,0,8,mixedType,1
8,2,0,10,mixedType,1
6,3,0,9,mixedType,1
4,6,0,10,mixedType,1
5,4,0,9,mixedType,1
6,1,0,7,mixedType,0
5,4,0,9,mixedType,1
6,2,0,8,mixedType,1
8,3,0,11,mixedType,1
7,1,0,8,mixedType,1
3,6,0,9,mixedType,1
2,8,0,10,mixedType,1
7,1,0,8,mixedType,1
12,3,0,15,mixedType,2
7,2,0,9,mixedType,1
15,1,0,16,mixedType,2
6,3,0,9,mixedType,1
8,1,0,9,mixedType,1
6,2,0,8,mixedType,1
7,3,0,10,mixedType,1
3,7,0,10,mixedType,1
6,6,0,12,mixedType,1
6,2,0,8,mixedType,1
9,3,0,12,mixedType,1
6,6,0,12,mixedType,1
7,2,0,9,mixedType,1
11,2,0,13,mixedType,1
6,3,0,9,mixedType,1
12,4,0,16,mixedType,2
4,6,0,10,mixedType,1
5,3,0,8,mixedType,1
3,6,0,9,mixedType,1
9,3,0,12,mixedType,1
6,2,0,8,mixedType,1
3,6,0,9,mixedType,1
8,4,0,12,mixedType,1
7,3,0,10,mixedType,1
7,5,0,12,mixedType,1
6,3,0,9,mixedType,1
6,1,0,7,mixedType,0
9,3,0,12,mixedType,1
5,2,0,7,mixedType,0
2,6,0,8,mixedType,1
7,2,0,9,mixedType,1
6,3,0,9,mixedType,1
7,1,0,8,mixedType,1
6,5,0,11,mixedType,1
5,4,0,9,mixedType,1
6,4,0,10,mixedType,1
0,9,3,12,mixedType,1
15,1,1,17,mixedType,2
11,5,0,16,mixedType,2
9,2,0,11,mixedType,1
7,3,0,10,mixedType,1
9,3,0,12,mixedType,1
6,4,0,10,mixedType,1
5,6,0,11,mixedType,1
4,2,0,6,mixedType,0
4,6,0,10,mixedType,1
5,5,0,10,mixedType,1
9,1,0,10,mixedType,1
8,3,0,11,mixedType,1
14,2,0,16,mixedType,2
3,5,0,8,mixedType,1
5,2,0,7,mixedType,0
8,2,0,10,mixedType,1
7,3,0,10,mixedType,1
6,3,0,9,mixedType,1
5,1,0,6,mixedType,0
6,4,0,10,mixedType,1
6,3,0,9,mixedType,1
3,5,0,8,mixedType,1
6,3,0,9,mixedType,1
14,2,0,16,mixedType,2
4,10,0,14,mixedType,2
5,3,0,8,mixedType,1
8,1,0,9,mixedType,1
2,8,0,10,mixedType,1
9,2,0,11,mixedType,1
10,2,2,14,mixedType,2
12,4,0,16,mixedType,2
5,3,0,8,mixedType,1
4,2,0,6,mixedType,0
7,3,0,10,mixedType,1
6,6,0,12,mixedType,1
11,3,0,14,mixedType,2
6,4,0,10,mixedType,1
6,1,0,7,mixedType,0
5,1,0,6,mixedType,0
12,4,0,16,mixedType,2
5,3,0,8,mixedType,1
4,4,0,8,mixedType,1
8,1,0,9,mixedType,1
8,2,0,10,mixedType,1
6,2,0,8,mixedType,1
6,2,0,8,mixedType,1
4,2,0,6,mixedType,0
6,6,0,12,mixedType,1
5,2,0,7,mixedType,0
10,2,0,12,mixedType,1
4,4,0,8,mixedType,1
6,4,0,10,mixedType,1
10,1,0,11,mixedType,1
5,4,0,9,mixedType,1
8,2,0,10,mixedType,1
9,2,0,11,mixedType,1
5,4,0,9,mixedType,1
3,6,0,9,mixedType,1
4,2,0,6,mixedType,0
2,6,0,8,mixedType,1
7,2,0,9,mixedType,1
2,8,0,10,mixedType,1
7,2,0,9,mixedType,1
9,4,0,13,mixedType,1
9,1,0,10,mixedType,1
10,2,0,12,mixedType,1
6,2,0,8,mixedType,1
12,3,0,15,mixedType,2
9,3,0,12,mixedType,1
9,1,0,10,mixedType,1
5,5,0,10,mixedType,1
8,1,0,9,mixedType,1
5,3,0,8,mixedType,1
14,2,0,16,mixedType,2
7,3,0,10,mixedType,1
6,3,0,9,mixedType,1
7,1,0,8,mixedType,1
8,1,0,9,mixedType,1
9,1,0,10,mixedType,1
8,1,0,9,mixedType,1
6,3,0,9,mixedType,1
11,3,0,14,mixedType,2
2,6,0,8,mixedType,1
9,4,0,13,mixedType,1
8,1,0,9,mixedType,1
9,2,0,11,mixedType,1
6,2,0,8,mixedType,1
7,1,0,8,mixedType,1
7,2,0,9,mixedType,1
6,1,0,7,mixedType,0
6,3,0,9,mixedType,1
1,9,0,10,mixedType,1
4,4,0,8,mixedType,1
1,9,0,10,mixedType,1
9,1,0,10,mixedType,1
6,3,0,9,mixedType,1
6,2,0,8,mixedType,1
6,4,0,10,mixedType,1
4,2,0,6,mixedType,0
6,4,0,10,mixedType,1
4,2,0,6,mixedType,0
9,1,0,10,mixedType,1
8,6,0,14,mixedType,2
4,6,0,10,mixedType,1
5,4,0,9,mixedType,1
7,2,0,9,mixedType,1
8,1,0,9,mixedType,1
5,4,0,9,mixedType,1
5,3,0,8,mixedType,1
6,3,0,9,mixedType,1
5,3,0,8,mixedType,1
7,3,0,10,mixedType,1
5,3,0,8,mixedType,1
10,2,0,12,mixedType,1
13,3,0,16,mixedType,2
5,4,0,9,mixedType,1
9,3,0,12,mixedType,1
5,3,0,8,mixedType,1
3,3,0,6,mixedType,0
6,1,0,7,mixedType,0
8,2,0,10,mixedType,1
9,1,0,10,mixedType,1
11,5,0,16,mixedType,2
6,4,0,10,mixedType,1
14,2,0,16,mixedType,2
6,3,0,9,mixedType,1
6,3,0,9,mixedType,1
7,2,0,9,mixedType,1
5,6,0,11,mixedType,1
3,8,0,11,mixedType,1
6,3,0,9,mixedType,1
6,4,0,10,mixedType,1
9,2,3,14,mixedType,2
5,3,0,8,mixedType,1
8,0,1,9,mixedType,1
6,2,0,8,mixedType,1
6,2,0,8,mixedType,1
8,1,0,9,mixedType,1
12,4,0,16,mixedType,2
2,9,0,11,mixedType,1
8,2,0,10,mixedType,1
2,6,0,8,mixedType,1
11,3,0,14,mixedType,2
7,3,0,10,mixedType,1
2,6,0,8,mixedType,1
1,9,0,10,mixedType,1
7,3,0,10,mixedType,1
6,3,0,9,mixedType,1
12,1,0,13,mixedType,1
7,2,0,9,mixedType,1
4,4,0,8,mixedType,1
7,1,0,8,mixedType,1
8,1,0,9,mixedType,1
5,3,0,8,mixedType,1
5,2,0,7,mixedType,0
7,2,0,9,mixedType,1
5,0,1,6,mixedType,0
1,8,0,9,mixedType,1
9,2,0,11,mixedType,1
8,1,0,9,mixedType,1
6,2,0,8,mixedType,1
4,5,0,9,mixedType,1
13,3,0,16,mixedType,2
5,5,0,10,mixedType,1
8,2,0,10,mixedType,1
6,3,0,9,mixedType,1
4,2,0,6,mixedType,0
8,4,0,12,mixedType,1
11,2,0,13,mixedType,1
4,2,0,6,mixedType,0
8,2,0,10,mixedType,1
14,2,0,16,mixedType,2
7,2,0,9,mixedType,1
7,3,0,10,mixedType,1
14,2,0,16,mixedType,2
4,2,0,6,mixedType,0
6,1,0,7,mixedType,0
1,8,0,9,mixedType,1
7,3,0,10,mixedType,1
6,2,0,8,mixedType,1
6,7,0,13,mixedType,1
7,6,0,13,mixedType,1
6,2,0,8,mixedType,1
8,2,0,10,mixedType,1
11,5,0,16,mixedType,2
8,1,1,10,mixedType,1
5,4,0,9,mixedType,1
8,4,0,12,mixedType,1
7,1,0,8,mixedType,1
4,4,0,8,mixedType,1
8,1,0,9,mixedType,1
5,2,0,7,mixedType,0
8,2,0,10,mixedType,1
9,1,0,10,mixedType,1
8,7,1,16,mixedType,2
5,1,0,6,mixedType,0
4,5,0,9,mixedType,1
8,3,0,11,mixedType,1
5,3,0,8,mixedType,1
5,2,0,7,mixedType,0
6,4,0,10,mixedType,1
8,1,0,9,mixedType,1
7,1,0,8,mixedType,1
6,4,0,10,mixedType,1
6,3,0,9,mixedType,1
6,3,0,9,mixedType,1
1,7,0,8,mixedType,1
6,1,0,7,mixedType,0
6,2,0,8,mixedType,1
7,4,0,11,mixedType,1
8,1,0,9,mixedType,1
7,4,0,11,mixedType,1
3,8,0,11,mixedType,1
6,3,0,9,mixedType,1
5,2,0,7,mixedType,0
6,3,0,9,mixedType,1
7,2,0,9,mixedType,1
7,1,0,8,mixedType,1
8,2,0,10,mixedType,1
13,2,0,15,mixedType,2
2,7,0,9,mixedType,1
6,3,0,9,mixedType,1
2,7,0,9,mixedType,1
4,4,0,8,mixedType,1
10,3,0,13,mixedType,1
9,1,0,10,mixedType,1
4,6,0,10,mixedType,1
8,2,0,10,mixedType,1
5,3,0,8,mixedType,1
5,4,0,9,mixedType,1
9,3,0,12,mixedType,1
6,3,0,9,mixedType,1
7,4,0,11,mixedType,1
7,3,0,10,mixedType,1
6,3,0,9,mixedType,1
6,3,0,9,mixedType,1
3,6,0,9,mixedType,1
8,1,0,9,mixedType,1
7,2,0,9,mixedType,1
8,1,0,9,mixedType,1
13,3,0,16,mixedType,2
6,3,0,9,mixedType,1
3,6,0,9,mixedType,1
5,3,0,8,mixedType,1
5,4,0,9,mixedType,1
7,3,0,10,mixedType,1
8,2,0,10,mixedType,1
3,7,0,10,mixedType,1
21,4,0,25,mixedType,2
6,1,0,7,mixedType,0
2,8,0,10,mixedType,1
6,3,0,9,mixedType,1
4,4,0,8,mixedType,1
11,2,0,13,mixedType,1
9,3,0,12,mixedType,1
1,9,0,10,mixedType,1
6,5,0,11,mixedType,1
7,1,0,8,mixedType,1
7,2,0,9,mixedType,1
7,3,0,10,mixedType,1
7,1,0,8,mixedType,1
15,1,0,16,mixedType,2
5,3,0,8,mixedType,1
4,6,0,10,mixedType,1
6,3,0,9,mixedType,1
4,4,0,8,mixedType,1
6,2,0,8,mixedType,1
11,1,0,12,mixedType,1
4,4,0,8,mixedType,1
2,6,0,8,mixedType,1
4,4,0,8,mixedType,1
8,1,0,9,mixedType,1
6,3,0,9,mixedType,1
6,3,0,9,mixedType,1
7,1,0,8,mixedType,1
6,3,0,9,mixedType,1
8,5,0,13,mixedType,1
2,6,0,8,mixedType,1
8,2,0,10,mixedType,1
7,2,0,9,mixedType,1
8,1,0,9,mixedType,1
5,2,0,7,mixedType,0
5,8,0,13,mixedType,1
4,4,0,8,mixedType,1
5,4,0,9,mixedType,1
5,2,0,7,mixedType,0
5,3,0,8,mixedType,1
7,1,0,8,mixedType,1
5,2,0,7,mixedType,0
9,1,0,10,mixedType,1
2,8,0,10,mixedType,1
1,7,0,8,mixedType,1
2,12,0,14,mixedType,2
8,1,0,9,mixedType,1
5,2,0,7,mixedType,0
7,2,0,9,mixedType,1
6,2,0,8,mixedType,1
3,6,0,9,mixedType,1
4,6,0,10,mixedType,1
8,4,0,12,mixedType,1
5,8,0,13,mixedType,1
5,8,0,13,mixedType,1
6,2,0,8,mixedType,1
1,10,0,11,mixedType,1
8,2,0,10,mixedType,1
12,4,0,16,mixedType,2
9,3,0,12,mixedType,1
2,9,0,11,mixedType,1
8,4,0,12,mixedType,1
8,1,0,9,mixedType,1
14,2,0,16,mixedType,2
2,8,0,10,mixedType,1
15,1,0,16,mixedType,2
7,2,0,9,mixedType,1
1,9,0,10,mixedType,1
10,2,0,12,mixedType,1
7,1,0,8,mixedType,1
5,1,0,6,mixedType,0
14,2,0,16,mixedType,2
6,3,0,9,mixedType,1
8,2,0,10,mixedType,1
5,2,0,7,mixedType,0
7,3,0,10,mixedType,1
2,7,0,9,mixedType,1
8,2,0,10,mixedType,1
3,3,0,6,mixedType,0
12,4,0,16,mixedType,2
9,3,0,12,mixedType,1
5,4,0,9,mixedType,1
9,1,0,10,mixedType,1
8,2,0,10,mixedType,1
7,3,0,10,mixedType,1
6,1,0,7,mixedType,0
6,6,0,12,mixedType,1
7,3,0,10,mixedType,1
6,3,0,9,mixedType,1
5,1,0,6,mixedType,0
9,2,0,11,mixedType,1
5,2,0,7,mixedType,0
4,4,0,8,mixedType,1
7,3,0,10,mixedType,1
8,4,0,12,mixedType,1
6,1,0,7,mixedType,0
1,8,0,9,mixedType,1
12,3,0,15,mixedType,2
7,2,0,9,mixedType,1
6,1,0,7,mixedType,0
6,3,0,9,mixedType,1
1,7,0,8,mixedType,1
15,1,0,16,mixedType,2
3,5,0,8,mixedType,1
4,4,0,8,mixedType,1
4,2,0,6,mixedType,0
9,1,0,10,mixedType,1
6,2,0,8,mixedType,1
7,3,0,10,mixedType,1
8,1,0,9,mixedType,1
5,3,0,8,mixedType,1
2,7,0,9,mixedType,1
11,1,0,12,mixedType,1
8,2,0,10,mixedType,1
8,2,0,10,mixedType,1
14,2,0,16,mixedType,2
9,4,0,13,mixedType,1
7,3,0,10,mixedType,1
4,6,0,10,mixedType,1
4,4,0,8,mixedType,1
11,5,0,16,mixedType,2
9,2,0,11,mixedType,1
5,2,0,7,mixedType,0
2,8,0,10,mixedType,1
4,6,0,10,mixedType,1
7,2,0,9,mixedType,1
15,1,1,17,mixedType,2
6,1,0,7,mixedType,0
4,4,0,8,mixedType,1
7,3,0,10,mixedType,1
7,3,0,10,mixedType,1
4,5,0,9,mixedType,1
7,1,0,8,mixedType,1
12,4,0,16,mixedType,2
7,4,0,11,mixedType,1
12,3,0,15,mixedType,2
4,4,0,8,mixedType,1
3,6,0,9,mixedType,1
6,1,0,7,mixedType,0
10,2,3,15,mixedType,2
6,3,0,9,mixedType,1
2,4,0,6,mixedType,0
9,1,0,10,mixedType,1
2,6,0,8,mixedType,1
2,7,0,9,mixedType,1
10,1,0,11,mixedType,1
6,3,0,9,mixedType,1
6,4,0,10,mixedType,1
9,3,0,12,mixedType,1
3,6,0,9,mixedType,1
6,2,0,8,mixedType,1
2,8,0,10,mixedType,1
6,1,0,7,mixedType,0
5,4,0,9,mixedType,1
13,3,0,16,mixedType,2
6,4,0,10,mixedType,1
5,2,0,7,mixedType,0
14,2,0,16,mixedType,2
3,6,0,9,mixedType,1
6,1,0,7,mixedType,0
4,2,0,6,mixedType,0
4,2,0,6,mixedType,0
5,2,0,7,mixedType,0
4,4,0,8,mixedType,1
6,2,0,8,mixedType,1
5,2,0,7,mixedType,0
7,1,0,8,mixedType,1
7,4,0,11,mixedType,1
6,3,0,9,mixedType,1
5,3,0,8,mixedType,1
6,3,0,9,mixedType,1
7,3,0,10,mixedType,1
6,2,0,8,mixedType,1
12,4,0,16,mixedType,2
4,2,0,6,mixedType,0
10,6,0,16,mixedType,2
5,1,0,6,mixedType,0
13,3,0,16,mixedType,2
13,3,0,16,mixedType,2
1,9,0,10,mixedType,1
5,3,0,8,mixedType,1
6,3,0,9,mixedType,1
7,1,0,8,mixedType,1
7,2,0,9,mixedType,1
7,2,0,9,mixedType,1
10,2,0,12,mixedType,1
5,4,0,9,mixedType,1
10,1,0,11,mixedType,1
7,2,0,9,mixedType,1
8,2,0,10,mixedType,1
6,2,0,8,mixedType,1
2,10,0,12,mixedType,1
11,1,0,12,mixedType,1
7,2,0,9,mixedType,1
14,2,0,16,mixedType,2
4,2,0,6,mixedType,0
6,1,0,7,mixedType,0
12,1,0,13,mixedType,1
7,3,0,10,mixedType,1
14,2,0,16,mixedType,2
14,2,0,16,mixedType,2
7,1,0,8,mixedType,1
9,4,0,13,mixedType,1
11,3,0,14,mixedType,2
5,3,0,8,mixedType,1
7,3,0,10,mixedType,1
6,3,0,9,mixedType,1
5,2,0,7,mixedType,0
8,1,0,9,mixedType,1
12,3,0,15,mixedType,2
7,2,0,9,mixedType,1
6,3,0,9,mixedType,1
5,2,0,7,mixedType,0
7,3,0,10,mixedType,1
5,2,0,7,mixedType,0
7,3,0,10,mixedType,1
8,2,0,10,mixedType,1
7,3,0,10,mixedType,1
7,1,0,8,mixedType,1
7,1,0,8,mixedType,1
7,2,0,9,mixedType,1
5,2,0,7,mixedType,0
6,4,0,10,mixedType,1
6,4,0,10,mixedType,1
8,2,0,10,mixedType,1
5,3,0,8,mixedType,1
5,3,0,8,mixedType,1
6,4,0,10,mixedType,1
4,4,0,8,mixedType,1
7,1,0,8,mixedType,1
15,1,0,16,mixedType,2
7,2,0,9,mixedType,1
9,6,0,15,mixedType,2
6,1,0,7,mixedType,0
8,1,0,9,mixedType,1
5,2,0,7,mixedType,0
5,4,0,9,mixedType,1
6,4,0,10,mixedType,1
12,4,0,16,mixedType,2
8,2,0,10,mixedType,1
10,1,0,11,mixedType,1
2,10,0,12,mixedType,1
3,6,0,9,mixedType,1
6,3,0,9,mixedType,1
6,2,0,8,mixedType,1
7,3,0,10,mixedType,1
9,2,0,11,mixedType,1
12,4,0,16,mixedType,2
6,3,0,9,mixedType,1
8,1,0,9,mixedType,1
3,6,0,9,mixedType,1
4,5,0,9,mixedType,1
14,2,0,16,mixedType,2
9,3,0,12,mixedType,1
8,4,0,12,mixedType,1
4,7,0,11,mixedType,1
5,3,0,8,mixedType,1
7,3,0,10,mixedType,1
5,4,0,9,mixedType,1
7,1,0,8,mixedType,1
6,3,0,9,mixedType,1
3,6,0,9,mixedType,1
5,3,0,8,mixedType,1
4,2,0,6,mixedType,0
4,4,0,8,mixedType,1
9,3,0,12,mixedType,1
7,5,0,12,mixedType,1
9,6,0,15,mixedType,2
6,3,0,9,mixedType,1
5,4,0,9,mixedType,1
2,7,0,9,mixedType,1
7,1,0,8,mixedType,1
1,8,0,9,mixedType,1
5,1,0,6,mixedType,0
2,10,0,12,mixedType,1
5,3,0,8,mixedType,1
7,3,0,10,mixedType,1
3,6,0,9,mixedType,1
2,8,0,10,mixedType,1
7,1,0,8,mixedType,1
7,2,0,9,mixedType,1
15,1,0,16,mixedType,2
14,2,0,16,mixedType,2
18,1,1,20,mixedType,2
7,2,0,9,mixedType,1
1,11,0,12,mixedType,1
2,4,0,6,mixedType,0
15,1,0,16,mixedType,2
2,6,0,8,mixedType,1
4,6,0,10,mixedType,1
5,4,0,9,mixedType,1
3,6,0,9,mixedType,1
8,4,0,12,mixedType,1
4,2,0,6,mixedType,0
8,1,0,9,mixedType,1
4,4,0,8,mixedType,1
6,2,0,8,mixedType,1
7,4,0,11,mixedType,1
6,4,0,10,mixedType,1
3,6,0,9,mixedType,1
4,2,0,6,mixedType,0
6,2,0,8,mixedType,1
8,6,0,14,mixedType,2
6,3,0,9,mixedType,1
5,2,0,7,mixedType,0
7,1,0,8,mixedType,1
6,7,0,13,mixedType,1
7,2,0,9,mixedType,1
7,2,0,9,mixedType,1
4,4,0,8,mixedType,1
14,2,0,16,mixedType,2
7,3,0,10,mixedType,1
5,5,0,10,mixedType,1
9,3,0,12,mixedType,1
6,4,0,10,mixedType,1
6,3,0,9,mixedType,1
5,1,0,6,mixedType,0
6,2,0,8,mixedType,1
8,2,0,10,mixedType,1
12,1,0,13,mixedType,1
12,3,0,15,mixedType,2
14,2,0,16,mixedType,2
8,2,0,10,mixedType,1
7,3,0,10,mixedType,1
4,2,0,6,mixedType,0
6,0,1,7,mixedType,0
5,4,0,9,mixedType,1
7,2,0,9,mixedType,1
4,4,0,8,mixedType,1
1,8,0,9,mixedType,1
4,2,0,6,mixedType,0
6,2,0,8,mixedType,1
11,1,0,12,mixedType,1
7,5,0,12,mixedType,1
4,6,0,10,mixedType,1
2,6,0,8,mixedType,1
6,3,0,9,mixedType,1
10,1,0,11,mixedType,1
3,6,0,9,mixedType,1
5,2,0,7,mixedType,0
14,2,0,16,mixedType,2
6,2,0,8,mixedType,1
4,2,0,6,mixedType,0
3,7,0,10,mixedType,1
2,8,0,10,mixedType,1
7,4,0,11,mixedType,1
12,4,0,16,mixedType,2
8,2,0,10,mixedType,1
8,2,0,10,mixedType,1
5,2,0,7,mixedType,0
7,2,0,9,mixedType,1
12,1,0,13,mixedType,1
5,3,0,8,mixedType,1
7,4,0,11,mixedType,1
5,4,0,9,mixedType,1
6,4,0,10,mixedType,1
9,3,0,12,mixedType,1
6,4,0,10,mixedType,1
8,1,0,9,mixedType,1
5,3,0,8,mixedType,1
4,5,0,9,mixedType,1
8,3,0,11,mixedType,1
7,2,0,9,mixedType,1
5,4,0,9,mixedType,1
3,5,0,8,mixedType,1
7,2,0,9,mixedType,1
6,4,0,10,mixedType,1
8,1,0,9,mixedType,1
8,2,0,10,mixedType,1
10,0,1,11,mixedType,1
7,3,0,10,mixedType,1
14,2,0,16,mixedType,2
2,6,0,8,mixedType,1
8,2,0,10,mixedType,1
5,2,0,7,mixedType,0
7,1,0,8,mixedType,1
9,1,0,10,mixedType,1
5,5,0,10,mixedType,1
5,5,0,10,mixedType,1
6,3,0,9,mixedType,1
8,2,0,10,mixedType,1
7,2,0,9,mixedType,1
1,10,0,11,mixedType,1
3,6,0,9,mixedType,1
4,4,0,8,mixedType,1
14,2,0,16,mixedType,2
11,2,0,13,mixedType,1
7,3,0,10,mixedType,1
8,1,0,9,mixedType,1
14,2,0,16,mixedType,2
2,6,0,8,mixedType,1
6,1,0,7,mixedType,0
7,4,0,11,mixedType,1
4,6,0,10,mixedType,1
13,3,0,16,mixedType,2
1,8,0,9,mixedType,1
7,4,0,11,mixedType,1
5,0,1,6,mixedType,0
9,3,0,12,mixedType,1
5,4,0,9,mixedType,1
5,2,0,7,mixedType,0
9,1,0,10,mixedType,1
7,3,0,10,mixedType,1
6,4,0,10,mixedType,1
7,2,0,9,mixedType,1
7,4,0,11,mixedType,1
16,4,0,20,mixedType,2
6,4,0,10,mixedType,1
6,3,0,9,mixedType,1
7,5,0,12,mixedType,1
7,3,0,10,mixedType,1
13,3,0,16,mixedType,2
11,4,0,15,mixedType,2
7,2,0,9,mixedType,1
1,8,0,9,mixedType,1
5,3,0,8,mixedType,1
6,3,0,9,mixedType,1
7,4,0,11,mixedType,1
6,2,0,8,mixedType,1
9,4,1,14,mixedType,2
4,4,0,8,mixedType,1
6,2,1,9,mixedType,1
2,6,0,8,mixedType,1
4,4,0,8,mixedType,1
5,4,0,9,mixedType,1
6,3,0,9,mixedType,1
5,3,0,8,mixedType,1
13,3,0,16,mixedType,2
5,4,0,9,mixedType,1
8,1,0,9,mixedType,1
11,4,1,16,mixedType,2
6,3,0,9,mixedType,1
6,3,0,9,mixedType,1
4,2,0,6,mixedType,0
15,1,0,16,mixedType,2
7,2,0,9,mixedType,1
5,4,0,9,mixedType,1
14,2,0,16,mixedType,2
3,5,0,8,mixedType,1
9,1,0,10,mixedType,1
8,3,0,11,mixedType,1
2,7,0,9,mixedType,1
4,4,0,8,mixedType,1
1,8,0,9,mixedType,1
5,3,0,8,mixedType,1
11,3,0,14,mixedType,2
4,6,0,10,mixedType,1
9,1,0,10,mixedType,1
5,2,0,7,mixedType,0
5,2,0,7,mixedType,0
15,1,0,16,mixedType,2
6,1,0,7,mixedType,0
8,2,0,10,mixedType,1
9,6,0,15,mixedType,2
6,4,0,10,mixedType,1
4,4,0,8,mixedType,1
6,4,0,10,mixedType,1
8,3,0,11,mixedType,1
7,1,0,8,mixedType,1
7,2,0,9,mixedType,1
6,1,0,7,mixedType,0
6,6,0,12,mixedType,1
10,3,0,13,mixedType,1
11,3,0,14,mixedType,2
10,3,0,13,mixedType,1
0,6,1,7,mixedType,0
4,2,0,6,mixedType,0
4,2,0,6,mixedType,0
4,4,0,8,mixedType,1
4,2,0,6,mixedType,0
9,1,0,10,mixedType,1
15,1,0,16,mixedType,2
6,3,0,9,mixedType,1
6,3,0,9,mixedType,1
7,2,0,9,mixedType,1
4,2,0,6,mixedType,0
15,1,0,16,mixedType,2
7,7,0,14,mixedType,2
5,3,0,8,mixedType,1
6,3,0,9,mixedType,1
5,2,0,7,mixedType,0
11,1,0,12,mixedType,1
1,8,0,9,mixedType,1
5,6,0,11,mixedType,1
9,1,0,10,mixedType,1
5,3,0,8,mixedType,1
5,5,0,10,mixedType,1
7,2,0,9,mixedType,1
7,3,0,10,mixedType,1
3,6,0,9,mixedType,1
6,1,0,7,mixedType,0
7,1,0,8,mixedType,1
11,1,0,12,mixedType,1
6,2,0,8,mixedType,1
1,8,0,9,mixedType,1
13,3,0,16,mixedType,2
2,8,0,10,mixedType,1
4,2,0,6,mixedType,0
7,3,0,10,mixedType,1
5,3,0,8,mixedType,1
5,2,0,7,mixedType,0
6,1,0,7,mixedType,0
6,4,0,10,mixedType,1
5,3,0,8,mixedType,1
10,2,0,12,mixedType,1
5,2,0,7,mixedType,0
8,3,0,11,mixedType,1
14,2,0,16,mixedType,2
5,3,0,8,mixedType,1
8,2,0,10,mixedType,1
5,2,0,7,mixedType,0
7,1,0,8,mixedType,1
8,2,0,10,mixedType,1
7,3,0,10,mixedType,1
11,3,0,14,mixedType,2
10,2,0,12,mixedType,1
2,7,0,9,mixedType,1
9,1,0,10,mixedType,1
5,2,0,7,mixedType,0
8,1,0,9,mixedType,1
4,4,0,8,mixedType,1
9,1,0,10,mixedType,1
6,2,0,8,mixedType,1
9,3,0,12,mixedType,1
10,1,0,11,mixedType,1
7,6,0,13,mixedType,1
8,1,0,9,mixedType,1
4,9,0,13,mixedType,1
4,4,0,8,mixedType,1
1,12,0,13,mixedType,1
7,2,0,9,mixedType,1
5,4,0,9,mixedType,1
8,4,0,12,mixedType,1
8,2,0,10,mixedType,1
6,3,0,9,mixedType,1
1,9,0,10,mixedType,1
8,1,0,9,mixedType,1
9,1,0,10,mixedType,1
1,8,0,9,mixedType,1
5,1,0,6,mixedType,0
5,3,0,8,mixedType,1
13,3,0,16,mixedType,2
5,2,0,7,mixedType,0
2,4,0,6,mixedType,0
3,6,0,9,mixedType,1
6,3,0,9,mixedType,1
7,1,0,8,mixedType,1
8,4,0,12,mixedType,1
14,2,0,16,mixedType,2
3,7,0,10,mixedType,1
6,3,0,9,mixedType,1
8,1,0,9,mixedType,1
2,4,0,6,mixedType,0
5,8,0,13,mixedType,1
5,3,0,8,mixedType,1
7,3,0,10,mixedType,1
5,3,0,8,mixedType,1
4,4,0,8,mixedType,1
11,1,0,12,mixedType,1
6,1,0,7,mixedType,0
14,2,0,16,mixedType,2
7,3,0,10,mixedType,1
6,3,0,9,mixedType,1
6,4,0,10,mixedType,1
6,3,0,9,mixedType,1
5,2,0,7,mixedType,0
5,3,0,8,mixedType,1
12,3,0,15,mixedType,2
8,2,0,10,mixedType,1
5,2,0,7,mixedType,0
13,3,0,16,mixedType,2
13,3,0,16,mixedType,2
8,4,0,12,mixedType,1
2,8,0,10,mixedType,1
4,4,0,8,mixedType,1
5,1,0,6,mixedType,0
8,1,0,9,mixedType,1
3,6,0,9,mixedType,1
4,2,0,6,mixedType,0
6,6,0,12,mixedType,1
6,1,0,7,mixedType,0
7,1,0,8,mixedType,1
10,2,0,12,mixedType,1
6,6,0,12,mixedType,1
7,1,0,8,mixedType,1
7,2,0,9,mixedType,1
9,5,0,14,mixedType,2
9,1,0,10,mixedType,1
6,4,0,10,mixedType,1
5,2,0,7,mixedType,0
6,2,0,8,mixedType,1
4,2,0,6,mixedType,0
5,2,0,7,mixedType,0
4,5,0,9,mixedType,1
15,1,0,16,mixedType,2
8,3,0,11,mixedType,1
8,1,0,9,mixedType,1
9,2,0,11,mixedType,1
5,4,0,9,mixedType,1
13,4,0,17,mixedType,2
9,2,0,11,mixedType,1
9,1,0,10,mixedType,1
5,3,0,8,mixedType,1
4,2,0,6,mixedType,0
7,2,0,9,mixedType,1
11,3,0,14,mixedType,2
6,3,0,9,mixedType,1
5,3,0,8,mixedType,1
1,8,0,9,mixedType,1
4,4,0,8,mixedType,1
13,3,0,16,mixedType,2
7,3,0,10,mixedType,1
6,1,0,7,mixedType,0
6,2,0,8,mixedType,1
4,2,0,6,mixedType,0
4,2,0,6,mixedType,0
13,3,0,16,mixedType,2
2,6,0,8,mixedType,1
8,3,0,11,mixedType,1
9,1,0,10,mixedType,1
4,2,0,6,mixedType,0
7,2,0,9,mixedType,1
7,3,0,10,mixedType,1
3,6,0,9,mixedType,1
2,4,0,6,mixedType,0
9,3,0,12,mixedType,1
7,1,0,8,mixedType,1
8,1,0,9,mixedType,1
5,2,0,7,mixedType,0
8,3,0,11,mixedType,1
10,2,0,12,mixedType,1
13,1,1,15,mixedType,2
6,2,0,8,mixedType,1
6,1,0,7,mixedType,0
6,4,0,10,mixedType,1
3,5,0,8,mixedType,1
5,1,0,6,mixedType,0
7,1,0,8,mixedType,1
15,1,0,16,mixedType,2
11,3,0,14,mixedType,2
1,11,0,12,mixedType,1
9,1,0,10,mixedType,1
3,3,0,6,mixedType,0
15,1,0,16,mixedType,2
5,4,0,9,mixedType,1
2,4,0,6,mixedType,0
2,8,0,10,mixedType,1
6,4,0,10,mixedType,1
9,1,0,10,mixedType,1
5,3,0,8,mixedType,1
2,8,0,10,mixedType,1
8,3,0,11,mixedType,1
11,3,0,14,mixedType,2
8,1,0,9,mixedType,1
5,4,0,9,mixedType,1
7,3,0,10,mixedType,1
7,3,0,10,mixedType,1
8,1,0,9,mixedType,1
7,3,0,10,mixedType,1
6,2,0,8,mixedType,1
8,1,0,9,mixedType,1
8,2,0,10,mixedType,1
6,3,0,9,mixedType,1
8,2,0,10,mixedType,1
4,4,0,8,mixedType,1
5,4,0,9,mixedType,1
10,6,1,17,mixedType,2
14,2,0,16,mixedType,2
3,8,0,11,mixedType,1
4,2,0,6,mixedType,0
6,4,0,10,mixedType,1
5,4,0,9,mixedType,1
15,1,0,16,mixedType,2
13,3,0,16,mixedType,2
8,2,0,10,mixedType,1
6,2,0,8,mixedType,1
7,3,0,10,mixedType,1
12,4,0,16,mixedType,2
1,8,0,9,mixedType,1
8,2,0,10,mixedType,1
4,9,0,13,mixedType,1
4,4,0,8,mixedType,1
0,4,2,6,mixedType,0
5,2,0,7,mixedType,0
9,2,0,11,mixedType,1
3,6,0,9,mixedType,1
7,2,0,9,mixedType,1
12,4,0,16,mixedType,2
6,1,0,7,mixedType,0
6,1,0,7,mixedType,0
5,3,0,8,mixedType,1
5,3,0,8,mixedType,1
9,2,0,11,mixedType,1
6,3,0,9,mixedType,1
7,4,0,11,mixedType,1
3,3,0,6,mixedType,0
5,7,0,12,mixedType,1
6,2,0,8,mixedType,1
6,1,0,7,mixedType,0
7,2,0,9,mixedType,1
4,2,0,6,mixedType,0
3,6,0,9,mixedType,1
9,4,0,13,mixedType,1
9,1,0,10,mixedType,1
5,2,0,7,mixedType,0
2,6,0,8,mixedType,1
11,2,0,13,mixedType,1
3,6,0,9,mixedType,1
11,5,0,16,mixedType,2
5,2,0,7,mixedType,0
5,3,0,8,mixedType,1
14,4,0,18,mixedType,2
7,3,0,10,mixedType,1
7,2,0,9,mixedType,1
6,2,0,8,mixedType,1
8,2,0,10,mixedType,1
5,2,0,7,mixedType,0
8,4,0,12,mixedType,1
12,1,0,13,mixedType,1
12,4,0,16,mixedType,2
4,5,0,9,mixedType,1
5,4,0,9,mixedType,1
5,2,0,7,mixedType,0
3,3,0,6,mixedType,0
7,4,0,11,mixedType,1
5,2,0,7,mixedType,0
5,6,0,11,mixedType,1
8,1,0,9,mixedType,1
7,2,0,9,mixedType,1
7,3,0,10,mixedType,1
8,1,0,9,mixedType,1
5,2,0,7,mixedType,0
6,4,0,10,mixedType,1
6,3,0,9,mixedType,1
8,9,0,17,mixedType,2
9,2,0,11,mixedType,1
7,2,0,9,mixedType,1
7,2,0,9,mixedType,1
6,3,0,9,mixedType,1
4,2,0,6,mixedType,0
6,4,0,10,mixedType,1
7,2,0,9,mixedType,1
6,4,0,10,mixedType,1
16,1,1,18,mixedType,2
9,1,0,10,mixedType,1
5,2,0,7,mixedType,0
4,4,0,8,mixedType,1
5,3,0,8,mixedType,1
14,2,0,16,mixedType,2
4,9,0,13,mixedType,1
7,2,0,9,mixedType,1
7,10,3,20,mixedType,2
9,2,0,11,mixedType,1
8,2,0,10,mixedType,1
9,2,0,11,mixedType,1
4,4,0,8,mixedType,1
7,3,0,10,mixedType,1
6,4,0,10,mixedType,1
3,10,0,13,mixedType,1
4,6,0,10,mixedType,1
7,3,0,10,mixedType,1
11,4,0,15,mixedType,2
7,1,0,8,mixedType,1
8,1,0,9,mixedType,1
5,3,0,8,mixedType,1
7,3,0,10,mixedType,1
1,8,0,9,mixedType,1
4,2,0,6,mixedType,0
4,4,0,8,mixedType,1
3,5,0,8,mixedType,1
15,1,0,16,mixedType,2
3,6,0,9,mixedType,1
5,2,0,7,mixedType,0
8,2,0,10,mixedType,1
4,4,0,8,mixedType,1
8,1,0,9,mixedType,1
7,3,0,10,mixedType,1
9,2,0,11,mixedType,1
10,1,0,11,mixedType,1
10,2,0,12,mixedType,1
2,7,0,9,mixedType,1
13,3,0,16,mixedType,2
7,4,0,11,mixedType,1
5,3,0,8,mixedType,1
1,10,0,11,mixedType,1
3,6,0,9,mixedType,1
9,4,0,13,mixedType,1
2,6,0,8,mixedType,1
6,3,0,9,mixedType,1
2,6,0,8,mixedType,1
6,2,0,8,mixedType,1
6,2,0,8,mixedType,1
7,1,0,8,mixedType,1
5,2,0,7,mixedType,0
6,2,0,8,mixedType,1
4,5,0,9,mixedType,1
14,2,0,16,mixedType,2
8,5,0,13,mixedType,1
2,4,0,6,mixedType,0
7,3,0,10,mixedType,1
6,1,0,7,mixedType,0
8,1,0,9,mixedType,1
3,6,0,9,mixedType,1
6,4,0,10,mixedType,1
7,3,0,10,mixedType,1
8,1,0,9,mixedType,1
5,2,0,7,mixedType,0
8,5,0,13,mixedType,1
5,4,0,9,mixedType,1
15,1,0,16,mixedType,2
4,4,0,8,mixedType,1
5,3,0,8,mixedType,1
5,1,0,6,mixedType,0
7,2,0,9,mixedType,1
3,6,0,9,mixedType,1
6,1,0,7,mixedType,0
7,2,0,9,mixedType,1
7,2,0,9,mixedType,1
10,2,0,12,mixedType,1
5,5,0,10,mixedType,1
9,3,0,12,mixedType,1
8,3,0,11,mixedType,1
5,2,0,7,mixedType,0
6,3,0,9,mixedType,1
6,3,0,9,mixedType,1
6,3,0,9,mixedType,1
8,1,0,9,mixedType,1
5,3,0,8,mixedType,1
5,3,0,8,mixedType,1
8,2,0,10,mixedType,1
6,3,0,9,mixedType,1
1,7,0,8,mixedType,1
6,2,0,8,mixedType,1
5,2,0,7,mixedType,0
5,4,0,9,mixedType,1
4,8,0,12,mixedType,1
7,2,0,9,mixedType,1
10,4,0,14,mixedType,2
6,4,0,10,mixedType,1
6,4,0,10,mixedType,1
7,2,0,9,mixedType,1
8,4,0,12,mixedType,1
5,4,0,9,mixedType,1
9,2,0,11,mixedType,1
7,2,0,9,mixedType,1
3,5,0,8,mixedType,1
7,3,0,10,mixedType,1
12,1,0,13,mixedType,1
0,4,0,4,sameType,0
5,1,0,6,mixedType,0
3,6,0,9,mixedType,1
4,7,0,11,mixedType,1
6,1,0,7,mixedType,0
8,3,0,11,mixedType,1
5,2,0,7,mixedType,0
8,4,0,12,mixedType,1
7,1,0,8,mixedType,1
5,3,0,8,mixedType,1
13,2,0,15,mixedType,2
5,1,0,6,mixedType,0
7,3,0,10,mixedType,1
10,3,0,13,mixedType,1
4,4,0,8,mixedType,1
5,1,0,6,mixedType,0
8,3,0,11,mixedType,1
5,2,0,7,mixedType,0
6,1,0,7,mixedType,0
7,2,0,9,mixedType,1
2,6,0,8,mixedType,1
11,3,0,14,mixedType,2
7,3,0,10,mixedType,1
9,3,0,12,mixedType,1
6,3,0,9,mixedType,1
9,3,0,12,mixedType,1
5,1,0,6,mixedType,0
5,4,0,9,mixedType,1
9,1,0,10,mixedType,1
5,2,0,7,mixedType,0
6,3,0,9,mixedType,1
9,2,0,11,mixedType,1
5,3,0,8,mixedType,1
4,6,0,10,mixedType,1
6,3,0,9,mixedType,1
13,3,0,16,mixedType,2
4,4,0,8,mixedType,1
9,2,0,11,mixedType,1
7,1,0,8,mixedType,1
6,2,0,8,mixedType,1
1,8,0,9,mixedType,1
5,10,0,15,mixedType,2
8,0,1,9,mixedType,1
4,4,0,8,mixedType,1
8,3,0,11,mixedType,1
9,2,0,11,mixedType,1
8,2,0,10,mixedType,1
12,4,0,16,mixedType,2
7,4,0,11,mixedType,1
10,2,0,12,mixedType,1
6,1,0,7,mixedType,0
6,3,0,9,mixedType,1
4,5,0,9,mixedType,1
15,1,0,16,mixedType,2
4,2,0,6,mixedType,0
4,5,0,9,mixedType,1
12,3,0,15,mixedType,2
6,3,0,9,mixedType,1
3,6,0,9,mixedType,1
6,1,0,7,mixedType,0
8,1,0,9,mixedType,1
7,2,0,9,mixedType,1
7,4,0,11,mixedType,1
5,4,0,9,mixedType,1
4,6,0,10,mixedType,1
10,1,0,11,mixedType,1
6,3,0,9,mixedType,1
15,1,0,16,mixedType,2
12,3,4,19,mixedType,2
7,3,0,10,mixedType,1
8,1,0,9,mixedType,1
6,2,0,8,mixedType,1
8,4,0,12,mixedType,1
2,6,0,8,mixedType,1
13,3,0,16,mixedType,2
15,1,1,17,mixedType,2
4,6,0,10,mixedType,1
2,6,0,8,mixedType,1
7,1,0,8,mixedType,1
4,2,0,6,mixedType,0
9,4,1,14,mixedType,2
14,2,0,16,mixedType,2
3,5,0,8,mixedType,1
3,6,0,9,mixedType,1
9,1,0,10,mixedType,1
10,1,0,11,mixedType,1
9,3,0,12,mixedType,1
2,8,0,10,mixedType,1
4,4,0,8,mixedType,1
11,1,0,12,mixedType,1
5,2,0,7,mixedType,0
8,2,0,10,mixedType,1
4,2,0,6,mixedType,0
2,6,0,8,mixedType,1
6,7,0,13,mixedType,1
4,4,0,8,mixedType,1
5,3,0,8,mixedType,1
5,4,0,9,mixedType,1
7,1,0,8,mixedType,1
7,2,0,9,mixedType,1
5,4,0,9,mixedType,1
7,2,0,9,mixedType,1
3,6,0,9,mixedType,1
4,5,0,9,mixedType,1
6,3,0,9,mixedType,1
6,6,0,12,mixedType,1
15,1,0,16,mixedType,2
10,2,0,12,mixedType,1
4,7,0,11,mixedType,1
5,3,0,8,mixedType,1
5,2,0,7,mixedType,0
6,3,0,9,mixedType,1
8,1,0,9,mixedType,1
6,1,0,7,mixedType,0
5,6,0,11,mixedType,1
4,4,0,8,mixedType,1
7,3,0,10,mixedType,1
8,2,0,10,mixedType,1
2,6,0,8,mixedType,1
6,3,0,9,mixedType,1
6,3,0,9,mixedType,1
6,1,0,7,mixedType,0
6,2,0,8,mixedType,1
9,1,0,10,mixedType,1
6,3,0,9,mixedType,1
8,2,0,10,mixedType,1
5,3,0,8,mixedType,1
7,2,0,9,mixedType,1
5,4,0,9,mixedType,1
6,3,0,9,mixedType,1
10,2,0,12,mixedType,1
4,2,0,6,mixedType,0
12,1,0,13,mixedType,1
4,4,0,8,mixedType,1
2,6,0,8,mixedType,1
6,5,0,11,mixedType,1
6,1,0,7,mixedType,0
5,8,0,13,mixedType,1
7,2,0,9,mixedType,1
7,2,0,9,mixedType,1
9,2,0,11,mixedType,1
7,3,0,10,mixedType,1
7,3,0,10,mixedType,1
4,6,0,10,mixedType,1
5,3,0,8,mixedType,1
15,1,0,16,mixedType,2
8,4,0,12,mixedType,1
2,7,0,9,mixedType,1
9,2,0,11,mixedType,1
5,2,0,7,mixedType,0
6,3,0,9,mixedType,1
6,1,0,7,mixedType,0
6,3,0,9,mixedType,1
6,2,0,8,mixedType,1
14,2,0,16,mixedType,2
4,4,0,8,mixedType,1
2,4,0,6,mixedType,0
5,4,0,9,mixedType,1
7,3,0,10,mixedType,1
7,1,0,8,mixedType,1
2,6,0,8,mixedType,1
7,2,0,9,mixedType,1
7,3,0,10,mixedType,1
3,3,0,6,mixedType,0
8,2,0,10,mixedType,1
11,3,0,14,mixedType,2
4,6,0,10,mixedType,1
8,1,0,9,mixedType,1
8,2,0,10,mixedType,1
6,1,0,7,mixedType,0
10,2,0,12,mixedType,1
6,4,0,10,mixedType,1
2,4,0,6,mixedType,0
6,6,0,12,mixedType,1
7,3,0,10,mixedType,1
6,5,0,11,mixedType,1
3,5,0,8,mixedType,1
11,3,0,14,mixedType,2
9,1,0,10,mixedType,1
5,1,0,6,mixedType,0
11,1,0,12,mixedType,1
14,2,0,16,mixedType,2
7,2,0,9,mixedType,1
6,5,0,11,mixedType,1
11,2,0,13,mixedType,1
5,4,0,9,mixedType,1
5,3,0,8,mixedType,1
4,5,0,9,mixedType,1
6,3,0,9,mixedType,1
14,2,0,16,mixedType,2
8,1,0,9,mixedType,1
5,3,0,8,mixedType,1
9,2,0,11,mixedType,1
6,4,0,10,mixedType,1
6,5,0,11,mixedType,1
5,3,0,8,mixedType,1
5,3,0,8,mixedType,1
5,5,0,10,mixedType,1
15,1,0,16,mixedType,2
8,2,0,10,mixedType,1
6,2,0,8,mixedType,1
8,1,0,9,mixedType,1
7,2,0,9,mixedType,1
8,2,0,10,mixedType,1
6,4,0,10,mixedType,1
8,1,0,9,mixedType,1
9,2,0,11,mixedType,1
6,4,0,10,mixedType,1
7,3,0,10,mixedType,1
8,3,0,11,mixedType,1
9,2,0,11,mixedType,1
6,3,0,9,mixedType,1
8,4,0,12,mixedType,1
12,1,0,13,mixedType,1
5,3,0,8,mixedType,1
6,1,0,7,mixedType,0
6,3,0,9,mixedType,1
14,2,0,16,mixedType,2
6,8,0,14,mixedType,2
7,6,0,13,mixedType,1
1,7,0,8,mixedType,1
4,4,0,8,mixedType,1
6,1,0,7,mixedType,0
9,2,0,11,mixedType,1
8,4,0,12,mixedType,1
1,9,0,10,mixedType,1
5,1,0,6,mixedType,0
5,4,0,9,mixedType,1
7,2,0,9,mixedType,1
5,7,0,12,mixedType,1
7,3,0,10,mixedType,1
6,4,0,10,mixedType,1
10,3,0,13,mixedType,1
1,8,0,9,mixedType,1
8,2,0,10,mixedType,1
14,2,0,16,mixedType,2
9,0,2,11,mixedType,1
2,4,0,6,mixedType,0
5,6,0,11,mixedType,1
8,2,0,10,mixedType,1
19,1,1,21,mixedType,2
7,3,0,10,mixedType,1
4,2,0,6,mixedType,0
7,1,0,8,mixedType,1
5,3,0,8,mixedType,1
6,3,1,10,mixedType,1
3,6,0,9,mixedType,1
6,4,0,10,mixedType,1
7,3,0,10,mixedType,1
7,2,0,9,mixedType,1
6,2,0,8,mixedType,1
5,2,0,7,mixedType,0
7,1,0,8,mixedType,1
6,2,0,8,mixedType,1
6,3,0,9,mixedType,1
6,6,0,12,mixedType,1
14,2,0,16,mixedType,2
2,7,0,9,mixedType,1
7,3,0,10,mixedType,1
6,4,0,10,mixedType,1
2,4,0,6,mixedType,0
14,2,0,16,mixedType,2
8,1,0,9,mixedType,1
4,6,0,10,mixedType,1
3,6,0,9,mixedType,1
7,0,1,8,mixedType,1
7,2,0,9,mixedType,1
5,1,0,6,mixedType,0
7,3,0,10,mixedType,1
5,1,0,6,mixedType,0
13,3,0,16,mixedType,2
11,2,0,13,mixedType,1
14,2,0,16,mixedType,2
6,2,0,8,mixedType,1
8,1,0,9,mixedType,1
6,2,0,8,mixedType,1
6,4,0,10,mixedType,1
7,4,0,11,mixedType,1
4,4,0,8,mixedType,1
8,1,0,9,mixedType,1
6,3,0,9,mixedType,1
6,0,2,8,mixedType,1
4,6,0,10,mixedType,1
8,4,0,12,mixedType,1
2,8,0,10,mixedType,1
5,4,0,9,mixedType,1
6,4,0,10,mixedType,1
7,4,0,11,mixedType,1
5,1,0,6,mixedType,0
5,5,0,10,mixedType,1
5,4,0,9,mixedType,1
1,10,0,11,mixedType,1
6,3,0,9,mixedType,1
5,4,0,9,mixedType,1
8,3,0,11,mixedType,1
6,3,0,9,mixedType,1
4,6,0,10,mixedType,1
8,2,0,10,mixedType,1
14,2,0,16,mixedType,2
8,2,0,10,mixedType,1
4,5,0,9,mixedType,1
5,0,1,6,mixedType,0
4,4,0,8,mixedType,1
9,1,0,10,mixedType,1
9,3,0,12,mixedType,1
8,2,0,10,mixedType,1
9,2,0,11,mixedType,1
1,8,0,9,mixedType,1
7,2,0,9,mixedType,1
14,2,0,16,mixedType,2
6,4,0,10,mixedType,1
7,3,0,10,mixedType,1
2,7,0,9,mixedType,1
7,3,0,10,mixedType,1
14,2,0,16,mixedType,2
6,1,0,7,mixedType,0
6,4,0,10,mixedType,1
7,2,0,9,mixedType,1
7,3,0,10,mixedType,1
2,6,0,8,mixedType,1
2,8,0,10,mixedType,1
14,2,0,16,mixedType,2
3,3,0,6,mixedType,0
11,2,0,13,mixedType,1
7,3,0,10,mixedType,1
2,10,0,12,mixedType,1
4,4,0,8,mixedType,1
5,6,0,11,mixedType,1
6,4,0,10,mixedType,1
6,2,0,8,mixedType,1
5,4,0,9,mixedType,1
8,1,0,9,mixedType,1
13,3,0,16,mixedType,2
7,3,0,10,mixedType,1
12,3,0,15,mixedType,2
10,2,0,12,mixedType,1
5,1,0,6,mixedType,0
6,4,0,10,mixedType,1
8,2,0,10,mixedType,1
12,4,0,16,mixedType,2
2,4,0,6,mixedType,0
5,4,0,9,mixedType,1
10,11,0,21,mixedType,2
6,4,0,10,mixedType,1
5,6,0,11,mixedType,1
6,5,0,11,mixedType,1
6,0,0,6,sameType,0
1,7,0,8,mixedType,1
6,3,0,9,mixedType,1
7,4,0,11,mixedType,1
3,9,0,12,mixedType,1
8,2,0,10,mixedType,1
5,3,0,8,mixedType,1
15,1,0,16,mixedType,2
4,8,0,12,mixedType,1
4,4,0,8,mixedType,1
6,4,0,10,mixedType,1
7,3,0,10,mixedType,1
6,1,0,7,mixedType,0
10,4,0,14,mixedType,2
6,2,0,8,mixedType,1
5,2,0,7,mixedType,0
6,4,0,10,mixedType,1
6,7,0,13,mixedType,1
5,4,0,9,mixedType,1
1,8,0,9,mixedType,1
15,1,0,16,mixedType,2
13,3,0,16,mixedType,2
6,3,0,9,mixedType,1
6,4,0,10,mixedType,1
0,10,0,10,sameType,1
4,4,0,8,mixedType,1
8,2,0,10,mixedType,1
2,4,0,6,mixedType,0
5,3,0,8,mixedType,1
8,1,0,9,mixedType,1
11,1,0,12,mixedType,1
6,3,0,9,mixedType,1
8,1,0,9,mixedType,1
14,2,0,16,mixedType,2
9,3,0,12,mixedType,1
23,4,3,30,mixedType,2
9,1,0,10,mixedType,1
2,8,0,10,mixedType,1
14,2,0,16,mixedType,2
1,7,0,8,mixedType,1
3,3,0,6,mixedType,0
7,1,0,8,mixedType,1
2,6,0,8,mixedType,1
7,3,0,10,mixedType,1
7,3,0,10,mixedType,1
8,1,0,9,mixedType,1
6,6,2,14,mixedType,2
6,2,0,8,mixedType,1
7,3,0,10,mixedType,1
12,4,0,16,mixedType,2
9,4,0,13,mixedType,1
7,4,0,11,mixedType,1
8,1,0,9,mixedType,1
3,6,0,9,mixedType,1
8,2,0,10,mixedType,1
4,5,0,9,mixedType,1
6,4,0,10,mixedType,1
6,2,0,8,mixedType,1
4,4,0,8,mixedType,1
1,9,0,10,mixedType,1
6,2,0,8,mixedType,1
3,6,0,9,mixedType,1
6,4,0,10,mixedType,1
6,3,0,9,mixedType,1
4,2,0,6,mixedType,0
4,4,0,8,mixedType,1
4,4,0,8,mixedType,1
5,5,0,10,mixedType,1
5,5,0,10,mixedType,1
5,3,0,8,mixedType,1
11,5,0,16,mixedType,2
14,2,0,16,mixedType,2
9,1,0,10,mixedType,1
6,1,0,7,mixedType,0
7,1,0,8,mixedType,1
5,7,0,12,mixedType,1
6,4,0,10,mixedType,1
7,2,0,9,mixedType,1
5,4,0,9,mixedType,1
6,1,0,7,mixedType,0
8,1,0,9,mixedType,1
5,1,0,6,mixedType,0
4,2,0,6,mixedType,0
9,3,0,12,mixedType,1
5,4,0,9,mixedType,1
8,2,0,10,mixedType,1
3,6,0,9,mixedType,1
5,6,0,11,mixedType,1
14,2,0,16,mixedType,2
8,1,0,9,mixedType,1
7,3,0,10,mixedType,1
5,4,0,9,mixedType,1
7,2,0,9,mixedType,1
11,3,0,14,mixedType,2
2,4,0,6,mixedType,0
4,2,0,6,mixedType,0
8,1,0,9,mixedType,1
5,4,0,9,mixedType,1
6,2,0,8,mixedType,1
11,1,0,12,mixedType,1
5,2,0,7,mixedType,0
5,3,0,8,mixedType,1
13,3,0,16,mixedType,2
11,2,0,13,mixedType,1
9,1,0,10,mixedType,1
5,3,0,8,mixedType,1
10,2,0,12,mixedType,1
8,1,0,9,mixedType,1
9,1,0,10,mixedType,1
14,2,0,16,mixedType,2
8,1,0,9,mixedType,1
3,6,0,9,mixedType,1
12,3,0,15,mixedType,2
7,2,0,9,mixedType,1
2,4,0,6,mixedType,0
15,1,0,16,mixedType,2
8,2,0,10,mixedType,1
6,2,0,8,mixedType,1
5,4,0,9,mixedType,1
4,4,0,8,mixedType,1
7,1,0,8,mixedType,1
7,1,0,8,mixedType,1
6,1,0,7,mixedType,0
2,10,0,12,mixedType,1
9,3,0,12,mixedType,1
9,3,0,12,mixedType,1
6,3,0,9,mixedType,1
5,3,0,8,mixedType,1
1,8,0,9,mixedType,1
7,1,0,8,mixedType,1
9,1,0,10,mixedType,1
8,2,0,10,mixedType,1
8,2,0,10,mixedType,1
6,2,0,8,mixedType,1
8,1,0,9,mixedType,1
6,2,0,8,mixedType,1
4,2,0,6,mixedType,0
7,1,0,8,mixedType,1
6,1,0,7,mixedType,0
7,2,0,9,mixedType,1
5,3,0,8,mixedType,1
4,9,3,16,mixedType,2
2,7,0,9,mixedType,1
8,1,0,9,mixedType,1
9,2,0,11,mixedType,1
6,3,0,9,mixedType,1
16,1,1,18,mixedType,2
8,1,0,9,mixedType,1
13,3,0,16,mixedType,2
3,6,0,9,mixedType,1
6,2,0,8,mixedType,1
1,7,0,8,mixedType,1
2,7,0,9,mixedType,1
6,3,0,9,mixedType,1
6,3,0,9,mixedType,1
5,1,0,6,mixedType,0
1,8,0,9,mixedType,1
5,3,0,8,mixedType,1
2,8,0,10,mixedType,1
14,1,1,16,mixedType,2
7,3,0,10,mixedType,1
6,4,0,10,mixedType,1
9,1,0,10,mixedType,1
4,2,0,6,mixedType,0
13,3,0,16,mixedType,2
6,2,0,8,mixedType,1
5,2,0,7,mixedType,0
5,5,0,10,mixedType,1
8,1,0,9,mixedType,1
1,8,0,9,mixedType,1
6,2,0,8,mixedType,1
5,3,0,8,mixedType,1
8,2,0,10,mixedType,1
7,2,0,9,mixedType,1
3,6,0,9,mixedType,1
4,2,0,6,mixedType,0
6,2,0,8,mixedType,1
6,2,0,8,mixedType,1
5,3,0,8,mixedType,1
7,3,0,10,mixedType,1
12,2,1,15,mixedType,2
13,3,0,16,mixedType,2
3,5,0,8,mixedType,1
8,4,0,12,mixedType,1
13,3,0,16,mixedType,2
15,1,0,16,mixedType,2
5,4,0,9,mixedType,1
4,2,0,6,mixedType,0
6,1,0,7,mixedType,0
4,6,0,10,mixedType,1
3,5,0,8,mixedType,1
7,6,0,13,mixedType,1
7,7,0,14,mixedType,2
8,3,0,11,mixedType,1
12,3,0,15,mixedType,2
7,2,0,9,mixedType,1
4,8,0,12,mixedType,1
8,2,0,10,mixedType,1
14,2,0,16,mixedType,2
7,4,0,11,mixedType,1
4,6,0,10,mixedType,1
20,2,0,22,mixedType,2
8,1,0,9,mixedType,1
6,2,0,8,mixedType,1
5,6,0,11,mixedType,1
14,2,0,16,mixedType,2
3,6,0,9,mixedType,1
19,1,1,21,mixedType,2
10,2,0,12,mixedType,1
14,2,0,16,mixedType,2
6,3,0,9,mixedType,1
1,9,0,10,mixedType,1
5,2,0,7,mixedType,0
9,3,0,12,mixedType,1
10,2,0,12,mixedType,1
9,1,0,10,mixedType,1
13,3,0,16,mixedType,2
8,1,0,9,mixedType,1
7,2,0,9,mixedType,1
9,2,0,11,mixedType,1
6,3,0,9,mixedType,1
7,3,0,10,mixedType,1
10,3,0,13,mixedType,1
2,6,0,8,mixedType,1
7,3,0,10,mixedType,1
3,6,0,9,mixedType,1
6,2,0,8,mixedType,1
8,2,0,10,mixedType,1
7,2,0,9,mixedType,1
6,3,0,9,mixedType,1
8,2,0,10,mixedType,1
7,3,0,10,mixedType,1
5,3,0,8,mixedType,1
14,2,0,16,mixedType,2
7,2,0,9,mixedType,1
9,3,2,14,mixedType,2
1,9,0,10,mixedType,1
6,1,0,7,mixedType,0
5,4,0,9,mixedType,1
9,0,1,10,mixedType,1
8,3,0,11,mixedType,1
7,2,0,9,mixedType,1
13,3,0,16,mixedType,2
4,6,0,10,mixedType,1
14,2,0,16,mixedType,2
7,3,0,10,mixedType,1
4,4,0,8,mixedType,1
4,6,0,10,mixedType,1
5,3,0,8,mixedType,1
11,1,0,12,mixedType,1
5,3,0,8,mixedType,1
6,4,0,10,mixedType,1
4,4,0,8,mixedType,1
13,3,0,16,mixedType,2
12,3,0,15,mixedType,2
4,2,0,6,mixedType,0
5,1,0,6,mixedType,0
6,2,0,8,mixedType,1
5,3,0,8,mixedType,1
8,2,0,10,mixedType,1
8,2,0,10,mixedType,1
7,1,0,8,mixedType,1
4,2,0,6,mixedType,0
4,2,0,6,mixedType,0
6,4,0,10,mixedType,1
7,2,0,9,mixedType,1
5,3,0,8,mixedType,1
14,2,0,16,mixedType,2
6,3,0,9,mixedType,1
4,6,0,10,mixedType,1
4,2,0,6,mixedType,0
7,1,0,8,mixedType,1
5,2,0,7,mixedType,0
7,2,0,9,mixedType,1
3,8,0,11,mixedType,1
6,3,0,9,mixedType,1
7,2,0,9,mixedType,1
15,1,0,16,mixedType,2
9,3,0,12,mixedType,1
4,4,0,8,mixedType,1
10,1,0,11,mixedType,1
11,1,0,12,mixedType,1
2,7,0,9,mixedType,1
7,0,1,8,mixedType,1
5,2,0,7,mixedType,0
7,2,0,9,mixedType,1
4,6,0,10,mixedType,1
7,1,0,8,mixedType,1
1,11,0,12,mixedType,1
4,2,0,6,mixedType,0
6,4,0,10,mixedType,1
4,4,0,8,mixedType,1
8,2,0,10,mixedType,1
11,5,0,16,mixedType,2
8,4,0,12,mixedType,1
7,3,0,10,mixedType,1
7,3,0,10,mixedType,1
4,5,0,9,mixedType,1
5,3,0,8,mixedType,1
7,1,0,8,mixedType,1
6,2,0,8,mixedType,1
8,2,0,10,mixedType,1
10,4,0,14,mixedType,2
5,3,0,8,mixedType,1
11,2,0,13,mixedType,1
5,2,0,7,mixedType,0
10,3,0,13,mixedType,1
1,8,0,9,mixedType,1
7,2,0,9,mixedType,1
4,4,0,8,mixedType,1
3,3,0,6,mixedType,0
6,3,0,9,mixedType,1
4,8,0,12,mixedType,1
14,2,0,16,mixedType,2
9,1,0,10,mixedType,1
5,6,0,11,mixedType,1
14,2,0,16,mixedType,2
6,4,0,10,mixedType,1
6,9,1,16,mixedType,2
4,2,0,6,mixedType,0
1,8,0,9,mixedType,1
7,2,0,9,mixedType,1
5,5,0,10,mixedType,1
6,1,0,7,mixedType,0
5,3,0,8,mixedType,1
4,2,0,6,mixedType,0
4,4,0,8,mixedType,1
7,1,0,8,mixedType,1
6,3,0,9,mixedType,1
4,4,0,8,mixedType,1
5,3,0,8,mixedType,1
14,2,0,16,mixedType,2
7,3,0,10,mixedType,1
6,2,0,8,mixedType,1
7,1,0,8,mixedType,1
6,4,0,10,mixedType,1
8,1,0,9,mixedType,1
7,1,0,8,mixedType,1
11,3,0,14,mixedType,2
6,2,0,8,mixedType,1
6,4,0,10,mixedType,1
8,4,0,12,mixedType,1
3,5,0,8,mixedType,1
8,2,0,10,mixedType,1
6,1,0,7,mixedType,0
6,2,0,8,mixedType,1
2,6,0,8,mixedType,1
15,1,1,17,mixedType,2
5,4,0,9,mixedType,1
14,2,0,16,mixedType,2
6,1,0,7,mixedType,0
9,2,0,11,mixedType,1
2,7,0,9,mixedType,1
5,1,0,6,mixedType,0
5,3,0,8,mixedType,1
8,3,0,11,mixedType,1
5,2,0,7,mixedType,0
5,4,0,9,mixedType,1
6,1,0,7,mixedType,0
6,3,0,9,mixedType,1
3,5,0,8,mixedType,1
8,1,0,9,mixedType,1
9,2,0,11,mixedType,1
6,4,0,10,mixedType,1
3,3,0,6,mixedType,0
4,4,0,8,mixedType,1
4,4,0,8,mixedType,1
9,3,0,12,mixedType,1
10,2,0,12,mixedType,1
6,3,0,9,mixedType,1
11,2,0,13,mixedType,1
6,4,0,10,mixedType,1
6,3,0,9,mixedType,1
4,9,0,13,mixedType,1
6,4,0,10,mixedType,1
8,4,0,12,mixedType,1
4,2,0,6,mixedType,0
8,2,0,10,mixedType,1
7,2,0,9,mixedType,1
4,4,0,8,mixedType,1
5,5,0,10,mixedType,1
14,2,0,16,mixedType,2
6,2,0,8,mixedType,1
7,1,0,8,mixedType,1
7,6,0,13,mixedType,1
3,8,0,11,mixedType,1
14,2,0,16,mixedType,2
6,4,0,10,mixedType,1
8,2,0,10,mixedType,1
5,4,0,9,mixedType,1
1,11,0,12,mixedType,1
2,6,0,8,mixedType,1
6,3,0,9,mixedType,1
7,1,0,8,mixedType,1
7,2,0,9,mixedType,1
9,3,3,15,mixedType,2
5,3,0,8,mixedType,1
7,2,0,9,mixedType,1
6,2,0,8,mixedType,1
6,1,0,7,mixedType,0
5,2,0,7,mixedType,0
6,1,0,7,mixedType,0
7,3,0,10,mixedType,1
1,7,0,8,mixedType,1
5,3,0,8,mixedType,1
1,8,0,9,mixedType,1
7,1,0,8,mixedType,1
8,2,0,10,mixedType,1
2,4,0,6,mixedType,0
9,1,0,10,mixedType,1
6,1,0,7,mixedType,0
5,1,0,6,mixedType,0
5,2,0,7,mixedType,0
6,3,0,9,mixedType,1
2,6,0,8,mixedType,1
15,1,0,16,mixedType,2
2,10,0,12,mixedType,1
7,2,0,9,mixedType,1
8,2,0,10,mixedType,1
9,2,0,11,mixedType,1
15,1,0,16,mixedType,2
5,1,0,6,mixedType,0
4,4,0,8,mixedType,1
7,2,0,9,mixedType,1
8,2,0,10,mixedType,1
8,1,0,9,mixedType,1
6,2,0,8,mixedType,1
5,4,0,9,mixedType,1
6,4,0,10,mixedType,1
5,4,0,9,mixedType,1
5,3,0,8,mixedType,1
5,3,0,8,mixedType,1
7,2,0,9,mixedType,1
7,1,0,8,mixedType,1
8,4,0,12,mixedType,1
5,3,0,8,mixedType,1
9,2,0,11,mixedType,1
2,9,0,11,mixedType,1
6,1,0,7,mixedType,0
7,3,0,10,mixedType,1
5,1,0,6,mixedType,0
9,3,0,12,mixedType,1
9,2,0,11,mixedType,1
13,3,0,16,mixedType,2
13,3,0,16,mixedType,2
2,7,0,9,mixedType,1
3,5,0,8,mixedType,1
11,6,0,17,mixedType,2
2,6,0,8,mixedType,1
8,1,0,9,mixedType,1
8,2,0,10,mixedType,1
6,3,0,9,mixedType,1
5,0,1,6,mixedType,0
6,2,0,8,mixedType,1
4,11,0,15,mixedType,2
5,3,0,8,mixedType,1
6,8,0,14,mixedType,2
14,2,0,16,mixedType,2
4,2,0,6,mixedType,0
6,3,0,9,mixedType,1
13,3,0,16,mixedType,2
10,2,0,12,mixedType,1
10,1,0,11,mixedType,1
7,3,0,10,mixedType,1
8,3,0,11,mixedType,1
6,4,0,10,mixedType,1
3,8,0,11,mixedType,1
7,3,0,10,mixedType,1
6,3,0,9,mixedType,1
2,6,0,8,mixedType,1
5,4,0,9,mixedType,1
6,2,0,8,mixedType,1
6,3,0,9,mixedType,1
6,4,0,10,mixedType,1
6,3,0,9,mixedType,1
6,2,0,8,mixedType,1
2,6,0,8,mixedType,1
2,8,0,10,mixedType,1
5,3,0,8,mixedType,1
5,2,0,7,mixedType,0
5,3,0,8,mixedType,1
8,1,0,9,mixedType,1
1,9,0,10,mixedType,1
2,7,0,9,mixedType,1
13,3,0,16,mixedType,2
5,1,0,6,mixedType,0
6,2,0,8,mixedType,1
2,7,0,9,mixedType,1
4,4,0,8,mixedType,1
5,4,0,9,mixedType,1
9,1,0,10,mixedType,1
8,3,0,11,mixedType,1
6,2,0,8,mixedType,1
6,2,0,8,mixedType,1
1,7,0,8,mixedType,1
8,3,0,11,mixedType,1
16,2,0,18,mixedType,2
6,2,0,8,mixedType,1
3,7,0,10,mixedType,1
5,6,0,11,mixedType,1
8,1,0,9,mixedType,1
7,3,0,10,mixedType,1
6,2,0,8,mixedType,1
4,2,0,6,mixedType,0
7,1,0,8,mixedType,1
5,3,0,8,mixedType,1
4,4,0,8,mixedType,1
8,2,0,10,mixedType,1
9,1,0,10,mixedType,1
4,2,0,6,mixedType,0
6,2,0,8,mixedType,1
9,1,0,10,mixedType,1
6,2,0,8,mixedType,1
3,6,0,9,mixedType,1
5,3,0,8,mixedType,1
7,4,0,11,mixedType,1
8,2,0,10,mixedType,1
6,3,0,9,mixedType,1
6,4,0,10,mixedType,1
13,3,0,16,mixedType,2
7,6,0,13,mixedType,1
6,4,0,10,mixedType,1
4,4,0,8,mixedType,1
7,1,0,8,mixedType,1
7,1,0,8,mixedType,1
6,3,0,9,mixedType,1
8,1,0,9,mixedType,1
8,1,0,9,mixedType,1
8,4,0,12,mixedType,1
3,5,0,8,mixedType,1
1,10,0,11,mixedType,1
7,3,0,10,mixedType,1
4,5,0,9,mixedType,1
5,1,0,6,mixedType,0
7,1,0,8,mixedType,1
3,6,0,9,mixedType,1
5,4,0,9,mixedType,1
4,6,0,10,mixedType,1
12,1,0,13,mixedType,1
9,0,1,10,mixedType,1
1,8,0,9,mixedType,1
11,3,0,14,mixedType,2
9,2,0,11,mixedType,1
6,2,0,8,mixedType,1
9,1,0,10,mixedType,1
3,8,0,11,mixedType,1
5,4,0,9,mixedType,1
1,8,0,9,mixedType,1
6,6,0,12,mixedType,1
6,3,0,9,mixedType,1
8,6,0,14,mixedType,2
6,6,0,12,mixedType,1
2,4,0,6,mixedType,0
10,5,1,16,mixedType,2
4,6,0,10,mixedType,1
7,3,0,10,mixedType,1
9,1,0,10,mixedType,1
13,3,0,16,mixedType,2
5,3,0,8,mixedType,1
9,3,0,12,mixedType,1
7,4,0,11,mixedType,1
9,2,0,11,mixedType,1
6,3,0,9,mixedType,1
7,3,0,10,mixedType,1
8,2,0,10,mixedType,1
9,3,0,12,mixedType,1
2,8,0,10,mixedType,1
5,4,0,9,mixedType,1
6,4,0,10,mixedType,1
6,4,0,10,mixedType,1
6,6,0,12,mixedType,1
7,3,0,10,mixedType,1
7,2,0,9,mixedType,1
6,3,0,9,mixedType,1
5,1,0,6,mixedType,0
7,3,0,10,mixedType,1
14,2,0,16,mixedType,2
4,6,0,10,mixedType,1
15,1,0,16,mixedType,2
14,2,0,16,mixedType,2
8,6,0,14,mixedType,2
9,3,0,12,mixedType,1
11,3,0,14,mixedType,2
8,2,0,10,mixedType,1
4,2,0,6,mixedType,0
6,4,0,10,mixedType,1
5,4,0,9,mixedType,1
5,4,0,9,mixedType,1
5,3,0,8,mixedType,1
7,3,0,10,mixedType,1
6,2,0,8,mixedType,1
6,1,0,7,mixedType,0
5,3,0,8,mixedType,1
2,8,0,10,mixedType,1
8,2,0,10,mixedType,1
8,2,0,10,mixedType,1
9,3,0,12,mixedType,1
6,6,0,12,mixedType,1
3,8,0,11,mixedType,1
5,4,0,9,mixedType,1
5,2,0,7,mixedType,0
6,2,0,8,mixedType,1
7,3,0,10,mixedType,1
8,1,0,9,mixedType,1
4,4,0,8,mixedType,1
15,1,0,16,mixedType,2
9,4,0,13,mixedType,1
5,3,1,9,mixedType,1
7,3,0,10,mixedType,1
5,3,0,8,mixedType,1
3,5,0,8,mixedType,1
11,3,0,14,mixedType,2
9,1,0,10,mixedType,1
7,3,0,10,mixedType,1
4,2,0,6,mixedType,0
8,1,0,9,mixedType,1
1,8,0,9,mixedType,1
6,2,0,8,mixedType,1
4,4,0,8,mixedType,1
3,5,0,8,mixedType,1
8,2,0,10,mixedType,1
6,3,0,9,mixedType,1
15,1,0,16,mixedType,2
8,1,0,9,mixedType,1
8,1,0,9,mixedType,1
5,1,0,6,mixedType,0
5,1,0,6,mixedType,0
1,7,0,8,mixedType,1
8,2,0,10,mixedType,1
4,4,0,8,mixedType,1
8,2,0,10,mixedType,1
8,1,0,9,mixedType,1
9,1,0,10,mixedType,1
7,3,0,10,mixedType,1
7,3,0,10,mixedType,1
11,1,0,12,mixedType,1
5,1,0,6,mixedType,0
10,1,0,11,mixedType,1
12,3,0,15,mixedType,2
6,1,0,7,mixedType,0
6,2,0,8,mixedType,1
10,1,0,11,mixedType,1
5,2,0,7,mixedType,0
7,2,0,9,mixedType,1
4,2,0,6,mixedType,0
13,3,0,16,mixedType,2
4,2,0,6,mixedType,0
9,1,0,10,mixedType,1
10,3,1,14,mixedType,2
7,2,0,9,mixedType,1
6,2,0,8,mixedType,1
4,4,0,8,mixedType,1
6,2,0,8,mixedType,1
5,3,0,8,mixedType,1
5,3,0,8,mixedType,1
9,4,0,13,mixedType,1
5,4,0,9,mixedType,1
7,3,0,10,mixedType,1
12,4,0,16,mixedType,2
9,2,0,11,mixedType,1
14,2,0,16,mixedType,2
6,3,0,9,mixedType,1
5,4,0,9,mixedType,1
5,2,0,7,mixedType,0
4,4,0,8,mixedType,1
13,2,2,17,mixedType,2
6,4,0,10,mixedType,1
7,3,0,10,mixedType,1
6,2,0,8,mixedType,1
5,3,0,8,mixedType,1
8,1,0,9,mixedType,1
7,2,0,9,mixedType,1
7,1,0,8,mixedType,1
7,2,0,9,mixedType,1
7,3,0,10,mixedType,1
6,1,0,7,mixedType,0
7,3,0,10,mixedType,1
6,2,0,8,mixedType,1
2,8,0,10,mixedType,1
11,2,0,13,mixedType,1
5,1,0,6,mixedType,0
4,4,0,8,mixedType,1
7,3,0,10,mixedType,1
5,1,0,6,mixedType,0
4,3,1,8,mixedType,1
2,10,0,12,mixedType,1
7,3,0,10,mixedType,1
14,2,0,16,mixedType,2
4,2,0,6,mixedType,0
7,2,0,9,mixedType,1
6,3,0,9,mixedType,1
15,1,0,16,mixedType,2
5,3,0,8,mixedType,1
7,3,0,10,mixedType,1
6,4,0,10,mixedType,1
6,2,0,8,mixedType,1
7,4,0,11,mixedType,1
10,7,2,19,mixedType,2
3,3,0,6,mixedType,0
15,1,0,16,mixedType,2
7,3,0,10,mixedType,1
5,4,0,9,mixedType,1
4,2,0,6,mixedType,0
7,1,0,8,mixedType,1
8,1,0,9,mixedType,1
6,3,0,9,mixedType,1
5,2,0,7,mixedType,0
1,7,0,8,mixedType,1
5,6,0,11,mixedType,1
6,1,0,7,mixedType,0
9,2,0,11,mixedType,1
5,9,0,14,mixedType,2
6,2,0,8,mixedType,1
5,4,0,9,mixedType,1
5,1,0,6,mixedType,0
6,2,0,8,mixedType,1
15,1,0,16,mixedType,2
11,1,0,12,mixedType,1
6,3,0,9,mixedType,1
7,2,0,9,mixedType,1
14,2,0,16,mixedType,2
10,1,0,11,mixedType,1
6,3,0,9,mixedType,1
8,1,0,9,mixedType,1
8,4,0,12,mixedType,1
15,1,0,16,mixedType,2
3,6,0,9,mixedType,1
4,2,0,6,mixedType,0
4,5,0,9,mixedType,1
11,3,0,14,mixedType,2
9,1,0,10,mixedType,1
5,2,0,7,mixedType,0
5,2,0,7,mixedType,0
3,5,0,8,mixedType,1
8,1,0,9,mixedType,1
1,8,0,9,mixedType,1
8,2,0,10,mixedType,1
12,4,0,16,mixedType,2
6,1,0,7,mixedType,0
12,4,0,16,mixedType,2
8,2,0,10,mixedType,1
10,2,0,12,mixedType,1
2,7,0,9,mixedType,1
8,4,0,12,mixedType,1
7,2,0,9,mixedType,1
9,3,0,12,mixedType,1
6,3,0,9,mixedType,1
6,3,0,9,mixedType,1
9,1,0,10,mixedType,1
5,5,0,10,mixedType,1
9,1,0,10,mixedType,1
4,2,0,6,mixedType,0
13,3,0,16,mixedType,2
6,6,0,12,mixedType,1
4,2,0,6,mixedType,0
8,2,0,10,mixedType,1
6,1,0,7,mixedType,0
6,4,0,10,mixedType,1
5,2,0,7,mixedType,0
6,3,0,9,mixedType,1
12,6,0,18,mixedType,2
7,2,0,9,mixedType,1
5,4,0,9,mixedType,1
3,6,0,9,mixedType,1
2,6,0,8,mixedType,1
7,4,0,11,mixedType,1
5,4,0,9,mixedType,1
6,3,0,9,mixedType,1
7,3,0,10,mixedType,1
15,1,0,16,mixedType,2
4,2,0,6,mixedType,0
6,3,0,9,mixedType,1
9,1,0,10,mixedType,1
8,2,0,10,mixedType,1
8,1,0,9,mixedType,1
4,4,0,8,mixedType,1
7,1,0,8,mixedType,1
6,3,0,9,mixedType,1
6,3,0,9,mixedType,1
6,1,0,7,mixedType,0
9,2,0,11,mixedType,1
5,3,0,8,mixedType,1
9,1,0,10,mixedType,1
6,6,0,12,mixedType,1
5,6,0,11,mixedType,1
14,2,0,16,mixedType,2
4,4,0,8,mixedType,1
16,2,2,20,mixedType,2
7,1,0,8,mixedType,1
7,3,0,10,mixedType,1
5,3,0,8,mixedType,1
9,1,0,10,mixedType,1
1,7,0,8,mixedType,1
5,1,0,6,mixedType,0
10,3,0,13,mixedType,1
8,2,0,10,mixedType,1
6,4,0,10,mixedType,1
5,3,0,8,mixedType,1
5,3,0,8,mixedType,1
7,2,0,9,mixedType,1
14,2,0,16,mixedType,2
4,5,0,9,mixedType,1
6,3,0,9,mixedType,1
4,2,0,6,mixedType,0
6,5,0,11,mixedType,1
4,2,0,6,mixedType,0
6,4,0,10,mixedType,1
6,1,0,7,mixedType,0
2,4,0,6,mixedType,0
8,1,0,9,mixedType,1
1,9,0,10,mixedType,1
6,1,0,7,mixedType,0
5,4,0,9,mixedType,1
7,3,0,10,mixedType,1
9,3,0,12,mixedType,1
14,2,0,16,mixedType,2
4,2,0,6,mixedType,0
8,1,0,9,mixedType,1
7,3,0,10,mixedType,1
5,2,0,7,mixedType,0
5,3,0,8,mixedType,1
9,2,0,11,mixedType,1
5,1,0,6,mixedType,0
5,1,0,6,mixedType,0
5,3,0,8,mixedType,1
8,2,0,10,mixedType,1
7,2,0,9,mixedType,1
8,2,0,10,mixedType,1
12,4,0,16,mixedType,2
6,3,0,9,mixedType,1
7,5,0,12,mixedType,1
6,2,0,8,mixedType,1
7,1,0,8,mixedType,1
4,4,0,8,mixedType,1
4,4,0,8,mixedType,1
4,8,0,12,mixedType,1
5,3,0,8,mixedType,1
6,6,0,12,mixedType,1
4,4,0,8,mixedType,1
14,2,0,16,mixedType,2
7,1,0,8,mixedType,1
8,3,0,11,mixedType,1
6,3,0,9,mixedType,1
2,6,0,8,mixedType,1
4,4,0,8,mixedType,1
7,3,0,10,mixedType,1
6,4,0,10,mixedType,1
6,4,0,10,mixedType,1
14,2,0,16,mixedType,2
4,2,0,6,mixedType,0
7,2,0,9,mixedType,1
6,2,0,8,mixedType,1
3,6,0,9,mixedType,1
1,8,0,9,mixedType,1
7,3,0,10,mixedType,1
4,6,0,10,mixedType,1
13,3,0,16,mixedType,2
2,10,0,12,mixedType,1
2,4,0,6,mixedType,0
7,3,0,10,mixedType,1
4,7,0,11,mixedType,1
6,3,0,9,mixedType,1
7,2,0,9,mixedType,1
2,7,0,9,mixedType,1
5,3,0,8,mixedType,1
2,4,0,6,mixedType,0
3,5,0,8,mixedType,1
6,2,0,8,mixedType,1
3,10,0,13,mixedType,1
6,4,0,10,mixedType,1
4,2,0,6,mixedType,0
6,3,0,9,mixedType,1
1,7,0,8,mixedType,1
6,4,0,10,mixedType,1
4,4,0,8,mixedType,1
5,3,0,8,mixedType,1
5,2,0,7,mixedType,0
8,1,0,9,mixedType,1
8,2,0,10,mixedType,1
7,3,0,10,mixedType,1
5,3,0,8,mixedType,1
4,4,0,8,mixedType,1
7,2,0,9,mixedType,1
6,2,0,8,mixedType,1
15,1,0,16,mixedType,2
8,2,0,10,mixedType,1
7,3,0,10,mixedType,1
6,1,0,7,mixedType,0
5,6,0,11,mixedType,1
7,2,0,9,mixedType,1
2,8,0,10,mixedType,1
6,3,0,9,mixedType,1
7,1,0,8,mixedType,1
10,3,0,13,mixedType,1
7,2,0,9,mixedType,1
5,3,0,8,mixedType,1
6,1,0,7,mixedType,0
8,1,0,9,mixedType,1
4,6,0,10,mixedType,1
4,4,0,8,mixedType,1
5,4,0,9,mixedType,1
8,2,0,10,mixedType,1
5,2,0,7,mixedType,0
7,3,0,10,mixedType,1
1,8,0,9,mixedType,1
6,4,0,10,mixedType,1
9,2,0,11,mixedType,1
3,5,0,8,mixedType,1
2,6,0,8,mixedType,1
6,1,0,7,mixedType,0
7,4,0,11,mixedType,1
4,2,0,6,mixedType,0
14,2,0,16,mixedType,2
3,6,0,9,mixedType,1
17,3,2,22,mixedType,2
5,4,0,9,mixedType,1
6,2,0,8,mixedType,1
0,2,0,2,sameType,0
6,3,0,9,mixedType,1
8,1,0,9,mixedType,1
6,3,0,9,mixedType,1
6,2,0,8,mixedType,1
8,1,0,9,mixedType,1
9,3,0,12,mixedType,1
5,3,0,8,mixedType,1
1,8,0,9,mixedType,1
6,4,0,10,mixedType,1
7,1,0,8,mixedType,1
7,3,0,10,mixedType,1
5,2,0,7,mixedType,0
13,3,0,16,mixedType,2
11,3,0,14,mixedType,2
7,2,0,9,mixedType,1
6,3,0,9,mixedType,1
1,7,0,8,mixedType,1
10,1,0,11,mixedType,1
7,1,0,8,mixedType,1
2,8,0,10,mixedType,1
1,8,0,9,mixedType,1
8,1,0,9,mixedType,1
5,6,0,11,mixedType,1
10,1,0,11,mixedType,1
2,8,0,10,mixedType,1
10,1,0,11,mixedType,1
11,4,1,16,mixedType,2
14,2,0,16,mixedType,2
1,10,0,11,mixedType,1
7,5,0,12,mixedType,1
13,3,0,16,mixedType,2
4,2,0,6,mixedType,0
5,2,0,7,mixedType,0
7,2,0,9,mixedType,1
4,2,0,6,mixedType,0
13,3,0,16,mixedType,2
14,2,0,16,mixedType,2
12,3,0,15,mixedType,2
7,3,0,10,mixedType,1
2,8,0,10,mixedType,1
5,4,0,9,mixedType,1
7,1,0,8,mixedType,1
4,4,0,8,mixedType,1
6,4,0,10,mixedType,1
1,12,0,13,mixedType,1
6,1,0,7,mixedType,0
7,3,0,10,mixedType,1
1,8,0,9,mixedType,1
5,3,0,8,mixedType,1
6,3,0,9,mixedType,1
7,1,0,8,mixedType,1
8,1,0,9,mixedType,1
3,3,0,6,mixedType,0
6,4,0,10,mixedType,1
5,3,0,8,mixedType,1
8,2,0,10,mixedType,1
6,4,0,10,mixedType,1
2,6,0,8,mixedType,1
3,6,0,9,mixedType,1
13,3,0,16,mixedType,2
8,3,0,11,mixedType,1
4,4,0,8,mixedType,1
5,8,0,13,mixedType,1
5,3,0,8,mixedType,1
6,4,0,10,mixedType,1
6,6,0,12,mixedType,1
5,3,0,8,mixedType,1
7,2,0,9,mixedType,1
8,2,0,10,mixedType,1
7,3,0,10,mixedType,1
4,5,0,9,mixedType,1
6,3,0,9,mixedType,1
5,1,0,6,mixedType,0
7,3,0,10,mixedType,1
6,2,0,8,mixedType,1
8,3,0,11,mixedType,1
7,3,0,10,mixedType,1
6,7,0,13,mixedType,1
7,3,0,10,mixedType,1
11,1,0,12,mixedType,1
8,1,0,9,mixedType,1
5,1,0,6,mixedType,0
5,3,0,8,mixedType,1
4,2,0,6,mixedType,0
8,1,0,9,mixedType,1
6,3,0,9,mixedType,1
5,6,0,11,mixedType,1
6,4,0,10,mixedType,1
7,3,0,10,mixedType,1
10,2,0,12,mixedType,1
11,5,0,16,mixedType,2
8,2,0,10,mixedType,1
12,3,0,15,mixedType,2
6,3,0,9,mixedType,1
7,2,0,9,mixedType,1
8,2,0,10,mixedType,1
5,6,0,11,mixedType,1
5,2,0,7,mixedType,0
6,4,0,10,mixedType,1
7,3,0,10,mixedType,1
6,4,0,10,mixedType,1
6,5,0,11,mixedType,1
7,2,0,9,mixedType,1
4,2,0,6,mixedType,0
7,4,0,11,mixedType,1
2,6,0,8,mixedType,1
6,1,0,7,mixedType,0
4,4,0,8,mixedType,1
17,5,0,22,mixedType,2
9,1,0,10,mixedType,1
5,4,0,9,mixedType,1
8,2,0,10,mixedType,1
8,4,0,12,mixedType,1
7,3,0,10,mixedType,1
7,3,0,10,mixedType,1
12,4,0,16,mixedType,2
5,4,0,9,mixedType,1
6,3,0,9,mixedType,1
8,2,0,10,mixedType,1
7,6,0,13,mixedType,1
7,3,0,10,mixedType,1
3,5,0,8,mixedType,1
5,3,0,8,mixedType,1
4,4,0,8,mixedType,1
5,4,0,9,mixedType,1
5,1,0,6,mixedType,0
9,3,0,12,mixedType,1
5,4,0,9,mixedType,1
5,1,0,6,mixedType,0
12,3,0,15,mixedType,2
9,4,0,13,mixedType,1
14,2,0,16,mixedType,2
2,4,0,6,mixedType,0
4,6,0,10,mixedType,1
12,4,0,16,mixedType,2
4,4,0,8,mixedType,1
6,5,0,11,mixedType,1
4,2,0,6,mixedType,0
8,2,0,10,mixedType,1
8,2,0,10,mixedType,1
6,2,0,8,mixedType,1
5,3,0,8,mixedType,1
6,2,0,8,mixedType,1
7,2,0,9,mixedType,1
5,2,0,7,mixedType,0
2,6,0,8,mixedType,1
5,3,0,8,mixedType,1
6,2,0,8,mixedType,1
13,3,0,16,mixedType,2
6,2,0,8,mixedType,1
9,1,0,10,mixedType,1
3,6,0,9,mixedType,1
4,4,0,8,mixedType,1
6,1,0,7,mixedType,0
7,2,0,9,mixedType,1
4,2,0,6,mixedType,0
6,6,0,12,mixedType,1
4,4,0,8,mixedType,1
7,4,0,11,mixedType,1
5,4,0,9,mixedType,1
7,2,0,9,mixedType,1
9,3,3,15,mixedType,2
4,4,0,8,mixedType,1
6,2,0,8,mixedType,1
7,3,0,10,mixedType,1
7,3,0,10,mixedType,1
15,1,0,16,mixedType,2
12,3,0,15,mixedType,2
12,4,0,16,mixedType,2
10,3,0,13,mixedType,1
2,6,0,8,mixedType,1
13,3,0,16,mixedType,2
6,3,0,9,mixedType,1
5,4,0,9,mixedType,1
7,2,0,9,mixedType,1
4,4,0,8,mixedType,1
6,2,0,8,mixedType,1
11,3,0,14,mixedType,2
2,7,0,9,mixedType,1
4,4,0,8,mixedType,1
0,5,1,6,mixedType,0
9,1,0,10,mixedType,1
11,2,1,14,mixedType,2
10,2,0,12,mixedType,1
9,1,0,10,mixedType,1
6,2,0,8,mixedType,1
6,3,0,9,mixedType,1
5,4,0,9,mixedType,1
5,4,0,9,mixedType,1
5,3,0,8,mixedType,1
4,4,0,8,mixedType,1
3,3,0,6,mixedType,0
5,5,0,10,mixedType,1
6,2,0,8,mixedType,1
7,3,0,10,mixedType,1
4,4,0,8,mixedType,1
11,2,0,13,mixedType,1
7,2,0,9,mixedType,1
5,4,0,9,mixedType,1
15,1,0,16,mixedType,2
7,3,0,10,mixedType,1
9,3,0,12,mixedType,1
7,3,0,10,mixedType,1
11,3,0,14,mixedType,2
6,1,0,7,mixedType,0
2,8,0,10,mixedType,1
7,1,0,8,mixedType,1
8,1,0,9,mixedType,1
6,3,0,9,mixedType,1
7,3,0,10,mixedType,1
11,1,0,12,mixedType,1
4,2,0,6,mixedType,0
5,5,0,10,mixedType,1
6,3,0,9,mixedType,1
7,2,0,9,mixedType,1
5,3,0,8,mixedType,1
5,4,0,9,mixedType,1
4,6,0,10,mixedType,1
7,2,0,9,mixedType,1
8,2,0,10,mixedType,1
5,2,0,7,mixedType,0
12,1,0,13,mixedType,1
6,3,0,9,mixedType,1
3,6,0,9,mixedType,1
7,3,0,10,mixedType,1
8,2,0,10,mixedType,1
1,8,0,9,mixedType,1
2,4,0,6,mixedType,0
5,4,0,9,mixedType,1
5,4,0,9,mixedType,1
8,1,0,9,mixedType,1
6,3,0,9,mixedType,1
5,2,0,7,mixedType,0
8,2,0,10,mixedType,1
6,4,0,10,mixedType,1
6,6,0,12,mixedType,1
4,4,0,8,mixedType,1
6,3,0,9,mixedType,1
6,4,0,10,mixedType,1
9,1,0,10,mixedType,1
8,2,0,10,mixedType,1
6,3,0,9,mixedType,1
7,2,0,9,mixedType,1
14,2,0,16,mixedType,2
13,3,0,16,mixedType,2
6,3,0,9,mixedType,1
2,6,0,8,mixedType,1
6,4,0,10,mixedType,1
7,6,0,13,mixedType,1
5,1,0,6,mixedType,0
6,3,0,9,mixedType,1
15,1,0,16,mixedType,2
8,2,0,10,mixedType,1
6,3,0,9,mixedType,1
4,4,0,8,mixedType,1
9,1,0,10,mixedType,1
9,2,0,11,mixedType,1
5,3,0,8,mixedType,1
4,4,0,8,mixedType,1
14,2,0,16,mixedType,2
3,5,0,8,mixedType,1
12,5,1,18,mixedType,2
6,3,0,9,mixedType,1
8,2,0,10,mixedType,1
4,4,0,8,mixedType,1
7,2,0,9,mixedType,1
8,4,0,12,mixedType,1
11,1,0,12,mixedType,1
7,3,0,10,mixedType,1
0,8,1,9,mixedType,1
11,2,0,13,mixedType,1
8,2,0,10,mixedType,1
5,3,0,8,mixedType,1
6,3,0,9,mixedType,1
8,2,0,10,mixedType,1
5,1,0,6,mixedType,0
6,3,0,9,mixedType,1
7,2,0,9,mixedType,1
8,3,0,11,mixedType,1
5,1,0,6,mixedType,0
7,3,0,10,mixedType,1
4,4,0,8,mixedType,1
8,2,0,10,mixedType,1
8,2,0,10,mixedType,1
8,2,0,10,mixedType,1
7,2,0,9,mixedType,1
6,4,0,10,mixedType,1
4,2,0,6,mixedType,0
7,2,0,9,mixedType,1
2,6,0,8,mixedType,1
6,3,0,9,mixedType,1
10,2,0,12,mixedType,1
7,2,0,9,mixedType,1
6,2,0,8,mixedType,1
11,2,0,13,mixedType,1
5,2,0,7,mixedType,0
6,3,0,9,mixedType,1
6,3,0,9,mixedType,1
5,2,0,7,mixedType,0
7,3,0,10,mixedType,1
7,3,0,10,mixedType,1
7,2,0,9,mixedType,1
7,3,0,10,mixedType,1
7,3,0,10,mixedType,1
4,4,0,8,mixedType,1
8,1,0,9,mixedType,1
14,2,0,16,mixedType,2
8,2,0,10,mixedType,1
6,2,0,8,mixedType,1
7,3,0,10,mixedType,1
6,6,0,12,mixedType,1
8,2,0,10,mixedType,1
8,3,0,11,mixedType,1
7,1,0,8,mixedType,1
6,1,0,7,mixedType,0
7,1,0,8,mixedType,1
4,2,0,6,mixedType,0
12,3,0,15,mixedType,2
6,3,0,9,mixedType,1
6,1,0,7,mixedType,0
5,3,0,8,mixedType,1
12,1,0,13,mixedType,1
8,2,0,10,mixedType,1
5,1,0,6,mixedType,0
7,3,0,10,mixedType,1
6,2,0,8,mixedType,1
1,9,0,10,mixedType,1
4,2,0,6,mixedType,0
5,2,0,7,mixedType,0
9,1,0,10,mixedType,1
6,2,0,8,mixedType,1
8,2,0,10,mixedType,1
9,4,0,13,mixedType,1
7,2,0,9,mixedType,1
4,2,0,6,mixedType,0
6,2,0,8,mixedType,1
6,3,0,9,mixedType,1
3,8,0,11,mixedType,1
7,3,0,10,mixedType,1
4,4,0,8,mixedType,1
9,2,0,11,mixedType,1
5,3,0,8,mixedType,1
11,2,0,13,mixedType,1
4,2,0,6,mixedType,0
15,1,0,16,mixedType,2
5,8,0,13,mixedType,1
7,3,0,10,mixedType,1
4,4,0,8,mixedType,1
3,6,0,9,mixedType,1
5,3,0,8,mixedType,1
5,3,0,8,mixedType,1
6,3,0,9,mixedType,1
2,6,0,8,mixedType,1
9,2,0,11,mixedType,1
10,1,0,11,mixedType,1
8,2,0,10,mixedType,1
12,4,0,16,mixedType,2
1,9,0,10,mixedType,1
6,3,0,9,mixedType,1
7,3,0,10,mixedType,1
4,4,0,8,mixedType,1
6,4,0,10,mixedType,1
9,3,0,12,mixedType,1
5,3,0,8,mixedType,1
6,4,0,10,mixedType,1
7,3,0,10,mixedType,1
12,1,0,13,mixedType,1
17,0,3,20,mixedType,2
8,2,0,10,mixedType,1
11,5,0,16,mixedType,2
7,3,0,10,mixedType,1
8,1,0,9,mixedType,1
7,3,0,10,mixedType,1
8,1,0,9,mixedType,1
5,2,0,7,mixedType,0
4,6,0,10,mixedType,1
7,3,0,10,mixedType,1
8,3,0,11,mixedType,1
9,4,0,13,mixedType,1
14,2,0,16,mixedType,2
6,7,0,13,mixedType,1
5,4,0,9,mixedType,1
7,3,0,10,mixedType,1
6,1,0,7,mixedType,0
8,1,0,9,mixedType,1
9,1,0,10,mixedType,1
7,3,0,10,mixedType,1
2,4,0,6,mixedType,0
2,7,0,9,mixedType,1
5,1,0,6,mixedType,0
2,8,0,10,mixedType,1
8,2,0,10,mixedType,1
10,3,0,13,mixedType,1
4,4,0,8,mixedType,1
4,4,0,8,mixedType,1
3,5,0,8,mixedType,1
11,3,0,14,mixedType,2
13,3,0,16,mixedType,2
9,3,0,12,mixedType,1
8,2,0,10,mixedType,1
6,4,0,10,mixedType,1
9,2,0,11,mixedType,1
5,4,0,9,mixedType,1
6,6,0,12,mixedType,1
7,2,0,9,mixedType,1
8,2,0,10,mixedType,1
8,4,0,12,mixedType,1
5,2,0,7,mixedType,0
11,6,0,17,mixedType,2
8,1,0,9,mixedType,1
2,6,0,8,mixedType,1
7,4,0,11,mixedType,1
10,2,0,12,mixedType,1
4,2,0,6,mixedType,0
5,1,0,6,mixedType,0
7,2,0,9,mixedType,1
8,1,0,9,mixedType,1
4,2,0,6,mixedType,0
7,4,0,11,mixedType,1
9,4,0,13,mixedType,1
4,2,0,6,mixedType,0
15,1,0,16,mixedType,2
6,3,0,9,mixedType,1
13,4,0,17,mixedType,2
6,3,0,9,mixedType,1
4,6,0,10,mixedType,1
1,8,0,9,mixedType,1
8,0,1,9,mixedType,1
8,2,0,10,mixedType,1
6,4,0,10,mixedType,1
8,2,0,10,mixedType,1
6,4,0,10,mixedType,1
6,2,0,8,mixedType,1
4,4,0,8,mixedType,1
9,2,0,11,mixedType,1
6,3,0,9,mixedType,1
9,1,0,10,mixedType,1
15,1,0,16,mixedType,2
10,2,0,12,mixedType,1
8,2,0,10,mixedType,1
5,2,0,7,mixedType,0
11,3,0,14,mixedType,2
15,1,0,16,mixedType,2
7,3,0,10,mixedType,1
12,4,0,16,mixedType,2
9,4,0,13,mixedType,1
7,1,0,8,mixedType,1
7,3,0,10,mixedType,1
7,3,0,10,mixedType,1
8,4,0,12,mixedType,1
5,1,0,6,mixedType,0
3,3,0,6,mixedType,0
17,2,0,19,mixedType,2
6,3,0,9,mixedType,1
8,3,0,11,mixedType,1
8,2,0,10,mixedType,1
5,4,0,9,mixedType,1
7,3,0,10,mixedType,1
5,2,0,7,mixedType,0
7,2,0,9,mixedType,1
8,4,0,12,mixedType,1
6,2,0,8,mixedType,1
7,7,0,14,mixedType,2
4,4,0,8,mixedType,1
5,2,0,7,mixedType,0
5,3,0,8,mixedType,1
6,3,0,9,mixedType,1
14,1,0,15,mixedType,2
14,2,0,16,mixedType,2
7,3,0,10,mixedType,1
6,4,0,10,mixedType,1
5,3,0,8,mixedType,1
11,3,0,14,mixedType,2
6,4,0,10,mixedType,1
3,6,0,9,mixedType,1
5,4,0,9,mixedType,1
7,2,0,9,mixedType,1
5,1,0,6,mixedType,0
5,2,0,7,mixedType,0
15,1,0,16,mixedType,2
5,5,0,10,mixedType,1
7,1,0,8,mixedType,1
8,4,0,12,mixedType,1
7,2,0,9,mixedType,1
6,4,0,10,mixedType,1
4,4,0,8,mixedType,1
6,1,0,7,mixedType,0
4,2,0,6,mixedType,0
2,8,0,10,mixedType,1
7,1,0,8,mixedType,1
8,2,0,10,mixedType,1
9,1,0,10,mixedType,1
1,8,0,9,mixedType,1
2,6,0,8,mixedType,1
14,2,0,16,mixedType,2
5,3,0,8,mixedType,1
5,3,0,8,mixedType,1
14,2,0,16,mixedType,2
3,8,0,11,mixedType,1
6,3,0,9,mixedType,1
8,4,0,12,mixedType,1
8,2,0,10,mixedType,1
14,3,0,17,mixedType,2
7,3,0,10,mixedType,1
5,3,0,8,mixedType,1
7,1,0,8,mixedType,1
6,2,0,8,mixedType,1
5,4,0,9,mixedType,1
3,7,0,10,mixedType,1
4,4,0,8,mixedType,1
14,2,0,16,mixedType,2
6,3,0,9,mixedType,1
8,4,0,12,mixedType,1
10,2,0,12,mixedType,1
7,2,0,9,mixedType,1
8,3,0,11,mixedType,1
7,2,0,9,mixedType,1
7,4,0,11,mixedType,1
2,6,0,8,mixedType,1
9,3,0,12,mixedType,1
5,4,0,9,mixedType,1
13,3,0,16,mixedType,2
9,1,0,10,mixedType,1
6,3,0,9,mixedType,1
6,2,0,8,mixedType,1
5,3,0,8,mixedType,1
5,2,0,7,mixedType,0
6,3,0,9,mixedType,1
4,6,0,10,mixedType,1
1,10,0,11,mixedType,1
8,2,0,10,mixedType,1
3,6,0,9,mixedType,1
5,3,0,8,mixedType,1
4,6,0,10,mixedType,1
4,4,0,8,mixedType,1
3,7,0,10,mixedType,1
6,6,0,12,mixedType,1
5,3,0,8,mixedType,1
9,2,0,11,mixedType,1
11,1,0,12,mixedType,1
7,2,0,9,mixedType,1
6,1,0,7,mixedType,0
13,3,0,16,mixedType,2
11,5,0,16,mixedType,2
5,2,0,7,mixedType,0
15,1,0,16,mixedType,2
7,2,0,9,mixedType,1
11,5,0,16,mixedType,2
8,1,0,9,mixedType,1
14,2,0,16,mixedType,2
6,3,0,9,mixedType,1
5,6,0,11,mixedType,1
7,6,1,14,mixedType,2
7,3,0,10,mixedType,1
6,3,0,9,mixedType,1
5,3,0,8,mixedType,1
10,3,0,13,mixedType,1
9,3,0,12,mixedType,1
6,3,0,9,mixedType,1
6,3,0,9,mixedType,1
8,1,0,9,mixedType,1
11,5,0,16,mixedType,2
14,2,0,16,mixedType,2
4,4,0,8,mixedType,1
6,3,0,9,mixedType,1
7,1,0,8,mixedType,1
6,3,0,9,mixedType,1
7,1,0,8,mixedType,1
5,3,0,8,mixedType,1
4,2,0,6,mixedType,0
3,7,0,10,mixedType,1
7,3,0,10,mixedType,1
5,4,0,9,mixedType,1
9,1,0,10,mixedType,1
8,1,0,9,mixedType,1
9,3,0,12,mixedType,1
7,2,0,9,mixedType,1
5,3,0,8,mixedType,1
7,2,0,9,mixedType,1
2,6,0,8,mixedType,1
7,1,0,8,mixedType,1
10,4,0,14,mixedType,2
11,1,0,12,mixedType,1
7,4,0,11,mixedType,1
1,9,0,10,mixedType,1
13,3,0,16,mixedType,2
4,2,0,6,mixedType,0
9,1,0,10,mixedType,1
4,4,0,8,mixedType,1
6,3,0,9,mixedType,1
8,3,0,11,mixedType,1
5,4,0,9,mixedType,1
7,3,0,10,mixedType,1
1,8,0,9,mixedType,1
1,9,0,10,mixedType,1
5,4,0,9,mixedType,1
4,4,0,8,mixedType,1
8,1,0,9,mixedType,1
14,2,0,16,mixedType,2
9,2,0,11,mixedType,1
6,3,0,9,mixedType,1
5,5,0,10,mixedType,1
8,1,0,9,mixedType,1
9,1,0,10,mixedType,1
7,1,0,8,mixedType,1
11,5,0,16,mixedType,2
7,2,0,9,mixedType,1
7,2,0,9,mixedType,1
4,4,0,8,mixedType,1
4,2,0,6,mixedType,0
15,1,0,16,mixedType,2
7,3,0,10,mixedType,1
8,3,0,11,mixedType,1
4,4,0,8,mixedType,1
8,2,0,10,mixedType,1
8,1,0,9,mixedType,1
11,3,1,15,mixedType,2
6,4,0,10,mixedType,1
6,4,0,10,mixedType,1
3,6,0,9,mixedType,1
7,3,0,10,mixedType,1
6,4,0,10,mixedType,1
5,6,0,11,mixedType,1
6,3,0,9,mixedType,1
7,2,0,9,mixedType,1
4,2,0,6,mixedType,0
14,2,0,16,mixedType,2
7,3,0,10,mixedType,1
9,1,0,10,mixedType,1
7,2,0,9,mixedType,1
5,3,0,8,mixedType,1
5,4,0,9,mixedType,1
4,6,0,10,mixedType,1
5,1,0,6,mixedType,0
6,2,0,8,mixedType,1
14,2,0,16,mixedType,2
5,3,0,8,mixedType,1
6,1,0,7,mixedType,0
6,1,0,7,mixedType,0
7,1,0,8,mixedType,1
11,3,0,14,mixedType,2
7,3,0,10,mixedType,1
6,4,0,10,mixedType,1
8,1,0,9,mixedType,1
7,3,0,10,mixedType,1
7,4,0,11,mixedType,1
7,3,0,10,mixedType,1
6,3,0,9,mixedType,1
9,2,0,11,mixedType,1
6,3,0,9,mixedType,1
2,4,0,6,mixedType,0
8,3,0,11,mixedType,1
14,1,0,15,mixedType,2
4,4,0,8,mixedType,1
11,5,0,16,mixedType,2
8,2,0,10,mixedType,1
3,6,0,9,mixedType,1
2,6,0,8,mixedType,1
15,1,0,16,mixedType,2
7,1,0,8,mixedType,1
5,1,0,6,mixedType,0
6,3,0,9,mixedType,1
7,2,0,9,mixedType,1
7,4,0,11,mixedType,1
1,11,0,12,mixedType,1
15,1,0,16,mixedType,2
7,3,0,10,mixedType,1
6,1,0,7,mixedType,0
6,1,0,7,mixedType,0
6,4,0,10,mixedType,1
2,8,0,10,mixedType,1
4,2,0,6,mixedType,0
5,4,0,9,mixedType,1
5,2,0,7,mixedType,0
5,3,0,8,mixedType,1
4,4,0,8,mixedType,1
4,2,0,6,mixedType,0
6,1,0,7,mixedType,0
6,3,0,9,mixedType,1
8,3,0,11,mixedType,1
8,2,0,10,mixedType,1
7,1,0,8,mixedType,1
2,7,0,9,mixedType,1
3,6,0,9,mixedType,1
6,1,0,7,mixedType,0
7,2,0,9,mixedType,1
7,1,0,8,mixedType,1
3,10,0,13,mixedType,1
5,2,0,7,mixedType,0
3,5,0,8,mixedType,1
8,4,0,12,mixedType,1
6,4,0,10,mixedType,1
6,2,0,8,mixedType,1
9,1,0,10,mixedType,1
10,1,0,11,mixedType,1
15,1,0,16,mixedType,2
8,1,0,9,mixedType,1
7,0,1,8,mixedType,1
11,2,0,13,mixedType,1
13,3,0,16,mixedType,2
8,2,0,10,mixedType,1
9,4,0,13,mixedType,1
8,2,0,10,mixedType,1
10,3,0,13,mixedType,1
8,2,0,10,mixedType,1
4,2,0,6,mixedType,0
3,3,0,6,mixedType,0
5,3,0,8,mixedType,1
15,1,0,16,mixedType,2
8,2,0,10,mixedType,1
7,2,0,9,mixedType,1
8,2,0,10,mixedType,1
6,3,0,9,mixedType,1
2,6,0,8,mixedType,1
6,4,0,10,mixedType,1
5,1,0,6,mixedType,0
5,3,0,8,mixedType,1
7,2,0,9,mixedType,1
15,1,0,16,mixedType,2
6,1,0,7,mixedType,0
7,2,0,9,mixedType,1
7,2,0,9,mixedType,1
6,2,0,8,mixedType,1
6,3,0,9,mixedType,1
7,3,0,10,mixedType,1
13,3,0,16,mixedType,2
6,4,0,10,mixedType,1
8,2,0,10,mixedType,1
5,5,0,10,mixedType,1
4,4,0,8,mixedType,1
7,3,0,10,mixedType,1
12,3,0,15,mixedType,2
9,4,0,13,mixedType,1
7,6,0,13,mixedType,1
3,6,0,9,mixedType,1
6,1,0,7,mixedType,0
7,2,0,9,mixedType,1
2,4,0,6,mixedType,0
4,10,0,14,mixedType,2
5,1,0,6,mixedType,0
9,4,0,13,mixedType,1
6,2,0,8,mixedType,1
4,2,0,6,mixedType,0
2,4,0,6,mixedType,0
9,4,0,13,mixedType,1
6,3,0,9,mixedType,1
8,4,3,15,mixedType,2
7,1,0,8,mixedType,1
8,3,0,11,mixedType,1
4,4,0,8,mixedType,1
3,5,0,8,mixedType,1
5,3,0,8,mixedType,1
15,1,0,16,mixedType,2
5,8,0,13,mixedType,1
1,10,0,11,mixedType,1
7,3,0,10,mixedType,1
12,3,0,15,mixedType,2
7,2,0,9,mixedType,1
12,1,0,13,mixedType,1
8,2,0,10,mixedType,1
6,1,0,7,mixedType,0
14,2,0,16,mixedType,2
13,3,0,16,mixedType,2
7,1,0,8,mixedType,1
6,1,0,7,mixedType,0
1,10,0,11,mixedType,1
11,3,0,14,mixedType,2
6,2,0,8,mixedType,1
3,6,0,9,mixedType,1
5,3,0,8,mixedType,1
5,1,0,6,mixedType,0
1,8,0,9,mixedType,1
8,1,0,9,mixedType,1
7,3,0,10,mixedType,1
2,6,0,8,mixedType,1
2,4,0,6,mixedType,0
6,2,0,8,mixedType,1
5,3,0,8,mixedType,1
2,6,0,8,mixedType,1
4,2,0,6,mixedType,0
8,2,0,10,mixedType,1
6,3,0,9,mixedType,1
5,2,0,7,mixedType,0
7,2,0,9,mixedType,1
5,1,0,6,mixedType,0
6,3,0,9,mixedType,1
6,4,0,10,mixedType,1
7,3,0,10,mixedType,1
4,5,0,9,mixedType,1
3,6,0,9,mixedType,1
5,3,0,8,mixedType,1
10,4,0,14,mixedType,2
5,2,0,7,mixedType,0
14,2,0,16,mixedType,2
7,3,0,10,mixedType,1
5,3,0,8,mixedType,1
3,6,0,9,mixedType,1
5,3,0,8,mixedType,1
11,1,0,12,mixedType,1
6,5,0,11,mixedType,1
8,2,0,10,mixedType,1
5,3,0,8,mixedType,1
5,3,0,8,mixedType,1
6,1,0,7,mixedType,0
5,5,0,10,mixedType,1
7,2,0,9,mixedType,1
5,4,0,9,mixedType,1
2,6,0,8,mixedType,1
4,4,0,8,mixedType,1
14,2,0,16,mixedType,2
8,1,0,9,mixedType,1
9,1,0,10,mixedType,1
4,4,0,8,mixedType,1
5,2,0,7,mixedType,0
8,2,0,10,mixedType,1
11,2,0,13,mixedType,1
5,1,0,6,mixedType,0
10,1,0,11,mixedType,1
7,4,0,11,mixedType,1
10,1,0,11,mixedType,1
9,4,0,13,mixedType,1
6,3,0,9,mixedType,1
7,4,0,11,mixedType,1
8,4,0,12,mixedType,1
11,1,0,12,mixedType,1
5,8,0,13,mixedType,1
6,2,0,8,mixedType,1
8,2,0,10,mixedType,1
5,2,0,7,mixedType,0
6,1,0,7,mixedType,0
7,2,0,9,mixedType,1
4,4,0,8,mixedType,1
2,6,0,8,mixedType,1
6,1,0,7,mixedType,0
11,1,0,12,mixedType,1
8,2,0,10,mixedType,1
9,2,0,11,mixedType,1
6,3,0,9,mixedType,1
5,3,0,8,mixedType,1
7,2,0,9,mixedType,1
5,5,0,10,mixedType,1
8,1,0,9,mixedType,1
11,1,0,12,mixedType,1
2,6,0,8,mixedType,1
7,1,0,8,mixedType,1
7,2,0,9,mixedType,1
4,2,0,6,mixedType,0
13,3,0,16,mixedType,2
8,2,0,10,mixedType,1
3,3,0,6,mixedType,0
8,2,0,10,mixedType,1
9,3,2,14,mixedType,2
6,2,0,8,mixedType,1
11,5,0,16,mixedType,2
1,7,0,8,mixedType,1
6,1,0,7,mixedType,0
4,5,0,9,mixedType,1
14,2,0,16,mixedType,2
6,4,0,10,mixedType,1
6,3,0,9,mixedType,1
3,5,0,8,mixedType,1
8,3,0,11,mixedType,1
13,3,0,16,mixedType,2
8,3,0,11,mixedType,1
6,3,0,9,mixedType,1
6,2,0,8,mixedType,1
6,2,0,8,mixedType,1
1,8,0,9,mixedType,1
9,1,0,10,mixedType,1
5,3,0,8,mixedType,1
7,2,0,9,mixedType,1
4,5,0,9,mixedType,1
6,2,0,8,mixedType,1
7,2,0,9,mixedType,1
7,2,0,9,mixedType,1
2,8,0,10,mixedType,1
7,4,0,11,mixedType,1
6,1,0,7,mixedType,0
6,1,0,7,mixedType,0
7,2,0,9,mixedType,1
8,2,0,10,mixedType,1
7,2,0,9,mixedType,1
8,3,0,11,mixedType,1
7,4,0,11,mixedType,1
8,2,0,10,mixedType,1
5,4,0,9,mixedType,1
5,2,0,7,mixedType,0
4,2,0,6,mixedType,0
9,2,0,11,mixedType,1
9,2,0,11,mixedType,1
4,4,0,8,mixedType,1
13,3,0,16,mixedType,2
6,1,0,7,mixedType,0
8,2,0,10,mixedType,1
5,2,0,7,mixedType,0
6,1,0,7,mixedType,0
8,2,0,10,mixedType,1
8,4,0,12,mixedType,1
4,4,0,8,mixedType,1
5,5,0,10,mixedType,1
7,3,0,10,mixedType,1
8,4,0,12,mixedType,1
6,1,0,7,mixedType,0
14,2,0,16,mixedType,2
14,2,0,16,mixedType,2
5,2,0,7,mixedType,0
8,1,0,9,mixedType,1
3,6,0,9,mixedType,1
6,1,0,7,mixedType,0
7,1,0,8,mixedType,1
8,2,0,10,mixedType,1
3,7,0,10,mixedType,1
6,6,0,12,mixedType,1
9,3,0,12,mixedType,1
7,2,0,9,mixedType,1
14,2,0,16,mixedType,2
5,2,0,7,mixedType,0
8,4,0,12,mixedType,1
5,1,0,6,mixedType,0
3,6,0,9,mixedType,1
7,2,0,9,mixedType,1
13,3,0,16,mixedType,2
5,2,0,7,mixedType,0
5,3,0,8,mixedType,1
5,3,0,8,mixedType,1
3,7,0,10,mixedType,1
8,2,0,10,mixedType,1
6,3,0,9,mixedType,1
8,2,0,10,mixedType,1
7,2,0,9,mixedType,1
8,4,0,12,mixedType,1
7,3,0,10,mixedType,1
6,2,0,8,mixedType,1
6,4,0,10,mixedType,1
7,3,0,10,mixedType,1
14,1,0,15,mixedType,2
8,2,0,10,mixedType,1
5,8,0,13,mixedType,1
11,4,0,15,mixedType,2
11,3,0,14,mixedType,2
6,1,0,7,mixedType,0
7,3,0,10,mixedType,1
9,2,0,11,mixedType,1
7,1,0,8,mixedType,1
6,1,0,7,mixedType,0
12,4,0,16,mixedType,2
6,3,0,9,mixedType,1
8,1,0,9,mixedType,1
10,6,0,16,mixedType,2
6,2,0,8,mixedType,1
4,4,0,8,mixedType,1
8,3,0,11,mixedType,1
9,3,2,14,mixedType,2
1,8,0,9,mixedType,1
8,1,0,9,mixedType,1
5,4,0,9,mixedType,1
5,2,0,7,mixedType,0
9,1,0,10,mixedType,1
6,2,0,8,mixedType,1
3,10,0,13,mixedType,1
6,1,0,7,mixedType,0
6,3,0,9,mixedType,1
5,3,0,8,mixedType,1
3,6,0,9,mixedType,1
7,4,0,11,mixedType,1
7,3,0,10,mixedType,1
8,2,0,10,mixedType,1
5,3,0,8,mixedType,1
7,1,0,8,mixedType,1
11,4,0,15,mixedType,2
6,10,0,16,mixedType,2
5,2,0,7,mixedType,0
8,4,0,12,mixedType,1
4,4,0,8,mixedType,1
6,1,0,7,mixedType,0
9,1,0,10,mixedType,1
9,4,0,13,mixedType,1
5,4,0,9,mixedType,1
7,3,0,10,mixedType,1
2,8,0,10,mixedType,1
1,7,0,8,mixedType,1
6,1,0,7,mixedType,0
5,2,0,7,mixedType,0
6,3,0,9,mixedType,1
6,2,0,8,mixedType,1
6,3,0,9,mixedType,1
5,6,0,11,mixedType,1
7,4,0,11,mixedType,1
8,2,0,10,mixedType,1
6,2,0,8,mixedType,1
7,3,0,10,mixedType,1
7,6,0,13,mixedType,1
4,4,0,8,mixedType,1
12,1,1,14,mixedType,2
6,2,0,8,mixedType,1
8,4,0,12,mixedType,1
5,2,0,7,mixedType,0
5,3,0,8,mixedType,1
5,1,0,6,mixedType,0
7,2,0,9,mixedType,1
4,2,0,6,mixedType,0
5,2,0,7,mixedType,0
8,4,0,12,mixedType,1
5,3,0,8,mixedType,1
7,1,0,8,mixedType,1
7,1,0,8,mixedType,1
5,2,0,7,mixedType,0
5,3,0,8,mixedType,1
2,6,0,8,mixedType,1
7,3,0,10,mixedType,1
14,2,0,16,mixedType,2
7,2,0,9,mixedType,1
10,2,0,12,mixedType,1
6,3,0,9,mixedType,1
7,2,0,9,mixedType,1
6,1,0,7,mixedType,0
7,2,0,9,mixedType,1
14,2,0,16,mixedType,2
14,2,0,16,mixedType,2
6,3,0,9,mixedType,1
6,1,0,7,mixedType,0
13,3,0,16,mixedType,2
7,3,0,10,mixedType,1
6,1,0,7,mixedType,0
8,4,0,12,mixedType,1
7,2,0,9,mixedType,1
7,3,0,10,mixedType,1
5,2,0,7,mixedType,0
2,6,0,8,mixedType,1
5,4,0,9,mixedType,1
5,3,0,8,mixedType,1
7,1,0,8,mixedType,1
6,3,0,9,mixedType,1
11,1,0,12,mixedType,1
11,4,0,15,mixedType,2
7,3,0,10,mixedType,1
15,1,0,16,mixedType,2
13,2,1,16,mixedType,2
8,2,0,10,mixedType,1
6,1,0,7,mixedType,0
15,1,0,16,mixedType,2
8,2,0,10,mixedType,1
6,2,0,8,mixedType,1
5,2,0,7,mixedType,0
3,7,0,10,mixedType,1
4,2,0,6,mixedType,0
5,4,0,9,mixedType,1
11,3,0,14,mixedType,2
6,3,0,9,mixedType,1
2,6,0,8,mixedType,1
7,3,0,10,mixedType,1
6,4,0,10,mixedType,1
6,3,0,9,mixedType,1
7,2,0,9,mixedType,1
14,2,0,16,mixedType,2
5,6,0,11,mixedType,1
4,6,0,10,mixedType,1
4,6,0,10,mixedType,1
5,3,0,8,mixedType,1
7,2,0,9,mixedType,1
5,4,0,9,mixedType,1
5,3,0,8,mixedType,1
14,2,0,16,mixedType,2
8,1,0,9,mixedType,1
7,2,0,9,mixedType,1
8,2,0,10,mixedType,1
6,2,0,8,mixedType,1
6,4,0,10,mixedType,1
1,8,0,9,mixedType,1
4,2,0,6,mixedType,0
4,4,0,8,mixedType,1
3,6,0,9,mixedType,1
7,2,0,9,mixedType,1
6,3,0,9,mixedType,1
7,3,0,10,mixedType,1
1,7,0,8,mixedType,1
2,4,0,6,mixedType,0
8,3,0,11,mixedType,1
7,4,0,11,mixedType,1
6,2,0,8,mixedType,1
13,3,0,16,mixedType,2
2,4,0,6,mixedType,0
6,2,0,8,mixedType,1
3,6,0,9,mixedType,1
2,10,0,12,mixedType,1
9,1,0,10,mixedType,1
2,4,0,6,mixedType,0
6,3,0,9,mixedType,1
6,4,0,10,mixedType,1
6,2,0,8,mixedType,1
6,6,0,12,mixedType,1
5,2,0,7,mixedType,0
5,3,0,8,mixedType,1
9,1,0,10,mixedType,1
4,4,0,8,mixedType,1
15,1,0,16,mixedType,2
6,3,0,9,mixedType,1
12,3,0,15,mixedType,2
5,8,0,13,mixedType,1
9,1,0,10,mixedType,1
5,4,0,9,mixedType,1
11,3,0,14,mixedType,2
12,3,0,15,mixedType,2
5,4,0,9,mixedType,1
7,4,0,11,mixedType,1
8,3,0,11,mixedType,1
14,2,0,16,mixedType,2
5,4,0,9,mixedType,1
4,2,0,6,mixedType,0
4,2,0,6,mixedType,0
5,5,0,10,mixedType,1
3,6,0,9,mixedType,1
6,3,0,9,mixedType,1
4,2,0,6,mixedType,0
5,4,0,9,mixedType,1
14,2,0,16,mixedType,2
8,2,0,10,mixedType,1
6,3,0,9,mixedType,1
5,2,0,7,mixedType,0
6,4,0,10,mixedType,1
1,8,0,9,mixedType,1
6,3,0,9,mixedType,1
6,1,0,7,mixedType,0
4,4,0,8,mixedType,1
8,1,0,9,mixedType,1
9,0,1,10,mixedType,1
9,3,0,12,mixedType,1
15,1,0,16,mixedType,2
5,6,0,11,mixedType,1
8,3,0,11,mixedType,1
8,4,0,12,mixedType,1
5,1,0,6,mixedType,0
7,1,0,8,mixedType,1
11,1,0,12,mixedType,1
9,3,0,12,mixedType,1
1,8,0,9,mixedType,1
2,8,0,10,mixedType,1
7,2,0,9,mixedType,1
4,2,0,6,mixedType,0
15,1,0,16,mixedType,2
5,3,0,8,mixedType,1
7,4,0,11,mixedType,1
5,2,0,7,mixedType,0
8,1,0,9,mixedType,1
8,1,0,9,mixedType,1
4,8,0,12,mixedType,1
14,2,0,16,mixedType,2
6,1,0,7,mixedType,0
9,1,0,10,mixedType,1
1,8,0,9,mixedType,1
22,8,0,30,mixedType,2
8,2,0,10,mixedType,1
2,6,0,8,mixedType,1
4,4,0,8,mixedType,1
4,2,0,6,mixedType,0
6,3,0,9,mixedType,1
5,8,0,13,mixedType,1
10,1,0,11,mixedType,1
8,1,0,9,mixedType,1
9,4,0,13,mixedType,1
6,1,0,7,mixedType,0
4,6,0,10,mixedType,1
3,6,0,9,mixedType,1
9,1,0,10,mixedType,1
6,1,0,7,mixedType,0
8,2,0,10,mixedType,1
6,3,0,9,mixedType,1
8,2,0,10,mixedType,1
5,2,0,7,mixedType,0
6,1,0,7,mixedType,0
10,6,0,16,mixedType,2
7,2,0,9,mixedType,1
12,4,0,16,mixedType,2
8,4,0,12,mixedType,1
5,2,0,7,mixedType,0
6,3,0,9,mixedType,1
1,8,0,9,mixedType,1
7,3,0,10,mixedType,1
6,3,0,9,mixedType,1
12,3,0,15,mixedType,2
6,4,0,10,mixedType,1
4,2,0,6,mixedType,0
9,4,0,13,mixedType,1
6,3,0,9,mixedType,1
7,6,0,13,mixedType,1
4,2,0,6,mixedType,0
4,5,0,9,mixedType,1
6,3,0,9,mixedType,1
3,8,0,11,mixedType,1
5,3,0,8,mixedType,1
5,4,0,9,mixedType,1
12,4,0,16,mixedType,2
4,4,0,8,mixedType,1
5,2,0,7,mixedType,0
8,2,0,10,mixedType,1
4,5,0,9,mixedType,1
12,4,0,16,mixedType,2
7,0,0,7,sameType,0
7,3,0,10,mixedType,1
8,2,0,10,mixedType,1
11,3,0,14,mixedType,2
5,1,0,6,mixedType,0
4,6,0,10,mixedType,1
7,3,0,10,mixedType,1
15,1,0,16,mixedType,2
11,3,0,14,mixedType,2
5,3,0,8,mixedType,1
4,6,0,10,mixedType,1
3,8,0,11,mixedType,1
4,7,0,11,mixedType,1
6,1,0,7,mixedType,0
4,4,0,8,mixedType,1
9,1,0,10,mixedType,1
9,3,0,12,mixedType,1
1,8,0,9,mixedType,1
6,3,0,9,mixedType,1
2,6,0,8,mixedType,1
7,2,0,9,mixedType,1
9,1,0,10,mixedType,1
3,6,0,9,mixedType,1
5,2,0,7,mixedType,0
5,2,0,7,mixedType,0
8,1,0,9,mixedType,1
5,2,0,7,mixedType,0
6,3,0,9,mixedType,1
5,4,0,9,mixedType,1
5,6,0,11,mixedType,1
9,3,0,12,mixedType,1
4,2,0,6,mixedType,0
5,3,0,8,mixedType,1
6,1,0,7,mixedType,0
9,3,0,12,mixedType,1
6,3,0,9,mixedType,1
1,8,0,9,mixedType,1
4,4,0,8,mixedType,1
7,2,0,9,mixedType,1
4,6,0,10,mixedType,1
1,11,0,12,mixedType,1
5,7,0,12,mixedType,1
6,3,0,9,mixedType,1
6,3,0,9,mixedType,1
5,4,0,9,mixedType,1
9,2,0,11,mixedType,1
2,8,0,10,mixedType,1
6,3,0,9,mixedType,1
6,4,0,10,mixedType,1
7,3,0,10,mixedType,1
7,1,0,8,mixedType,1
6,3,0,9,mixedType,1
8,4,0,12,mixedType,1
6,3,0,9,mixedType,1
7,5,0,12,mixedType,1
3,5,0,8,mixedType,1
5,3,0,8,mixedType,1
6,4,0,10,mixedType,1
4,3,0,7,mixedType,0
4,2,0,6,mixedType,0
10,1,0,11,mixedType,1
12,1,0,13,mixedType,1
3,6,0,9,mixedType,1
8,2,0,10,mixedType,1
9,1,0,10,mixedType,1
7,1,0,8,mixedType,1
12,3,0,15,mixedType,2
7,5,0,12,mixedType,1
2,8,0,10,mixedType,1
11,2,0,13,mixedType,1
3,9,0,12,mixedType,1
7,1,0,8,mixedType,1
13,3,0,16,mixedType,2
3,5,0,8,mixedType,1
10,0,2,12,mixedType,1
4,8,0,12,mixedType,1
11,2,0,13,mixedType,1
6,2,0,8,mixedType,1
6,5,0,11,mixedType,1
6,2,0,8,mixedType,1
8,2,0,10,mixedType,1
7,3,0,10,mixedType,1
7,1,0,8,mixedType,1
12,1,0,13,mixedType,1
9,2,0,11,mixedType,1
7,5,0,12,mixedType,1
8,1,0,9,mixedType,1
8,1,0,9,mixedType,1
6,2,0,8,mixedType,1
8,2,0,10,mixedType,1
6,3,0,9,mixedType,1
3,5,0,8,mixedType,1
20,2,0,22,mixedType,2
9,1,0,10,mixedType,1
10,1,0,11,mixedType,1
8,2,0,10,mixedType,1
3,3,0,6,mixedType,0
16,2,0,18,mixedType,2
6,4,0,10,mixedType,1
5,4,0,9,mixedType,1
1,10,0,11,mixedType,1
8,1,0,9,mixedType,1
8,2,0,10,mixedType,1
7,3,0,10,mixedType,1
5,3,0,8,mixedType,1
10,1,0,11,mixedType,1
13,3,0,16,mixedType,2
9,4,0,13,mixedType,1
6,4,0,10,mixedType,1
6,2,0,8,mixedType,1
1,9,0,10,mixedType,1
1,9,0,10,mixedType,1
7,2,0,9,mixedType,1
4,2,0,6,mixedType,0
5,1,0,6,mixedType,0
7,2,0,9,mixedType,1
4,2,0,6,mixedType,0
6,4,0,10,mixedType,1
7,1,0,8,mixedType,1
4,2,0,6,mixedType,0
3,6,0,9,mixedType,1
7,1,0,8,mixedType,1
4,2,0,6,mixedType,0
2,8,0,10,mixedType,1
8,2,0,10,mixedType,1
9,1,0,10,mixedType,1
5,2,0,7,mixedType,0
5,2,0,7,mixedType,0
4,4,0,8,mixedType,1
4,2,0,6,mixedType,0
5,5,0,10,mixedType,1
5,3,0,8,mixedType,1
10,2,0,12,mixedType,1
2,6,0,8,mixedType,1
5,1,0,6,mixedType,0
6,4,0,10,mixedType,1
5,2,0,7,mixedType,0
12,4,0,16,mixedType,2
5,1,0,6,mixedType,0
6,1,0,7,mixedType,0
3,8,0,11,mixedType,1
4,2,0,6,mixedType,0
8,4,0,12,mixedType,1
7,3,0,10,mixedType,1
5,3,0,8,mixedType,1
7,3,0,10,mixedType,1
5,4,0,9,mixedType,1
13,3,0,16,mixedType,2
7,2,0,9,mixedType,1
9,1,0,10,mixedType,1
9,1,0,10,mixedType,1
7,1,0,8,mixedType,1
8,2,0,10,mixedType,1
4,7,0,11,mixedType,1
5,2,0,7,mixedType,0
16,2,0,18,mixedType,2
4,6,0,10,mixedType,1
2,7,0,9,mixedType,1
5,2,0,7,mixedType,0
8,3,0,11,mixedType,1
11,3,0,14,mixedType,2
10,3,0,13,mixedType,1
7,6,0,13,mixedType,1
8,6,0,14,mixedType,2
4,5,0,9,mixedType,1
6,3,0,9,mixedType,1
7,3,0,10,mixedType,1
4,2,0,6,mixedType,0
6,3,0,9,mixedType,1
8,2,0,10,mixedType,1
5,1,0,6,mixedType,0
5,2,0,7,mixedType,0
9,1,0,10,mixedType,1
4,4,0,8,mixedType,1
6,1,0,7,mixedType,0
9,1,0,10,mixedType,1
6,1,0,7,mixedType,0
7,1,0,8,mixedType,1
2,8,0,10,mixedType,1
8,1,0,9,mixedType,1
5,3,0,8,mixedType,1
6,2,0,8,mixedType,1
8,2,0,10,mixedType,1
13,3,0,16,mixedType,2
6,6,0,12,mixedType,1
8,5,0,13,mixedType,1
13,1,1,15,mixedType,2
7,0,0,7,sameType,0
6,6,0,12,mixedType,1
7,2,0,9,mixedType,1
8,1,0,9,mixedType,1
6,4,0,10,mixedType,1
9,1,0,10,mixedType,1
6,3,0,9,mixedType,1
5,2,0,7,mixedType,0
7,2,0,9,mixedType,1
7,2,0,9,mixedType,1
5,4,0,9,mixedType,1
6,2,0,8,mixedType,1
15,1,0,16,mixedType,2
4,4,0,8,mixedType,1
8,7,0,15,mixedType,2
5,4,0,9,mixedType,1
9,4,0,13,mixedType,1
10,1,0,11,mixedType,1
5,4,0,9,mixedType,1
5,3,0,8,mixedType,1
7,3,0,10,mixedType,1
5,1,0,6,mixedType,0
5,2,0,7,mixedType,0
8,2,0,10,mixedType,1
15,3,0,18,mixedType,2
7,2,0,9,mixedType,1
7,3,0,10,mixedType,1
6,3,0,9,mixedType,1
8,2,0,10,mixedType,1
4,4,0,8,mixedType,1
6,1,0,7,mixedType,0
5,8,0,13,mixedType,1
4,4,0,8,mixedType,1
4,2,0,6,mixedType,0
1,11,0,12,mixedType,1
6,2,0,8,mixedType,1
9,2,0,11,mixedType,1
15,1,0,16,mixedType,2
4,2,0,6,mixedType,0
9,1,0,10,mixedType,1
6,1,0,7,mixedType,0
5,1,0,6,mixedType,0
5,6,0,11,mixedType,1
7,3,0,10,mixedType,1
8,2,0,10,mixedType,1
4,2,0,6,mixedType,0
5,1,0,6,mixedType,0
14,2,0,16,mixedType,2
11,2,0,13,mixedType,1
6,3,0,9,mixedType,1
7,5,0,12,mixedType,1
6,3,0,9,mixedType,1
6,4,0,10,mixedType,1
5,4,0,9,mixedType,1
5,2,0,7,mixedType,0
6,0,1,7,mixedType,0
12,4,0,16,mixedType,2
6,3,0,9,mixedType,1
8,2,0,10,mixedType,1
14,1,1,16,mixedType,2
10,6,0,16,mixedType,2
4,7,0,11,mixedType,1
10,1,0,11,mixedType,1
6,2,0,8,mixedType,1
4,2,0,6,mixedType,0
5,4,0,9,mixedType,1
7,3,0,10,mixedType,1
5,8,0,13,mixedType,1
6,3,0,9,mixedType,1
8,2,0,10,mixedType,1
5,3,0,8,mixedType,1
8,1,0,9,mixedType,1
9,1,0,10,mixedType,1
6,3,0,9,mixedType,1
7,2,0,9,mixedType,1
5,5,0,10,mixedType,1
7,2,0,9,mixedType,1
6,2,0,8,mixedType,1
4,6,0,10,mixedType,1
4,5,0,9,mixedType,1
7,3,0,10,mixedType,1
6,4,0,10,mixedType,1
7,1,0,8,mixedType,1
7,2,0,9,mixedType,1
6,3,0,9,mixedType,1
7,1,0,8,mixedType,1
7,1,0,8,mixedType,1
6,4,0,10,mixedType,1
4,6,0,10,mixedType,1
2,8,0,10,mixedType,1
9,2,0,11,mixedType,1
7,3,0,10,mixedType,1
7,2,0,9,mixedType,1
5,2,0,7,mixedType,0
6,1,0,7,mixedType,0
5,6,0,11,mixedType,1
5,1,0,6,mixedType,0
8,2,0,10,mixedType,1
9,3,0,12,mixedType,1
13,3,0,16,mixedType,2
4,4,0,8,mixedType,1
8,2,0,10,mixedType,1
18,2,0,20,mixedType,2
4,2,0,6,mixedType,0
9,3,0,12,mixedType,1
5,3,0,8,mixedType,1
2,8,0,10,mixedType,1
4,4,0,8,mixedType,1
6,4,0,10,mixedType,1
9,2,0,11,mixedType,1
5,3,0,8,mixedType,1
5,2,0,7,mixedType,0
4,4,0,8,mixedType,1
6,1,0,7,mixedType,0
4,2,0,6,mixedType,0
8,2,0,10,mixedType,1
10,2,0,12,mixedType,1
2,9,0,11,mixedType,1
4,2,0,6,mixedType,0
10,1,0,11,mixedType,1
7,2,0,9,mixedType,1
7,2,0,9,mixedType,1
7,2,0,9,mixedType,1
7,3,0,10,mixedType,1
7,2,0,9,mixedType,1
7,2,0,9,mixedType,1
4,4,0,8,mixedType,1
5,1,0,6,mixedType,0
4,2,0,6,mixedType,0
6,3,0,9,mixedType,1
4,4,0,8,mixedType,1
6,4,0,10,mixedType,1
4,7,0,11,mixedType,1
6,2,0,8,mixedType,1
7,2,0,9,mixedType,1
6,1,0,7,mixedType,0
8,1,0,9,mixedType,1
5,1,0,6,mixedType,0
5,3,0,8,mixedType,1
8,2,0,10,mixedType,1
5,2,0,7,mixedType,0
6,2,0,8,mixedType,1
2,4,0,6,mixedType,0
6,4,0,10,mixedType,1
8,4,0,12,mixedType,1
9,1,0,10,mixedType,1
8,1,0,9,mixedType,1
5,4,0,9,mixedType,1
6,6,0,12,mixedType,1
5,2,0,7,mixedType,0
6,3,0,9,mixedType,1
3,6,0,9,mixedType,1
6,1,0,7,mixedType,0
5,3,0,8,mixedType,1
7,2,0,9,mixedType,1
8,1,0,9,mixedType,1
5,4,0,9,mixedType,1
4,2,0,6,mixedType,0
6,4,0,10,mixedType,1
6,3,0,9,mixedType,1
6,1,0,7,mixedType,0
9,1,0,10,mixedType,1
4,6,0,10,mixedType,1
5,2,0,7,mixedType,0
7,5,0,12,mixedType,1
7,3,0,10,mixedType,1
7,1,0,8,mixedType,1
7,2,0,9,mixedType,1
6,4,0,10,mixedType,1
5,4,0,9,mixedType,1
8,2,0,10,mixedType,1
6,4,0,10,mixedType,1
4,7,0,11,mixedType,1
9,4,0,13,mixedType,1
7,6,0,13,mixedType,1
7,2,0,9,mixedType,1
7,3,0,10,mixedType,1
9,3,0,12,mixedType,1
5,4,0,9,mixedType,1
7,3,0,10,mixedType,1
6,2,0,8,mixedType,1
6,1,0,7,mixedType,0
13,3,0,16,mixedType,2
9,4,0,13,mixedType,1
6,3,0,9,mixedType,1
14,4,0,18,mixedType,2
6,1,0,7,mixedType,0
7,3,0,10,mixedType,1
7,2,0,9,mixedType,1
4,2,0,6,mixedType,0
2,9,0,11,mixedType,1
9,1,0,10,mixedType,1
4,6,0,10,mixedType,1
7,3,0,10,mixedType,1
12,4,0,16,mixedType,2
7,3,0,10,mixedType,1
6,2,0,8,mixedType,1
5,3,0,8,mixedType,1
10,2,0,12,mixedType,1
11,3,0,14,mixedType,2
5,1,0,6,mixedType,0
6,4,0,10,mixedType,1
6,3,0,9,mixedType,1
2,6,0,8,mixedType,1
9,3,0,12,mixedType,1
9,4,0,13,mixedType,1
8,3,0,11,mixedType,1
6,1,0,7,mixedType,0
9,2,0,11,mixedType,1
6,2,0,8,mixedType,1
7,3,0,10,mixedType,1
12,3,0,15,mixedType,2
8,2,0,10,mixedType,1
7,4,0,11,mixedType,1
5,3,0,8,mixedType,1
6,2,0,8,mixedType,1
9,3,0,12,mixedType,1
7,3,0,10,mixedType,1
3,6,0,9,mixedType,1
3,7,0,10,mixedType,1
10,3,0,13,mixedType,1
6,4,0,10,mixedType,1
4,5,0,9,mixedType,1
9,4,0,13,mixedType,1
3,4,0,7,mixedType,0
8,4,0,12,mixedType,1
7,4,0,11,mixedType,1
6,3,0,9,mixedType,1
6,1,0,7,mixedType,0
6,2,0,8,mixedType,1
2,4,0,6,mixedType,0
2,6,0,8,mixedType,1
7,2,0,9,mixedType,1
7,1,0,8,mixedType,1
6,2,0,8,mixedType,1
4,4,0,8,mixedType,1
7,5,0,12,mixedType,1
5,2,0,7,mixedType,0
12,4,0,16,mixedType,2
7,2,0,9,mixedType,1
15,1,0,16,mixedType,2
7,2,0,9,mixedType,1
2,11,0,13,mixedType,1
13,3,0,16,mixedType,2
8,1,0,9,mixedType,1
4,6,0,10,mixedType,1
4,6,0,10,mixedType,1
1,7,0,8,mixedType,1
7,2,0,9,mixedType,1
14,2,0,16,mixedType,2
8,4,0,12,mixedType,1
7,3,0,10,mixedType,1
4,2,0,6,mixedType,0
5,2,0,7,mixedType,0
6,4,0,10,mixedType,1
8,1,0,9,mixedType,1
2,6,0,8,mixedType,1
5,2,0,7,mixedType,0
5,2,0,7,mixedType,0
6,3,0,9,mixedType,1
15,1,0,16,mixedType,2
15,1,0,16,mixedType,2
7,3,0,10,mixedType,1
5,2,0,7,mixedType,0
6,4,0,10,mixedType,1
13,3,0,16,mixedType,2
7,3,0,10,mixedType,1
15,1,0,16,mixedType,2
2,4,0,6,mixedType,0
8,1,0,9,mixedType,1
7,3,0,10,mixedType,1
0,6,1,7,mixedType,0
5,2,0,7,mixedType,0
7,3,0,10,mixedType,1
5,2,0,7,mixedType,0
8,1,0,9,mixedType,1
5,4,0,9,mixedType,1
5,3,0,8,mixedType,1
9,1,0,10,mixedType,1
21,1,0,22,mixedType,2
6,1,0,7,mixedType,0
14,2,0,16,mixedType,2
8,1,0,9,mixedType,1
5,4,0,9,mixedType,1
8,1,0,9,mixedType,1
5,4,0,9,mixedType,1
15,1,0,16,mixedType,2
5,3,0,8,mixedType,1
1,6,0,7,mixedType,0
7,3,0,10,mixedType,1
7,1,0,8,mixedType,1
4,2,0,6,mixedType,0
9,1,0,10,mixedType,1
4,4,0,8,mixedType,1
7,3,0,10,mixedType,1
9,1,0,10,mixedType,1
8,1,0,9,mixedType,1
9,1,0,10,mixedType,1
14,2,0,16,mixedType,2
14,2,0,16,mixedType,2
6,1,0,7,mixedType,0
14,2,0,16,mixedType,2
3,6,0,9,mixedType,1
4,4,0,8,mixedType,1
4,2,0,6,mixedType,0
6,1,0,7,mixedType,0
7,1,0,8,mixedType,1
6,1,0,7,mixedType,0
5,3,0,8,mixedType,1
8,2,0,10,mixedType,1
13,3,0,16,mixedType,2
5,5,0,10,mixedType,1
16,2,2,20,mixedType,2
10,2,0,12,mixedType,1
7,2,0,9,mixedType,1
7,3,0,10,mixedType,1
1,8,0,9,mixedType,1
6,3,0,9,mixedType,1
4,2,0,6,mixedType,0
6,3,0,9,mixedType,1
3,9,0,12,mixedType,1
8,1,0,9,mixedType,1
7,3,0,10,mixedType,1
11,3,0,14,mixedType,2
5,3,0,8,mixedType,1
7,3,0,10,mixedType,1
15,1,0,16,mixedType,2
5,4,0,9,mixedType,1
5,1,0,6,mixedType,0
2,6,0,8,mixedType,1
7,3,0,10,mixedType,1
8,2,0,10,mixedType,1
9,1,0,10,mixedType,1
8,4,0,12,mixedType,1
2,4,0,6,mixedType,0
7,3,0,10,mixedType,1
9,2,0,11,mixedType,1
1,8,0,9,mixedType,1
4,2,0,6,mixedType,0
5,1,0,6,mixedType,0
6,1,0,7,mixedType,0
6,2,0,8,mixedType,1
7,2,0,9,mixedType,1
6,1,0,7,mixedType,0
4,4,0,8,mixedType,1
5,3,0,8,mixedType,1
6,4,0,10,mixedType,1
2,4,0,6,mixedType,0
7,3,0,10,mixedType,1
6,1,0,7,mixedType,0
5,3,0,8,mixedType,1
15,1,0,16,mixedType,2
2,6,0,8,mixedType,1
5,3,0,8,mixedType,1
8,5,0,13,mixedType,1
5,4,0,9,mixedType,1
7,3,0,10,mixedType,1
5,2,0,7,mixedType,0
5,2,0,7,mixedType,0
5,6,0,11,mixedType,1
4,2,0,6,mixedType,0
13,3,0,16,mixedType,2
7,2,0,9,mixedType,1
5,2,0,7,mixedType,0
6,3,0,9,mixedType,1
7,4,0,11,mixedType,1
12,3,0,15,mixedType,2
4,2,0,6,mixedType,0
8,2,0,10,mixedType,1
6,1,0,7,mixedType,0
15,1,0,16,mixedType,2
6,3,0,9,mixedType,1
6,3,0,9,mixedType,1
5,2,0,7,mixedType,0
7,3,0,10,mixedType,1
4,2,0,6,mixedType,0
3,6,0,9,mixedType,1
8,1,0,9,mixedType,1
8,3,0,11,mixedType,1
8,2,0,10,mixedType,1
7,3,0,10,mixedType,1
6,3,0,9,mixedType,1
5,1,0,6,mixedType,0
9,1,0,10,mixedType,1
9,1,0,10,mixedType,1
4,4,0,8,mixedType,1
1,7,0,8,mixedType,1
6,2,0,8,mixedType,1
6,4,0,10,mixedType,1
7,4,0,11,mixedType,1
5,3,0,8,mixedType,1
5,3,0,8,mixedType,1
7,2,0,9,mixedType,1
4,4,0,8,mixedType,1
6,2,0,8,mixedType,1
6,3,0,9,mixedType,1
8,1,0,9,mixedType,1
9,1,0,10,mixedType,1
14,2,0,16,mixedType,2
4,2,0,6,mixedType,0
4,4,0,8,mixedType,1
8,2,0,10,mixedType,1
7,3,0,10,mixedType,1
7,2,0,9,mixedType,1
6,4,0,10,mixedType,1
5,1,0,6,mixedType,0
6,4,0,10,mixedType,1
5,4,0,9,mixedType,1
1,7,0,8,mixedType,1
6,2,0,8,mixedType,1
7,1,0,8,mixedType,1
15,1,0,16,mixedType,2
12,4,0,16,mixedType,2
8,2,0,10,mixedType,1
6,3,0,9,mixedType,1
6,4,0,10,mixedType,1
8,1,0,9,mixedType,1
11,2,0,13,mixedType,1
2,6,0,8,mixedType,1
8,1,0,9,mixedType,1
6,2,0,8,mixedType,1
7,1,0,8,mixedType,1
11,1,0,12,mixedType,1
5,4,0,9,mixedType,1
3,8,0,11,mixedType,1
14,2,0,16,mixedType,2
7,2,0,9,mixedType,1
6,3,0,9,mixedType,1
5,3,0,8,mixedType,1
6,1,0,7,mixedType,0
13,3,0,16,mixedType,2
7,1,0,8,mixedType,1
7,3,0,10,mixedType,1
3,9,0,12,mixedType,1
6,1,0,7,mixedType,0
4,2,0,6,mixedType,0
15,1,0,16,mixedType,2
6,1,0,7,mixedType,0
3,6,0,9,mixedType,1
3,3,0,6,mixedType,0
4,5,0,9,mixedType,1
5,3,0,8,mixedType,1
9,3,0,12,mixedType,1
4,4,0,8,mixedType,1
5,2,0,7,mixedType,0
7,1,0,8,mixedType,1
8,2,0,10,mixedType,1
1,7,0,8,mixedType,1
5,4,0,9,mixedType,1
5,6,0,11,mixedType,1
6,2,0,8,mixedType,1
12,4,0,16,mixedType,2
7,3,0,10,mixedType,1
15,1,0,16,mixedType,2
7,2,0,9,mixedType,1
12,3,0,15,mixedType,2
4,4,0,8,mixedType,1
7,3,0,10,mixedType,1
4,2,0,6,mixedType,0
7,1,0,8,mixedType,1
7,3,0,10,mixedType,1
5,2,0,7,mixedType,0
4,5,0,9,mixedType,1
3,6,0,9,mixedType,1
7,3,0,10,mixedType,1
6,3,0,9,mixedType,1
5,5,0,10,mixedType,1
6,3,0,9,mixedType,1
16,3,0,19,mixedType,2
5,2,0,7,mixedType,0
6,2,0,8,mixedType,1
12,4,0,16,mixedType,2
8,3,0,11,mixedType,1
7,5,0,12,mixedType,1
7,3,0,10,mixedType,1
7,1,0,8,mixedType,1
4,4,0,8,mixedType,1
14,2,0,16,mixedType,2
7,3,0,10,mixedType,1
4,6,0,10,mixedType,1
14,2,0,16,mixedType,2
6,2,0,8,mixedType,1
15,1,0,16,mixedType,2
7,1,0,8,mixedType,1
7,1,0,8,mixedType,1
8,1,0,9,mixedType,1
7,2,0,9,mixedType,1
3,8,0,11,mixedType,1
9,2,0,11,mixedType,1
13,3,0,16,mixedType,2
5,4,0,9,mixedType,1
13,3,0,16,mixedType,2
6,1,0,7,mixedType,0
7,4,0,11,mixedType,1
9,2,0,11,mixedType,1
3,6,0,9,mixedType,1
2,6,0,8,mixedType,1
6,1,0,7,mixedType,0
9,2,0,11,mixedType,1
6,3,0,9,mixedType,1
3,6,0,9,mixedType,1
7,2,0,9,mixedType,1
5,3,0,8,mixedType,1
7,3,0,10,mixedType,1
7,3,0,10,mixedType,1
5,1,0,6,mixedType,0
9,1,0,10,mixedType,1
6,2,0,8,mixedType,1
15,1,0,16,mixedType,2
13,3,0,16,mixedType,2
6,1,0,7,mixedType,0
5,4,0,9,mixedType,1
10,0,2,12,mixedType,1
5,2,0,7,mixedType,0
1,8,0,9,mixedType,1
3,6,0,9,mixedType,1
11,5,0,16,mixedType,2
8,3,0,11,mixedType,1
5,3,0,8,mixedType,1
9,2,0,11,mixedType,1
6,2,0,8,mixedType,1
2,4,0,6,mixedType,0
0,6,0,6,sameType,0
12,4,0,16,mixedType,2
5,3,0,8,mixedType,1
11,3,0,14,mixedType,2
4,2,0,6,mixedType,0
7,3,0,10,mixedType,1
7,3,0,10,mixedType,1
10,1,0,11,mixedType,1
3,6,0,9,mixedType,1
5,3,0,8,mixedType,1
7,2,0,9,mixedType,1
6,1,0,7,mixedType,0
13,3,0,16,mixedType,2
14,2,0,16,mixedType,2
8,1,0,9,mixedType,1
6,2,0,8,mixedType,1
7,3,0,10,mixedType,1
5,7,0,12,mixedType,1
5,1,0,6,mixedType,0
6,3,0,9,mixedType,1
8,2,0,10,mixedType,1
5,2,0,7,mixedType,0
4,4,0,8,mixedType,1
7,4,0,11,mixedType,1
5,1,0,6,mixedType,0
4,2,0,6,mixedType,0
6,3,0,9,mixedType,1
7,1,0,8,mixedType,1
6,1,0,7,mixedType,0
5,2,0,7,mixedType,0
6,6,0,12,mixedType,1
2,4,0,6,mixedType,0
5,3,0,8,mixedType,1
7,2,0,9,mixedType,1
7,2,0,9,mixedType,1
5,6,0,11,mixedType,1
11,2,0,13,mixedType,1
7,3,0,10,mixedType,1
5,0,2,7,mixedType,0
5,3,0,8,mixedType,1
4,2,0,6,mixedType,0
5,3,0,8,mixedType,1
6,3,0,9,mixedType,1
5,4,0,9,mixedType,1
15,1,0,16,mixedType,2
8,4,0,12,mixedType,1
5,3,0,8,mixedType,1
4,2,0,6,mixedType,0
10,1,0,11,mixedType,1
8,2,0,10,mixedType,1
13,3,0,16,mixedType,2
5,3,0,8,mixedType,1
6,4,0,10,mixedType,1
5,3,0,8,mixedType,1
8,2,0,10,mixedType,1
6,4,0,10,mixedType,1
2,6,0,8,mixedType,1
6,3,0,9,mixedType,1
6,3,0,9,mixedType,1
12,3,0,15,mixedType,2
5,2,0,7,mixedType,0
8,2,0,10,mixedType,1
5,3,0,8,mixedType,1
5,4,0,9,mixedType,1
4,4,0,8,mixedType,1
3,6,0,9,mixedType,1
13,3,0,16,mixedType,2
6,4,0,10,mixedType,1
1,7,0,8,mixedType,1
6,2,0,8,mixedType,1
10,1,0,11,mixedType,1
10,2,0,12,mixedType,1
6,3,0,9,mixedType,1
5,2,0,7,mixedType,0
6,3,0,9,mixedType,1
9,2,0,11,mixedType,1
9,1,0,10,mixedType,1
1,11,0,12,mixedType,1
4,2,0,6,mixedType,0
13,3,0,16,mixedType,2
7,5,0,12,mixedType,1
4,2,0,6,mixedType,0
4,6,0,10,mixedType,1
8,2,0,10,mixedType,1
6,1,0,7,mixedType,0
2,8,0,10,mixedType,1
4,2,0,6,mixedType,0
6,3,0,9,mixedType,1
1,8,0,9,mixedType,1
7,3,0,10,mixedType,1
3,9,0,12,mixedType,1
6,1,0,7,mixedType,0
7,3,0,10,mixedType,1
7,3,0,10,mixedType,1
7,2,0,9,mixedType,1
5,2,0,7,mixedType,0
5,4,0,9,mixedType,1
4,2,0,6,mixedType,0
12,4,0,16,mixedType,2
8,2,0,10,mixedType,1
5,1,0,6,mixedType,0
8,4,0,12,mixedType,1
12,4,0,16,mixedType,2
1,8,0,9,mixedType,1
5,3,0,8,mixedType,1
9,3,0,12,mixedType,1
8,1,0,9,mixedType,1
6,1,0,7,mixedType,0
3,10,0,13,mixedType,1
14,2,0,16,mixedType,2
4,6,0,10,mixedType,1
6,1,0,7,mixedType,0
5,3,0,8,mixedType,1
1,5,0,6,mixedType,0
4,2,0,6,mixedType,0
15,1,0,16,mixedType,2
4,4,0,8,mixedType,1
6,4,0,10,mixedType,1
6,4,0,10,mixedType,1
6,2,0,8,mixedType,1
6,4,0,10,mixedType,1
2,6,0,8,mixedType,1
3,6,0,9,mixedType,1
5,3,0,8,mixedType,1
6,3,0,9,mixedType,1
1,10,0,11,mixedType,1
8,2,0,10,mixedType,1
8,2,0,10,mixedType,1
6,4,0,10,mixedType,1
6,2,0,8,mixedType,1
7,2,0,9,mixedType,1
6,3,0,9,mixedType,1
15,3,0,18,mixedType,2
15,1,0,16,mixedType,2
5,4,0,9,mixedType,1
2,8,0,10,mixedType,1
2,8,0,10,mixedType,1
8,2,0,10,mixedType,1
7,3,0,10,mixedType,1
5,3,0,8,mixedType,1
4,4,0,8,mixedType,1
9,1,0,10,mixedType,1
2,8,0,10,mixedType,1
14,2,0,16,mixedType,2
10,2,0,12,mixedType,1
14,2,0,16,mixedType,2
8,2,0,10,mixedType,1
13,3,0,16,mixedType,2
9,2,0,11,mixedType,1
7,2,0,9,mixedType,1
7,2,0,9,mixedType,1
5,6,0,11,mixedType,1
4,2,0,6,mixedType,0
7,3,0,10,mixedType,1
6,3,0,9,mixedType,1
7,1,0,8,mixedType,1
2,9,0,11,mixedType,1
6,4,0,10,mixedType,1
7,3,0,10,mixedType,1
14,2,0,16,mixedType,2
1,5,0,6,mixedType,0
9,1,0,10,mixedType,1
8,1,0,9,mixedType,1
5,2,0,7,mixedType,0
5,1,0,6,mixedType,0
5,3,0,8,mixedType,1
9,3,0,12,mixedType,1
7,3,0,10,mixedType,1
9,1,0,10,mixedType,1
4,2,0,6,mixedType,0
5,3,0,8,mixedType,1
5,4,0,9,mixedType,1
5,2,0,7,mixedType,0
5,2,0,7,mixedType,0
7,2,0,9,mixedType,1
6,3,0,9,mixedType,1
4,4,0,8,mixedType,1
4,6,0,10,mixedType,1
6,3,0,9,mixedType,1
5,4,0,9,mixedType,1
5,2,0,7,mixedType,0
3,6,0,9,mixedType,1
6,3,0,9,mixedType,1
18,4,0,22,mixedType,2
3,7,0,10,mixedType,1
6,3,0,9,mixedType,1
7,1,0,8,mixedType,1
5,3,0,8,mixedType,1
6,4,0,10,mixedType,1
6,3,0,9,mixedType,1
6,6,0,12,mixedType,1
1,6,0,7,mixedType,0
5,3,0,8,mixedType,1
3,7,0,10,mixedType,1
5,3,0,8,mixedType,1
7,1,0,8,mixedType,1
9,1,0,10,mixedType,1
6,2,0,8,mixedType,1
6,3,0,9,mixedType,1
8,4,0,12,mixedType,1
2,7,0,9,mixedType,1
6,3,0,9,mixedType,1
6,3,0,9,mixedType,1
12,4,0,16,mixedType,2
7,3,0,10,mixedType,1
5,3,0,8,mixedType,1
5,3,0,8,mixedType,1
5,2,0,7,mixedType,0
7,3,0,10,mixedType,1
5,3,0,8,mixedType,1
7,2,0,9,mixedType,1
2,11,0,13,mixedType,1
7,4,0,11,mixedType,1
2,4,0,6,mixedType,0
6,3,0,9,mixedType,1
7,3,0,10,mixedType,1
5,2,0,7,mixedType,0
6,4,0,10,mixedType,1
9,0,1,10,mixedType,1
6,3,0,9,mixedType,1
7,3,0,10,mixedType,1
7,3,0,10,mixedType,1
4,4,0,8,mixedType,1
2,4,0,6,mixedType,0
10,1,0,11,mixedType,1
11,3,0,14,mixedType,2
12,4,0,16,mixedType,2
10,2,0,12,mixedType,1
2,6,0,8,mixedType,1
7,3,0,10,mixedType,1
14,2,0,16,mixedType,2
4,2,0,6,mixedType,0
3,3,0,6,mixedType,0
8,3,0,11,mixedType,1
3,5,0,8,mixedType,1
4,4,0,8,mixedType,1
9,1,0,10,mixedType,1
10,1,0,11,mixedType,1
5,3,0,8,mixedType,1
8,1,0,9,mixedType,1
5,3,0,8,mixedType,1
8,2,0,10,mixedType,1
7,2,0,9,mixedType,1
7,3,0,10,mixedType,1
3,8,0,11,mixedType,1
10,1,0,11,mixedType,1
4,7,0,11,mixedType,1
13,3,0,16,mixedType,2
6,6,0,12,mixedType,1
7,4,0,11,mixedType,1
4,2,0,6,mixedType,0
7,3,0,10,mixedType,1
9,1,0,10,mixedType,1
10,1,0,11,mixedType,1
7,3,0,10,mixedType,1
7,4,0,11,mixedType,1
7,2,0,9,mixedType,1
7,3,0,10,mixedType,1
6,2,0,8,mixedType,1
8,4,0,12,mixedType,1
6,2,0,8,mixedType,1
7,3,0,10,mixedType,1
2,6,0,8,mixedType,1
6,4,0,10,mixedType,1
7,1,0,8,mixedType,1
4,4,0,8,mixedType,1
5,2,0,7,mixedType,0
14,2,0,16,mixedType,2
5,3,0,8,mixedType,1
10,3,0,13,mixedType,1
8,1,0,9,mixedType,1
10,7,0,17,mixedType,2
5,7,0,12,mixedType,1
10,2,0,12,mixedType,1
2,8,0,10,mixedType,1
15,1,0,16,mixedType,2
6,1,0,7,mixedType,0
4,2,0,6,mixedType,0
8,2,0,10,mixedType,1
7,3,0,10,mixedType,1
7,2,0,9,mixedType,1
6,4,0,10,mixedType,1
14,2,0,16,mixedType,2
10,6,0,16,mixedType,2
4,8,0,12,mixedType,1
3,9,0,12,mixedType,1
5,3,0,8,mixedType,1
8,2,0,10,mixedType,1
7,1,0,8,mixedType,1
7,3,0,10,mixedType,1
6,4,0,10,mixedType,1
12,4,0,16,mixedType,2
3,5,0,8,mixedType,1
6,3,0,9,mixedType,1
6,1,0,7,mixedType,0
6,4,0,10,mixedType,1
7,2,0,9,mixedType,1
6,3,0,9,mixedType,1
7,5,0,12,mixedType,1
1,8,0,9,mixedType,1
9,1,0,10,mixedType,1
8,1,0,9,mixedType,1
5,2,0,7,mixedType,0
3,3,0,6,mixedType,0
3,3,0,6,mixedType,0
4,4,0,8,mixedType,1
11,1,0,12,mixedType,1
9,3,0,12,mixedType,1
9,1,0,10,mixedType,1
6,3,0,9,mixedType,1
5,1,0,6,mixedType,0
4,2,0,6,mixedType,0
7,3,0,10,mixedType,1
2,9,0,11,mixedType,1
5,7,0,12,mixedType,1
6,2,0,8,mixedType,1
11,1,0,12,mixedType,1
10,2,0,12,mixedType,1
13,3,0,16,mixedType,2
1,9,0,10,mixedType,1
8,3,0,11,mixedType,1
4,4,0,8,mixedType,1
7,3,0,10,mixedType,1
5,3,0,8,mixedType,1
3,5,0,8,mixedType,1
5,3,0,8,mixedType,1
9,3,0,12,mixedType,1
6,1,0,7,mixedType,0
8,2,0,10,mixedType,1
6,2,0,8,mixedType,1
5,6,0,11,mixedType,1
6,2,0,8,mixedType,1
5,3,0,8,mixedType,1
7,3,0,10,mixedType,1
5,6,0,11,mixedType,1
7,3,0,10,mixedType,1
2,6,0,8,mixedType,1
8,3,0,11,mixedType,1
4,6,0,10,mixedType,1
11,2,1,14,mixedType,2
7,3,0,10,mixedType,1
7,2,0,9,mixedType,1
7,3,0,10,mixedType,1
12,4,0,16,mixedType,2
4,4,0,8,mixedType,1
14,2,0,16,mixedType,2
6,6,0,12,mixedType,1
6,3,0,9,mixedType,1
3,7,0,10,mixedType,1
13,3,0,16,mixedType,2
7,1,0,8,mixedType,1
6,3,0,9,mixedType,1
4,4,0,8,mixedType,1
8,3,0,11,mixedType,1
7,4,0,11,mixedType,1
8,2,0,10,mixedType,1
14,2,0,16,mixedType,2
14,2,0,16,mixedType,2
7,1,0,8,mixedType,1
6,2,0,8,mixedType,1
4,8,0,12,mixedType,1
5,3,0,8,mixedType,1
2,7,0,9,mixedType,1
8,1,0,9,mixedType,1
6,2,0,8,mixedType,1
9,2,0,11,mixedType,1
7,2,0,9,mixedType,1
6,4,0,10,mixedType,1
13,3,2,18,mixedType,2
7,2,0,9,mixedType,1
5,4,0,9,mixedType,1
4,6,0,10,mixedType,1
6,4,0,10,mixedType,1
6,3,0,9,mixedType,1
8,3,0,11,mixedType,1
4,2,0,6,mixedType,0
15,1,0,16,mixedType,2
6,3,0,9,mixedType,1
8,4,0,12,mixedType,1
8,1,0,9,mixedType,1
6,3,0,9,mixedType,1
6,3,0,9,mixedType,1
5,3,0,8,mixedType,1
2,6,0,8,mixedType,1
12,3,0,15,mixedType,2
8,4,0,12,mixedType,1
1,8,0,9,mixedType,1
6,4,0,10,mixedType,1
7,4,0,11,mixedType,1
15,1,0,16,mixedType,2
9,0,3,12,mixedType,1
8,1,0,9,mixedType,1
6,2,0,8,mixedType,1
8,4,0,12,mixedType,1
7,3,0,10,mixedType,1
15,1,0,16,mixedType,2
6,3,0,9,mixedType,1
5,3,0,8,mixedType,1
10,1,0,11,mixedType,1
6,1,0,7,mixedType,0
2,6,0,8,mixedType,1
8,1,0,9,mixedType,1
8,2,0,10,mixedType,1
5,2,0,7,mixedType,0
2,6,0,8,mixedType,1
7,3,0,10,mixedType,1
12,3,0,15,mixedType,2
7,1,0,8,mixedType,1
5,5,0,10,mixedType,1
6,3,0,9,mixedType,1
13,3,0,16,mixedType,2
6,4,0,10,mixedType,1
8,1,0,9,mixedType,1
6,2,0,8,mixedType,1
6,3,0,9,mixedType,1
5,3,0,8,mixedType,1
13,2,0,15,mixedType,2
7,3,0,10,mixedType,1
3,8,0,11,mixedType,1
4,2,0,6,mixedType,0
6,3,0,9,mixedType,1
9,2,0,11,mixedType,1
9,1,0,10,mixedType,1
6,3,0,9,mixedType,1
4,6,0,10,mixedType,1
9,1,0,10,mixedType,1
6,3,0,9,mixedType,1
5,3,0,8,mixedType,1
13,3,0,16,mixedType,2
9,2,0,11,mixedType,1
12,1,0,13,mixedType,1
3,7,0,10,mixedType,1
9,5,0,14,mixedType,2
8,2,0,10,mixedType,1
10,1,0,11,mixedType,1
11,5,0,16,mixedType,2
9,3,0,12,mixedType,1
7,3,0,10,mixedType,1
9,3,0,12,mixedType,1
4,8,0,12,mixedType,1
5,3,0,8,mixedType,1
11,3,0,14,mixedType,2
9,3,0,12,mixedType,1
4,2,0,6,mixedType,0
11,2,0,13,mixedType,1
6,2,0,8,mixedType,1
6,2,0,8,mixedType,1
8,1,0,9,mixedType,1
5,5,0,10,mixedType,1
1,8,0,9,mixedType,1
5,4,0,9,mixedType,1
9,4,0,13,mixedType,1
5,4,0,9,mixedType,1
5,4,0,9,mixedType,1
5,2,0,7,mixedType,0
6,3,0,9,mixedType,1
2,7,0,9,mixedType,1
5,3,0,8,mixedType,1
2,6,0,8,mixedType,1
6,3,0,9,mixedType,1
14,2,0,16,mixedType,2
6,5,0,11,mixedType,1
4,4,0,8,mixedType,1
9,3,0,12,mixedType,1
2,6,0,8,mixedType,1
5,8,0,13,mixedType,1
7,3,0,10,mixedType,1
3,6,0,9,mixedType,1
5,2,0,7,mixedType,0
9,1,0,10,mixedType,1
3,7,0,10,mixedType,1
3,6,0,9,mixedType,1
5,4,0,9,mixedType,1
7,3,0,10,mixedType,1
7,4,0,11,mixedType,1
5,4,0,9,mixedType,1
11,3,0,14,mixedType,2
7,3,0,10,mixedType,1
5,2,0,7,mixedType,0
3,6,0,9,mixedType,1
4,4,0,8,mixedType,1
3,3,0,6,mixedType,0
8,1,0,9,mixedType,1
7,2,0,9,mixedType,1
11,3,0,14,mixedType,2
4,4,0,8,mixedType,1
7,1,0,8,mixedType,1
6,3,0,9,mixedType,1
2,7,0,9,mixedType,1
8,2,0,10,mixedType,1
6,1,0,7,mixedType,0
7,2,0,9,mixedType,1
5,1,0,6,mixedType,0
11,1,0,12,mixedType,1
4,6,0,10,mixedType,1
7,2,0,9,mixedType,1
14,2,0,16,mixedType,2
8,2,0,10,mixedType,1
3,7,0,10,mixedType,1
8,1,0,9,mixedType,1
3,6,0,9,mixedType,1
6,4,0,10,mixedType,1
10,2,0,12,mixedType,1
9,4,0,13,mixedType,1
6,1,0,7,mixedType,0
4,6,0,10,mixedType,1
8,4,0,12,mixedType,1
7,3,0,10,mixedType,1
6,3,0,9,mixedType,1
4,2,0,6,mixedType,0
1,7,0,8,mixedType,1
8,1,0,9,mixedType,1
10,2,0,12,mixedType,1
4,4,0,8,mixedType,1
5,2,0,7,mixedType,0
12,4,0,16,mixedType,2
7,2,0,9,mixedType,1
8,1,0,9,mixedType,1
7,5,0,12,mixedType,1
10,3,0,13,mixedType,1
6,2,0,8,mixedType,1
2,6,0,8,mixedType,1
7,1,0,8,mixedType,1
11,2,0,13,mixedType,1
7,2,0,9,mixedType,1
9,4,0,13,mixedType,1
6,2,0,8,mixedType,1
2,10,0,12,mixedType,1
8,2,0,10,mixedType,1
8,4,0,12,mixedType,1
7,2,0,9,mixedType,1
7,3,0,10,mixedType,1
8,2,0,10,mixedType,1
6,4,0,10,mixedType,1
19,6,0,25,mixedType,2
9,1,0,10,mixedType,1
7,3,0,10,mixedType,1
6,4,0,10,mixedType,1
4,4,0,8,mixedType,1
4,4,0,8,mixedType,1
5,4,0,9,mixedType,1
4,6,0,10,mixedType,1
13,3,0,16,mixedType,2
7,2,0,9,mixedType,1
12,3,0,15,mixedType,2
8,1,0,9,mixedType,1
8,1,0,9,mixedType,1
6,1,0,7,mixedType,0
7,2,0,9,mixedType,1
12,4,0,16,mixedType,2
4,2,0,6,mixedType,0
5,9,0,14,mixedType,2
6,4,0,10,mixedType,1
5,2,0,7,mixedType,0
1,11,0,12,mixedType,1
4,9,0,13,mixedType,1
12,3,0,15,mixedType,2
4,2,0,6,mixedType,0
10,2,0,12,mixedType,1
8,1,0,9,mixedType,1
2,8,0,10,mixedType,1
7,6,0,13,mixedType,1
4,4,0,8,mixedType,1
8,2,0,10,mixedType,1
6,2,0,8,mixedType,1
5,3,0,8,mixedType,1
13,3,0,16,mixedType,2
4,6,0,10,mixedType,1
14,2,0,16,mixedType,2
6,3,0,9,mixedType,1
15,1,0,16,mixedType,2
10,1,0,11,mixedType,1
5,4,0,9,mixedType,1
6,7,0,13,mixedType,1
6,2,0,8,mixedType,1
3,6,0,9,mixedType,1
8,1,0,9,mixedType,1
5,3,0,8,mixedType,1
6,6,0,12,mixedType,1
5,3,0,8,mixedType,1
8,4,0,12,mixedType,1
6,1,0,7,mixedType,0
14,2,0,16,mixedType,2
5,4,0,9,mixedType,1
4,4,0,8,mixedType,1
4,4,0,8,mixedType,1
6,6,0,12,mixedType,1
6,11,3,20,mixedType,2
14,2,0,16,mixedType,2
5,7,0,12,mixedType,1
7,3,0,10,mixedType,1
2,4,0,6,mixedType,0
5,4,0,9,mixedType,1
11,5,0,16,mixedType,2
5,2,0,7,mixedType,0
7,4,0,11,mixedType,1
6,3,0,9,mixedType,1
3,10,0,13,mixedType,1
9,3,0,12,mixedType,1
14,2,0,16,mixedType,2
2,6,0,8,mixedType,1
8,2,0,10,mixedType,1
7,3,0,10,mixedType,1
7,3,0,10,mixedType,1
5,4,0,9,mixedType,1
2,6,0,8,mixedType,1
2,5,0,7,mixedType,0
5,3,0,8,mixedType,1
6,3,0,9,mixedType,1
7,3,0,10,mixedType,1
6,1,0,7,mixedType,0
7,2,0,9,mixedType,1
1,13,1,15,mixedType,2
6,7,0,13,mixedType,1
4,2,0,6,mixedType,0
5,3,0,8,mixedType,1
5,5,0,10,mixedType,1
2,9,0,11,mixedType,1
7,2,0,9,mixedType,1
9,3,0,12,mixedType,1
6,1,0,7,mixedType,0
5,8,0,13,mixedType,1
13,3,0,16,mixedType,2
13,3,0,16,mixedType,2
12,3,0,15,mixedType,2
6,1,0,7,mixedType,0
5,3,0,8,mixedType,1
7,1,0,8,mixedType,1
5,4,0,9,mixedType,1
12,4,0,16,mixedType,2
7,2,0,9,mixedType,1
5,4,0,9,mixedType,1
8,3,0,11,mixedType,1
8,2,0,10,mixedType,1
7,1,0,8,mixedType,1
7,4,0,11,mixedType,1
6,3,0,9,mixedType,1
5,4,0,9,mixedType,1
7,2,0,9,mixedType,1
7,2,0,9,mixedType,1
6,3,0,9,mixedType,1
6,2,0,8,mixedType,1
6,3,0,9,mixedType,1
10,3,0,13,mixedType,1
5,2,0,7,mixedType,0
8,2,0,10,mixedType,1
6,4,0,10,mixedType,1
15,1,0,16,mixedType,2
4,6,0,10,mixedType,1
11,3,0,14,mixedType,2
8,2,0,10,mixedType,1
6,1,0,7,mixedType,0
6,3,0,9,mixedType,1
2,6,0,8,mixedType,1
4,2,0,6,mixedType,0
7,2,0,9,mixedType,1
14,2,0,16,mixedType,2
6,1,0,7,mixedType,0
6,3,0,9,mixedType,1
7,1,0,8,mixedType,1
2,6,0,8,mixedType,1
2,7,0,9,mixedType,1
5,2,0,7,mixedType,0
5,2,0,7,mixedType,0
5,2,0,7,mixedType,0
4,4,0,8,mixedType,1
6,3,0,9,mixedType,1
15,1,0,16,mixedType,2
4,2,0,6,mixedType,0
5,1,0,6,mixedType,0
8,2,0,10,mixedType,1
7,3,0,10,mixedType,1
6,1,0,7,mixedType,0
7,3,0,10,mixedType,1
7,3,0,10,mixedType,1
5,3,0,8,mixedType,1
4,2,0,6,mixedType,0
7,3,0,10,mixedType,1
5,4,0,9,mixedType,1
6,0,1,7,mixedType,0
2,6,0,8,mixedType,1
11,3,0,14,mixedType,2
10,4,2,16,mixedType,2
5,2,0,7,mixedType,0
6,1,0,7,mixedType,0
7,3,0,10,mixedType,1
5,1,0,6,mixedType,0
5,3,0,8,mixedType,1
7,3,0,10,mixedType,1
13,3,0,16,mixedType,2
7,3,0,10,mixedType,1
8,1,0,9,mixedType,1
3,11,0,14,mixedType,2
9,4,0,13,mixedType,1
8,2,0,10,mixedType,1
13,3,0,16,mixedType,2
2,8,0,10,mixedType,1
8,1,0,9,mixedType,1
7,3,0,10,mixedType,1
10,2,0,12,mixedType,1
4,6,0,10,mixedType,1
6,2,0,8,mixedType,1
9,2,0,11,mixedType,1
2,7,0,9,mixedType,1
2,8,0,10,mixedType,1
5,3,0,8,mixedType,1
3,6,0,9,mixedType,1
7,2,0,9,mixedType,1
6,1,0,7,mixedType,0
4,2,0,6,mixedType,0
5,4,0,9,mixedType,1
9,3,0,12,mixedType,1
9,1,0,10,mixedType,1
4,9,0,13,mixedType,1
8,3,0,11,mixedType,1
9,1,0,10,mixedType,1
6,3,0,9,mixedType,1
5,2,0,7,mixedType,0
4,4,0,8,mixedType,1
14,2,0,16,mixedType,2
7,1,0,8,mixedType,1
15,1,0,16,mixedType,2
6,3,0,9,mixedType,1
9,4,0,13,mixedType,1
8,2,0,10,mixedType,1
1,7,0,8,mixedType,1
4,6,0,10,mixedType,1
8,1,0,9,mixedType,1
13,3,0,16,mixedType,2
6,1,0,7,mixedType,0
13,1,1,15,mixedType,2
4,2,0,6,mixedType,0
8,1,0,9,mixedType,1
5,2,0,7,mixedType,0
7,3,0,10,mixedType,1
7,3,0,10,mixedType,1
7,2,0,9,mixedType,1
2,4,0,6,mixedType,0
8,3,0,11,mixedType,1
5,2,0,7,mixedType,0
8,2,0,10,mixedType,1
7,2,0,9,mixedType,1
4,4,0,8,mixedType,1
6,4,0,10,mixedType,1
7,3,0,10,mixedType,1
4,9,0,13,mixedType,1
5,4,0,9,mixedType,1
6,3,0,9,mixedType,1
6,1,0,7,mixedType,0
9,3,0,12,mixedType,1
5,2,0,7,mixedType,0
7,3,0,10,mixedType,1
7,2,0,9,mixedType,1
2,8,0,10,mixedType,1
15,1,0,16,mixedType,2
2,4,0,6,mixedType,0
3,7,0,10,mixedType,1
6,3,0,9,mixedType,1
4,4,0,8,mixedType,1
3,6,0,9,mixedType,1
12,3,0,15,mixedType,2
1,10,0,11,mixedType,1
6,3,0,9,mixedType,1
7,4,0,11,mixedType,1
6,3,0,9,mixedType,1
5,4,0,9,mixedType,1
1,8,0,9,mixedType,1
5,5,0,10,mixedType,1
7,3,0,10,mixedType,1
5,1,0,6,mixedType,0
4,2,0,6,mixedType,0
12,4,0,16,mixedType,2
7,3,0,10,mixedType,1
6,1,0,7,mixedType,0
15,1,0,16,mixedType,2
5,4,0,9,mixedType,1
6,1,0,7,mixedType,0
5,5,0,10,mixedType,1
6,2,0,8,mixedType,1
14,2,0,16,mixedType,2
7,2,0,9,mixedType,1
6,3,0,9,mixedType,1
8,1,0,9,mixedType,1
10,2,0,12,mixedType,1
5,2,0,7,mixedType,0
5,6,0,11,mixedType,1
13,3,0,16,mixedType,2
4,6,0,10,mixedType,1
11,3,0,14,mixedType,2
6,3,0,9,mixedType,1
8,2,0,10,mixedType,1
4,7,0,11,mixedType,1
6,3,0,9,mixedType,1
8,2,0,10,mixedType,1
4,4,0,8,mixedType,1
6,4,0,10,mixedType,1
6,3,0,9,mixedType,1
11,2,0,13,mixedType,1
4,7,0,11,mixedType,1
11,3,0,14,mixedType,2
4,2,0,6,mixedType,0
1,10,0,11,mixedType,1
3,6,0,9,mixedType,1
9,1,0,10,mixedType,1
4,4,0,8,mixedType,1
6,2,0,8,mixedType,1
4,4,0,8,mixedType,1
7,4,0,11,mixedType,1
9,1,0,10,mixedType,1
3,5,0,8,mixedType,1
14,2,0,16,mixedType,2
7,6,0,13,mixedType,1
14,2,0,16,mixedType,2
1,8,0,9,mixedType,1
7,2,0,9,mixedType,1
8,1,0,9,mixedType,1
8,2,0,10,mixedType,1
3,9,0,12,mixedType,1
8,1,0,9,mixedType,1
12,3,0,15,mixedType,2
12,4,0,16,mixedType,2
3,6,0,9,mixedType,1
14,2,0,16,mixedType,2
6,2,0,8,mixedType,1
7,1,0,8,mixedType,1
11,3,0,14,mixedType,2
11,3,0,14,mixedType,2
6,3,0,9,mixedType,1
7,3,0,10,mixedType,1
14,2,0,16,mixedType,2
6,4,0,10,mixedType,1
3,5,0,8,mixedType,1
8,3,0,11,mixedType,1
6,3,0,9,mixedType,1
12,4,0,16,mixedType,2
5,3,0,8,mixedType,1
4,2,0,6,mixedType,0
6,6,0,12,mixedType,1
10,2,0,12,mixedType,1
4,4,0,8,mixedType,1
9,4,0,13,mixedType,1
8,1,0,9,mixedType,1
6,2,0,8,mixedType,1
6,4,0,10,mixedType,1
8,1,0,9,mixedType,1
6,3,0,9,mixedType,1
7,2,0,9,mixedType,1
12,3,0,15,mixedType,2
7,2,0,9,mixedType,1
6,4,0,10,mixedType,1
2,6,0,8,mixedType,1
7,3,0,10,mixedType,1
1,7,0,8,mixedType,1
7,4,0,11,mixedType,1
7,2,0,9,mixedType,1
12,4,0,16,mixedType,2
9,1,0,10,mixedType,1
4,2,0,6,mixedType,0
11,2,0,13,mixedType,1
7,4,0,11,mixedType,1
4,4,0,8,mixedType,1
6,5,0,11,mixedType,1
3,5,0,8,mixedType,1
8,1,0,9,mixedType,1
11,1,0,12,mixedType,1
6,5,0,11,mixedType,1
6,3,0,9,mixedType,1
14,2,0,16,mixedType,2
6,2,0,8,mixedType,1
9,2,0,11,mixedType,1
4,6,0,10,mixedType,1
6,1,0,7,mixedType,0
7,1,0,8,mixedType,1
6,2,0,8,mixedType,1
7,2,0,9,mixedType,1
6,3,0,9,mixedType,1
7,3,0,10,mixedType,1
5,4,0,9,mixedType,1
7,1,0,8,mixedType,1
3,5,0,8,mixedType,1
2,4,0,6,mixedType,0
8,2,0,10,mixedType,1
8,2,0,10,mixedType,1
6,1,0,7,mixedType,0
1,5,0,6,mixedType,0
6,2,0,8,mixedType,1
7,2,0,9,mixedType,1
14,2,0,16,mixedType,2
7,3,0,10,mixedType,1
7,2,0,9,mixedType,1
6,2,0,8,mixedType,1
7,8,0,15,mixedType,2
15,1,0,16,mixedType,2
5,4,0,9,mixedType,1
7,4,0,11,mixedType,1
4,2,0,6,mixedType,0
9,1,0,10,mixedType,1
9,3,0,12,mixedType,1
5,4,0,9,mixedType,1
7,4,0,11,mixedType,1
11,5,0,16,mixedType,2
5,6,0,11,mixedType,1
9,1,0,10,mixedType,1
7,2,0,9,mixedType,1
8,4,0,12,mixedType,1
2,4,0,6,mixedType,0
4,4,0,8,mixedType,1
4,2,0,6,mixedType,0
3,9,0,12,mixedType,1
6,1,0,7,mixedType,0
5,4,0,9,mixedType,1
7,2,0,9,mixedType,1
6,3,0,9,mixedType,1
7,3,0,10,mixedType,1
6,1,0,7,mixedType,0
8,3,0,11,mixedType,1
5,1,0,6,mixedType,0
2,4,0,6,mixedType,0
13,3,0,16,mixedType,2
7,3,0,10,mixedType,1
6,6,0,12,mixedType,1
13,3,0,16,mixedType,2
3,6,0,9,mixedType,1
14,2,0,16,mixedType,2
5,1,0,6,mixedType,0
7,3,0,10,mixedType,1
5,4,0,9,mixedType,1
7,3,0,10,mixedType,1
7,2,0,9,mixedType,1
12,1,0,13,mixedType,1
3,7,0,10,mixedType,1
4,6,0,10,mixedType,1
1,7,0,8,mixedType,1
6,1,0,7,mixedType,0
5,1,0,6,mixedType,0
6,2,0,8,mixedType,1
7,1,0,8,mixedType,1
7,2,0,9,mixedType,1
7,3,0,10,mixedType,1
5,1,0,6,mixedType,0
5,6,0,11,mixedType,1
13,3,0,16,mixedType,2
7,1,0,8,mixedType,1
6,2,0,8,mixedType,1
4,4,0,8,mixedType,1
6,3,0,9,mixedType,1
9,1,0,10,mixedType,1
5,5,0,10,mixedType,1
7,3,0,10,mixedType,1
6,4,0,10,mixedType,1
5,3,0,8,mixedType,1
5,3,0,8,mixedType,1
5,3,0,8,mixedType,1
8,2,0,10,mixedType,1
7,3,0,10,mixedType,1
7,3,0,10,mixedType,1
6,2,0,8,mixedType,1
9,3,0,12,mixedType,1
8,1,0,9,mixedType,1
6,3,0,9,mixedType,1
5,2,0,7,mixedType,0
6,3,0,9,mixedType,1
5,1,0,6,mixedType,0
4,5,0,9,mixedType,1
5,3,0,8,mixedType,1
5,2,0,7,mixedType,0
3,6,0,9,mixedType,1
7,2,0,9,mixedType,1
8,3,0,11,mixedType,1
1,8,0,9,mixedType,1
12,3,0,15,mixedType,2
7,3,0,10,mixedType,1
7,3,0,10,mixedType,1
7,2,0,9,mixedType,1
5,4,0,9,mixedType,1
6,5,0,11,mixedType,1
4,2,0,6,mixedType,0
8,1,0,9,mixedType,1
6,2,0,8,mixedType,1
1,11,0,12,mixedType,1
5,2,0,7,mixedType,0
8,1,0,9,mixedType,1
6,1,0,7,mixedType,0
3,6,0,9,mixedType,1
5,3,0,8,mixedType,1
7,2,0,9,mixedType,1
3,7,0,10,mixedType,1
8,2,4,14,mixedType,2
9,3,0,12,mixedType,1
7,4,0,11,mixedType,1
6,4,0,10,mixedType,1
7,3,0,10,mixedType,1
7,3,0,10,mixedType,1
10,2,0,12,mixedType,1
4,2,0,6,mixedType,0
5,3,0,8,mixedType,1
6,4,0,10,mixedType,1
4,4,0,8,mixedType,1
8,2,0,10,mixedType,1
5,6,0,11,mixedType,1
11,2,0,13,mixedType,1
8,3,0,11,mixedType,1
8,2,0,10,mixedType,1
6,2,0,8,mixedType,1
4,6,0,10,mixedType,1
10,1,0,11,mixedType,1
4,2,0,6,mixedType,0
7,3,0,10,mixedType,1
7,2,0,9,mixedType,1
9,1,0,10,mixedType,1
4,4,0,8,mixedType,1
8,2,0,10,mixedType,1
7,5,0,12,mixedType,1
1,5,0,6,mixedType,0
8,2,0,10,mixedType,1
9,1,0,10,mixedType,1
4,4,0,8,mixedType,1
14,1,1,16,mixedType,2
1,8,0,9,mixedType,1
6,4,0,10,mixedType,1
1,7,0,8,mixedType,1
8,2,0,10,mixedType,1
9,4,0,13,mixedType,1
7,1,0,8,mixedType,1
9,1,0,10,mixedType,1
6,3,0,9,mixedType,1
6,3,0,9,mixedType,1
8,2,0,10,mixedType,1
14,2,0,16,mixedType,2
4,6,0,10,mixedType,1
14,2,0,16,mixedType,2
9,1,0,10,mixedType,1
6,3,0,9,mixedType,1
6,4,0,10,mixedType,1
12,3,0,15,mixedType,2
5,3,0,8,mixedType,1
7,3,0,10,mixedType,1
5,1,0,6,mixedType,0
11,2,0,13,mixedType,1
14,2,0,16,mixedType,2
3,6,0,9,mixedType,1
7,3,0,10,mixedType,1
7,3,0,10,mixedType,1
4,6,0,10,mixedType,1
8,2,0,10,mixedType,1
8,2,0,10,mixedType,1
6,2,0,8,mixedType,1
5,2,0,7,mixedType,0
9,3,0,12,mixedType,1
5,3,0,8,mixedType,1
10,3,0,13,mixedType,1
5,4,0,9,mixedType,1
14,2,0,16,mixedType,2
3,6,0,9,mixedType,1
7,2,0,9,mixedType,1
4,2,0,6,mixedType,0
6,2,0,8,mixedType,1
5,1,0,6,mixedType,0
11,3,1,15,mixedType,2
11,3,0,14,mixedType,2
5,1,0,6,mixedType,0
9,3,0,12,mixedType,1
13,3,0,16,mixedType,2
6,1,0,7,mixedType,0
6,2,0,8,mixedType,1
4,2,0,6,mixedType,0
14,2,0,16,mixedType,2
6,3,0,9,mixedType,1
12,3,0,15,mixedType,2
7,3,0,10,mixedType,1
8,1,0,9,mixedType,1
9,2,0,11,mixedType,1
4,2,0,6,mixedType,0
6,1,0,7,mixedType,0
6,1,0,7,mixedType,0
8,1,0,9,mixedType,1
5,2,0,7,mixedType,0
14,2,0,16,mixedType,2
4,6,0,10,mixedType,1
12,3,0,15,mixedType,2
7,1,0,8,mixedType,1
6,3,0,9,mixedType,1
9,1,0,10,mixedType,1
1,5,0,6,mixedType,0
7,3,0,10,mixedType,1
14,2,0,16,mixedType,2
11,2,0,13,mixedType,1
6,3,0,9,mixedType,1
15,1,0,16,mixedType,2
6,1,0,7,mixedType,0
6,3,0,9,mixedType,1
18,1,1,20,mixedType,2
6,3,0,9,mixedType,1
8,4,0,12,mixedType,1
6,4,0,10,mixedType,1
4,4,0,8,mixedType,1
8,1,0,9,mixedType,1
14,2,0,16,mixedType,2
6,4,0,10,mixedType,1
6,3,0,9,mixedType,1
5,3,0,8,mixedType,1
9,2,0,11,mixedType,1
6,4,0,10,mixedType,1
8,2,0,10,mixedType,1
7,3,0,10,mixedType,1
9,1,0,10,mixedType,1
6,4,0,10,mixedType,1
8,1,0,9,mixedType,1
2,7,0,9,mixedType,1
6,3,0,9,mixedType,1
5,4,0,9,mixedType,1
6,1,0,7,mixedType,0
6,2,0,8,mixedType,1
6,2,0,8,mixedType,1
5,2,0,7,mixedType,0
4,2,0,6,mixedType,0
12,3,0,15,mixedType,2
12,3,0,15,mixedType,2
14,2,0,16,mixedType,2
9,1,0,10,mixedType,1
4,9,1,14,mixedType,2
5,1,0,6,mixedType,0
7,4,0,11,mixedType,1
1,8,0,9,mixedType,1
8,7,0,15,mixedType,2
6,6,0,12,mixedType,1
7,2,0,9,mixedType,1
6,2,0,8,mixedType,1
6,4,0,10,mixedType,1
7,2,0,9,mixedType,1
5,2,0,7,mixedType,0
7,4,0,11,mixedType,1
5,4,0,9,mixedType,1
10,3,0,13,mixedType,1
6,4,0,10,mixedType,1
5,2,0,7,mixedType,0
12,4,0,16,mixedType,2
8,1,0,9,mixedType,1
5,4,0,9,mixedType,1
7,3,0,10,mixedType,1
6,3,0,9,mixedType,1
6,2,0,8,mixedType,1
3,7,0,10,mixedType,1
5,2,0,7,mixedType,0
8,3,0,11,mixedType,1
6,1,0,7,mixedType,0
4,2,0,6,mixedType,0
9,1,0,10,mixedType,1
6,5,0,11,mixedType,1
6,2,0,8,mixedType,1
5,2,0,7,mixedType,0
5,5,0,10,mixedType,1
12,3,0,15,mixedType,2
12,3,0,15,mixedType,2
8,2,0,10,mixedType,1
5,3,0,8,mixedType,1
6,1,0,7,mixedType,0
4,2,0,6,mixedType,0
6,4,0,10,mixedType,1
6,4,0,10,mixedType,1
5,4,0,9,mixedType,1
13,3,0,16,mixedType,2
1,7,0,8,mixedType,1
6,2,0,8,mixedType,1
6,3,0,9,mixedType,1
7,3,0,10,mixedType,1
9,4,0,13,mixedType,1
4,2,0,6,mixedType,0
4,2,0,6,mixedType,0
2,7,0,9,mixedType,1
4,4,0,8,mixedType,1
8,1,0,9,mixedType,1
4,4,0,8,mixedType,1
10,2,0,12,mixedType,1
5,2,0,7,mixedType,0
11,1,0,12,mixedType,1
1,10,0,11,mixedType,1
8,3,0,11,mixedType,1
6,3,0,9,mixedType,1
7,1,0,8,mixedType,1
13,3,0,16,mixedType,2
5,1,0,6,mixedType,0
5,2,0,7,mixedType,0
6,4,0,10,mixedType,1
8,2,0,10,mixedType,1
6,4,0,10,mixedType,1
6,2,0,8,mixedType,1
7,4,0,11,mixedType,1
11,3,0,14,mixedType,2
15,1,0,16,mixedType,2
5,2,0,7,mixedType,0
6,2,0,8,mixedType,1
5,4,0,9,mixedType,1
6,4,0,10,mixedType,1
4,2,0,6,mixedType,0
8,4,0,12,mixedType,1
18,3,0,21,mixedType,2
9,4,0,13,mixedType,1
4,7,0,11,mixedType,1
6,2,0,8,mixedType,1
1,9,0,10,mixedType,1
12,3,0,15,mixedType,2
9,4,0,13,mixedType,1
1,8,0,9,mixedType,1
5,4,0,9,mixedType,1
8,2,0,10,mixedType,1
13,3,0,16,mixedType,2
7,3,0,10,mixedType,1
12,3,0,15,mixedType,2
5,4,0,9,mixedType,1
1,8,0,9,mixedType,1
6,2,0,8,mixedType,1
9,1,0,10,mixedType,1
6,4,0,10,mixedType,1
6,1,0,7,mixedType,0
4,4,0,8,mixedType,1
3,7,0,10,mixedType,1
13,3,0,16,mixedType,2
7,2,0,9,mixedType,1
4,2,0,6,mixedType,0
5,3,0,8,mixedType,1
5,3,0,8,mixedType,1
6,1,0,7,mixedType,0
6,2,0,8,mixedType,1
7,3,0,10,mixedType,1
6,1,0,7,mixedType,0
7,3,0,10,mixedType,1
9,1,0,10,mixedType,1
11,3,0,14,mixedType,2
1,8,0,9,mixedType,1
4,7,0,11,mixedType,1
5,4,0,9,mixedType,1
7,3,0,10,mixedType,1
7,1,0,8,mixedType,1
8,2,0,10,mixedType,1
5,4,0,9,mixedType,1
4,4,0,8,mixedType,1
5,2,0,7,mixedType,0
1,9,0,10,mixedType,1
6,3,0,9,mixedType,1
3,4,0,7,mixedType,0
5,3,0,8,mixedType,1
5,4,0,9,mixedType,1
5,3,0,8,mixedType,1
6,3,0,9,mixedType,1
7,3,0,10,mixedType,1
4,8,0,12,mixedType,1
5,8,0,13,mixedType,1
2,8,0,10,mixedType,1
7,4,0,11,mixedType,1
4,2,0,6,mixedType,0
6,4,0,10,mixedType,1
9,2,0,11,mixedType,1
6,3,0,9,mixedType,1
5,4,0,9,mixedType,1
7,3,0,10,mixedType,1
8,2,0,10,mixedType,1
3,5,0,8,mixedType,1
8,1,0,9,mixedType,1
5,3,0,8,mixedType,1
6,6,0,12,mixedType,1
6,4,0,10,mixedType,1
5,4,0,9,mixedType,1
5,4,0,9,mixedType,1
6,2,0,8,mixedType,1
9,3,0,12,mixedType,1
9,4,0,13,mixedType,1
15,1,0,16,mixedType,2
5,1,0,6,mixedType,0
7,3,0,10,mixedType,1
5,1,0,6,mixedType,0
14,2,0,16,mixedType,2
4,2,0,6,mixedType,0
3,11,0,14,mixedType,2
11,6,0,17,mixedType,2
8,5,0,13,mixedType,1
1,12,0,13,mixedType,1
8,1,0,9,mixedType,1
4,2,0,6,mixedType,0
4,4,0,8,mixedType,1
14,2,0,16,mixedType,2
7,3,0,10,mixedType,1
3,6,0,9,mixedType,1
7,2,0,9,mixedType,1
13,3,0,16,mixedType,2
6,4,0,10,mixedType,1
1,5,0,6,mixedType,0
5,5,0,10,mixedType,1
5,5,0,10,mixedType,1
8,1,0,9,mixedType,1
7,2,0,9,mixedType,1
7,2,0,9,mixedType,1
8,2,0,10,mixedType,1
7,3,0,10,mixedType,1
5,3,0,8,mixedType,1
5,0,1,6,mixedType,0
7,1,0,8,mixedType,1
9,3,0,12,mixedType,1
1,8,0,9,mixedType,1
8,1,0,9,mixedType,1
5,3,0,8,mixedType,1
6,4,0,10,mixedType,1
5,2,0,7,mixedType,0
6,2,0,8,mixedType,1
4,4,0,8,mixedType,1
4,4,0,8,mixedType,1
1,8,0,9,mixedType,1
5,3,0,8,mixedType,1
11,3,0,14,mixedType,2
5,4,0,9,mixedType,1
10,2,0,12,mixedType,1
13,3,0,16,mixedType,2
6,3,0,9,mixedType,1
7,1,0,8,mixedType,1
6,8,0,14,mixedType,2
6,4,0,10,mixedType,1
7,3,0,10,mixedType,1
6,1,0,7,mixedType,0
2,7,0,9,mixedType,1
4,4,0,8,mixedType,1
2,7,0,9,mixedType,1
15,1,0,16,mixedType,2
7,2,0,9,mixedType,1
5,2,0,7,mixedType,0
7,3,0,10,mixedType,1
9,2,0,11,mixedType,1
4,4,0,8,mixedType,1
8,1,0,9,mixedType,1
8,2,0,10,mixedType,1
4,2,0,6,mixedType,0
6,3,0,9,mixedType,1
8,1,0,9,mixedType,1
6,1,0,7,mixedType,0
5,3,0,8,mixedType,1
7,3,0,10,mixedType,1
5,8,0,13,mixedType,1
5,2,0,7,mixedType,0
15,1,0,16,mixedType,2
7,2,0,9,mixedType,1
8,3,0,11,mixedType,1
7,2,0,9,mixedType,1
9,2,0,11,mixedType,1
5,1,0,6,mixedType,0
8,2,0,10,mixedType,1
11,2,0,13,mixedType,1
5,2,0,7,mixedType,0
7,5,0,12,mixedType,1
7,3,0,10,mixedType,1
5,6,0,11,mixedType,1
7,0,1,8,mixedType,1
3,6,0,9,mixedType,1
5,2,0,7,mixedType,0
5,3,0,8,mixedType,1
11,2,0,13,mixedType,1
6,8,0,14,mixedType,2
8,1,0,9,mixedType,1
3,7,0,10,mixedType,1
4,2,0,6,mixedType,0
8,2,0,10,mixedType,1
7,2,0,9,mixedType,1
6,4,0,10,mixedType,1
14,1,1,16,mixedType,2
8,1,0,9,mixedType,1
7,3,0,10,mixedType,1
9,4,0,13,mixedType,1
7,2,0,9,mixedType,1
6,2,0,8,mixedType,1
7,5,0,12,mixedType,1
6,1,0,7,mixedType,0
9,2,0,11,mixedType,1
10,1,0,11,mixedType,1
6,3,0,9,mixedType,1
4,2,0,6,mixedType,0
2,6,0,8,mixedType,1
5,2,0,7,mixedType,0
6,1,0,7,mixedType,0
14,2,0,16,mixedType,2
12,2,2,16,mixedType,2
7,7,0,14,mixedType,2
3,8,0,11,mixedType,1
6,3,0,9,mixedType,1
8,1,0,9,mixedType,1
13,3,0,16,mixedType,2
6,4,0,10,mixedType,1
0,8,1,9,mixedType,1
4,2,0,6,mixedType,0
8,2,0,10,mixedType,1
3,10,0,13,mixedType,1
6,2,0,8,mixedType,1
10,2,0,12,mixedType,1
9,3,0,12,mixedType,1
6,3,0,9,mixedType,1
6,3,0,9,mixedType,1
15,1,0,16,mixedType,2
6,1,0,7,mixedType,0
9,6,1,16,mixedType,2
5,4,0,9,mixedType,1
8,2,0,10,mixedType,1
2,6,0,8,mixedType,1
6,6,0,12,mixedType,1
5,2,0,7,mixedType,0
5,1,0,6,mixedType,0
5,2,0,7,mixedType,0
5,2,0,7,mixedType,0
3,3,0,6,mixedType,0
4,5,0,9,mixedType,1
5,3,0,8,mixedType,1
6,3,0,9,mixedType,1
9,6,0,15,mixedType,2
5,3,0,8,mixedType,1
7,2,0,9,mixedType,1
6,2,0,8,mixedType,1
2,6,0,8,mixedType,1
4,2,0,6,mixedType,0
3,7,0,10,mixedType,1
4,2,0,6,mixedType,0
1,8,0,9,mixedType,1
4,4,0,8,mixedType,1
6,4,0,10,mixedType,1
5,3,0,8,mixedType,1
4,2,0,6,mixedType,0
9,1,0,10,mixedType,1
4,6,0,10,mixedType,1
9,1,0,10,mixedType,1
8,2,0,10,mixedType,1
2,6,0,8,mixedType,1
9,1,0,10,mixedType,1
4,6,0,10,mixedType,1
5,4,0,9,mixedType,1
5,4,0,9,mixedType,1
4,4,0,8,mixedType,1
8,4,0,12,mixedType,1
9,3,0,12,mixedType,1
6,4,0,10,mixedType,1
5,6,0,11,mixedType,1
5,2,0,7,mixedType,0
11,1,0,12,mixedType,1
12,4,0,16,mixedType,2
14,2,0,16,mixedType,2
7,2,0,9,mixedType,1
8,1,0,9,mixedType,1
6,3,0,9,mixedType,1
7,2,0,9,mixedType,1
8,4,0,12,mixedType,1
4,4,0,8,mixedType,1
11,3,0,14,mixedType,2
6,2,0,8,mixedType,1
6,3,0,9,mixedType,1
5,3,0,8,mixedType,1
5,4,0,9,mixedType,1
5,3,0,8,mixedType,1
4,2,0,6,mixedType,0
13,6,0,19,mixedType,2
5,1,0,6,mixedType,0
6,3,0,9,mixedType,1
8,1,0,9,mixedType,1
8,1,0,9,mixedType,1
11,5,0,16,mixedType,2
13,3,0,16,mixedType,2
13,3,0,16,mixedType,2
7,3,0,10,mixedType,1
11,3,0,14,mixedType,2
8,4,0,12,mixedType,1
1,9,0,10,mixedType,1
5,4,0,9,mixedType,1
7,3,0,10,mixedType,1
6,2,0,8,mixedType,1
9,2,0,11,mixedType,1
6,3,0,9,mixedType,1
5,4,0,9,mixedType,1
7,6,0,13,mixedType,1
2,6,0,8,mixedType,1
9,2,0,11,mixedType,1
7,3,0,10,mixedType,1
3,7,0,10,mixedType,1
3,6,0,9,mixedType,1
5,3,0,8,mixedType,1
3,7,0,10,mixedType,1
4,4,0,8,mixedType,1
6,4,0,10,mixedType,1
6,2,0,8,mixedType,1
6,3,0,9,mixedType,1
1,10,0,11,mixedType,1
7,1,0,8,mixedType,1
2,8,0,10,mixedType,1
8,2,0,10,mixedType,1
7,4,0,11,mixedType,1
12,4,0,16,mixedType,2
10,4,0,14,mixedType,2
8,2,0,10,mixedType,1
6,3,0,9,mixedType,1
10,3,0,13,mixedType,1
4,4,0,8,mixedType,1
5,4,0,9,mixedType,1
7,1,0,8,mixedType,1
13,3,0,16,mixedType,2
6,3,0,9,mixedType,1
3,5,0,8,mixedType,1
13,3,0,16,mixedType,2
8,2,0,10,mixedType,1
7,2,0,9,mixedType,1
7,3,0,10,mixedType,1
1,7,0,8,mixedType,1
9,1,0,10,mixedType,1
13,3,0,16,mixedType,2
3,5,0,8,mixedType,1
14,2,0,16,mixedType,2
7,1,0,8,mixedType,1
5,2,0,7,mixedType,0
6,4,0,10,mixedType,1
8,2,0,10,mixedType,1
3,7,0,10,mixedType,1
9,1,0,10,mixedType,1
9,4,0,13,mixedType,1
7,3,0,10,mixedType,1
11,3,0,14,mixedType,2
7,3,0,10,mixedType,1
2,4,0,6,mixedType,0
4,2,0,6,mixedType,0
8,1,0,9,mixedType,1
5,3,0,8,mixedType,1
5,4,0,9,mixedType,1
6,4,0,10,mixedType,1
4,2,0,6,mixedType,0
7,2,0,9,mixedType,1
5,4,0,9,mixedType,1
6,1,0,7,mixedType,0
5,2,0,7,mixedType,0
7,1,0,8,mixedType,1
6,3,0,9,mixedType,1
7,2,0,9,mixedType,1
2,8,0,10,mixedType,1
8,1,0,9,mixedType,1
7,3,0,10,mixedType,1
13,1,1,15,mixedType,2
6,4,0,10,mixedType,1
7,3,0,10,mixedType,1
5,3,0,8,mixedType,1
6,3,0,9,mixedType,1
5,10,1,16,mixedType,2
6,3,0,9,mixedType,1
4,2,0,6,mixedType,0
3,8,0,11,mixedType,1
7,3,0,10,mixedType,1
14,2,0,16,mixedType,2
15,1,0,16,mixedType,2
5,3,0,8,mixedType,1
5,5,0,10,mixedType,1
12,3,0,15,mixedType,2
12,3,0,15,mixedType,2
7,2,0,9,mixedType,1
10,3,0,13,mixedType,1
8,4,0,12,mixedType,1
9,1,0,10,mixedType,1
7,3,0,10,mixedType,1
6,3,0,9,mixedType,1
12,1,0,13,mixedType,1
10,4,0,14,mixedType,2
6,2,0,8,mixedType,1
6,3,0,9,mixedType,1
7,1,0,8,mixedType,1
4,4,0,8,mixedType,1
6,3,0,9,mixedType,1
9,3,0,12,mixedType,1
6,4,0,10,mixedType,1
5,2,0,7,mixedType,0
8,1,0,9,mixedType,1
5,2,0,7,mixedType,0
12,4,0,16,mixedType,2
7,1,0,8,mixedType,1
12,3,0,15,mixedType,2
7,1,0,8,mixedType,1
2,9,0,11,mixedType,1
5,1,0,6,mixedType,0
6,2,0,8,mixedType,1
7,3,0,10,mixedType,1
6,2,0,8,mixedType,1
7,3,0,10,mixedType,1
12,1,0,13,mixedType,1
7,1,0,8,mixedType,1
5,3,0,8,mixedType,1
7,3,0,10,mixedType,1
13,3,0,16,mixedType,2
8,2,0,10,mixedType,1
3,6,0,9,mixedType,1
5,2,0,7,mixedType,0
5,2,0,7,mixedType,0
4,4,0,8,mixedType,1
6,6,0,12,mixedType,1
3,6,0,9,mixedType,1
8,1,0,9,mixedType,1
9,1,0,10,mixedType,1
12,4,0,16,mixedType,2
5,2,0,7,mixedType,0
9,1,0,10,mixedType,1
6,3,0,9,mixedType,1
1,8,0,9,mixedType,1
7,1,0,8,mixedType,1
6,3,0,9,mixedType,1
5,3,0,8,mixedType,1
7,2,0,9,mixedType,1
6,1,0,7,mixedType,0
7,3,0,10,mixedType,1
6,2,0,8,mixedType,1
4,4,0,8,mixedType,1
5,4,0,9,mixedType,1
6,3,0,9,mixedType,1
8,2,0,10,mixedType,1
5,4,0,9,mixedType,1
8,2,0,10,mixedType,1
8,5,0,13,mixedType,1
2,8,0,10,mixedType,1
3,6,0,9,mixedType,1
8,2,0,10,mixedType,1
7,2,0,9,mixedType,1
14,2,0,16,mixedType,2
2,4,0,6,mixedType,0
5,3,0,8,mixedType,1
5,3,0,8,mixedType,1
7,2,0,9,mixedType,1
9,2,0,11,mixedType,1
5,4,0,9,mixedType,1
7,3,0,10,mixedType,1
12,4,0,16,mixedType,2
5,2,0,7,mixedType,0
5,5,0,10,mixedType,1
7,2,0,9,mixedType,1
8,4,0,12,mixedType,1
2,7,0,9,mixedType,1
8,1,0,9,mixedType,1
5,3,0,8,mixedType,1
15,1,0,16,mixedType,2
7,1,0,8,mixedType,1
2,7,0,9,mixedType,1
13,3,0,16,mixedType,2
2,8,0,10,mixedType,1
8,2,0,10,mixedType,1
8,1,0,9,mixedType,1
7,3,0,10,mixedType,1
19,1,1,21,mixedType,2
11,3,0,14,mixedType,2
10,4,0,14,mixedType,2
6,4,0,10,mixedType,1
5,2,0,7,mixedType,0
7,5,0,12,mixedType,1
6,4,0,10,mixedType,1
4,2,0,6,mixedType,0
2,4,0,6,mixedType,0
3,6,0,9,mixedType,1
6,3,0,9,mixedType,1
1,8,0,9,mixedType,1
8,1,0,9,mixedType,1
5,3,0,8,mixedType,1
6,2,0,8,mixedType,1
10,4,0,14,mixedType,2
15,1,0,16,mixedType,2
8,2,0,10,mixedType,1
13,3,0,16,mixedType,2
4,2,0,6,mixedType,0
5,3,0,8,mixedType,1
4,2,0,6,mixedType,0
12,1,0,13,mixedType,1
7,3,0,10,mixedType,1
6,2,0,8,mixedType,1
6,3,0,9,mixedType,1
14,2,0,16,mixedType,2
7,1,0,8,mixedType,1
6,2,0,8,mixedType,1
6,4,0,10,mixedType,1
7,2,0,9,mixedType,1
7,4,0,11,mixedType,1
4,2,0,6,mixedType,0
4,4,0,8,mixedType,1
5,1,0,6,mixedType,0
1,8,0,9,mixedType,1
3,3,0,6,mixedType,0
7,3,0,10,mixedType,1
8,1,0,9,mixedType,1
10,1,0,11,mixedType,1
10,1,0,11,mixedType,1
5,3,0,8,mixedType,1
2,7,0,9,mixedType,1
8,1,0,9,mixedType,1
12,1,0,13,mixedType,1
6,3,0,9,mixedType,1
6,4,0,10,mixedType,1
6,1,0,7,mixedType,0
3,6,0,9,mixedType,1
4,2,0,6,mixedType,0
6,4,0,10,mixedType,1
6,1,0,7,mixedType,0
5,6,0,11,mixedType,1
9,1,0,10,mixedType,1
8,2,0,10,mixedType,1
6,3,0,9,mixedType,1
7,4,0,11,mixedType,1
5,2,0,7,mixedType,0
4,2,0,6,mixedType,0
9,2,0,11,mixedType,1
13,3,0,16,mixedType,2
4,0,3,7,mixedType,0
5,2,0,7,mixedType,0
5,1,0,6,mixedType,0
5,4,0,9,mixedType,1
6,1,0,7,mixedType,0
6,1,0,7,mixedType,0
8,1,0,9,mixedType,1
9,2,0,11,mixedType,1
7,3,0,10,mixedType,1
2,8,0,10,mixedType,1
14,2,0,16,mixedType,2
6,4,0,10,mixedType,1
3,6,0,9,mixedType,1
6,1,0,7,mixedType,0
4,6,0,10,mixedType,1
8,3,0,11,mixedType,1
5,4,0,9,mixedType,1
8,3,0,11,mixedType,1
5,1,0,6,mixedType,0
7,3,0,10,mixedType,1
1,7,0,8,mixedType,1
5,2,0,7,mixedType,0
8,2,0,10,mixedType,1
14,2,0,16,mixedType,2
6,3,0,9,mixedType,1
5,3,0,8,mixedType,1
10,2,0,12,mixedType,1
4,6,0,10,mixedType,1
9,2,0,11,mixedType,1
8,2,0,10,mixedType,1
3,3,0,6,mixedType,0
8,3,0,11,mixedType,1
7,5,0,12,mixedType,1
2,7,0,9,mixedType,1
4,6,0,10,mixedType,1
5,4,0,9,mixedType,1
8,1,0,9,mixedType,1
3,2,0,5,mixedType,0
5,2,0,7,mixedType,0
4,2,0,6,mixedType,0
7,1,0,8,mixedType,1
9,1,0,10,mixedType,1
9,1,0,10,mixedType,1
8,3,0,11,mixedType,1
10,2,0,12,mixedType,1
5,3,0,8,mixedType,1
4,8,0,12,mixedType,1
17,2,0,19,mixedType,2
4,5,0,9,mixedType,1
7,3,0,10,mixedType,1
4,2,0,6,mixedType,0
3,7,0,10,mixedType,1
7,1,0,8,mixedType,1
9,2,0,11,mixedType,1
1,9,0,10,mixedType,1
8,2,0,10,mixedType,1
1,8,0,9,mixedType,1
6,1,0,7,mixedType,0
4,4,0,8,mixedType,1
2,6,0,8,mixedType,1
13,3,0,16,mixedType,2
6,4,0,10,mixedType,1
6,1,0,7,mixedType,0
7,3,0,10,mixedType,1
4,6,0,10,mixedType,1
7,2,0,9,mixedType,1
4,2,0,6,mixedType,0
8,3,0,11,mixedType,1
1,8,0,9,mixedType,1
1,9,0,10,mixedType,1
1,8,0,9,mixedType,1
7,2,5,14,mixedType,2
15,1,0,16,mixedType,2
6,4,0,10,mixedType,1
3,7,0,10,mixedType,1
6,3,0,9,mixedType,1
9,4,0,13,mixedType,1
6,3,0,9,mixedType,1
5,4,0,9,mixedType,1
2,11,0,13,mixedType,1
5,4,0,9,mixedType,1
7,3,0,10,mixedType,1
5,3,0,8,mixedType,1
13,3,0,16,mixedType,2
4,4,0,8,mixedType,1
8,4,0,12,mixedType,1
5,3,0,8,mixedType,1
4,2,0,6,mixedType,0
6,4,0,10,mixedType,1
3,6,0,9,mixedType,1
5,2,0,7,mixedType,0
13,3,0,16,mixedType,2
7,3,0,10,mixedType,1
9,1,0,10,mixedType,1
6,2,0,8,mixedType,1
4,2,0,6,mixedType,0
5,3,0,8,mixedType,1
5,3,0,8,mixedType,1
12,4,1,17,mixedType,2
5,3,0,8,mixedType,1
5,4,0,9,mixedType,1
6,3,0,9,mixedType,1
7,3,0,10,mixedType,1
7,2,0,9,mixedType,1
9,1,0,10,mixedType,1
6,7,0,13,mixedType,1
10,3,0,13,mixedType,1
1,8,0,9,mixedType,1
7,1,0,8,mixedType,1
9,2,0,11,mixedType,1
9,2,0,11,mixedType,1
5,4,0,9,mixedType,1
6,3,0,9,mixedType,1
12,3,0,15,mixedType,2
5,3,0,8,mixedType,1
7,1,0,8,mixedType,1
3,8,0,11,mixedType,1
2,6,0,8,mixedType,1
6,2,0,8,mixedType,1
5,4,0,9,mixedType,1
3,7,0,10,mixedType,1
3,6,0,9,mixedType,1
4,2,0,6,mixedType,0
12,4,0,16,mixedType,2
6,2,0,8,mixedType,1
5,3,0,8,mixedType,1
6,3,0,9,mixedType,1
8,1,0,9,mixedType,1
3,5,0,8,mixedType,1
6,4,0,10,mixedType,1
5,4,0,9,mixedType,1
11,5,0,16,mixedType,2
4,4,0,8,mixedType,1
1,8,0,9,mixedType,1
2,8,0,10,mixedType,1
16,4,1,21,mixedType,2
8,2,0,10,mixedType,1
5,4,0,9,mixedType,1
7,3,0,10,mixedType,1
5,1,0,6,mixedType,0
5,6,0,11,mixedType,1
7,3,0,10,mixedType,1
9,0,1,10,mixedType,1
8,2,0,10,mixedType,1
13,3,0,16,mixedType,2
6,2,0,8,mixedType,1
10,2,0,12,mixedType,1
5,2,0,7,mixedType,0
8,2,0,10,mixedType,1
6,3,0,9,mixedType,1
8,1,0,9,mixedType,1
12,4,0,16,mixedType,2
8,2,0,10,mixedType,1
5,3,0,8,mixedType,1
5,2,0,7,mixedType,0
5,4,0,9,mixedType,1
5,3,0,8,mixedType,1
1,9,0,10,mixedType,1
7,2,0,9,mixedType,1
10,2,0,12,mixedType,1
8,1,0,9,mixedType,1
8,2,0,10,mixedType,1
7,3,0,10,mixedType,1
5,2,0,7,mixedType,0
10,7,0,17,mixedType,2
7,2,0,9,mixedType,1
4,2,0,6,mixedType,0
15,1,0,16,mixedType,2
7,3,0,10,mixedType,1
6,4,0,10,mixedType,1
4,5,0,9,mixedType,1
5,2,0,7,mixedType,0
9,2,0,11,mixedType,1
5,4,0,9,mixedType,1
7,4,0,11,mixedType,1
3,6,0,9,mixedType,1
13,3,0,16,mixedType,2
5,4,0,9,mixedType,1
12,3,0,15,mixedType,2
6,3,0,9,mixedType,1
9,2,0,11,mixedType,1
8,1,0,9,mixedType,1
4,4,0,8,mixedType,1
9,1,0,10,mixedType,1
7,1,0,8,mixedType,1
7,3,0,10,mixedType,1
6,3,0,9,mixedType,1
1,6,0,7,mixedType,0
9,3,0,12,mixedType,1
12,5,1,18,mixedType,2
5,4,0,9,mixedType,1
11,3,0,14,mixedType,2
7,3,0,10,mixedType,1
1,10,0,11,mixedType,1
7,1,0,8,mixedType,1
4,4,0,8,mixedType,1
11,0,2,13,mixedType,1
6,3,0,9,mixedType,1
14,2,0,16,mixedType,2
9,1,0,10,mixedType,1
5,5,0,10,mixedType,1
5,1,0,6,mixedType,0
5,3,0,8,mixedType,1
6,1,0,7,mixedType,0
12,0,1,13,mixedType,1
11,2,0,13,mixedType,1
4,2,0,6,mixedType,0
7,2,0,9,mixedType,1
6,4,0,10,mixedType,1
6,0,1,7,mixedType,0
13,3,0,16,mixedType,2
7,3,0,10,mixedType,1
14,2,0,16,mixedType,2
9,2,0,11,mixedType,1
4,2,0,6,mixedType,0
5,2,0,7,mixedType,0
8,4,0,12,mixedType,1
4,4,0,8,mixedType,1
6,2,0,8,mixedType,1
9,1,0,10,mixedType,1
7,3,0,10,mixedType,1
8,2,0,10,mixedType,1
6,1,0,7,mixedType,0
2,7,0,9,mixedType,1
10,1,0,11,mixedType,1
6,2,0,8,mixedType,1
5,2,0,7,mixedType,0
6,2,0,8,mixedType,1
6,3,0,9,mixedType,1
6,4,0,10,mixedType,1
3,6,0,9,mixedType,1
12,1,1,14,mixedType,2
7,2,0,9,mixedType,1
9,3,0,12,mixedType,1
1,7,0,8,mixedType,1
14,2,0,16,mixedType,2
6,4,0,10,mixedType,1
6,3,0,9,mixedType,1
2,10,0,12,mixedType,1
7,5,0,12,mixedType,1
7,3,0,10,mixedType,1
14,2,0,16,mixedType,2
3,6,0,9,mixedType,1
5,2,0,7,mixedType,0
5,2,0,7,mixedType,0
2,6,0,8,mixedType,1
7,2,0,9,mixedType,1
7,2,0,9,mixedType,1
5,4,0,9,mixedType,1
14,2,0,16,mixedType,2
4,7,0,11,mixedType,1
9,1,0,10,mixedType,1
8,3,0,11,mixedType,1
10,2,0,12,mixedType,1
8,1,0,9,mixedType,1
9,3,0,12,mixedType,1
9,1,0,10,mixedType,1
7,4,0,11,mixedType,1
5,1,0,6,mixedType,0
6,3,0,9,mixedType,1
4,4,0,8,mixedType,1
8,3,0,11,mixedType,1
5,3,0,8,mixedType,1
8,1,0,9,mixedType,1
13,3,0,16,mixedType,2
10,3,0,13,mixedType,1
2,7,0,9,mixedType,1
8,2,0,10,mixedType,1
7,1,0,8,mixedType,1
5,4,0,9,mixedType,1
6,3,0,9,mixedType,1
6,1,0,7,mixedType,0
7,1,0,8,mixedType,1
9,1,0,10,mixedType,1
8,1,0,9,mixedType,1
9,4,0,13,mixedType,1
7,3,0,10,mixedType,1
14,2,0,16,mixedType,2
7,4,0,11,mixedType,1
10,2,0,12,mixedType,1
6,1,0,7,mixedType,0
13,3,0,16,mixedType,2
4,4,0,8,mixedType,1
5,5,0,10,mixedType,1
11,2,0,13,mixedType,1
9,1,0,10,mixedType,1
5,2,0,7,mixedType,0
7,3,0,10,mixedType,1
9,4,0,13,mixedType,1
8,4,0,12,mixedType,1
5,5,0,10,mixedType,1
5,1,0,6,mixedType,0
8,4,0,12,mixedType,1
6,3,0,9,mixedType,1
8,2,0,10,mixedType,1
9,1,0,10,mixedType,1
7,2,0,9,mixedType,1
5,4,0,9,mixedType,1
4,6,0,10,mixedType,1
2,8,0,10,mixedType,1
7,1,0,8,mixedType,1
3,3,0,6,mixedType,0
3,7,0,10,mixedType,1
4,4,0,8,mixedType,1
7,1,0,8,mixedType,1
9,1,0,10,mixedType,1
7,4,0,11,mixedType,1
6,1,0,7,mixedType,0
8,4,0,12,mixedType,1
1,10,0,11,mixedType,1
4,2,0,6,mixedType,0
6,6,0,12,mixedType,1
5,4,0,9,mixedType,1
7,3,0,10,mixedType,1
6,4,0,10,mixedType,1
5,1,0,6,mixedType,0
12,4,0,16,mixedType,2
9,1,0,10,mixedType,1
2,4,0,6,mixedType,0
9,4,0,13,mixedType,1
6,3,0,9,mixedType,1
2,8,0,10,mixedType,1
13,3,0,16,mixedType,2
8,2,0,10,mixedType,1
1,7,0,8,mixedType,1
6,4,0,10,mixedType,1
6,3,0,9,mixedType,1
3,6,0,9,mixedType,1
1,8,0,9,mixedType,1
7,2,0,9,mixedType,1
11,4,0,15,mixedType,2
11,5,0,16,mixedType,2
8,1,0,9,mixedType,1
11,2,0,13,mixedType,1
8,4,0,12,mixedType,1
5,1,0,6,mixedType,0
6,4,0,10,mixedType,1
9,1,0,10,mixedType,1
1,12,0,13,mixedType,1
7,2,0,9,mixedType,1
6,1,0,7,mixedType,0
7,1,0,8,mixedType,1
14,2,0,16,mixedType,2
13,3,0,16,mixedType,2
6,2,0,8,mixedType,1
6,3,0,9,mixedType,1
14,2,0,16,mixedType,2
7,4,0,11,mixedType,1
11,2,0,13,mixedType,1
6,1,0,7,mixedType,0
5,2,0,7,mixedType,0
5,3,0,8,mixedType,1
5,3,0,8,mixedType,1
9,1,0,10,mixedType,1
3,6,0,9,mixedType,1
6,1,0,7,mixedType,0
6,3,0,9,mixedType,1
6,4,0,10,mixedType,1
5,5,0,10,mixedType,1
7,2,0,9,mixedType,1
9,1,0,10,mixedType,1
7,4,0,11,mixedType,1
8,3,0,11,mixedType,1
8,2,0,10,mixedType,1
8,2,0,10,mixedType,1
4,4,0,8,mixedType,1
7,1,0,8,mixedType,1
5,3,0,8,mixedType,1
11,1,0,12,mixedType,1
9,1,0,10,mixedType,1
5,2,0,7,mixedType,0
11,2,0,13,mixedType,1
5,1,0,6,mixedType,0
5,2,0,7,mixedType,0
6,6,0,12,mixedType,1
11,2,0,13,mixedType,1
5,2,0,7,mixedType,0
4,4,0,8,mixedType,1
4,6,0,10,mixedType,1
5,2,0,7,mixedType,0
7,2,0,9,mixedType,1
8,2,0,10,mixedType,1
2,6,0,8,mixedType,1
4,6,0,10,mixedType,1
7,3,0,10,mixedType,1
7,2,0,9,mixedType,1
15,1,0,16,mixedType,2
9,2,0,11,mixedType,1
1,8,0,9,mixedType,1
7,3,0,10,mixedType,1
6,4,0,10,mixedType,1
4,4,0,8,mixedType,1
5,4,0,9,mixedType,1
6,2,0,8,mixedType,1
5,3,0,8,mixedType,1
9,4,0,13,mixedType,1
6,1,0,7,mixedType,0
14,2,0,16,mixedType,2
7,2,0,9,mixedType,1
6,3,0,9,mixedType,1
3,8,0,11,mixedType,1
9,3,0,12,mixedType,1
5,1,0,6,mixedType,0
7,5,0,12,mixedType,1
6,4,0,10,mixedType,1
7,2,0,9,mixedType,1
5,2,0,7,mixedType,0
5,3,0,8,mixedType,1
1,7,0,8,mixedType,1
9,0,1,10,mixedType,1
5,6,0,11,mixedType,1
6,4,0,10,mixedType,1
6,3,0,9,mixedType,1
9,2,0,11,mixedType,1
12,3,0,15,mixedType,2
6,3,0,9,mixedType,1
9,1,0,10,mixedType,1
14,2,0,16,mixedType,2
15,1,0,16,mixedType,2
2,6,0,8,mixedType,1
5,2,0,7,mixedType,0
14,2,0,16,mixedType,2
4,4,0,8,mixedType,1
6,1,0,7,mixedType,0
13,1,1,15,mixedType,2
5,6,0,11,mixedType,1
5,2,0,7,mixedType,0
9,1,0,10,mixedType,1
7,1,0,8,mixedType,1
8,4,0,12,mixedType,1
7,3,0,10,mixedType,1
4,2,0,6,mixedType,0
4,11,0,15,mixedType,2
7,2,0,9,mixedType,1
4,2,0,6,mixedType,0
8,2,0,10,mixedType,1
14,2,0,16,mixedType,2
0,6,3,9,mixedType,1
7,1,0,8,mixedType,1
9,4,0,13,mixedType,1
2,8,0,10,mixedType,1
11,3,0,14,mixedType,2
8,2,0,10,mixedType,1
7,1,0,8,mixedType,1
6,1,0,7,mixedType,0
7,3,0,10,mixedType,1
9,2,0,11,mixedType,1
6,3,0,9,mixedType,1
2,8,0,10,mixedType,1
4,2,0,6,mixedType,0
7,2,0,9,mixedType,1
15,1,0,16,mixedType,2
0,9,1,10,mixedType,1
3,3,0,6,mixedType,0
3,7,0,10,mixedType,1
6,2,0,8,mixedType,1
3,5,0,8,mixedType,1
9,3,0,12,mixedType,1
13,3,0,16,mixedType,2
6,1,0,7,mixedType,0
6,6,0,12,mixedType,1
5,0,1,6,mixedType,0
12,4,0,16,mixedType,2
7,1,0,8,mixedType,1
8,2,0,10,mixedType,1
4,2,0,6,mixedType,0
4,4,0,8,mixedType,1
5,3,0,8,mixedType,1
7,2,0,9,mixedType,1
14,1,1,16,mixedType,2
8,4,0,12,mixedType,1
7,1,0,8,mixedType,1
1,7,0,8,mixedType,1
5,3,0,8,mixedType,1
6,2,0,8,mixedType,1
4,6,0,10,mixedType,1
1,7,0,8,mixedType,1
1,8,0,9,mixedType,1
12,3,0,15,mixedType,2
7,1,0,8,mixedType,1
6,2,0,8,mixedType,1
14,2,0,16,mixedType,2
8,2,0,10,mixedType,1
8,1,0,9,mixedType,1
14,2,0,16,mixedType,2
5,4,0,9,mixedType,1
15,1,0,16,mixedType,2
6,2,0,8,mixedType,1
8,2,0,10,mixedType,1
6,1,0,7,mixedType,0
5,1,0,6,mixedType,0
5,3,0,8,mixedType,1
0,4,3,7,mixedType,0
5,4,0,9,mixedType,1
2,9,0,11,mixedType,1
5,3,0,8,mixedType,1
9,1,0,10,mixedType,1
9,1,0,10,mixedType,1
7,6,0,13,mixedType,1
1,7,0,8,mixedType,1
7,1,0,8,mixedType,1
5,3,0,8,mixedType,1
5,2,0,7,mixedType,0
7,2,0,9,mixedType,1
6,3,0,9,mixedType,1
12,2,2,16,mixedType,2
6,3,0,9,mixedType,1
11,1,0,12,mixedType,1
1,8,0,9,mixedType,1
8,1,0,9,mixedType,1
3,8,0,11,mixedType,1
6,2,0,8,mixedType,1
5,3,0,8,mixedType,1
7,4,0,11,mixedType,1
9,2,0,11,mixedType,1
3,6,0,9,mixedType,1
4,4,0,8,mixedType,1
5,2,0,7,mixedType,0
7,2,0,9,mixedType,1
6,4,0,10,mixedType,1
6,6,0,12,mixedType,1
9,4,0,13,mixedType,1
8,0,1,9,mixedType,1
5,6,0,11,mixedType,1
11,3,0,14,mixedType,2
7,3,0,10,mixedType,1
6,2,0,8,mixedType,1
4,4,0,8,mixedType,1
5,6,0,11,mixedType,1
12,3,0,15,mixedType,2
4,6,0,10,mixedType,1
8,2,0,10,mixedType,1
9,1,0,10,mixedType,1
5,2,0,7,mixedType,0
10,2,0,12,mixedType,1
2,6,0,8,mixedType,1
5,5,0,10,mixedType,1
7,2,0,9,mixedType,1
6,1,0,7,mixedType,0
6,3,0,9,mixedType,1
9,1,0,10,mixedType,1
5,5,0,10,mixedType,1
7,3,0,10,mixedType,1
8,4,0,12,mixedType,1
6,3,0,9,mixedType,1
3,6,0,9,mixedType,1
1,8,0,9,mixedType,1
6,3,0,9,mixedType,1
8,2,0,10,mixedType,1
8,4,0,12,mixedType,1
6,2,0,8,mixedType,1
5,1,0,6,mixedType,0
6,3,0,9,mixedType,1
5,3,0,8,mixedType,1
8,3,0,11,mixedType,1
4,2,0,6,mixedType,0
5,2,0,7,mixedType,0
6,4,0,10,mixedType,1
10,1,0,11,mixedType,1
4,4,0,8,mixedType,1
3,5,0,8,mixedType,1
5,3,0,8,mixedType,1
5,6,0,11,mixedType,1
5,2,0,7,mixedType,0
4,2,0,6,mixedType,0
4,4,0,8,mixedType,1
6,1,0,7,mixedType,0
4,2,0,6,mixedType,0
7,4,0,11,mixedType,1
5,2,0,7,mixedType,0
14,2,0,16,mixedType,2
3,7,0,10,mixedType,1
5,3,0,8,mixedType,1
5,3,0,8,mixedType,1
5,2,0,7,mixedType,0
14,2,0,16,mixedType,2
4,4,0,8,mixedType,1
7,2,0,9,mixedType,1
4,4,0,8,mixedType,1
3,6,0,9,mixedType,1
7,3,0,10,mixedType,1
9,2,0,11,mixedType,1
7,3,0,10,mixedType,1
5,2,0,7,mixedType,0
5,6,0,11,mixedType,1
5,1,0,6,mixedType,0
5,3,0,8,mixedType,1
14,2,0,16,mixedType,2
5,3,0,8,mixedType,1
5,1,0,6,mixedType,0
6,3,0,9,mixedType,1
11,3,0,14,mixedType,2
6,3,0,9,mixedType,1
5,2,0,7,mixedType,0
6,4,0,10,mixedType,1
5,3,0,8,mixedType,1
5,1,0,6,mixedType,0
6,2,0,8,mixedType,1
7,3,0,10,mixedType,1
12,4,1,17,mixedType,2
7,2,0,9,mixedType,1
11,2,0,13,mixedType,1
2,4,0,6,mixedType,0
9,1,0,10,mixedType,1
7,2,0,9,mixedType,1
14,2,0,16,mixedType,2
5,3,0,8,mixedType,1
8,2,0,10,mixedType,1
6,3,0,9,mixedType,1
5,3,0,8,mixedType,1
6,2,0,8,mixedType,1
14,2,0,16,mixedType,2
15,1,0,16,mixedType,2
6,4,0,10,mixedType,1
2,8,0,10,mixedType,1
7,2,0,9,mixedType,1
5,2,0,7,mixedType,0
3,5,0,8,mixedType,1
8,2,0,10,mixedType,1
6,1,0,7,mixedType,0
6,1,0,7,mixedType,0
7,2,0,9,mixedType,1
6,2,0,8,mixedType,1
6,4,0,10,mixedType,1
8,2,0,10,mixedType,1
6,3,0,9,mixedType,1
8,2,0,10,mixedType,1
8,2,0,10,mixedType,1
12,4,0,16,mixedType,2
5,2,0,7,mixedType,0
4,6,0,10,mixedType,1
7,1,0,8,mixedType,1
6,2,0,8,mixedType,1
1,7,0,8,mixedType,1
10,2,0,12,mixedType,1
9,1,0,10,mixedType,1
7,3,0,10,mixedType,1
8,1,0,9,mixedType,1
9,1,0,10,mixedType,1
12,3,0,15,mixedType,2
2,7,0,9,mixedType,1
9,4,0,13,mixedType,1
7,2,0,9,mixedType,1
5,3,0,8,mixedType,1
7,3,0,10,mixedType,1
7,1,0,8,mixedType,1
6,4,0,10,mixedType,1
5,3,0,8,mixedType,1
9,3,0,12,mixedType,1
3,9,0,12,mixedType,1
4,2,0,6,mixedType,0
6,4,0,10,mixedType,1
7,5,0,12,mixedType,1
7,3,0,10,mixedType,1
8,2,0,10,mixedType,1
4,4,0,8,mixedType,1
2,6,0,8,mixedType,1
6,2,0,8,mixedType,1
6,3,0,9,mixedType,1
8,1,0,9,mixedType,1
4,6,0,10,mixedType,1
12,4,0,16,mixedType,2
4,4,0,8,mixedType,1
15,1,0,16,mixedType,2
5,2,0,7,mixedType,0
4,6,0,10,mixedType,1
5,4,0,9,mixedType,1
6,1,0,7,mixedType,0
10,4,0,14,mixedType,2
9,2,0,11,mixedType,1
1,7,0,8,mixedType,1
12,3,0,15,mixedType,2
13,3,0,16,mixedType,2
1,8,0,9,mixedType,1
6,3,0,9,mixedType,1
7,3,0,10,mixedType,1
9,1,0,10,mixedType,1
8,2,0,10,mixedType,1
4,4,0,8,mixedType,1
4,8,0,12,mixedType,1
15,1,0,16,mixedType,2
8,1,0,9,mixedType,1
5,3,0,8,mixedType,1
7,3,0,10,mixedType,1
6,3,0,9,mixedType,1
9,2,0,11,mixedType,1
7,1,0,8,mixedType,1
12,1,0,13,mixedType,1
5,6,0,11,mixedType,1
5,4,0,9,mixedType,1
5,1,0,6,mixedType,0
15,1,0,16,mixedType,2
8,6,0,14,mixedType,2
9,4,0,13,mixedType,1
5,1,0,6,mixedType,0
7,3,0,10,mixedType,1
4,2,0,6,mixedType,0
7,7,0,14,mixedType,2
8,4,0,12,mixedType,1
8,3,0,11,mixedType,1
6,3,0,9,mixedType,1
7,4,0,11,mixedType,1
1,9,0,10,mixedType,1
7,2,0,9,mixedType,1
9,1,0,10,mixedType,1
7,3,0,10,mixedType,1
8,1,0,9,mixedType,1
13,2,0,15,mixedType,2
15,1,0,16,mixedType,2
9,1,0,10,mixedType,1
6,6,0,12,mixedType,1
4,4,0,8,mixedType,1
4,2,0,6,mixedType,0
5,4,0,9,mixedType,1
5,3,0,8,mixedType,1
10,4,0,14,mixedType,2
8,3,0,11,mixedType,1
5,4,0,9,mixedType,1
8,4,0,12,mixedType,1
5,4,0,9,mixedType,1
3,6,0,9,mixedType,1
7,3,0,10,mixedType,1
6,3,0,9,mixedType,1
5,3,0,8,mixedType,1
5,7,0,12,mixedType,1
6,4,0,10,mixedType,1
6,5,0,11,mixedType,1
11,3,0,14,mixedType,2
7,1,0,8,mixedType,1
5,1,0,6,mixedType,0
6,3,0,9,mixedType,1
11,5,0,16,mixedType,2
7,6,0,13,mixedType,1
8,1,0,9,mixedType,1
6,1,0,7,mixedType,0
8,1,0,9,mixedType,1
7,5,0,12,mixedType,1
4,2,0,6,mixedType,0
6,4,0,10,mixedType,1
9,1,0,10,mixedType,1
12,4,0,16,mixedType,2
6,2,0,8,mixedType,1
7,2,0,9,mixedType,1
6,4,0,10,mixedType,1
6,7,0,13,mixedType,1
5,3,0,8,mixedType,1
8,3,0,11,mixedType,1
5,2,0,7,mixedType,0
8,1,0,9,mixedType,1
5,3,0,8,mixedType,1
8,4,0,12,mixedType,1
14,2,0,16,mixedType,2
10,3,2,15,mixedType,2
7,2,0,9,mixedType,1
7,1,0,8,mixedType,1
6,1,0,7,mixedType,0
3,6,0,9,mixedType,1
6,3,0,9,mixedType,1
6,8,1,15,mixedType,2
8,2,0,10,mixedType,1
8,2,0,10,mixedType,1
6,1,0,7,mixedType,0
7,1,0,8,mixedType,1
1,5,0,6,mixedType,0
4,2,0,6,mixedType,0
5,2,0,7,mixedType,0
3,8,0,11,mixedType,1
7,3,0,10,mixedType,1
5,3,0,8,mixedType,1
5,4,0,9,mixedType,1
5,0,0,5,sameType,0
6,6,0,12,mixedType,1
5,2,0,7,mixedType,0
5,3,0,8,mixedType,1
4,2,0,6,mixedType,0
8,1,0,9,mixedType,1
4,2,0,6,mixedType,0
9,7,0,16,mixedType,2
8,4,0,12,mixedType,1
7,2,0,9,mixedType,1
5,6,0,11,mixedType,1
11,3,0,14,mixedType,2
4,2,0,6,mixedType,0
4,4,0,8,mixedType,1
13,3,0,16,mixedType,2
5,1,0,6,mixedType,0
11,2,0,13,mixedType,1
5,4,0,9,mixedType,1
6,3,0,9,mixedType,1
13,2,0,15,mixedType,2
7,4,0,11,mixedType,1
8,2,0,10,mixedType,1
6,2,0,8,mixedType,1
7,3,0,10,mixedType,1
7,2,0,9,mixedType,1
5,3,0,8,mixedType,1
2,4,0,6,mixedType,0
6,3,0,9,mixedType,1
12,3,0,15,mixedType,2
7,2,0,9,mixedType,1
6,1,0,7,mixedType,0
3,8,0,11,mixedType,1
9,3,0,12,mixedType,1
7,2,0,9,mixedType,1
8,2,0,10,mixedType,1
1,8,0,9,mixedType,1
3,6,0,9,mixedType,1
6,3,0,9,mixedType,1
6,8,0,14,mixedType,2
9,3,0,12,mixedType,1
7,4,0,11,mixedType,1
2,8,0,10,mixedType,1
4,2,0,6,mixedType,0
3,6,0,9,mixedType,1
7,3,0,10,mixedType,1
6,2,0,8,mixedType,1
7,2,0,9,mixedType,1
9,1,0,10,mixedType,1
7,3,0,10,mixedType,1
5,2,0,7,mixedType,0
14,1,0,15,mixedType,2
5,2,0,7,mixedType,0
5,7,0,12,mixedType,1
13,3,0,16,mixedType,2
8,3,0,11,mixedType,1
6,3,0,9,mixedType,1
5,4,0,9,mixedType,1
8,2,0,10,mixedType,1
7,2,0,9,mixedType,1
5,2,0,7,mixedType,0
7,3,0,10,mixedType,1
12,3,0,15,mixedType,2
4,4,0,8,mixedType,1
9,4,0,13,mixedType,1
3,6,0,9,mixedType,1
7,2,0,9,mixedType,1
2,7,0,9,mixedType,1
6,2,0,8,mixedType,1
6,4,0,10,mixedType,1
4,2,0,6,mixedType,0
11,5,0,16,mixedType,2
6,3,0,9,mixedType,1
6,1,0,7,mixedType,0
9,2,0,11,mixedType,1
2,4,0,6,mixedType,0
6,4,0,10,mixedType,1
9,7,0,16,mixedType,2
8,4,0,12,mixedType,1
6,2,0,8,mixedType,1
6,4,0,10,mixedType,1
4,4,0,8,mixedType,1
14,2,0,16,mixedType,2
18,2,0,20,mixedType,2
2,9,0,11,mixedType,1
8,1,0,9,mixedType,1
7,2,0,9,mixedType,1
7,3,0,10,mixedType,1
5,3,0,8,mixedType,1
7,2,0,9,mixedType,1
8,2,0,10,mixedType,1
11,5,0,16,mixedType,2
6,2,0,8,mixedType,1
5,4,0,9,mixedType,1
9,2,0,11,mixedType,1
9,1,0,10,mixedType,1
14,2,0,16,mixedType,2
7,3,0,10,mixedType,1
4,5,0,9,mixedType,1
7,3,0,10,mixedType,1
7,3,0,10,mixedType,1
15,1,0,16,mixedType,2
7,3,0,10,mixedType,1
8,2,0,10,mixedType,1
7,3,0,10,mixedType,1
8,2,0,10,mixedType,1
7,2,0,9,mixedType,1
6,1,0,7,mixedType,0
8,1,0,9,mixedType,1
5,1,0,6,mixedType,0
6,1,0,7,mixedType,0
8,1,0,9,mixedType,1
7,2,0,9,mixedType,1
7,3,0,10,mixedType,1
9,2,0,11,mixedType,1
8,3,0,11,mixedType,1
6,3,0,9,mixedType,1
12,3,0,15,mixedType,2
8,3,0,11,mixedType,1
5,4,0,9,mixedType,1
12,3,0,15,mixedType,2
4,4,0,8,mixedType,1
8,1,0,9,mixedType,1
8,4,0,12,mixedType,1
1,12,0,13,mixedType,1
5,2,0,7,mixedType,0
8,1,0,9,mixedType,1
6,1,0,7,mixedType,0
9,4,1,14,mixedType,2
3,6,0,9,mixedType,1
6,2,0,8,mixedType,1
7,2,0,9,mixedType,1
15,1,0,16,mixedType,2
6,4,0,10,mixedType,1
6,3,0,9,mixedType,1
5,2,0,7,mixedType,0
7,4,0,11,mixedType,1
7,6,0,13,mixedType,1
7,3,0,10,mixedType,1
4,2,0,6,mixedType,0
6,4,0,10,mixedType,1
4,7,0,11,mixedType,1
7,3,0,10,mixedType,1
1,8,0,9,mixedType,1
2,10,0,12,mixedType,1
5,2,0,7,mixedType,0
7,1,0,8,mixedType,1
4,4,0,8,mixedType,1
5,6,0,11,mixedType,1
6,3,0,9,mixedType,1
6,3,0,9,mixedType,1
6,6,0,12,mixedType,1
4,4,0,8,mixedType,1
15,1,0,16,mixedType,2
14,2,0,16,mixedType,2
9,2,0,11,mixedType,1
7,4,0,11,mixedType,1
12,3,0,15,mixedType,2
12,1,0,13,mixedType,1
4,4,0,8,mixedType,1
6,4,0,10,mixedType,1
6,5,0,11,mixedType,1
7,1,0,8,mixedType,1
13,3,0,16,mixedType,2
7,3,0,10,mixedType,1
6,2,0,8,mixedType,1
2,10,0,12,mixedType,1
7,3,0,10,mixedType,1
6,4,0,10,mixedType,1
10,2,0,12,mixedType,1
6,3,0,9,mixedType,1
4,2,0,6,mixedType,0
6,2,0,8,mixedType,1
14,2,0,16,mixedType,2
13,3,0,16,mixedType,2
5,2,0,7,mixedType,0
4,2,0,6,mixedType,0
6,4,0,10,mixedType,1
5,4,0,9,mixedType,1
6,6,0,12,mixedType,1
6,3,0,9,mixedType,1
14,1,1,16,mixedType,2
3,8,0,11,mixedType,1
6,4,0,10,mixedType,1
6,4,0,10,mixedType,1
10,1,0,11,mixedType,1
6,3,0,9,mixedType,1
6,3,0,9,mixedType,1
8,3,0,11,mixedType,1
13,3,0,16,mixedType,2
6,1,0,7,mixedType,0
5,2,0,7,mixedType,0
3,8,0,11,mixedType,1
15,1,0,16,mixedType,2
9,2,0,11,mixedType,1
7,4,6,17,mixedType,2
8,2,0,10,mixedType,1
6,4,0,10,mixedType,1
8,4,0,12,mixedType,1
2,4,0,6,mixedType,0
6,3,0,9,mixedType,1
5,6,0,11,mixedType,1
6,1,0,7,mixedType,0
5,3,0,8,mixedType,1
8,1,0,9,mixedType,1
6,1,0,7,mixedType,0
6,2,0,8,mixedType,1
7,2,0,9,mixedType,1
10,2,0,12,mixedType,1
4,4,0,8,mixedType,1
2,8,0,10,mixedType,1
6,2,0,8,mixedType,1
10,1,0,11,mixedType,1
14,2,0,16,mixedType,2
6,4,0,10,mixedType,1
4,2,0,6,mixedType,0
7,2,0,9,mixedType,1
6,1,0,7,mixedType,0
5,1,0,6,mixedType,0
3,5,0,8,mixedType,1
6,1,0,7,mixedType,0
14,2,0,16,mixedType,2
7,1,0,8,mixedType,1
2,6,0,8,mixedType,1
4,2,0,6,mixedType,0
8,4,0,12,mixedType,1
6,3,0,9,mixedType,1
7,3,0,10,mixedType,1
11,2,0,13,mixedType,1
8,2,0,10,mixedType,1
8,1,0,9,mixedType,1
5,4,0,9,mixedType,1
6,3,0,9,mixedType,1
8,2,0,10,mixedType,1
4,2,0,6,mixedType,0
4,4,0,8,mixedType,1
2,8,0,10,mixedType,1
5,2,0,7,mixedType,0
4,2,0,6,mixedType,0
7,1,0,8,mixedType,1
12,3,0,15,mixedType,2
6,4,0,10,mixedType,1
7,3,0,10,mixedType,1
4,6,0,10,mixedType,1
5,4,0,9,mixedType,1
4,2,0,6,mixedType,0
6,3,0,9,mixedType,1
8,4,0,12,mixedType,1
9,1,0,10,mixedType,1
13,3,0,16,mixedType,2
6,3,0,9,mixedType,1
6,4,0,10,mixedType,1
7,3,0,10,mixedType,1
7,2,0,9,mixedType,1
6,3,0,9,mixedType,1
9,1,0,10,mixedType,1
1,8,0,9,mixedType,1
7,2,0,9,mixedType,1
2,6,0,8,mixedType,1
7,3,0,10,mixedType,1
1,8,0,9,mixedType,1
8,2,0,10,mixedType,1
11,0,1,12,mixedType,1
7,1,0,8,mixedType,1
23,5,0,28,mixedType,2
6,3,0,9,mixedType,1
7,3,0,10,mixedType,1
6,3,0,9,mixedType,1
7,3,0,10,mixedType,1
1,5,0,6,mixedType,0
12,3,0,15,mixedType,2
10,8,0,18,mixedType,2
8,1,0,9,mixedType,1
4,6,0,10,mixedType,1
2,7,0,9,mixedType,1
6,4,0,10,mixedType,1
8,3,0,11,mixedType,1
4,2,0,6,mixedType,0
8,2,0,10,mixedType,1
12,4,0,16,mixedType,2
8,1,0,9,mixedType,1
4,2,0,6,mixedType,0
7,1,0,8,mixedType,1
11,3,0,14,mixedType,2
7,3,0,10,mixedType,1
7,2,0,9,mixedType,1
7,4,0,11,mixedType,1
6,1,0,7,mixedType,0
8,2,0,10,mixedType,1
10,3,0,13,mixedType,1
2,7,0,9,mixedType,1
7,1,0,8,mixedType,1
4,4,0,8,mixedType,1
6,1,0,7,mixedType,0
6,3,0,9,mixedType,1
6,4,0,10,mixedType,1
6,3,0,9,mixedType,1
3,6,0,9,mixedType,1
6,2,0,8,mixedType,1
9,2,0,11,mixedType,1
4,4,0,8,mixedType,1
15,1,0,16,mixedType,2
4,2,0,6,mixedType,0
1,7,0,8,mixedType,1
8,2,0,10,mixedType,1
6,2,0,8,mixedType,1
6,7,0,13,mixedType,1
3,3,0,6,mixedType,0
6,1,0,7,mixedType,0
4,2,0,6,mixedType,0
6,3,0,9,mixedType,1
6,2,0,8,mixedType,1
5,2,0,7,mixedType,0
6,4,0,10,mixedType,1
9,2,0,11,mixedType,1
14,2,0,16,mixedType,2
9,2,0,11,mixedType,1
7,2,0,9,mixedType,1
13,3,0,16,mixedType,2
19,1,0,20,mixedType,2
4,2,0,6,mixedType,0
11,1,0,12,mixedType,1
7,3,0,10,mixedType,1
1,9,0,10,mixedType,1
7,1,0,8,mixedType,1
4,2,0,6,mixedType,0
7,3,0,10,mixedType,1
1,8,0,9,mixedType,1
4,4,0,8,mixedType,1
9,2,0,11,mixedType,1
10,1,0,11,mixedType,1
6,1,0,7,mixedType,0
9,2,0,11,mixedType,1
4,6,0,10,mixedType,1
10,6,0,16,mixedType,2
9,3,0,12,mixedType,1
4,2,0,6,mixedType,0
8,2,0,10,mixedType,1
6,4,0,10,mixedType,1
7,5,0,12,mixedType,1
3,7,0,10,mixedType,1
7,3,0,10,mixedType,1
5,2,0,7,mixedType,0
6,6,0,12,mixedType,1
8,2,0,10,mixedType,1
7,3,0,10,mixedType,1
5,2,0,7,mixedType,0
13,3,0,16,mixedType,2
6,4,0,10,mixedType,1
8,2,0,10,mixedType,1
7,2,0,9,mixedType,1
3,7,0,10,mixedType,1
4,5,0,9,mixedType,1
6,3,0,9,mixedType,1
1,7,0,8,mixedType,1
7,4,0,11,mixedType,1
7,2,0,9,mixedType,1
5,3,0,8,mixedType,1
6,3,0,9,mixedType,1
5,4,0,9,mixedType,1
9,1,0,10,mixedType,1
5,1,0,6,mixedType,0
7,3,0,10,mixedType,1
5,1,0,6,mixedType,0
4,6,0,10,mixedType,1
14,2,0,16,mixedType,2
2,6,0,8,mixedType,1
9,3,0,12,mixedType,1
2,4,0,6,mixedType,0
6,3,0,9,mixedType,1
7,3,0,10,mixedType,1
15,1,0,16,mixedType,2
7,2,0,9,mixedType,1
4,2,0,6,mixedType,0
6,3,0,9,mixedType,1
5,2,0,7,mixedType,0
7,3,0,10,mixedType,1
3,6,0,9,mixedType,1
3,6,0,9,mixedType,1
1,8,0,9,mixedType,1
6,3,0,9,mixedType,1
8,4,0,12,mixedType,1
6,3,0,9,mixedType,1
11,1,0,12,mixedType,1
7,4,0,11,mixedType,1
8,3,0,11,mixedType,1
5,2,0,7,mixedType,0
6,1,0,7,mixedType,0
9,3,0,12,mixedType,1
13,3,0,16,mixedType,2
6,3,0,9,mixedType,1
11,3,0,14,mixedType,2
6,2,0,8,mixedType,1
6,3,0,9,mixedType,1
8,1,0,9,mixedType,1
8,2,0,10,mixedType,1
8,2,0,10,mixedType,1
6,3,0,9,mixedType,1
6,3,0,9,mixedType,1
1,8,0,9,mixedType,1
12,4,0,16,mixedType,2
6,3,0,9,mixedType,1
4,2,0,6,mixedType,0
10,1,0,11,mixedType,1
12,4,0,16,mixedType,2
6,4,0,10,mixedType,1
7,11,0,18,mixedType,2
9,2,0,11,mixedType,1
7,3,0,10,mixedType,1
4,4,0,8,mixedType,1
8,6,0,14,mixedType,2
15,1,0,16,mixedType,2
7,1,0,8,mixedType,1
7,3,0,10,mixedType,1
7,1,0,8,mixedType,1
5,2,0,7,mixedType,0
2,4,0,6,mixedType,0
2,11,0,13,mixedType,1
4,4,0,8,mixedType,1
4,2,0,6,mixedType,0
8,2,0,10,mixedType,1
7,2,0,9,mixedType,1
9,3,0,12,mixedType,1
5,3,0,8,mixedType,1
11,3,0,14,mixedType,2
2,6,0,8,mixedType,1
4,2,0,6,mixedType,0
6,1,0,7,mixedType,0
4,2,0,6,mixedType,0
5,1,0,6,mixedType,0
8,1,0,9,mixedType,1
1,10,0,11,mixedType,1
1,8,0,9,mixedType,1
6,4,0,10,mixedType,1
6,4,0,10,mixedType,1
8,1,0,9,mixedType,1
5,4,0,9,mixedType,1
7,3,0,10,mixedType,1
14,2,0,16,mixedType,2
2,6,0,8,mixedType,1
5,4,0,9,mixedType,1
6,1,0,7,mixedType,0
14,2,0,16,mixedType,2
8,3,0,11,mixedType,1
4,6,0,10,mixedType,1
11,4,0,15,mixedType,2
4,5,0,9,mixedType,1
6,2,0,8,mixedType,1
5,2,0,7,mixedType,0
6,1,0,7,mixedType,0
7,3,0,10,mixedType,1
2,7,0,9,mixedType,1
13,3,0,16,mixedType,2
6,3,0,9,mixedType,1
9,1,0,10,mixedType,1
8,5,0,13,mixedType,1
5,4,0,9,mixedType,1
3,3,0,6,mixedType,0
4,6,0,10,mixedType,1
8,1,0,9,mixedType,1
5,4,0,9,mixedType,1
8,4,0,12,mixedType,1
7,3,0,10,mixedType,1
4,2,0,6,mixedType,0
12,1,1,14,mixedType,2
5,3,0,8,mixedType,1
7,3,0,10,mixedType,1
4,2,0,6,mixedType,0
6,1,0,7,mixedType,0
8,1,0,9,mixedType,1
1,6,0,7,mixedType,0
6,1,0,7,mixedType,0
6,6,0,12,mixedType,1
6,2,0,8,mixedType,1
5,4,0,9,mixedType,1
7,3,0,10,mixedType,1
8,4,0,12,mixedType,1
5,3,0,8,mixedType,1
5,1,0,6,mixedType,0
10,1,0,11,mixedType,1
5,2,0,7,mixedType,0
5,3,0,8,mixedType,1
4,12,1,17,mixedType,2
7,2,0,9,mixedType,1
4,6,0,10,mixedType,1
4,4,0,8,mixedType,1
5,6,0,11,mixedType,1
8,2,0,10,mixedType,1
7,1,0,8,mixedType,1
6,4,0,10,mixedType,1
3,7,0,10,mixedType,1
7,1,0,8,mixedType,1
2,8,0,10,mixedType,1
7,2,0,9,mixedType,1
6,1,0,7,mixedType,0
6,3,0,9,mixedType,1
8,2,0,10,mixedType,1
6,2,0,8,mixedType,1
7,3,0,10,mixedType,1
10,3,0,13,mixedType,1
2,7,0,9,mixedType,1
4,4,0,8,mixedType,1
7,3,0,10,mixedType,1
3,6,0,9,mixedType,1
8,1,0,9,mixedType,1
3,5,0,8,mixedType,1
2,7,0,9,mixedType,1
7,1,0,8,mixedType,1
6,2,0,8,mixedType,1
4,0,2,6,mixedType,0
8,3,0,11,mixedType,1
7,1,0,8,mixedType,1
7,3,0,10,mixedType,1
5,3,0,8,mixedType,1
3,7,0,10,mixedType,1
4,4,0,8,mixedType,1
6,3,0,9,mixedType,1
7,2,0,9,mixedType,1
4,2,0,6,mixedType,0
5,3,0,8,mixedType,1
9,1,0,10,mixedType,1
3,3,0,6,mixedType,0
5,4,0,9,mixedType,1
5,6,0,11,mixedType,1
3,6,0,9,mixedType,1
2,8,0,10,mixedType,1
6,3,0,9,mixedType,1
6,2,0,8,mixedType,1
8,2,0,10,mixedType,1
3,8,0,11,mixedType,1
9,2,0,11,mixedType,1
9,5,0,14,mixedType,2
8,1,0,9,mixedType,1
6,2,0,8,mixedType,1
7,3,0,10,mixedType,1
3,10,0,13,mixedType,1
4,4,0,8,mixedType,1
7,2,0,9,mixedType,1
9,6,0,15,mixedType,2
14,1,0,15,mixedType,2
2,8,0,10,mixedType,1
7,2,0,9,mixedType,1
8,2,0,10,mixedType,1
13,3,0,16,mixedType,2
8,1,0,9,mixedType,1
6,3,0,9,mixedType,1
3,10,0,13,mixedType,1
6,1,0,7,mixedType,0
5,5,0,10,mixedType,1
7,3,0,10,mixedType,1
5,3,0,8,mixedType,1
14,2,0,16,mixedType,2
8,1,0,9,mixedType,1
12,3,0,15,mixedType,2
9,0,1,10,mixedType,1
15,1,0,16,mixedType,2
10,0,1,11,mixedType,1
4,8,0,12,mixedType,1
7,2,0,9,mixedType,1
6,4,0,10,mixedType,1
14,2,0,16,mixedType,2
2,4,0,6,mixedType,0
6,2,0,8,mixedType,1
2,6,0,8,mixedType,1
7,4,0,11,mixedType,1
8,1,0,9,mixedType,1
8,1,0,9,mixedType,1
3,5,0,8,mixedType,1
4,4,0,8,mixedType,1
7,6,0,13,mixedType,1
9,3,0,12,mixedType,1
4,4,0,8,mixedType,1
4,6,0,10,mixedType,1
14,2,0,16,mixedType,2
5,4,0,9,mixedType,1
10,3,0,13,mixedType,1
2,7,0,9,mixedType,1
9,5,0,14,mixedType,2
6,1,0,7,mixedType,0
9,1,0,10,mixedType,1
8,2,0,10,mixedType,1
7,2,0,9,mixedType,1
0,6,1,7,mixedType,0
14,1,1,16,mixedType,2
6,1,0,7,mixedType,0
6,3,0,9,mixedType,1
8,1,0,9,mixedType,1
5,4,0,9,mixedType,1
7,3,0,10,mixedType,1
9,3,0,12,mixedType,1
7,3,0,10,mixedType,1
6,6,0,12,mixedType,1
8,1,0,9,mixedType,1
6,4,0,10,mixedType,1
6,3,0,9,mixedType,1
4,2,0,6,mixedType,0
8,1,0,9,mixedType,1
5,2,0,7,mixedType,0
1,5,0,6,mixedType,0
5,3,0,8,mixedType,1
8,2,0,10,mixedType,1
7,3,0,10,mixedType,1
7,1,0,8,mixedType,1
9,2,0,11,mixedType,1
6,4,0,10,mixedType,1
5,2,0,7,mixedType,0
13,3,0,16,mixedType,2
6,4,0,10,mixedType,1
5,4,0,9,mixedType,1
1,7,0,8,mixedType,1
14,2,0,16,mixedType,2
13,3,0,16,mixedType,2
6,3,0,9,mixedType,1
6,1,0,7,mixedType,0
6,5,0,11,mixedType,1
1,8,0,9,mixedType,1
8,1,0,9,mixedType,1
6,2,0,8,mixedType,1
2,6,0,8,mixedType,1
6,3,0,9,mixedType,1
7,3,0,10,mixedType,1
8,1,0,9,mixedType,1
7,4,0,11,mixedType,1
8,3,0,11,mixedType,1
9,4,0,13,mixedType,1
6,4,0,10,mixedType,1
8,4,0,12,mixedType,1
7,2,0,9,mixedType,1
10,2,0,12,mixedType,1
12,4,0,16,mixedType,2
6,2,0,8,mixedType,1
7,3,0,10,mixedType,1
7,3,0,10,mixedType,1
6,4,0,10,mixedType,1
6,2,0,8,mixedType,1
9,1,0,10,mixedType,1
1,8,0,9,mixedType,1
5,3,0,8,mixedType,1
6,3,0,9,mixedType,1
5,2,0,7,mixedType,0
4,4,0,8,mixedType,1
6,2,0,8,mixedType,1
9,1,0,10,mixedType,1
7,3,0,10,mixedType,1
5,8,0,13,mixedType,1
6,1,0,7,mixedType,0
5,3,0,8,mixedType,1
4,4,0,8,mixedType,1
15,1,0,16,mixedType,2
15,1,0,16,mixedType,2
5,2,0,7,mixedType,0
4,6,0,10,mixedType,1
8,2,0,10,mixedType,1
5,2,0,7,mixedType,0
1,8,0,9,mixedType,1
7,3,0,10,mixedType,1
5,6,0,11,mixedType,1
4,2,0,6,mixedType,0
8,3,0,11,mixedType,1
6,4,0,10,mixedType,1
5,3,0,8,mixedType,1
5,4,0,9,mixedType,1
9,2,0,11,mixedType,1
7,3,0,10,mixedType,1
12,4,0,16,mixedType,2
8,1,0,9,mixedType,1
11,1,0,12,mixedType,1
9,1,0,10,mixedType,1
11,3,0,14,mixedType,2
4,4,0,8,mixedType,1
8,3,0,11,mixedType,1
6,3,0,9,mixedType,1
15,1,0,16,mixedType,2
9,4,0,13,mixedType,1
14,2,0,16,mixedType,2
2,9,0,11,mixedType,1
5,4,0,9,mixedType,1
8,1,0,9,mixedType,1
6,3,0,9,mixedType,1
7,1,0,8,mixedType,1
5,1,0,6,mixedType,0
7,1,0,8,mixedType,1
10,0,1,11,mixedType,1
6,3,0,9,mixedType,1
6,6,0,12,mixedType,1
2,8,0,10,mixedType,1
7,3,0,10,mixedType,1
6,1,0,7,mixedType,0
7,1,0,8,mixedType,1
3,5,0,8,mixedType,1
9,2,0,11,mixedType,1
14,2,0,16,mixedType,2
11,0,1,12,mixedType,1
6,3,0,9,mixedType,1
5,2,0,7,mixedType,0
8,2,0,10,mixedType,1
6,2,0,8,mixedType,1
6,4,0,10,mixedType,1
5,3,0,8,mixedType,1
16,2,0,18,mixedType,2
4,8,0,12,mixedType,1
6,6,0,12,mixedType,1
1,8,0,9,mixedType,1
7,3,0,10,mixedType,1
10,2,2,14,mixedType,2
7,2,0,9,mixedType,1
15,1,0,16,mixedType,2
7,3,0,10,mixedType,1
9,1,0,10,mixedType,1
9,4,0,13,mixedType,1
5,4,0,9,mixedType,1
2,8,7,17,mixedType,2
15,1,0,16,mixedType,2
6,3,0,9,mixedType,1
4,4,0,8,mixedType,1
6,3,0,9,mixedType,1
4,2,0,6,mixedType,0
3,5,0,8,mixedType,1
10,2,0,12,mixedType,1
4,2,0,6,mixedType,0
5,2,0,7,mixedType,0
6,2,0,8,mixedType,1
6,2,0,8,mixedType,1
6,1,0,7,mixedType,0
6,2,0,8,mixedType,1
3,6,0,9,mixedType,1
7,2,0,9,mixedType,1
7,1,0,8,mixedType,1
6,3,0,9,mixedType,1
5,1,0,6,mixedType,0
7,2,0,9,mixedType,1
13,3,0,16,mixedType,2
4,2,0,6,mixedType,0
13,3,0,16,mixedType,2
4,4,0,8,mixedType,1
10,1,0,11,mixedType,1
6,1,0,7,mixedType,0
4,6,0,10,mixedType,1
1,8,0,9,mixedType,1
7,5,0,12,mixedType,1
4,2,0,6,mixedType,0
10,2,0,12,mixedType,1
7,2,0,9,mixedType,1
4,4,0,8,mixedType,1
5,3,0,8,mixedType,1
5,3,0,8,mixedType,1
6,4,0,10,mixedType,1
6,2,0,8,mixedType,1
8,4,0,12,mixedType,1
4,9,1,14,mixedType,2
2,4,0,6,mixedType,0
7,2,0,9,mixedType,1
15,1,0,16,mixedType,2
7,3,0,10,mixedType,1
8,2,0,10,mixedType,1
9,1,0,10,mixedType,1
7,2,0,9,mixedType,1
5,3,0,8,mixedType,1
14,2,0,16,mixedType,2
10,1,0,11,mixedType,1
3,6,0,9,mixedType,1
6,4,0,10,mixedType,1
1,8,0,9,mixedType,1
1,8,0,9,mixedType,1
6,4,0,10,mixedType,1
2,8,0,10,mixedType,1
4,4,0,8,mixedType,1
3,5,0,8,mixedType,1
6,4,0,10,mixedType,1
5,3,0,8,mixedType,1
5,5,0,10,mixedType,1
15,1,0,16,mixedType,2
6,2,0,8,mixedType,1
5,3,0,8,mixedType,1
3,3,0,6,mixedType,0
4,7,0,11,mixedType,1
10,3,0,13,mixedType,1
6,1,0,7,mixedType,0
9,1,0,10,mixedType,1
6,3,0,9,mixedType,1
2,10,0,12,mixedType,1
4,0,2,6,mixedType,0
7,2,0,9,mixedType,1
8,1,0,9,mixedType,1
5,3,0,8,mixedType,1
8,2,0,10,mixedType,1
9,3,0,12,mixedType,1
8,4,0,12,mixedType,1
7,3,0,10,mixedType,1
8,1,1,10,mixedType,1
14,2,0,16,mixedType,2
11,3,0,14,mixedType,2
14,2,0,16,mixedType,2
5,4,0,9,mixedType,1
7,2,0,9,mixedType,1
8,1,0,9,mixedType,1
8,4,0,12,mixedType,1
2,7,0,9,mixedType,1
6,1,0,7,mixedType,0
6,8,0,14,mixedType,2
5,2,0,7,mixedType,0
5,2,0,7,mixedType,0
4,2,0,6,mixedType,0
7,1,0,8,mixedType,1
7,3,0,10,mixedType,1
8,1,0,9,mixedType,1
5,5,0,10,mixedType,1
14,2,0,16,mixedType,2
8,2,0,10,mixedType,1
8,1,0,9,mixedType,1
2,7,0,9,mixedType,1
6,0,1,7,mixedType,0
9,4,0,13,mixedType,1
1,7,0,8,mixedType,1
6,4,0,10,mixedType,1
7,3,0,10,mixedType,1
6,4,0,10,mixedType,1
6,2,0,8,mixedType,1
6,3,0,9,mixedType,1
5,3,0,8,mixedType,1
7,4,0,11,mixedType,1
7,2,0,9,mixedType,1
4,8,0,12,mixedType,1
8,1,0,9,mixedType,1
4,2,0,6,mixedType,0
3,5,0,8,mixedType,1
8,1,0,9,mixedType,1
1,8,0,9,mixedType,1
4,5,0,9,mixedType,1
9,2,0,11,mixedType,1
2,4,0,6,mixedType,0
1,8,0,9,mixedType,1
7,1,0,8,mixedType,1
7,3,0,10,mixedType,1
7,3,0,10,mixedType,1
3,8,0,11,mixedType,1
6,1,0,7,mixedType,0
9,2,0,11,mixedType,1
9,3,0,12,mixedType,1
2,10,0,12,mixedType,1
5,3,0,8,mixedType,1
6,2,0,8,mixedType,1
7,0,1,8,mixedType,1
2,6,0,8,mixedType,1
13,2,0,15,mixedType,2
10,1,0,11,mixedType,1
11,2,0,13,mixedType,1
6,3,0,9,mixedType,1
6,4,0,10,mixedType,1
5,1,0,6,mixedType,0
8,2,0,10,mixedType,1
6,1,0,7,mixedType,0
15,1,0,16,mixedType,2
5,3,0,8,mixedType,1
4,2,0,6,mixedType,0
8,2,0,10,mixedType,1
9,3,0,12,mixedType,1
11,2,0,13,mixedType,1
8,4,0,12,mixedType,1
6,4,0,10,mixedType,1
6,4,0,10,mixedType,1
5,3,0,8,mixedType,1
4,4,0,8,mixedType,1
6,3,0,9,mixedType,1
6,4,0,10,mixedType,1
7,2,0,9,mixedType,1
7,3,0,10,mixedType,1
8,4,0,12,mixedType,1
4,10,0,14,mixedType,2
5,3,0,8,mixedType,1
5,3,0,8,mixedType,1
4,7,0,11,mixedType,1
7,3,0,10,mixedType,1
8,1,0,9,mixedType,1
13,3,0,16,mixedType,2
2,4,0,6,mixedType,0
7,3,0,10,mixedType,1
8,2,0,10,mixedType,1
5,2,0,7,mixedType,0
8,1,0,9,mixedType,1
8,2,0,10,mixedType,1
6,3,0,9,mixedType,1
5,3,0,8,mixedType,1
2,6,0,8,mixedType,1
4,4,0,8,mixedType,1
5,3,0,8,mixedType,1
6,6,0,12,mixedType,1
7,3,0,10,mixedType,1
8,1,0,9,mixedType,1
5,1,0,6,mixedType,0
8,1,0,9,mixedType,1
7,1,0,8,mixedType,1
6,2,0,8,mixedType,1
6,3,0,9,mixedType,1
4,6,0,10,mixedType,1
5,3,0,8,mixedType,1
7,3,0,10,mixedType,1
4,4,0,8,mixedType,1
5,3,0,8,mixedType,1
4,4,0,8,mixedType,1
5,3,0,8,mixedType,1
4,6,0,10,mixedType,1
4,2,0,6,mixedType,0
13,3,0,16,mixedType,2
8,1,0,9,mixedType,1
14,2,0,16,mixedType,2
7,3,0,10,mixedType,1
4,4,0,8,mixedType,1
6,2,0,8,mixedType,1
8,3,0,11,mixedType,1
6,2,0,8,mixedType,1
10,1,0,11,mixedType,1
8,3,0,11,mixedType,1
11,2,1,14,mixedType,2
4,2,0,6,mixedType,0
8,2,0,10,mixedType,1
9,1,0,10,mixedType,1
11,2,0,13,mixedType,1
5,2,0,7,mixedType,0
3,6,0,9,mixedType,1
6,4,0,10,mixedType,1
10,1,0,11,mixedType,1
1,7,0,8,mixedType,1
3,6,0,9,mixedType,1
2,8,0,10,mixedType,1
4,5,0,9,mixedType,1
1,8,0,9,mixedType,1
11,2,0,13,mixedType,1
9,3,0,12,mixedType,1
8,0,1,9,mixedType,1
4,2,0,6,mixedType,0
6,1,0,7,mixedType,0
8,2,0,10,mixedType,1
9,1,0,10,mixedType,1
6,1,0,7,mixedType,0
3,7,0,10,mixedType,1
5,4,0,9,mixedType,1
6,2,0,8,mixedType,1
15,1,0,16,mixedType,2
8,2,0,10,mixedType,1
7,2,0,9,mixedType,1
5,5,0,10,mixedType,1
7,1,0,8,mixedType,1
8,3,0,11,mixedType,1
8,1,0,9,mixedType,1
7,2,0,9,mixedType,1
9,1,0,10,mixedType,1
15,1,0,16,mixedType,2
5,5,0,10,mixedType,1
7,3,0,10,mixedType,1
5,1,0,6,mixedType,0
5,3,0,8,mixedType,1
7,1,0,8,mixedType,1
5,3,0,8,mixedType,1
4,4,0,8,mixedType,1
6,4,0,10,mixedType,1
15,1,0,16,mixedType,2
12,1,0,13,mixedType,1
4,2,0,6,mixedType,0
4,2,0,6,mixedType,0
6,2,0,8,mixedType,1
5,3,0,8,mixedType,1
5,2,0,7,mixedType,0
12,4,0,16,mixedType,2
9,1,0,10,mixedType,1
15,1,0,16,mixedType,2
3,0,3,6,mixedType,0
6,3,0,9,mixedType,1
7,2,0,9,mixedType,1
7,2,0,9,mixedType,1
6,2,0,8,mixedType,1
7,2,0,9,mixedType,1
5,2,0,7,mixedType,0
9,2,0,11,mixedType,1
6,2,0,8,mixedType,1
6,4,0,10,mixedType,1
8,1,0,9,mixedType,1
6,1,0,7,mixedType,0
6,4,0,10,mixedType,1
5,1,0,6,mixedType,0
5,3,0,8,mixedType,1
5,4,0,9,mixedType,1
5,4,0,9,mixedType,1
3,6,0,9,mixedType,1
7,3,0,10,mixedType,1
4,6,0,10,mixedType,1
9,3,0,12,mixedType,1
7,5,0,12,mixedType,1
13,3,0,16,mixedType,2
4,2,0,6,mixedType,0
8,1,0,9,mixedType,1
10,1,0,11,mixedType,1
5,2,0,7,mixedType,0
5,3,0,8,mixedType,1
5,1,0,6,mixedType,0
7,2,0,9,mixedType,1
6,1,0,7,mixedType,0
14,2,0,16,mixedType,2
4,6,0,10,mixedType,1
13,3,0,16,mixedType,2
6,1,0,7,mixedType,0
8,1,0,9,mixedType,1
14,2,0,16,mixedType,2
6,3,0,9,mixedType,1
7,4,0,11,mixedType,1
8,1,0,9,mixedType,1
6,3,0,9,mixedType,1
4,4,0,8,mixedType,1
12,3,0,15,mixedType,2
13,4,0,17,mixedType,2
8,2,0,10,mixedType,1
11,5,0,16,mixedType,2
6,3,0,9,mixedType,1
7,4,0,11,mixedType,1
2,6,0,8,mixedType,1
6,4,0,10,mixedType,1
4,4,0,8,mixedType,1
7,4,0,11,mixedType,1
6,3,0,9,mixedType,1
12,4,0,16,mixedType,2
2,8,0,10,mixedType,1
7,7,0,14,mixedType,2
5,2,0,7,mixedType,0
10,4,0,14,mixedType,2
4,4,0,8,mixedType,1
3,6,0,9,mixedType,1
8,2,0,10,mixedType,1
4,2,0,6,mixedType,0
6,2,0,8,mixedType,1
8,1,0,9,mixedType,1
10,4,0,14,mixedType,2
8,4,0,12,mixedType,1
14,2,0,16,mixedType,2
5,3,0,8,mixedType,1
13,4,0,17,mixedType,2
3,5,0,8,mixedType,1
4,6,0,10,mixedType,1
9,4,0,13,mixedType,1
14,2,0,16,mixedType,2
2,4,0,6,mixedType,0
11,1,0,12,mixedType,1
7,1,0,8,mixedType,1
6,2,0,8,mixedType,1
5,2,0,7,mixedType,0
2,9,0,11,mixedType,1
4,6,0,10,mixedType,1
8,4,0,12,mixedType,1
4,4,0,8,mixedType,1
3,6,0,9,mixedType,1
5,8,0,13,mixedType,1
6,4,0,10,mixedType,1
5,3,0,8,mixedType,1
6,1,0,7,mixedType,0
10,2,0,12,mixedType,1
2,9,0,11,mixedType,1
8,3,0,11,mixedType,1
14,2,0,16,mixedType,2
5,3,0,8,mixedType,1
1,11,0,12,mixedType,1
4,2,0,6,mixedType,0
5,2,0,7,mixedType,0
8,2,0,10,mixedType,1
8,3,0,11,mixedType,1
13,3,0,16,mixedType,2
5,3,0,8,mixedType,1
6,2,0,8,mixedType,1
4,2,0,6,mixedType,0
6,3,0,9,mixedType,1
8,4,0,12,mixedType,1
5,8,0,13,mixedType,1
1,8,0,9,mixedType,1
6,5,0,11,mixedType,1
9,1,0,10,mixedType,1
4,4,0,8,mixedType,1
1,8,0,9,mixedType,1
5,1,0,6,mixedType,0
10,2,0,12,mixedType,1
14,2,0,16,mixedType,2
1,10,0,11,mixedType,1
5,3,0,8,mixedType,1
7,1,0,8,mixedType,1
5,2,0,7,mixedType,0
8,1,0,9,mixedType,1
7,2,0,9,mixedType,1
6,6,0,12,mixedType,1
4,2,0,6,mixedType,0
4,2,0,6,mixedType,0
7,4,0,11,mixedType,1
7,1,0,8,mixedType,1
7,1,0,8,mixedType,1
7,2,0,9,mixedType,1
8,4,0,12,mixedType,1
4,4,0,8,mixedType,1
6,2,0,8,mixedType,1
6,2,0,8,mixedType,1
7,1,0,8,mixedType,1
4,2,0,6,mixedType,0
5,4,0,9,mixedType,1
6,4,0,10,mixedType,1
14,1,1,16,mixedType,2
8,1,0,9,mixedType,1
7,3,0,10,mixedType,1
7,3,0,10,mixedType,1
8,4,0,12,mixedType,1
1,10,0,11,mixedType,1
6,4,0,10,mixedType,1
3,7,0,10,mixedType,1
15,4,0,19,mixedType,2
6,1,0,7,mixedType,0
3,8,0,11,mixedType,1
1,7,0,8,mixedType,1
9,1,0,10,mixedType,1
8,2,0,10,mixedType,1
6,1,0,7,mixedType,0
8,2,0,10,mixedType,1
14,2,0,16,mixedType,2
1,8,0,9,mixedType,1
8,4,0,12,mixedType,1
8,1,0,9,mixedType,1
3,6,0,9,mixedType,1
1,8,0,9,mixedType,1
1,8,0,9,mixedType,1
15,1,0,16,mixedType,2
6,1,0,7,mixedType,0
11,4,0,15,mixedType,2
6,3,0,9,mixedType,1
5,1,0,6,mixedType,0
3,6,0,9,mixedType,1
4,7,0,11,mixedType,1
7,3,0,10,mixedType,1
7,3,0,10,mixedType,1
5,4,0,9,mixedType,1
6,3,0,9,mixedType,1
5,3,0,8,mixedType,1
7,2,0,9,mixedType,1
8,1,0,9,mixedType,1
3,9,0,12,mixedType,1
5,2,0,7,mixedType,0
6,6,0,12,mixedType,1
1,7,0,8,mixedType,1
7,3,0,10,mixedType,1
5,4,0,9,mixedType,1
13,3,0,16,mixedType,2
6,3,0,9,mixedType,1
5,5,0,10,mixedType,1
15,1,0,16,mixedType,2
12,3,0,15,mixedType,2
5,4,0,9,mixedType,1
6,3,0,9,mixedType,1
8,2,0,10,mixedType,1
7,2,0,9,mixedType,1
12,3,0,15,mixedType,2
6,1,0,7,mixedType,0
13,3,0,16,mixedType,2
8,2,0,10,mixedType,1
8,1,0,9,mixedType,1
3,7,0,10,mixedType,1
5,1,0,6,mixedType,0
8,1,0,9,mixedType,1
5,1,0,6,mixedType,0
10,2,0,12,mixedType,1
6,2,0,8,mixedType,1
7,3,0,10,mixedType,1
9,2,0,11,mixedType,1
4,4,0,8,mixedType,1
9,2,0,11,mixedType,1
2,6,0,8,mixedType,1
7,3,0,10,mixedType,1
6,3,0,9,mixedType,1
3,6,0,9,mixedType,1
5,3,0,8,mixedType,1
6,4,0,10,mixedType,1
34,5,0,39,mixedType,2
14,2,0,16,mixedType,2
7,3,0,10,mixedType,1
9,3,0,12,mixedType,1
7,3,0,10,mixedType,1
6,1,0,7,mixedType,0
7,2,0,9,mixedType,1
5,2,0,7,mixedType,0
7,1,0,8,mixedType,1
6,3,0,9,mixedType,1
11,3,0,14,mixedType,2
1,8,0,9,mixedType,1
15,1,0,16,mixedType,2
5,2,0,7,mixedType,0
9,1,0,10,mixedType,1
7,5,0,12,mixedType,1
12,4,0,16,mixedType,2
3,3,0,6,mixedType,0
9,4,0,13,mixedType,1
4,2,0,6,mixedType,0
6,1,0,7,mixedType,0
7,4,0,11,mixedType,1
9,4,0,13,mixedType,1
6,4,0,10,mixedType,1
2,8,0,10,mixedType,1
12,3,0,15,mixedType,2
8,4,0,12,mixedType,1
4,6,0,10,mixedType,1
4,6,0,10,mixedType,1
6,2,0,8,mixedType,1
13,3,0,16,mixedType,2
7,2,0,9,mixedType,1
9,3,0,12,mixedType,1
5,3,0,8,mixedType,1
5,3,0,8,mixedType,1
7,2,0,9,mixedType,1
4,4,0,8,mixedType,1
6,4,0,10,mixedType,1
5,4,0,9,mixedType,1
4,2,0,6,mixedType,0
14,2,0,16,mixedType,2
6,4,0,10,mixedType,1
5,1,0,6,mixedType,0
8,3,0,11,mixedType,1
8,2,0,10,mixedType,1
8,2,0,10,mixedType,1
4,4,0,8,mixedType,1
6,3,0,9,mixedType,1
9,2,0,11,mixedType,1
4,2,0,6,mixedType,0
6,1,0,7,mixedType,0
6,6,0,12,mixedType,1
3,8,0,11,mixedType,1
6,1,0,7,mixedType,0
5,2,0,7,mixedType,0
6,2,0,8,mixedType,1
9,1,0,10,mixedType,1
2,4,0,6,mixedType,0
7,3,0,10,mixedType,1
1,9,0,10,mixedType,1
12,4,0,16,mixedType,2
9,5,0,14,mixedType,2
5,1,0,6,mixedType,0
12,3,0,15,mixedType,2
2,8,0,10,mixedType,1
5,1,0,6,mixedType,0
3,5,0,8,mixedType,1
4,4,0,8,mixedType,1
6,2,0,8,mixedType,1
3,6,0,9,mixedType,1
6,2,0,8,mixedType,1
4,4,0,8,mixedType,1
3,3,0,6,mixedType,0
5,4,0,9,mixedType,1
5,6,0,11,mixedType,1
3,8,0,11,mixedType,1
6,4,0,10,mixedType,1
7,1,0,8,mixedType,1
1,7,0,8,mixedType,1
13,3,0,16,mixedType,2
5,2,0,7,mixedType,0
6,3,0,9,mixedType,1
5,4,0,9,mixedType,1
9,5,0,14,mixedType,2
8,3,0,11,mixedType,1
5,1,0,6,mixedType,0
9,3,0,12,mixedType,1
6,3,0,9,mixedType,1
7,3,0,10,mixedType,1
6,1,0,7,mixedType,0
8,2,0,10,mixedType,1
6,2,0,8,mixedType,1
15,1,0,16,mixedType,2
5,2,0,7,mixedType,0
8,2,0,10,mixedType,1
3,7,0,10,mixedType,1
5,3,0,8,mixedType,1
11,2,1,14,mixedType,2
10,3,0,13,mixedType,1
5,4,0,9,mixedType,1
11,3,0,14,mixedType,2
10,2,0,12,mixedType,1
9,3,0,12,mixedType,1
4,8,0,12,mixedType,1
6,3,0,9,mixedType,1
2,8,0,10,mixedType,1
11,5,0,16,mixedType,2
14,2,0,16,mixedType,2
5,4,0,9,mixedType,1
2,7,0,9,mixedType,1
6,1,0,7,mixedType,0
9,1,0,10,mixedType,1
10,3,0,13,mixedType,1
6,4,0,10,mixedType,1
8,3,0,11,mixedType,1
8,2,0,10,mixedType,1
5,3,0,8,mixedType,1
9,4,0,13,mixedType,1
5,1,0,6,mixedType,0
5,4,0,9,mixedType,1
6,3,0,9,mixedType,1
6,4,0,10,mixedType,1
6,3,0,9,mixedType,1
6,1,0,7,mixedType,0
7,3,0,10,mixedType,1
9,2,0,11,mixedType,1
10,3,0,13,mixedType,1
9,1,0,10,mixedType,1
6,4,0,10,mixedType,1
3,7,0,10,mixedType,1
6,3,0,9,mixedType,1
4,6,0,10,mixedType,1
6,1,0,7,mixedType,0
12,4,0,16,mixedType,2
6,4,0,10,mixedType,1
4,6,0,10,mixedType,1
5,1,0,6,mixedType,0
7,2,0,9,mixedType,1
7,1,0,8,mixedType,1
7,3,0,10,mixedType,1
10,3,0,13,mixedType,1
7,2,0,9,mixedType,1
9,4,0,13,mixedType,1
15,1,0,16,mixedType,2
7,2,0,9,mixedType,1
7,3,0,10,mixedType,1
9,5,0,14,mixedType,2
5,1,0,6,mixedType,0
8,5,0,13,mixedType,1
7,2,0,9,mixedType,1
3,8,0,11,mixedType,1
9,2,0,11,mixedType,1
5,1,0,6,mixedType,0
4,4,0,8,mixedType,1
7,2,0,9,mixedType,1
15,1,0,16,mixedType,2
5,3,0,8,mixedType,1
6,3,0,9,mixedType,1
4,2,0,6,mixedType,0
8,4,0,12,mixedType,1
8,4,0,12,mixedType,1
9,3,0,12,mixedType,1
14,2,0,16,mixedType,2
6,1,0,7,mixedType,0
2,8,0,10,mixedType,1
5,2,0,7,mixedType,0
6,3,0,9,mixedType,1
7,2,0,9,mixedType,1
13,3,0,16,mixedType,2
7,2,0,9,mixedType,1
6,4,0,10,mixedType,1
9,3,0,12,mixedType,1
13,3,0,16,mixedType,2
8,4,0,12,mixedType,1
5,4,0,9,mixedType,1
4,6,0,10,mixedType,1
7,3,0,10,mixedType,1
5,0,1,6,mixedType,0
7,6,0,13,mixedType,1
6,4,0,10,mixedType,1
8,2,0,10,mixedType,1
6,3,0,9,mixedType,1
7,5,0,12,mixedType,1
7,1,0,8,mixedType,1
7,6,0,13,mixedType,1
8,2,0,10,mixedType,1
8,1,0,9,mixedType,1
14,2,0,16,mixedType,2
4,2,0,6,mixedType,0
9,2,0,11,mixedType,1
1,7,0,8,mixedType,1
5,3,0,8,mixedType,1
11,1,0,12,mixedType,1
5,3,0,8,mixedType,1
2,8,0,10,mixedType,1
7,2,0,9,mixedType,1
6,3,0,9,mixedType,1
6,2,0,8,mixedType,1
9,2,0,11,mixedType,1
6,2,0,8,mixedType,1
7,2,0,9,mixedType,1
4,2,0,6,mixedType,0
4,4,0,8,mixedType,1
2,9,0,11,mixedType,1
14,2,0,16,mixedType,2
8,1,0,9,mixedType,1
7,0,0,7,sameType,0
10,2,0,12,mixedType,1
8,1,0,9,mixedType,1
6,3,0,9,mixedType,1
5,5,0,10,mixedType,1
5,4,0,9,mixedType,1
6,4,0,10,mixedType,1
8,2,0,10,mixedType,1
17,2,0,19,mixedType,2
8,1,0,9,mixedType,1
14,2,0,16,mixedType,2
7,3,0,10,mixedType,1
9,0,1,10,mixedType,1
7,1,0,8,mixedType,1
2,7,0,9,mixedType,1
6,4,0,10,mixedType,1
6,3,0,9,mixedType,1
7,2,0,9,mixedType,1
5,6,0,11,mixedType,1
5,2,0,7,mixedType,0
4,9,0,13,mixedType,1
7,4,0,11,mixedType,1
2,11,1,14,mixedType,2
6,4,0,10,mixedType,1
6,2,0,8,mixedType,1
7,2,0,9,mixedType,1
13,3,0,16,mixedType,2
7,2,0,9,mixedType,1
6,4,0,10,mixedType,1
1,9,0,10,mixedType,1
9,1,0,10,mixedType,1
2,8,0,10,mixedType,1
6,3,0,9,mixedType,1
7,3,0,10,mixedType,1
15,1,0,16,mixedType,2
18,1,1,20,mixedType,2
5,1,0,6,mixedType,0
5,2,0,7,mixedType,0
6,1,0,7,mixedType,0
4,5,0,9,mixedType,1
13,3,0,16,mixedType,2
18,5,1,24,mixedType,2
9,3,0,12,mixedType,1
6,2,0,8,mixedType,1
6,3,0,9,mixedType,1
6,4,0,10,mixedType,1
5,2,0,7,mixedType,0
3,3,0,6,mixedType,0
8,2,0,10,mixedType,1
2,8,0,10,mixedType,1
4,4,0,8,mixedType,1
6,3,0,9,mixedType,1
11,2,1,14,mixedType,2
1,7,0,8,mixedType,1
4,6,0,10,mixedType,1
6,2,0,8,mixedType,1
8,3,0,11,mixedType,1
6,2,0,8,mixedType,1
1,7,0,8,mixedType,1
13,3,0,16,mixedType,2
9,1,0,10,mixedType,1
6,1,0,7,mixedType,0
8,3,0,11,mixedType,1
4,5,0,9,mixedType,1
6,4,0,10,mixedType,1
8,1,0,9,mixedType,1
14,2,0,16,mixedType,2
5,1,0,6,mixedType,0
5,2,0,7,mixedType,0
5,6,0,11,mixedType,1
12,3,0,15,mixedType,2
5,4,0,9,mixedType,1
12,3,0,15,mixedType,2
5,8,0,13,mixedType,1
5,3,0,8,mixedType,1
5,3,0,8,mixedType,1
10,2,0,12,mixedType,1
9,1,0,10,mixedType,1
6,4,0,10,mixedType,1
9,3,0,12,mixedType,1
7,1,0,8,mixedType,1
5,3,0,8,mixedType,1
7,2,0,9,mixedType,1
7,3,0,10,mixedType,1
1,7,0,8,mixedType,1
6,4,0,10,mixedType,1
5,4,0,9,mixedType,1
4,2,0,6,mixedType,0
4,6,0,10,mixedType,1
4,8,0,12,mixedType,1
6,4,0,10,mixedType,1
5,2,0,7,mixedType,0
7,6,0,13,mixedType,1
5,4,0,9,mixedType,1
2,6,0,8,mixedType,1
7,3,0,10,mixedType,1
14,2,0,16,mixedType,2
2,8,0,10,mixedType,1
6,3,0,9,mixedType,1
13,3,0,16,mixedType,2
7,3,0,10,mixedType,1
5,4,0,9,mixedType,1
12,1,0,13,mixedType,1
5,1,0,6,mixedType,0
7,2,0,9,mixedType,1
6,3,0,9,mixedType,1
5,6,0,11,mixedType,1
5,3,0,8,mixedType,1
7,1,0,8,mixedType,1
5,2,0,7,mixedType,0
10,1,0,11,mixedType,1
4,6,0,10,mixedType,1
6,3,0,9,mixedType,1
7,1,0,8,mixedType,1
8,2,0,10,mixedType,1
5,2,0,7,mixedType,0
6,0,0,6,sameType,0
5,1,0,6,mixedType,0
7,7,0,14,mixedType,2
5,4,0,9,mixedType,1
8,2,0,10,mixedType,1
5,3,0,8,mixedType,1
7,1,0,8,mixedType,1
7,3,0,10,mixedType,1
6,4,0,10,mixedType,1
12,4,0,16,mixedType,2
12,4,0,16,mixedType,2
7,3,0,10,mixedType,1
2,4,0,6,mixedType,0
7,4,0,11,mixedType,1
4,2,0,6,mixedType,0
7,4,0,11,mixedType,1
6,4,0,10,mixedType,1
11,3,0,14,mixedType,2
8,2,0,10,mixedType,1
7,2,0,9,mixedType,1
11,1,0,12,mixedType,1
5,2,0,7,mixedType,0
7,2,0,9,mixedType,1
15,2,1,18,mixedType,2
8,2,0,10,mixedType,1
7,3,0,10,mixedType,1
15,1,0,16,mixedType,2
14,2,0,16,mixedType,2
6,3,0,9,mixedType,1
8,2,0,10,mixedType,1
3,5,0,8,mixedType,1
14,2,0,16,mixedType,2
8,1,0,9,mixedType,1
6,3,0,9,mixedType,1
7,3,0,10,mixedType,1
7,2,0,9,mixedType,1
4,4,0,8,mixedType,1
7,3,0,10,mixedType,1
0,6,2,8,mixedType,1
6,4,0,10,mixedType,1
5,3,0,8,mixedType,1
8,1,0,9,mixedType,1
11,3,0,14,mixedType,2
7,2,0,9,mixedType,1
5,3,0,8,mixedType,1
8,3,0,11,mixedType,1
5,2,0,7,mixedType,0
6,1,0,7,mixedType,0
1,8,0,9,mixedType,1
7,3,0,10,mixedType,1
5,2,0,7,mixedType,0
8,3,0,11,mixedType,1
6,3,0,9,mixedType,1
6,2,0,8,mixedType,1
6,3,0,9,mixedType,1
7,6,0,13,mixedType,1
7,2,0,9,mixedType,1
7,2,0,9,mixedType,1
6,3,0,9,mixedType,1
8,2,0,10,mixedType,1
12,4,0,16,mixedType,2
6,2,0,8,mixedType,1
5,4,0,9,mixedType,1
8,1,0,9,mixedType,1
9,2,0,11,mixedType,1
6,1,0,7,mixedType,0
6,3,0,9,mixedType,1
11,3,0,14,mixedType,2
8,2,0,10,mixedType,1
6,2,0,8,mixedType,1
5,2,0,7,mixedType,0
7,1,0,8,mixedType,1
7,1,0,8,mixedType,1
12,4,0,16,mixedType,2
14,2,0,16,mixedType,2
5,8,0,13,mixedType,1
7,3,0,10,mixedType,1
5,1,0,6,mixedType,0
6,1,0,7,mixedType,0
3,5,0,8,mixedType,1
7,4,0,11,mixedType,1
7,2,0,9,mixedType,1
1,8,0,9,mixedType,1
8,2,0,10,mixedType,1
5,2,0,7,mixedType,0
4,2,0,6,mixedType,0
7,1,0,8,mixedType,1
9,4,0,13,mixedType,1
13,2,0,15,mixedType,2
6,3,0,9,mixedType,1
2,8,0,10,mixedType,1
8,4,0,12,mixedType,1
4,2,0,6,mixedType,0
7,3,0,10,mixedType,1
9,2,0,11,mixedType,1
2,4,0,6,mixedType,0
13,2,0,15,mixedType,2
4,7,0,11,mixedType,1
4,4,0,8,mixedType,1
8,4,0,12,mixedType,1
8,2,0,10,mixedType,1
8,2,0,10,mixedType,1
8,1,0,9,mixedType,1
6,2,0,8,mixedType,1
4,2,0,6,mixedType,0
10,6,0,16,mixedType,2
6,3,0,9,mixedType,1
8,2,0,10,mixedType,1
11,2,0,13,mixedType,1
6,1,0,7,mixedType,0
6,1,0,7,mixedType,0
1,9,0,10,mixedType,1
6,3,0,9,mixedType,1
14,2,0,16,mixedType,2
6,2,0,8,mixedType,1
8,4,0,12,mixedType,1
6,2,0,8,mixedType,1
5,4,0,9,mixedType,1
12,3,0,15,mixedType,2
8,1,0,9,mixedType,1
8,1,0,9,mixedType,1
7,1,0,8,mixedType,1
5,2,0,7,mixedType,0
13,3,0,16,mixedType,2
5,4,0,9,mixedType,1
6,2,0,8,mixedType,1
8,2,0,10,mixedType,1
6,2,0,8,mixedType,1
3,3,0,6,mixedType,0
11,3,0,14,mixedType,2
8,4,0,12,mixedType,1
11,1,0,12,mixedType,1
7,3,0,10,mixedType,1
5,3,0,8,mixedType,1
3,7,0,10,mixedType,1
11,2,0,13,mixedType,1
15,1,0,16,mixedType,2
6,3,0,9,mixedType,1
15,1,0,16,mixedType,2
6,4,0,10,mixedType,1
5,8,0,13,mixedType,1
6,3,0,9,mixedType,1
6,1,0,7,mixedType,0
6,1,0,7,mixedType,0
6,3,0,9,mixedType,1
11,1,0,12,mixedType,1
6,3,0,9,mixedType,1
8,2,0,10,mixedType,1
4,2,0,6,mixedType,0
2,6,0,8,mixedType,1
6,4,0,10,mixedType,1
11,3,0,14,mixedType,2
10,3,0,13,mixedType,1
9,2,0,11,mixedType,1
6,4,0,10,mixedType,1
6,3,0,9,mixedType,1
6,4,0,10,mixedType,1
12,3,0,15,mixedType,2
5,3,0,8,mixedType,1
8,4,0,12,mixedType,1
6,3,0,9,mixedType,1
7,2,0,9,mixedType,1
15,1,0,16,mixedType,2
15,1,0,16,mixedType,2
1,10,0,11,mixedType,1
3,3,0,6,mixedType,0
4,4,0,8,mixedType,1
8,2,0,10,mixedType,1
6,5,0,11,mixedType,1
11,3,0,14,mixedType,2
6,1,0,7,mixedType,0
15,1,0,16,mixedType,2
8,1,0,9,mixedType,1
7,3,0,10,mixedType,1
3,8,0,11,mixedType,1
2,10,0,12,mixedType,1
2,4,0,6,mixedType,0
6,3,0,9,mixedType,1
5,3,0,8,mixedType,1
8,1,0,9,mixedType,1
5,3,0,8,mixedType,1
6,4,0,10,mixedType,1
11,0,2,13,mixedType,1
7,3,0,10,mixedType,1
5,4,0,9,mixedType,1
12,4,0,16,mixedType,2
5,2,0,7,mixedType,0
14,1,1,16,mixedType,2
7,1,0,8,mixedType,1
7,1,0,8,mixedType,1
6,4,0,10,mixedType,1
6,4,0,10,mixedType,1
8,2,0,10,mixedType,1
5,4,0,9,mixedType,1
6,1,0,7,mixedType,0
6,3,0,9,mixedType,1
8,4,0,12,mixedType,1
7,3,0,10,mixedType,1
6,4,0,10,mixedType,1
13,3,0,16,mixedType,2
6,2,0,8,mixedType,1
7,2,0,9,mixedType,1
5,4,0,9,mixedType,1
9,6,1,16,mixedType,2
8,2,0,10,mixedType,1
9,2,0,11,mixedType,1
3,6,0,9,mixedType,1
6,7,0,13,mixedType,1
7,4,0,11,mixedType,1
8,2,0,10,mixedType,1
8,2,0,10,mixedType,1
5,2,0,7,mixedType,0
7,3,0,10,mixedType,1
5,2,0,7,mixedType,0
9,2,0,11,mixedType,1
15,3,0,18,mixedType,2
6,1,0,7,mixedType,0
5,0,2,7,mixedType,0
4,4,0,8,mixedType,1
8,2,0,10,mixedType,1
5,4,0,9,mixedType,1
10,3,0,13,mixedType,1
8,3,0,11,mixedType,1
7,3,0,10,mixedType,1
4,6,0,10,mixedType,1
1,7,0,8,mixedType,1
1,8,0,9,mixedType,1
6,4,0,10,mixedType,1
7,3,0,10,mixedType,1
7,2,0,9,mixedType,1
6,5,0,11,mixedType,1
7,3,0,10,mixedType,1
6,2,0,8,mixedType,1
5,2,0,7,mixedType,0
7,2,0,9,mixedType,1
7,1,0,8,mixedType,1
6,5,0,11,mixedType,1
14,2,0,16,mixedType,2
3,6,0,9,mixedType,1
5,4,0,9,mixedType,1
6,3,0,9,mixedType,1
5,2,0,7,mixedType,0
2,7,0,9,mixedType,1
3,7,0,10,mixedType,1
6,3,0,9,mixedType,1
6,3,0,9,mixedType,1
6,2,0,8,mixedType,1
3,3,0,6,mixedType,0
5,4,0,9,mixedType,1
5,1,0,6,mixedType,0
9,0,1,10,mixedType,1
8,3,0,11,mixedType,1
12,4,0,16,mixedType,2
10,1,0,11,mixedType,1
4,2,0,6,mixedType,0
0,5,2,7,mixedType,0
6,3,0,9,mixedType,1
8,2,0,10,mixedType,1
8,3,0,11,mixedType,1
8,2,0,10,mixedType,1
3,6,0,9,mixedType,1
9,6,0,15,mixedType,2
7,3,0,10,mixedType,1
5,4,0,9,mixedType,1
11,5,0,16,mixedType,2
8,1,0,9,mixedType,1
5,3,0,8,mixedType,1
14,2,0,16,mixedType,2
4,6,0,10,mixedType,1
8,3,0,11,mixedType,1
7,3,0,10,mixedType,1
5,6,0,11,mixedType,1
8,2,0,10,mixedType,1
6,6,0,12,mixedType,1
2,4,0,6,mixedType,0
9,1,0,10,mixedType,1
7,2,0,9,mixedType,1
7,1,0,8,mixedType,1
13,3,0,16,mixedType,2
7,1,0,8,mixedType,1
6,4,0,10,mixedType,1
6,2,0,8,mixedType,1
6,4,0,10,mixedType,1
7,3,0,10,mixedType,1
8,3,0,11,mixedType,1
7,2,0,9,mixedType,1
8,1,0,9,mixedType,1
2,7,0,9,mixedType,1
8,3,0,11,mixedType,1
4,2,0,6,mixedType,0
6,4,0,10,mixedType,1
9,4,0,13,mixedType,1
8,2,0,10,mixedType,1
6,4,0,10,mixedType,1
5,1,0,6,mixedType,0
3,5,0,8,mixedType,1
6,1,0,7,mixedType,0
11,0,1,12,mixedType,1
5,4,0,9,mixedType,1
7,5,0,12,mixedType,1
7,2,0,9,mixedType,1
5,2,0,7,mixedType,0
8,0,1,9,mixedType,1
7,2,0,9,mixedType,1
9,3,0,12,mixedType,1
3,6,0,9,mixedType,1
6,3,0,9,mixedType,1
8,2,0,10,mixedType,1
7,3,0,10,mixedType,1
8,2,0,10,mixedType,1
6,3,0,9,mixedType,1
8,1,0,9,mixedType,1
4,2,0,6,mixedType,0
7,5,0,12,mixedType,1
9,2,0,11,mixedType,1
13,3,0,16,mixedType,2
5,3,0,8,mixedType,1
6,4,0,10,mixedType,1
7,3,0,10,mixedType,1
10,2,0,12,mixedType,1
4,2,0,6,mixedType,0
7,6,0,13,mixedType,1
4,8,0,12,mixedType,1
5,8,0,13,mixedType,1
4,5,0,9,mixedType,1
4,4,0,8,mixedType,1
2,8,0,10,mixedType,1
7,1,0,8,mixedType,1
8,1,0,9,mixedType,1
9,1,0,10,mixedType,1
12,4,0,16,mixedType,2
8,1,0,9,mixedType,1
7,2,0,9,mixedType,1
3,6,0,9,mixedType,1
6,3,0,9,mixedType,1
5,2,0,7,mixedType,0
1,8,0,9,mixedType,1
7,3,0,10,mixedType,1
4,2,0,6,mixedType,0
5,2,0,7,mixedType,0
1,8,0,9,mixedType,1
5,2,0,7,mixedType,0
5,2,0,7,mixedType,0
6,2,0,8,mixedType,1
5,2,0,7,mixedType,0
11,3,0,14,mixedType,2
5,4,0,9,mixedType,1
6,6,0,12,mixedType,1
0,9,1,10,mixedType,1
6,3,0,9,mixedType,1
4,6,0,10,mixedType,1
7,2,0,9,mixedType,1
4,4,0,8,mixedType,1
5,3,0,8,mixedType,1
4,6,0,10,mixedType,1
6,1,0,7,mixedType,0
4,2,0,6,mixedType,0
2,4,0,6,mixedType,0
9,2,0,11,mixedType,1
6,2,0,8,mixedType,1
7,3,0,10,mixedType,1
13,2,0,15,mixedType,2
6,7,0,13,mixedType,1
7,3,0,10,mixedType,1
8,1,0,9,mixedType,1
4,2,0,6,mixedType,0
7,3,0,10,mixedType,1
4,4,0,8,mixedType,1
11,3,0,14,mixedType,2
7,6,0,13,mixedType,1
8,1,0,9,mixedType,1
6,3,0,9,mixedType,1
5,4,0,9,mixedType,1
4,2,0,6,mixedType,0
3,6,0,9,mixedType,1
5,5,0,10,mixedType,1
8,2,0,10,mixedType,1
4,8,0,12,mixedType,1
11,4,0,15,mixedType,2
5,3,0,8,mixedType,1
4,6,0,10,mixedType,1
8,2,0,10,mixedType,1
8,2,0,10,mixedType,1
4,8,0,12,mixedType,1
1,5,0,6,mixedType,0
9,2,0,11,mixedType,1
7,1,0,8,mixedType,1
7,1,0,8,mixedType,1
7,2,0,9,mixedType,1
8,1,0,9,mixedType,1
5,3,0,8,mixedType,1
4,7,0,11,mixedType,1
6,1,0,7,mixedType,0
7,3,0,10,mixedType,1
2,6,0,8,mixedType,1
5,8,0,13,mixedType,1
8,2,0,10,mixedType,1
6,3,0,9,mixedType,1
3,7,0,10,mixedType,1
6,9,0,15,mixedType,2
7,5,0,12,mixedType,1
5,3,0,8,mixedType,1
6,3,0,9,mixedType,1
5,1,0,6,mixedType,0
4,4,0,8,mixedType,1
7,1,0,8,mixedType,1
10,2,0,12,mixedType,1
8,2,0,10,mixedType,1
4,8,0,12,mixedType,1
15,1,0,16,mixedType,2
12,3,0,15,mixedType,2
6,1,0,7,mixedType,0
6,5,0,11,mixedType,1
5,4,0,9,mixedType,1
6,2,0,8,mixedType,1
5,5,0,10,mixedType,1
5,3,0,8,mixedType,1
12,1,0,13,mixedType,1
4,2,0,6,mixedType,0
9,2,0,11,mixedType,1
13,3,0,16,mixedType,2
4,6,0,10,mixedType,1
7,5,0,12,mixedType,1
7,3,0,10,mixedType,1
13,3,0,16,mixedType,2
13,3,0,16,mixedType,2
7,3,0,10,mixedType,1
10,1,0,11,mixedType,1
15,1,0,16,mixedType,2
6,4,0,10,mixedType,1
7,2,0,9,mixedType,1
6,4,0,10,mixedType,1
12,3,0,15,mixedType,2
5,4,0,9,mixedType,1
8,3,0,11,mixedType,1
9,3,0,12,mixedType,1
3,5,0,8,mixedType,1
1,9,0,10,mixedType,1
8,2,0,10,mixedType,1
3,7,0,10,mixedType,1
5,1,0,6,mixedType,0
3,3,0,6,mixedType,0
4,2,0,6,mixedType,0
15,1,0,16,mixedType,2
6,1,0,7,mixedType,0
2,7,0,9,mixedType,1
5,2,0,7,mixedType,0
13,3,0,16,mixedType,2
5,1,0,6,mixedType,0
6,4,0,10,mixedType,1
5,4,0,9,mixedType,1
4,7,0,11,mixedType,1
8,2,0,10,mixedType,1
8,8,0,16,mixedType,2
7,2,0,9,mixedType,1
13,3,0,16,mixedType,2
6,3,0,9,mixedType,1
14,2,0,16,mixedType,2
8,2,0,10,mixedType,1
6,3,0,9,mixedType,1
6,2,0,8,mixedType,1
5,3,0,8,mixedType,1
6,2,0,8,mixedType,1
4,2,0,6,mixedType,0
11,5,0,16,mixedType,2
7,2,0,9,mixedType,1
5,3,0,8,mixedType,1
6,3,0,9,mixedType,1
6,3,0,9,mixedType,1
6,3,0,9,mixedType,1
3,6,0,9,mixedType,1
12,3,0,15,mixedType,2
7,2,0,9,mixedType,1
4,4,0,8,mixedType,1
8,1,0,9,mixedType,1
6,3,0,9,mixedType,1
5,2,0,7,mixedType,0
4,4,0,8,mixedType,1
1,7,0,8,mixedType,1
6,3,0,9,mixedType,1
4,2,0,6,mixedType,0
6,3,0,9,mixedType,1
8,1,0,9,mixedType,1
8,5,0,13,mixedType,1
13,3,0,16,mixedType,2
6,2,0,8,mixedType,1
6,2,0,8,mixedType,1
5,4,0,9,mixedType,1
13,3,0,16,mixedType,2
4,9,0,13,mixedType,1
5,4,0,9,mixedType,1
7,3,0,10,mixedType,1
11,5,0,16,mixedType,2
6,1,0,7,mixedType,0
9,3,0,12,mixedType,1
14,2,0,16,mixedType,2
13,3,0,16,mixedType,2
8,2,0,10,mixedType,1
6,1,0,7,mixedType,0
9,0,1,10,mixedType,1
13,3,0,16,mixedType,2
6,3,0,9,mixedType,1
7,2,0,9,mixedType,1
4,7,0,11,mixedType,1
5,4,0,9,mixedType,1
8,1,0,9,mixedType,1
10,2,0,12,mixedType,1
11,5,0,16,mixedType,2
13,3,0,16,mixedType,2
9,1,0,10,mixedType,1
5,4,0,9,mixedType,1
6,7,0,13,mixedType,1
3,7,0,10,mixedType,1
0,8,2,10,mixedType,1
16,3,0,19,mixedType,2
8,1,0,9,mixedType,1
7,1,0,8,mixedType,1
9,1,0,10,mixedType,1
8,2,0,10,mixedType,1
6,3,0,9,mixedType,1
5,2,0,7,mixedType,0
12,2,1,15,mixedType,2
6,2,0,8,mixedType,1
6,3,0,9,mixedType,1
5,6,0,11,mixedType,1
15,1,0,16,mixedType,2
7,2,0,9,mixedType,1
5,5,0,10,mixedType,1
8,2,0,10,mixedType,1
2,13,0,15,mixedType,2
6,6,0,12,mixedType,1
5,2,0,7,mixedType,0
5,2,0,7,mixedType,0
5,5,0,10,mixedType,1
5,2,0,7,mixedType,0
6,1,0,7,mixedType,0
8,2,0,10,mixedType,1
3,6,0,9,mixedType,1
6,3,0,9,mixedType,1
8,3,0,11,mixedType,1
8,1,0,9,mixedType,1
3,3,0,6,mixedType,0
10,2,0,12,mixedType,1
8,2,0,10,mixedType,1
8,2,0,10,mixedType,1
7,2,0,9,mixedType,1
15,1,0,16,mixedType,2
13,3,0,16,mixedType,2
5,3,0,8,mixedType,1
7,4,0,11,mixedType,1
13,3,0,16,mixedType,2
6,2,0,8,mixedType,1
5,3,0,8,mixedType,1
5,3,0,8,mixedType,1
5,2,0,7,mixedType,0
5,4,0,9,mixedType,1
10,2,0,12,mixedType,1
5,2,0,7,mixedType,0
6,2,0,8,mixedType,1
5,4,0,9,mixedType,1
5,2,0,7,mixedType,0
7,2,0,9,mixedType,1
13,3,0,16,mixedType,2
6,4,0,10,mixedType,1
7,3,0,10,mixedType,1
6,4,0,10,mixedType,1
13,3,0,16,mixedType,2
5,4,0,9,mixedType,1
4,5,0,9,mixedType,1
7,1,0,8,mixedType,1
5,2,0,7,mixedType,0
6,8,0,14,mixedType,2
9,0,0,9,sameType,1
12,3,0,15,mixedType,2
9,2,0,11,mixedType,1
6,1,0,7,mixedType,0
5,4,0,9,mixedType,1
4,4,0,8,mixedType,1
5,2,0,7,mixedType,0
11,3,0,14,mixedType,2
5,6,0,11,mixedType,1
4,5,0,9,mixedType,1
5,2,0,7,mixedType,0
12,4,0,16,mixedType,2
8,2,0,10,mixedType,1
5,3,0,8,mixedType,1
1,10,0,11,mixedType,1
9,1,0,10,mixedType,1
6,3,0,9,mixedType,1
9,2,0,11,mixedType,1
3,5,0,8,mixedType,1
5,4,0,9,mixedType,1
7,2,0,9,mixedType,1
5,4,0,9,mixedType,1
7,4,0,11,mixedType,1
5,4,0,9,mixedType,1
6,2,0,8,mixedType,1
5,1,0,6,mixedType,0
6,3,0,9,mixedType,1
5,3,0,8,mixedType,1
7,1,0,8,mixedType,1
5,4,0,9,mixedType,1
6,4,0,10,mixedType,1
7,1,0,8,mixedType,1
4,2,0,6,mixedType,0
4,2,0,6,mixedType,0
10,6,0,16,mixedType,2
14,2,0,16,mixedType,2
5,0,0,5,sameType,0
8,2,0,10,mixedType,1
3,5,0,8,mixedType,1
8,3,0,11,mixedType,1
5,4,0,9,mixedType,1
11,5,0,16,mixedType,2
3,8,0,11,mixedType,1
8,4,0,12,mixedType,1
5,4,0,9,mixedType,1
13,3,0,16,mixedType,2
1,8,0,9,mixedType,1
6,3,0,9,mixedType,1
1,9,0,10,mixedType,1
7,4,0,11,mixedType,1
6,2,0,8,mixedType,1
4,6,0,10,mixedType,1
13,3,0,16,mixedType,2
10,3,0,13,mixedType,1
6,3,0,9,mixedType,1
6,3,0,9,mixedType,1
7,3,0,10,mixedType,1
9,1,0,10,mixedType,1
6,2,0,8,mixedType,1
5,4,0,9,mixedType,1
11,1,0,12,mixedType,1
7,3,0,10,mixedType,1
13,3,0,16,mixedType,2
3,3,0,6,mixedType,0
5,1,0,6,mixedType,0
9,2,0,11,mixedType,1
9,3,0,12,mixedType,1
12,1,0,13,mixedType,1
1,8,0,9,mixedType,1
8,2,0,10,mixedType,1
7,2,0,9,mixedType,1
9,3,0,12,mixedType,1
3,6,0,9,mixedType,1
6,5,0,11,mixedType,1
6,4,0,10,mixedType,1
6,3,0,9,mixedType,1
7,3,0,10,mixedType,1
9,1,0,10,mixedType,1
5,3,0,8,mixedType,1
2,8,0,10,mixedType,1
5,1,0,6,mixedType,0
1,8,0,9,mixedType,1
13,3,0,16,mixedType,2
9,2,0,11,mixedType,1
2,6,0,8,mixedType,1
4,6,0,10,mixedType,1
4,2,0,6,mixedType,0
4,2,0,6,mixedType,0
6,2,0,8,mixedType,1
3,8,0,11,mixedType,1
10,2,0,12,mixedType,1
5,3,0,8,mixedType,1
14,2,0,16,mixedType,2
6,3,0,9,mixedType,1
6,1,0,7,mixedType,0
12,4,0,16,mixedType,2
6,3,0,9,mixedType,1
8,4,0,12,mixedType,1
2,6,0,8,mixedType,1
7,2,0,9,mixedType,1
9,1,0,10,mixedType,1
7,4,0,11,mixedType,1
4,4,0,8,mixedType,1
4,4,0,8,mixedType,1
7,2,0,9,mixedType,1
3,0,3,6,mixedType,0
7,2,0,9,mixedType,1
7,4,0,11,mixedType,1
8,2,0,10,mixedType,1
2,8,0,10,mixedType,1
3,3,0,6,mixedType,0
5,4,0,9,mixedType,1
8,2,0,10,mixedType,1
4,4,0,8,mixedType,1
7,2,0,9,mixedType,1
7,4,0,11,mixedType,1
5,3,0,8,mixedType,1
6,6,0,12,mixedType,1
6,2,0,8,mixedType,1
4,5,0,9,mixedType,1
5,2,0,7,mixedType,0
6,3,0,9,mixedType,1
4,5,0,9,mixedType,1
4,2,0,6,mixedType,0
2,6,0,8,mixedType,1
6,3,0,9,mixedType,1
9,1,0,10,mixedType,1
7,1,0,8,mixedType,1
11,2,0,13,mixedType,1
1,7,0,8,mixedType,1
7,2,0,9,mixedType,1
5,1,0,6,mixedType,0
6,4,0,10,mixedType,1
6,3,0,9,mixedType,1
2,6,0,8,mixedType,1
8,1,0,9,mixedType,1
6,2,0,8,mixedType,1
6,1,0,7,mixedType,0
14,2,0,16,mixedType,2
7,4,0,11,mixedType,1
14,2,0,16,mixedType,2
10,2,0,12,mixedType,1
9,2,0,11,mixedType,1
9,2,0,11,mixedType,1
11,2,0,13,mixedType,1
12,3,4,19,mixedType,2
6,2,0,8,mixedType,1
6,4,0,10,mixedType,1
1,11,0,12,mixedType,1
6,1,0,7,mixedType,0
5,1,0,6,mixedType,0
7,2,0,9,mixedType,1
7,2,0,9,mixedType,1
9,0,2,11,mixedType,1
10,3,0,13,mixedType,1
14,2,0,16,mixedType,2
7,2,0,9,mixedType,1
4,2,0,6,mixedType,0
8,2,0,10,mixedType,1
6,6,0,12,mixedType,1
7,3,0,10,mixedType,1
8,2,0,10,mixedType,1
9,2,0,11,mixedType,1
6,3,0,9,mixedType,1
6,4,0,10,mixedType,1
9,1,0,10,mixedType,1
7,3,0,10,mixedType,1
7,6,0,13,mixedType,1
5,2,0,7,mixedType,0
8,1,0,9,mixedType,1
7,2,0,9,mixedType,1
6,4,0,10,mixedType,1
4,2,0,6,mixedType,0
5,3,0,8,mixedType,1
4,4,0,8,mixedType,1
5,2,0,7,mixedType,0
10,2,0,12,mixedType,1
3,3,0,6,mixedType,0
7,1,0,8,mixedType,1
12,1,0,13,mixedType,1
5,2,0,7,mixedType,0
7,2,0,9,mixedType,1
4,2,0,6,mixedType,0
4,6,0,10,mixedType,1
6,1,0,7,mixedType,0
5,2,0,7,mixedType,0
5,2,0,7,mixedType,0
4,2,0,6,mixedType,0
10,2,0,12,mixedType,1
4,5,0,9,mixedType,1
10,1,0,11,mixedType,1
6,3,0,9,mixedType,1
12,4,0,16,mixedType,2
8,1,0,9,mixedType,1
3,8,0,11,mixedType,1
8,1,0,9,mixedType,1
7,3,0,10,mixedType,1
7,2,0,9,mixedType,1
5,3,0,8,mixedType,1
3,10,0,13,mixedType,1
3,6,0,9,mixedType,1
6,2,0,8,mixedType,1
11,5,0,16,mixedType,2
1,10,0,11,mixedType,1
11,1,0,12,mixedType,1
7,3,0,10,mixedType,1
5,1,0,6,mixedType,0
7,3,0,10,mixedType,1
8,1,0,9,mixedType,1
9,3,3,15,mixedType,2
14,2,0,16,mixedType,2
3,3,0,6,mixedType,0
8,1,0,9,mixedType,1
6,1,0,7,mixedType,0
7,2,0,9,mixedType,1
8,2,0,10,mixedType,1
12,3,0,15,mixedType,2
3,3,0,6,mixedType,0
7,3,0,10,mixedType,1
6,4,0,10,mixedType,1
9,3,0,12,mixedType,1
8,1,0,9,mixedType,1
11,1,0,12,mixedType,1
2,6,0,8,mixedType,1
6,2,0,8,mixedType,1
8,4,0,12,mixedType,1
3,6,0,9,mixedType,1
6,1,0,7,mixedType,0
6,2,0,8,mixedType,1
6,1,0,7,mixedType,0
9,2,0,11,mixedType,1
4,7,0,11,mixedType,1
2,6,0,8,mixedType,1
5,5,0,10,mixedType,1
6,1,0,7,mixedType,0
7,2,0,9,mixedType,1
7,2,0,9,mixedType,1
8,1,0,9,mixedType,1
4,2,0,6,mixedType,0
7,3,0,10,mixedType,1
8,1,0,9,mixedType,1
7,3,0,10,mixedType,1
5,1,0,6,mixedType,0
11,1,0,12,mixedType,1
6,1,0,7,mixedType,0
7,4,0,11,mixedType,1
4,6,0,10,mixedType,1
6,3,0,9,mixedType,1
6,1,0,7,mixedType,0
7,2,0,9,mixedType,1
15,1,0,16,mixedType,2
7,3,0,10,mixedType,1
3,7,0,10,mixedType,1
7,1,0,8,mixedType,1
6,3,0,9,mixedType,1
5,2,0,7,mixedType,0
7,4,0,11,mixedType,1
14,2,0,16,mixedType,2
8,2,0,10,mixedType,1
6,1,0,7,mixedType,0
1,8,0,9,mixedType,1
13,3,0,16,mixedType,2
6,1,0,7,mixedType,0
11,2,0,13,mixedType,1
4,2,0,6,mixedType,0
5,4,0,9,mixedType,1
8,2,0,10,mixedType,1
1,9,0,10,mixedType,1
6,1,0,7,mixedType,0
3,7,0,10,mixedType,1
9,1,0,10,mixedType,1
5,2,0,7,mixedType,0
6,3,0,9,mixedType,1
3,6,0,9,mixedType,1
4,2,0,6,mixedType,0
6,1,0,7,mixedType,0
6,2,0,8,mixedType,1
8,3,0,11,mixedType,1
5,3,0,8,mixedType,1
4,4,0,8,mixedType,1
6,3,0,9,mixedType,1
8,1,0,9,mixedType,1
4,4,0,8,mixedType,1
11,1,3,15,mixedType,2
5,2,0,7,mixedType,0
12,4,0,16,mixedType,2
9,1,0,10,mixedType,1
9,1,0,10,mixedType,1
14,2,0,16,mixedType,2
10,4,0,14,mixedType,2
2,10,0,12,mixedType,1
4,2,0,6,mixedType,0
12,4,0,16,mixedType,2
8,3,0,11,mixedType,1
13,3,0,16,mixedType,2
11,2,0,13,mixedType,1
8,3,0,11,mixedType,1
7,3,0,10,mixedType,1
14,2,0,16,mixedType,2
2,8,0,10,mixedType,1
7,1,0,8,mixedType,1
7,3,0,10,mixedType,1
6,2,0,8,mixedType,1
3,6,0,9,mixedType,1
5,2,0,7,mixedType,0
7,3,0,10,mixedType,1
4,2,0,6,mixedType,0
6,3,0,9,mixedType,1
11,2,0,13,mixedType,1
6,4,0,10,mixedType,1
4,2,0,6,mixedType,0
2,8,0,10,mixedType,1
4,4,0,8,mixedType,1
7,3,0,10,mixedType,1
3,7,0,10,mixedType,1
3,6,0,9,mixedType,1
6,2,0,8,mixedType,1
1,7,0,8,mixedType,1
7,1,0,8,mixedType,1
4,4,0,8,mixedType,1
2,4,0,6,mixedType,0
7,3,0,10,mixedType,1
6,2,0,8,mixedType,1
6,2,0,8,mixedType,1
7,1,0,8,mixedType,1
7,6,0,13,mixedType,1
2,4,0,6,mixedType,0
6,3,0,9,mixedType,1
7,3,0,10,mixedType,1
7,3,0,10,mixedType,1
6,1,0,7,mixedType,0
6,3,0,9,mixedType,1
8,2,0,10,mixedType,1
6,6,0,12,mixedType,1
13,3,0,16,mixedType,2
2,4,0,6,mixedType,0
8,2,0,10,mixedType,1
1,9,0,10,mixedType,1
12,4,0,16,mixedType,2
8,3,0,11,mixedType,1
6,2,0,8,mixedType,1
13,3,0,16,mixedType,2
15,1,0,16,mixedType,2
10,3,0,13,mixedType,1
6,1,0,7,mixedType,0
6,2,0,8,mixedType,1
5,5,0,10,mixedType,1
9,4,0,13,mixedType,1
5,4,0,9,mixedType,1
7,3,0,10,mixedType,1
6,2,0,8,mixedType,1
5,5,0,10,mixedType,1
5,4,0,9,mixedType,1
4,2,0,6,mixedType,0
6,4,0,10,mixedType,1
5,1,0,6,mixedType,0
6,2,0,8,mixedType,1
7,2,0,9,mixedType,1
8,1,0,9,mixedType,1
6,3,0,9,mixedType,1
6,2,0,8,mixedType,1
14,2,0,16,mixedType,2
6,3,0,9,mixedType,1
8,1,0,9,mixedType,1
5,0,3,8,mixedType,1
4,2,0,6,mixedType,0
7,1,0,8,mixedType,1
7,2,0,9,mixedType,1
6,3,0,9,mixedType,1
6,6,0,12,mixedType,1
14,2,0,16,mixedType,2
15,1,0,16,mixedType,2
6,3,0,9,mixedType,1
15,1,0,16,mixedType,2
5,4,0,9,mixedType,1
6,1,0,7,mixedType,0
6,4,0,10,mixedType,1
7,2,0,9,mixedType,1
7,1,0,8,mixedType,1
6,3,0,9,mixedType,1
12,4,0,16,mixedType,2
5,5,0,10,mixedType,1
9,4,0,13,mixedType,1
4,4,0,8,mixedType,1
5,1,0,6,mixedType,0
7,1,0,8,mixedType,1
8,4,0,12,mixedType,1
15,1,0,16,mixedType,2
6,2,0,8,mixedType,1
5,7,0,12,mixedType,1
5,4,0,9,mixedType,1
8,2,0,10,mixedType,1
8,1,0,9,mixedType,1
4,2,0,6,mixedType,0
8,2,0,10,mixedType,1
7,3,0,10,mixedType,1
8,1,0,9,mixedType,1
6,2,0,8,mixedType,1
0,9,0,9,sameType,1
3,9,0,12,mixedType,1
14,2,0,16,mixedType,2
8,3,0,11,mixedType,1
6,2,0,8,mixedType,1
6,1,0,7,mixedType,0
7,6,0,13,mixedType,1
9,2,0,11,mixedType,1
6,3,0,9,mixedType,1
7,2,0,9,mixedType,1
15,1,1,17,mixedType,2
7,2,0,9,mixedType,1
12,4,0,16,mixedType,2
6,2,0,8,mixedType,1
7,7,0,14,mixedType,2
5,3,0,8,mixedType,1
7,2,0,9,mixedType,1
6,3,0,9,mixedType,1
8,9,0,17,mixedType,2
8,1,0,9,mixedType,1
7,3,0,10,mixedType,1
4,2,0,6,mixedType,0
6,4,0,10,mixedType,1
2,8,0,10,mixedType,1
6,1,0,7,mixedType,0
15,1,0,16,mixedType,2
15,1,0,16,mixedType,2
10,4,0,14,mixedType,2
7,1,0,8,mixedType,1
5,4,0,9,mixedType,1
4,4,0,8,mixedType,1
6,4,0,10,mixedType,1
10,3,0,13,mixedType,1
10,3,0,13,mixedType,1
6,3,0,9,mixedType,1
7,3,0,10,mixedType,1
9,1,0,10,mixedType,1
7,3,0,10,mixedType,1
6,2,0,8,mixedType,1
7,3,0,10,mixedType,1
9,3,0,12,mixedType,1
7,2,0,9,mixedType,1
11,5,0,16,mixedType,2
10,1,0,11,mixedType,1
7,3,0,10,mixedType,1
5,2,0,7,mixedType,0
4,2,0,6,mixedType,0
8,3,0,11,mixedType,1
6,4,0,10,mixedType,1
4,4,0,8,mixedType,1
15,1,0,16,mixedType,2
9,2,0,11,mixedType,1
5,2,0,7,mixedType,0
8,1,0,9,mixedType,1
6,3,0,9,mixedType,1
4,2,0,6,mixedType,0
5,3,0,8,mixedType,1
2,8,0,10,mixedType,1
7,3,0,10,mixedType,1
7,3,0,10,mixedType,1
5,8,0,13,mixedType,1
9,5,0,14,mixedType,2
1,8,0,9,mixedType,1
5,2,0,7,mixedType,0
5,3,0,8,mixedType,1
14,2,0,16,mixedType,2
6,1,0,7,mixedType,0
7,3,0,10,mixedType,1
5,3,0,8,mixedType,1
3,5,0,8,mixedType,1
3,7,0,10,mixedType,1
8,3,0,11,mixedType,1
7,3,0,10,mixedType,1
3,5,0,8,mixedType,1
8,2,0,10,mixedType,1
6,2,0,8,mixedType,1
5,4,0,9,mixedType,1
10,4,0,14,mixedType,2
8,0,1,9,mixedType,1
7,6,0,13,mixedType,1
8,3,0,11,mixedType,1
1,7,0,8,mixedType,1
1,8,0,9,mixedType,1
6,3,0,9,mixedType,1
14,2,0,16,mixedType,2
8,1,0,9,mixedType,1
5,2,0,7,mixedType,0
3,6,0,9,mixedType,1
8,2,0,10,mixedType,1
9,1,0,10,mixedType,1
8,1,0,9,mixedType,1
6,4,0,10,mixedType,1
9,1,0,10,mixedType,1
13,3,0,16,mixedType,2
8,2,0,10,mixedType,1
8,2,0,10,mixedType,1
2,7,0,9,mixedType,1
4,6,0,10,mixedType,1
3,6,0,9,mixedType,1
6,3,0,9,mixedType,1
1,5,0,6,mixedType,0
4,6,0,10,mixedType,1
7,3,0,10,mixedType,1
7,1,0,8,mixedType,1
4,5,0,9,mixedType,1
6,3,0,9,mixedType,1
5,3,0,8,mixedType,1
3,1,0,4,mixedType,0
8,1,0,9,mixedType,1
7,3,0,10,mixedType,1
5,5,0,10,mixedType,1
12,2,1,15,mixedType,2
7,3,0,10,mixedType,1
6,1,0,7,mixedType,0
6,4,0,10,mixedType,1
3,9,0,12,mixedType,1
3,6,0,9,mixedType,1
5,4,0,9,mixedType,1
14,2,0,16,mixedType,2
8,1,0,9,mixedType,1
1,7,0,8,mixedType,1
4,2,0,6,mixedType,0
7,3,0,10,mixedType,1
8,1,0,9,mixedType,1
6,1,0,7,mixedType,0
9,3,0,12,mixedType,1
6,4,0,10,mixedType,1
5,4,0,9,mixedType,1
5,4,0,9,mixedType,1
6,3,0,9,mixedType,1
12,3,0,15,mixedType,2
4,6,0,10,mixedType,1
6,4,0,10,mixedType,1
7,2,0,9,mixedType,1
4,6,0,10,mixedType,1
14,2,0,16,mixedType,2
6,2,0,8,mixedType,1
5,2,0,7,mixedType,0
7,3,0,10,mixedType,1
14,2,0,16,mixedType,2
15,1,0,16,mixedType,2
6,2,0,8,mixedType,1
6,2,0,8,mixedType,1
9,1,0,10,mixedType,1
6,2,0,8,mixedType,1
5,1,0,6,mixedType,0
9,2,0,11,mixedType,1
9,1,0,10,mixedType,1
7,3,0,10,mixedType,1
15,3,2,20,mixedType,2
3,8,0,11,mixedType,1
6,3,0,9,mixedType,1
3,2,0,5,mixedType,0
4,4,0,8,mixedType,1
8,2,0,10,mixedType,1
7,1,0,8,mixedType,1
3,9,0,12,mixedType,1
4,2,0,6,mixedType,0
9,1,0,10,mixedType,1
12,4,0,16,mixedType,2
3,3,0,6,mixedType,0
5,2,0,7,mixedType,0
7,2,0,9,mixedType,1
6,4,0,10,mixedType,1
7,3,0,10,mixedType,1
5,2,0,7,mixedType,0
8,1,0,9,mixedType,1
7,2,0,9,mixedType,1
4,2,0,6,mixedType,0
3,6,0,9,mixedType,1
6,1,0,7,mixedType,0
9,3,0,12,mixedType,1
5,4,0,9,mixedType,1
5,4,0,9,mixedType,1
8,4,0,12,mixedType,1
5,4,0,9,mixedType,1
6,3,0,9,mixedType,1
5,4,0,9,mixedType,1
14,2,0,16,mixedType,2
3,6,0,9,mixedType,1
5,1,0,6,mixedType,0
7,2,0,9,mixedType,1
3,6,0,9,mixedType,1
14,2,0,16,mixedType,2
5,2,0,7,mixedType,0
10,2,0,12,mixedType,1
6,3,0,9,mixedType,1
6,3,0,9,mixedType,1
2,8,0,10,mixedType,1
5,1,0,6,mixedType,0
9,2,0,11,mixedType,1
3,6,0,9,mixedType,1
12,3,0,15,mixedType,2
1,7,0,8,mixedType,1
8,2,0,10,mixedType,1
7,2,0,9,mixedType,1
4,2,0,6,mixedType,0
7,3,0,10,mixedType,1
8,4,0,12,mixedType,1
14,2,0,16,mixedType,2
7,3,0,10,mixedType,1
1,10,0,11,mixedType,1
5,2,0,7,mixedType,0
7,2,0,9,mixedType,1
14,2,0,16,mixedType,2
6,3,0,9,mixedType,1
3,6,0,9,mixedType,1
12,1,0,13,mixedType,1
8,3,0,11,mixedType,1
9,3,0,12,mixedType,1
9,1,0,10,mixedType,1
6,1,0,7,mixedType,0
5,6,0,11,mixedType,1
8,1,0,9,mixedType,1
4,6,0,10,mixedType,1
14,4,0,18,mixedType,2
5,5,0,10,mixedType,1
7,3,0,10,mixedType,1
6,3,0,9,mixedType,1
6,4,0,10,mixedType,1
6,4,0,10,mixedType,1
6,4,0,10,mixedType,1
4,8,0,12,mixedType,1
13,3,0,16,mixedType,2
2,8,0,10,mixedType,1
5,4,6,15,mixedType,2
11,2,0,13,mixedType,1
8,1,0,9,mixedType,1
4,2,0,6,mixedType,0
5,3,0,8,mixedType,1
6,3,0,9,mixedType,1
5,1,0,6,mixedType,0
9,1,0,10,mixedType,1
5,1,0,6,mixedType,0
7,1,0,8,mixedType,1
14,2,0,16,mixedType,2
7,3,0,10,mixedType,1
7,3,0,10,mixedType,1
7,2,0,9,mixedType,1
15,1,0,16,mixedType,2
13,3,0,16,mixedType,2
2,6,0,8,mixedType,1
2,6,0,8,mixedType,1
7,2,0,9,mixedType,1
6,4,0,10,mixedType,1
5,4,0,9,mixedType,1
7,3,0,10,mixedType,1
13,3,0,16,mixedType,2
6,4,0,10,mixedType,1
8,3,0,11,mixedType,1
5,3,0,8,mixedType,1
7,3,0,10,mixedType,1
8,3,0,11,mixedType,1
7,3,0,10,mixedType,1
6,1,0,7,mixedType,0
8,4,0,12,mixedType,1
11,5,0,16,mixedType,2
5,3,0,8,mixedType,1
5,1,0,6,mixedType,0
6,2,0,8,mixedType,1
4,2,0,6,mixedType,0
5,4,0,9,mixedType,1
3,8,0,11,mixedType,1
7,3,0,10,mixedType,1
3,6,0,9,mixedType,1
5,3,0,8,mixedType,1
4,5,0,9,mixedType,1
12,1,0,13,mixedType,1
1,9,0,10,mixedType,1
7,2,0,9,mixedType,1
12,4,0,16,mixedType,2
4,2,0,6,mixedType,0
9,2,0,11,mixedType,1
7,2,0,9,mixedType,1
14,2,0,16,mixedType,2
6,2,0,8,mixedType,1
14,2,0,16,mixedType,2
6,3,0,9,mixedType,1
1,8,0,9,mixedType,1
7,2,0,9,mixedType,1
6,3,0,9,mixedType,1
13,3,0,16,mixedType,2
6,3,0,9,mixedType,1
5,4,0,9,mixedType,1
6,4,0,10,mixedType,1
6,1,0,7,mixedType,0
6,3,0,9,mixedType,1
8,3,0,11,mixedType,1
12,4,0,16,mixedType,2
12,4,0,16,mixedType,2
10,3,0,13,mixedType,1
8,2,0,10,mixedType,1
2,6,0,8,mixedType,1
5,2,0,7,mixedType,0
1,9,0,10,mixedType,1
7,3,0,10,mixedType,1
9,3,0,12,mixedType,1
8,1,0,9,mixedType,1
7,1,0,8,mixedType,1
4,6,0,10,mixedType,1
7,1,0,8,mixedType,1
14,2,0,16,mixedType,2
9,1,0,10,mixedType,1
7,1,0,8,mixedType,1
15,1,0,16,mixedType,2
7,2,0,9,mixedType,1
7,3,0,10,mixedType,1
4,6,0,10,mixedType,1
7,3,0,10,mixedType,1
8,8,0,16,mixedType,2
6,2,0,8,mixedType,1
5,3,0,8,mixedType,1
6,3,0,9,mixedType,1
5,3,0,8,mixedType,1
6,2,0,8,mixedType,1
9,3,0,12,mixedType,1
2,6,0,8,mixedType,1
4,6,0,10,mixedType,1
6,4,0,10,mixedType,1
5,4,0,9,mixedType,1
1,7,0,8,mixedType,1
5,4,0,9,mixedType,1
7,3,0,10,mixedType,1
5,4,0,9,mixedType,1
14,2,0,16,mixedType,2
5,4,0,9,mixedType,1
6,3,0,9,mixedType,1
14,2,0,16,mixedType,2
4,5,0,9,mixedType,1
5,3,0,8,mixedType,1
1,7,0,8,mixedType,1
6,1,0,7,mixedType,0
9,2,0,11,mixedType,1
5,2,0,7,mixedType,0
1,8,0,9,mixedType,1
1,8,0,9,mixedType,1
2,6,0,8,mixedType,1
6,3,0,9,mixedType,1
5,4,0,9,mixedType,1
8,1,0,9,mixedType,1
7,3,0,10,mixedType,1
6,2,0,8,mixedType,1
5,9,0,14,mixedType,2
6,3,0,9,mixedType,1
3,6,0,9,mixedType,1
4,6,0,10,mixedType,1
3,10,0,13,mixedType,1
6,4,0,10,mixedType,1
4,6,0,10,mixedType,1
8,3,0,11,mixedType,1
8,3,0,11,mixedType,1
8,3,0,11,mixedType,1
6,3,0,9,mixedType,1
9,1,0,10,mixedType,1
8,1,0,9,mixedType,1
6,6,0,12,mixedType,1
6,4,0,10,mixedType,1
4,5,0,9,mixedType,1
12,3,0,15,mixedType,2
4,4,0,8,mixedType,1
7,1,0,8,mixedType,1
4,2,0,6,mixedType,0
7,4,0,11,mixedType,1
9,1,0,10,mixedType,1
6,2,0,8,mixedType,1
15,1,0,16,mixedType,2
9,3,0,12,mixedType,1
9,3,0,12,mixedType,1
4,2,0,6,mixedType,0
4,4,0,8,mixedType,1
8,2,0,10,mixedType,1
7,3,0,10,mixedType,1
1,8,0,9,mixedType,1
4,2,0,6,mixedType,0
11,2,0,13,mixedType,1
8,1,0,9,mixedType,1
6,3,0,9,mixedType,1
8,2,0,10,mixedType,1
9,3,0,12,mixedType,1
6,4,0,10,mixedType,1
3,6,0,9,mixedType,1
6,3,0,9,mixedType,1
7,2,0,9,mixedType,1
6,3,0,9,mixedType,1
7,2,0,9,mixedType,1
7,3,0,10,mixedType,1
12,4,0,16,mixedType,2
7,1,0,8,mixedType,1
8,4,0,12,mixedType,1
7,3,0,10,mixedType,1
5,6,0,11,mixedType,1
1,8,0,9,mixedType,1
8,2,0,10,mixedType,1
6,3,0,9,mixedType,1
13,3,0,16,mixedType,2
5,4,0,9,mixedType,1
7,3,0,10,mixedType,1
5,1,0,6,mixedType,0
8,1,0,9,mixedType,1
7,1,0,8,mixedType,1
14,2,0,16,mixedType,2
7,3,0,10,mixedType,1
6,4,0,10,mixedType,1
3,6,0,9,mixedType,1
5,3,0,8,mixedType,1
4,4,0,8,mixedType,1
7,2,0,9,mixedType,1
13,3,0,16,mixedType,2
8,3,0,11,mixedType,1
7,2,0,9,mixedType,1
8,3,0,11,mixedType,1
3,7,0,10,mixedType,1
2,6,0,8,mixedType,1
10,2,0,12,mixedType,1
5,2,0,7,mixedType,0
14,6,0,20,mixedType,2
12,4,0,16,mixedType,2
7,2,0,9,mixedType,1
6,4,0,10,mixedType,1
5,4,0,9,mixedType,1
2,6,0,8,mixedType,1
7,2,0,9,mixedType,1
5,6,0,11,mixedType,1
4,4,0,8,mixedType,1
7,3,0,10,mixedType,1
5,2,0,7,mixedType,0
15,1,0,16,mixedType,2
6,2,0,8,mixedType,1
6,3,0,9,mixedType,1
6,1,0,7,mixedType,0
6,7,0,13,mixedType,1
10,4,1,15,mixedType,2
7,1,0,8,mixedType,1
3,6,0,9,mixedType,1
1,5,0,6,mixedType,0
7,3,0,10,mixedType,1
8,1,0,9,mixedType,1
5,3,0,8,mixedType,1
8,1,0,9,mixedType,1
13,3,0,16,mixedType,2
4,5,0,9,mixedType,1
7,1,0,8,mixedType,1
7,1,0,8,mixedType,1
7,2,0,9,mixedType,1
13,3,0,16,mixedType,2
10,3,0,13,mixedType,1
7,3,0,10,mixedType,1
4,2,0,6,mixedType,0
5,1,0,6,mixedType,0
6,1,0,7,mixedType,0
3,8,0,11,mixedType,1
7,3,0,10,mixedType,1
16,5,0,21,mixedType,2
7,3,0,10,mixedType,1
6,1,0,7,mixedType,0
12,3,0,15,mixedType,2
4,2,0,6,mixedType,0
6,3,0,9,mixedType,1
6,1,0,7,mixedType,0
13,3,0,16,mixedType,2
6,4,0,10,mixedType,1
9,2,0,11,mixedType,1
6,2,0,8,mixedType,1
7,2,0,9,mixedType,1
5,3,0,8,mixedType,1
9,1,0,10,mixedType,1
8,2,0,10,mixedType,1
4,6,0,10,mixedType,1
5,3,0,8,mixedType,1
1,8,0,9,mixedType,1
6,1,0,7,mixedType,0
7,3,0,10,mixedType,1
4,8,0,12,mixedType,1
7,1,0,8,mixedType,1
9,5,0,14,mixedType,2
8,1,0,9,mixedType,1
6,1,0,7,mixedType,0
8,1,0,9,mixedType,1
20,6,0,26,mixedType,2
7,3,0,10,mixedType,1
4,4,0,8,mixedType,1
5,2,0,7,mixedType,0
4,4,0,8,mixedType,1
5,2,0,7,mixedType,0
6,3,0,9,mixedType,1
5,3,0,8,mixedType,1
5,4,0,9,mixedType,1
7,3,0,10,mixedType,1
5,4,0,9,mixedType,1
13,3,0,16,mixedType,2
1,7,0,8,mixedType,1
5,1,0,6,mixedType,0
6,1,0,7,mixedType,0
6,4,0,10,mixedType,1
5,1,0,6,mixedType,0
6,1,0,7,mixedType,0
6,3,0,9,mixedType,1
5,2,0,7,mixedType,0
5,4,0,9,mixedType,1
5,2,0,7,mixedType,0
6,2,0,8,mixedType,1
6,4,0,10,mixedType,1
3,7,0,10,mixedType,1
8,2,0,10,mixedType,1
8,1,0,9,mixedType,1
5,3,0,8,mixedType,1
7,4,0,11,mixedType,1
8,2,0,10,mixedType,1
15,1,0,16,mixedType,2
6,3,0,9,mixedType,1
5,4,0,9,mixedType,1
12,4,0,16,mixedType,2
5,4,0,9,mixedType,1
6,1,0,7,mixedType,0
9,1,0,10,mixedType,1
6,4,0,10,mixedType,1
4,4,0,8,mixedType,1
7,4,0,11,mixedType,1
6,3,0,9,mixedType,1
6,2,0,8,mixedType,1
3,3,0,6,mixedType,0
7,2,0,9,mixedType,1
5,1,0,6,mixedType,0
3,6,0,9,mixedType,1
8,2,0,10,mixedType,1
7,3,0,10,mixedType,1
4,6,0,10,mixedType,1
14,2,0,16,mixedType,2
6,2,0,8,mixedType,1
4,2,0,6,mixedType,0
9,1,0,10,mixedType,1
2,6,0,8,mixedType,1
6,3,0,9,mixedType,1
15,1,0,16,mixedType,2
12,3,0,15,mixedType,2
5,3,0,8,mixedType,1
5,3,0,8,mixedType,1
5,7,0,12,mixedType,1
5,1,0,6,mixedType,0
6,3,0,9,mixedType,1
6,3,0,9,mixedType,1
6,4,0,10,mixedType,1
12,6,4,22,mixedType,2
15,1,0,16,mixedType,2
3,3,0,6,mixedType,0
7,1,0,8,mixedType,1
7,2,0,9,mixedType,1
4,4,0,8,mixedType,1
7,2,0,9,mixedType,1
7,4,0,11,mixedType,1
4,4,0,8,mixedType,1
11,5,0,16,mixedType,2
6,1,0,7,mixedType,0
7,3,0,10,mixedType,1
4,2,0,6,mixedType,0
9,2,0,11,mixedType,1
6,1,0,7,mixedType,0
3,6,0,9,mixedType,1
8,1,0,9,mixedType,1
7,3,0,10,mixedType,1
6,3,0,9,mixedType,1
6,2,0,8,mixedType,1
8,2,0,10,mixedType,1
6,4,0,10,mixedType,1
15,1,0,16,mixedType,2
5,6,0,11,mixedType,1
9,1,0,10,mixedType,1
2,4,0,6,mixedType,0
8,2,0,10,mixedType,1
8,1,0,9,mixedType,1
7,3,0,10,mixedType,1
6,4,0,10,mixedType,1
5,3,0,8,mixedType,1
6,2,0,8,mixedType,1
5,4,0,9,mixedType,1
8,1,0,9,mixedType,1
5,2,0,7,mixedType,0
6,4,0,10,mixedType,1
8,2,0,10,mixedType,1
7,1,0,8,mixedType,1
13,3,0,16,mixedType,2
7,3,0,10,mixedType,1
4,5,0,9,mixedType,1
5,1,0,6,mixedType,0
5,8,0,13,mixedType,1
7,2,0,9,mixedType,1
9,1,0,10,mixedType,1
2,7,0,9,mixedType,1
12,4,0,16,mixedType,2
13,3,0,16,mixedType,2
9,3,0,12,mixedType,1
5,4,0,9,mixedType,1
4,4,0,8,mixedType,1
3,7,0,10,mixedType,1
5,1,0,6,mixedType,0
6,3,0,9,mixedType,1
8,1,0,9,mixedType,1
5,3,0,8,mixedType,1
6,4,0,10,mixedType,1
8,1,0,9,mixedType,1
13,2,0,15,mixedType,2
6,6,0,12,mixedType,1
7,5,0,12,mixedType,1
5,5,0,10,mixedType,1
4,4,0,8,mixedType,1
6,3,0,9,mixedType,1
14,2,0,16,mixedType,2
9,4,0,13,mixedType,1
2,8,0,10,mixedType,1
2,8,0,10,mixedType,1
5,4,0,9,mixedType,1
8,3,0,11,mixedType,1
7,1,0,8,mixedType,1
14,2,0,16,mixedType,2
4,4,0,8,mixedType,1
6,1,0,7,mixedType,0
7,2,0,9,mixedType,1
6,3,0,9,mixedType,1
5,3,0,8,mixedType,1
7,2,0,9,mixedType,1
6,2,0,8,mixedType,1
5,4,0,9,mixedType,1
10,2,0,12,mixedType,1
10,2,0,12,mixedType,1
6,4,0,10,mixedType,1
7,4,0,11,mixedType,1
6,1,0,7,mixedType,0
5,6,0,11,mixedType,1
9,2,0,11,mixedType,1
2,6,0,8,mixedType,1
14,2,0,16,mixedType,2
6,3,0,9,mixedType,1
6,2,0,8,mixedType,1
6,1,0,7,mixedType,0
3,10,0,13,mixedType,1
4,4,0,8,mixedType,1
8,2,0,10,mixedType,1
8,2,0,10,mixedType,1
5,2,0,7,mixedType,0
10,2,0,12,mixedType,1
6,2,0,8,mixedType,1
6,1,0,7,mixedType,0
6,1,0,7,mixedType,0
6,3,0,9,mixedType,1
8,1,0,9,mixedType,1
7,3,0,10,mixedType,1
1,6,0,7,mixedType,0
12,1,0,13,mixedType,1
6,3,0,9,mixedType,1
1,9,0,10,mixedType,1
9,3,0,12,mixedType,1
7,3,0,10,mixedType,1
3,6,0,9,mixedType,1
9,3,0,12,mixedType,1
5,4,0,9,mixedType,1
13,3,0,16,mixedType,2
8,3,0,11,mixedType,1
7,1,0,8,mixedType,1
3,6,0,9,mixedType,1
5,10,1,16,mixedType,2
1,11,0,12,mixedType,1
11,1,0,12,mixedType,1
9,4,0,13,mixedType,1
5,4,0,9,mixedType,1
7,3,0,10,mixedType,1
8,2,0,10,mixedType,1
7,2,0,9,mixedType,1
8,4,0,12,mixedType,1
8,1,0,9,mixedType,1
11,5,0,16,mixedType,2
15,1,0,16,mixedType,2
6,2,0,8,mixedType,1
9,3,0,12,mixedType,1
9,3,0,12,mixedType,1
4,4,0,8,mixedType,1
6,1,0,7,mixedType,0
11,3,0,14,mixedType,2
9,2,0,11,mixedType,1
8,2,0,10,mixedType,1
5,3,0,8,mixedType,1
6,3,0,9,mixedType,1
3,7,0,10,mixedType,1
4,2,0,6,mixedType,0
15,5,0,20,mixedType,2
8,1,0,9,mixedType,1
3,6,0,9,mixedType,1
5,1,0,6,mixedType,0
12,4,0,16,mixedType,2
5,2,0,7,mixedType,0
4,4,0,8,mixedType,1
6,2,0,8,mixedType,1
8,1,0,9,mixedType,1
7,1,0,8,mixedType,1
6,3,0,9,mixedType,1
12,4,0,16,mixedType,2
2,7,0,9,mixedType,1
8,2,0,10,mixedType,1
7,2,0,9,mixedType,1
8,1,0,9,mixedType,1
6,1,0,7,mixedType,0
8,2,0,10,mixedType,1
8,2,0,10,mixedType,1
7,2,0,9,mixedType,1
5,2,0,7,mixedType,0
8,1,0,9,mixedType,1
2,4,0,6,mixedType,0
4,2,0,6,mixedType,0
6,4,0,10,mixedType,1
6,2,0,8,mixedType,1
7,2,0,9,mixedType,1
8,2,0,10,mixedType,1
6,4,0,10,mixedType,1
8,2,0,10,mixedType,1
5,3,0,8,mixedType,1
3,3,0,6,mixedType,0
6,3,0,9,mixedType,1
7,2,0,9,mixedType,1
7,3,0,10,mixedType,1
7,3,0,10,mixedType,1
11,3,0,14,mixedType,2
2,6,0,8,mixedType,1
6,2,0,8,mixedType,1
12,3,0,15,mixedType,2
8,2,0,10,mixedType,1
5,2,0,7,mixedType,0
1,6,0,7,mixedType,0
9,1,0,10,mixedType,1
7,3,0,10,mixedType,1
4,4,0,8,mixedType,1
9,1,0,10,mixedType,1
2,6,0,8,mixedType,1
8,2,0,10,mixedType,1
7,2,0,9,mixedType,1
8,1,0,9,mixedType,1
5,3,0,8,mixedType,1
6,1,0,7,mixedType,0
11,5,0,16,mixedType,2
6,1,0,7,mixedType,0
6,3,0,9,mixedType,1
6,5,0,11,mixedType,1
2,6,0,8,mixedType,1
15,1,0,16,mixedType,2
3,6,0,9,mixedType,1
3,3,0,6,mixedType,0
6,3,0,9,mixedType,1
8,2,0,10,mixedType,1
13,3,0,16,mixedType,2
3,3,0,6,mixedType,0
7,3,0,10,mixedType,1
11,2,0,13,mixedType,1
5,7,0,12,mixedType,1
10,3,0,13,mixedType,1
4,2,0,6,mixedType,0
4,2,0,6,mixedType,0
6,2,0,8,mixedType,1
6,4,0,10,mixedType,1
6,3,0,9,mixedType,1
7,3,0,10,mixedType,1
7,2,0,9,mixedType,1
8,3,0,11,mixedType,1
3,8,0,11,mixedType,1
5,2,0,7,mixedType,0
8,4,0,12,mixedType,1
3,7,0,10,mixedType,1
3,6,0,9,mixedType,1
6,4,0,10,mixedType,1
6,2,0,8,mixedType,1
8,4,0,12,mixedType,1
4,6,0,10,mixedType,1
6,4,0,10,mixedType,1
6,2,0,8,mixedType,1
8,4,0,12,mixedType,1
9,1,0,10,mixedType,1
5,2,0,7,mixedType,0
7,2,0,9,mixedType,1
9,2,0,11,mixedType,1
9,2,0,11,mixedType,1
6,2,0,8,mixedType,1
6,2,0,8,mixedType,1
6,1,0,7,mixedType,0
5,1,0,6,mixedType,0
4,6,0,10,mixedType,1
1,8,0,9,mixedType,1
6,1,0,7,mixedType,0
6,4,0,10,mixedType,1
8,2,0,10,mixedType,1
6,2,0,8,mixedType,1
10,3,0,13,mixedType,1
6,3,0,9,mixedType,1
10,2,0,12,mixedType,1
7,3,0,10,mixedType,1
6,2,0,8,mixedType,1
6,1,0,7,mixedType,0
7,4,0,11,mixedType,1
5,2,0,7,mixedType,0
8,2,0,10,mixedType,1
4,6,0,10,mixedType,1
4,6,0,10,mixedType,1
9,2,0,11,mixedType,1
14,2,0,16,mixedType,2
5,3,0,8,mixedType,1
11,1,0,12,mixedType,1
3,5,0,8,mixedType,1
6,3,0,9,mixedType,1
6,3,0,9,mixedType,1
11,5,0,16,mixedType,2
4,4,0,8,mixedType,1
5,4,0,9,mixedType,1
7,4,0,11,mixedType,1
7,2,0,9,mixedType,1
6,1,0,7,mixedType,0
1,7,0,8,mixedType,1
8,2,0,10,mixedType,1
1,9,0,10,mixedType,1
5,4,0,9,mixedType,1
7,1,0,8,mixedType,1
9,1,0,10,mixedType,1
4,6,0,10,mixedType,1
4,9,0,13,mixedType,1
3,3,0,6,mixedType,0
13,3,0,16,mixedType,2
6,2,0,8,mixedType,1
7,3,0,10,mixedType,1
6,2,0,8,mixedType,1
7,1,0,8,mixedType,1
5,4,0,9,mixedType,1
6,4,0,10,mixedType,1
6,1,0,7,mixedType,0
1,7,0,8,mixedType,1
7,3,0,10,mixedType,1
2,9,0,11,mixedType,1
6,3,0,9,mixedType,1
7,1,0,8,mixedType,1
12,4,0,16,mixedType,2
13,3,0,16,mixedType,2
5,3,0,8,mixedType,1
4,4,0,8,mixedType,1
2,4,0,6,mixedType,0
15,1,0,16,mixedType,2
5,2,0,7,mixedType,0
7,2,0,9,mixedType,1
14,2,0,16,mixedType,2
6,6,0,12,mixedType,1
9,2,0,11,mixedType,1
4,4,0,8,mixedType,1
11,2,0,13,mixedType,1
6,1,0,7,mixedType,0
5,3,0,8,mixedType,1
6,4,0,10,mixedType,1
11,3,0,14,mixedType,2
13,3,0,16,mixedType,2
6,1,0,7,mixedType,0
7,2,0,9,mixedType,1
5,7,0,12,mixedType,1
7,3,0,10,mixedType,1
6,3,0,9,mixedType,1
6,3,0,9,mixedType,1
13,3,0,16,mixedType,2
5,9,1,15,mixedType,2
6,3,0,9,mixedType,1
5,2,0,7,mixedType,0
15,1,0,16,mixedType,2
6,5,0,11,mixedType,1
15,1,0,16,mixedType,2
4,6,0,10,mixedType,1
7,3,0,10,mixedType,1
2,9,0,11,mixedType,1
6,3,0,9,mixedType,1
6,2,0,8,mixedType,1
14,2,0,16,mixedType,2
6,3,0,9,mixedType,1
8,1,0,9,mixedType,1
10,2,0,12,mixedType,1
3,5,0,8,mixedType,1
6,4,0,10,mixedType,1
6,4,0,10,mixedType,1
4,4,0,8,mixedType,1
5,2,0,7,mixedType,0
1,9,0,10,mixedType,1
4,2,0,6,mixedType,0
6,2,0,8,mixedType,1
7,1,0,8,mixedType,1
10,4,0,14,mixedType,2
5,1,0,6,mixedType,0
8,2,0,10,mixedType,1
6,4,0,10,mixedType,1
4,4,0,8,mixedType,1
6,3,0,9,mixedType,1
7,3,0,10,mixedType,1
6,3,0,9,mixedType,1
6,4,0,10,mixedType,1
8,3,0,11,mixedType,1
6,3,0,9,mixedType,1
4,6,0,10,mixedType,1
6,1,0,7,mixedType,0
6,4,0,10,mixedType,1
11,5,0,16,mixedType,2
12,4,0,16,mixedType,2
6,3,0,9,mixedType,1
9,1,0,10,mixedType,1
13,3,0,16,mixedType,2
8,1,0,9,mixedType,1
4,5,0,9,mixedType,1
6,3,0,9,mixedType,1
4,8,0,12,mixedType,1
8,2,0,10,mixedType,1
7,2,0,9,mixedType,1
6,3,0,9,mixedType,1
8,3,0,11,mixedType,1
7,4,0,11,mixedType,1
7,4,0,11,mixedType,1
5,4,0,9,mixedType,1
5,2,0,7,mixedType,0
8,2,0,10,mixedType,1
8,2,0,10,mixedType,1
9,0,2,11,mixedType,1
14,2,0,16,mixedType,2
6,3,0,9,mixedType,1
4,4,0,8,mixedType,1
8,4,0,12,mixedType,1
5,2,0,7,mixedType,0
8,2,0,10,mixedType,1
9,1,0,10,mixedType,1
10,11,0,21,mixedType,2
10,3,0,13,mixedType,1
7,2,0,9,mixedType,1
5,2,0,7,mixedType,0
6,4,0,10,mixedType,1
1,8,0,9,mixedType,1
1,8,0,9,mixedType,1
9,2,0,11,mixedType,1
7,2,0,9,mixedType,1
9,1,0,10,mixedType,1
15,1,0,16,mixedType,2
4,4,0,8,mixedType,1
9,2,0,11,mixedType,1
6,1,0,7,mixedType,0
7,1,0,8,mixedType,1
6,1,0,7,mixedType,0
7,1,0,8,mixedType,1
6,2,0,8,mixedType,1
3,8,0,11,mixedType,1
7,2,0,9,mixedType,1
13,4,0,17,mixedType,2
4,4,0,8,mixedType,1
8,2,0,10,mixedType,1
0,10,0,10,sameType,1
1,8,0,9,mixedType,1
5,3,0,8,mixedType,1
18,4,0,22,mixedType,2
6,3,0,9,mixedType,1
7,3,0,10,mixedType,1
6,2,0,8,mixedType,1
9,1,0,10,mixedType,1
6,3,0,9,mixedType,1
8,6,0,14,mixedType,2
5,3,0,8,mixedType,1
15,1,0,16,mixedType,2
6,3,0,9,mixedType,1
5,3,0,8,mixedType,1
4,2,0,6,mixedType,0
8,2,0,10,mixedType,1
5,3,0,8,mixedType,1
5,2,0,7,mixedType,0
2,6,0,8,mixedType,1
8,2,0,10,mixedType,1
5,3,0,8,mixedType,1
9,1,0,10,mixedType,1
8,3,0,11,mixedType,1
5,4,0,9,mixedType,1
4,6,0,10,mixedType,1
6,1,0,7,mixedType,0
14,2,0,16,mixedType,2
7,3,0,10,mixedType,1
5,6,0,11,mixedType,1
5,3,0,8,mixedType,1
6,2,0,8,mixedType,1
13,3,0,16,mixedType,2
5,1,0,6,mixedType,0
15,1,0,16,mixedType,2
15,1,0,16,mixedType,2
9,2,0,11,mixedType,1
2,6,0,8,mixedType,1
6,1,0,7,mixedType,0
5,3,0,8,mixedType,1
6,3,0,9,mixedType,1
7,3,0,10,mixedType,1
7,1,0,8,mixedType,1
15,1,0,16,mixedType,2
6,2,0,8,mixedType,1
11,5,0,16,mixedType,2
15,1,0,16,mixedType,2
6,1,0,7,mixedType,0
3,7,0,10,mixedType,1
5,2,0,7,mixedType,0
11,1,0,12,mixedType,1
6,1,0,7,mixedType,0
6,3,0,9,mixedType,1
5,5,0,10,mixedType,1
7,4,0,11,mixedType,1
8,2,0,10,mixedType,1
5,8,0,13,mixedType,1
10,4,0,14,mixedType,2
6,3,0,9,mixedType,1
5,3,0,8,mixedType,1
8,1,0,9,mixedType,1
6,3,0,9,mixedType,1
8,1,0,9,mixedType,1
7,3,0,10,mixedType,1
8,1,0,9,mixedType,1
1,8,0,9,mixedType,1
6,2,0,8,mixedType,1
7,3,0,10,mixedType,1
4,4,0,8,mixedType,1
4,2,0,6,mixedType,0
6,2,0,8,mixedType,1
9,2,0,11,mixedType,1
7,1,0,8,mixedType,1
9,1,0,10,mixedType,1
9,1,0,10,mixedType,1
12,3,0,15,mixedType,2
6,1,0,7,mixedType,0
6,3,0,9,mixedType,1
8,4,0,12,mixedType,1
7,2,0,9,mixedType,1
5,2,0,7,mixedType,0
9,2,0,11,mixedType,1
6,2,0,8,mixedType,1
7,2,0,9,mixedType,1
9,3,0,12,mixedType,1
2,7,0,9,mixedType,1
3,10,1,14,mixedType,2
14,2,0,16,mixedType,2
7,3,0,10,mixedType,1
14,2,0,16,mixedType,2
5,3,0,8,mixedType,1
7,3,0,10,mixedType,1
9,2,0,11,mixedType,1
4,4,0,8,mixedType,1
7,2,0,9,mixedType,1
3,3,0,6,mixedType,0
4,2,0,6,mixedType,0
6,2,0,8,mixedType,1
5,3,0,8,mixedType,1
15,1,0,16,mixedType,2
9,3,0,12,mixedType,1
4,4,0,8,mixedType,1
6,1,0,7,mixedType,0
7,6,0,13,mixedType,1
7,1,0,8,mixedType,1
3,3,0,6,mixedType,0
6,1,0,7,mixedType,0
7,4,0,11,mixedType,1
2,6,0,8,mixedType,1
6,1,0,7,mixedType,0
6,3,0,9,mixedType,1
6,3,0,9,mixedType,1
7,3,0,10,mixedType,1
12,0,1,13,mixedType,1
4,2,0,6,mixedType,0
6,2,0,8,mixedType,1
12,1,0,13,mixedType,1
7,2,0,9,mixedType,1
7,2,0,9,mixedType,1
6,1,0,7,mixedType,0
6,4,0,10,mixedType,1
6,2,0,8,mixedType,1
7,1,0,8,mixedType,1
7,1,0,8,mixedType,1
3,8,0,11,mixedType,1
8,1,0,9,mixedType,1
8,2,0,10,mixedType,1
1,0,6,7,mixedType,0
10,2,0,12,mixedType,1
1,9,0,10,mixedType,1
7,1,0,8,mixedType,1
5,6,0,11,mixedType,1
14,2,0,16,mixedType,2
11,3,0,14,mixedType,2
6,3,0,9,mixedType,1
6,3,0,9,mixedType,1
9,1,0,10,mixedType,1
5,1,0,6,mixedType,0
6,4,0,10,mixedType,1
6,1,0,7,mixedType,0
14,2,0,16,mixedType,2
12,3,0,15,mixedType,2
8,2,0,10,mixedType,1
6,2,0,8,mixedType,1
4,2,0,6,mixedType,0
9,2,0,11,mixedType,1
6,0,1,7,mixedType,0
5,3,0,8,mixedType,1
6,2,0,8,mixedType,1
9,3,0,12,mixedType,1
11,2,0,13,mixedType,1
4,4,0,8,mixedType,1
3,6,0,9,mixedType,1
8,2,0,10,mixedType,1
10,3,0,13,mixedType,1
7,3,0,10,mixedType,1
6,3,0,9,mixedType,1
9,1,0,10,mixedType,1
7,3,0,10,mixedType,1
5,3,0,8,mixedType,1
7,2,0,9,mixedType,1
12,3,0,15,mixedType,2
2,8,0,10,mixedType,1
7,1,0,8,mixedType,1
6,3,0,9,mixedType,1
5,2,0,7,mixedType,0
3,5,0,8,mixedType,1
4,2,0,6,mixedType,0
7,3,0,10,mixedType,1
14,4,0,18,mixedType,2
10,2,0,12,mixedType,1
5,2,0,7,mixedType,0
6,4,0,10,mixedType,1
5,3,0,8,mixedType,1
4,2,0,6,mixedType,0
5,2,0,7,mixedType,0
6,3,0,9,mixedType,1
9,3,0,12,mixedType,1
5,2,0,7,mixedType,0
7,3,0,10,mixedType,1
6,3,0,9,mixedType,1
8,1,0,9,mixedType,1
4,4,0,8,mixedType,1
8,2,0,10,mixedType,1
4,2,0,6,mixedType,0
8,1,0,9,mixedType,1
5,4,0,9,mixedType,1
3,6,0,9,mixedType,1
6,3,0,9,mixedType,1
5,5,0,10,mixedType,1
6,2,0,8,mixedType,1
6,1,0,7,mixedType,0
3,6,0,9,mixedType,1
5,2,0,7,mixedType,0
7,3,0,10,mixedType,1
5,3,0,8,mixedType,1
6,5,0,11,mixedType,1
8,1,0,9,mixedType,1
7,3,0,10,mixedType,1
7,2,0,9,mixedType,1
9,1,0,10,mixedType,1
8,2,0,10,mixedType,1
4,2,0,6,mixedType,0
6,3,0,9,mixedType,1
8,2,0,10,mixedType,1
5,3,0,8,mixedType,1
2,4,0,6,mixedType,0
3,6,0,9,mixedType,1
5,5,0,10,mixedType,1
6,4,0,10,mixedType,1
4,2,0,6,mixedType,0
11,2,0,13,mixedType,1
7,1,0,8,mixedType,1
5,4,0,9,mixedType,1
5,2,0,7,mixedType,0
13,3,0,16,mixedType,2
10,2,0,12,mixedType,1
3,5,0,8,mixedType,1
7,2,0,9,mixedType,1
5,4,0,9,mixedType,1
12,1,0,13,mixedType,1
9,3,0,12,mixedType,1
6,3,0,9,mixedType,1
5,3,0,8,mixedType,1
10,1,0,11,mixedType,1
15,1,0,16,mixedType,2
6,4,0,10,mixedType,1
8,2,0,10,mixedType,1
10,2,0,12,mixedType,1
5,1,0,6,mixedType,0
7,3,0,10,mixedType,1
6,3,0,9,mixedType,1
4,4,0,8,mixedType,1
8,2,0,10,mixedType,1
4,2,0,6,mixedType,0
5,1,0,6,mixedType,0
6,3,0,9,mixedType,1
8,1,0,9,mixedType,1
7,1,0,8,mixedType,1
6,4,0,10,mixedType,1
6,2,0,8,mixedType,1
8,2,0,10,mixedType,1
6,1,0,7,mixedType,0
11,5,0,16,mixedType,2
7,5,0,12,mixedType,1
8,2,0,10,mixedType,1
5,4,0,9,mixedType,1
7,2,0,9,mixedType,1
6,3,0,9,mixedType,1
8,1,0,9,mixedType,1
8,2,0,10,mixedType,1
3,6,0,9,mixedType,1
6,3,0,9,mixedType,1
10,2,0,12,mixedType,1
11,4,0,15,mixedType,2
9,1,0,10,mixedType,1
6,2,0,8,mixedType,1
10,2,0,12,mixedType,1
3,6,0,9,mixedType,1
6,4,0,10,mixedType,1
8,2,0,10,mixedType,1
5,3,0,8,mixedType,1
5,1,0,6,mixedType,0
5,2,0,7,mixedType,0
8,2,0,10,mixedType,1
5,2,0,7,mixedType,0
5,5,0,10,mixedType,1
8,3,0,11,mixedType,1
5,2,0,7,mixedType,0
2,8,0,10,mixedType,1
12,4,0,16,mixedType,2
8,1,0,9,mixedType,1
3,3,0,6,mixedType,0
6,1,0,7,mixedType,0
10,2,0,12,mixedType,1
6,2,0,8,mixedType,1
6,4,0,10,mixedType,1
7,3,0,10,mixedType,1
7,3,0,10,mixedType,1
4,4,0,8,mixedType,1
13,3,0,16,mixedType,2
2,10,0,12,mixedType,1
6,4,0,10,mixedType,1
8,1,0,9,mixedType,1
5,2,0,7,mixedType,0
6,2,0,8,mixedType,1
8,3,0,11,mixedType,1
6,3,0,9,mixedType,1
4,4,0,8,mixedType,1
5,5,0,10,mixedType,1
5,2,0,7,mixedType,0
6,2,0,8,mixedType,1
3,7,0,10,mixedType,1
6,5,0,11,mixedType,1
5,3,0,8,mixedType,1
5,4,0,9,mixedType,1
6,3,0,9,mixedType,1
1,7,0,8,mixedType,1
1,8,0,9,mixedType,1
4,2,0,6,mixedType,0
6,1,0,7,mixedType,0
7,3,0,10,mixedType,1
7,2,0,9,mixedType,1
4,4,0,8,mixedType,1
6,8,0,14,mixedType,2
6,3,0,9,mixedType,1
9,1,0,10,mixedType,1
6,2,0,8,mixedType,1
6,2,0,8,mixedType,1
7,3,0,10,mixedType,1
6,1,0,7,mixedType,0
14,4,0,18,mixedType,2
6,4,0,10,mixedType,1
16,1,1,18,mixedType,2
6,6,0,12,mixedType,1
7,1,0,8,mixedType,1
8,2,0,10,mixedType,1
4,4,0,8,mixedType,1
5,3,0,8,mixedType,1
4,4,0,8,mixedType,1
6,6,0,12,mixedType,1
6,2,0,8,mixedType,1
7,2,0,9,mixedType,1
8,3,0,11,mixedType,1
7,3,0,10,mixedType,1
10,1,0,11,mixedType,1
6,1,0,7,mixedType,0
5,3,0,8,mixedType,1
8,1,0,9,mixedType,1
5,2,0,7,mixedType,0
9,3,0,12,mixedType,1
14,2,0,16,mixedType,2
7,3,0,10,mixedType,1
6,2,0,8,mixedType,1
8,3,0,11,mixedType,1
8,9,0,17,mixedType,2
8,3,0,11,mixedType,1
6,5,0,11,mixedType,1
6,2,0,8,mixedType,1
8,2,2,12,mixedType,1
4,2,0,6,mixedType,0
6,4,0,10,mixedType,1
13,3,0,16,mixedType,2
8,2,0,10,mixedType,1
8,2,0,10,mixedType,1
4,6,0,10,mixedType,1
13,1,1,15,mixedType,2
6,1,0,7,mixedType,0
6,3,0,9,mixedType,1
5,2,0,7,mixedType,0
5,4,0,9,mixedType,1
6,1,0,7,mixedType,0
7,2,0,9,mixedType,1
7,2,0,9,mixedType,1
9,1,0,10,mixedType,1
7,3,0,10,mixedType,1
7,2,0,9,mixedType,1
5,4,0,9,mixedType,1
5,4,0,9,mixedType,1
1,8,0,9,mixedType,1
5,3,0,8,mixedType,1
12,2,1,15,mixedType,2
6,5,0,11,mixedType,1
4,2,0,6,mixedType,0
9,1,0,10,mixedType,1
8,2,0,10,mixedType,1
7,3,0,10,mixedType,1
6,4,0,10,mixedType,1
4,4,0,8,mixedType,1
3,6,0,9,mixedType,1
9,1,0,10,mixedType,1
6,3,0,9,mixedType,1
6,3,0,9,mixedType,1
6,4,0,10,mixedType,1
7,3,0,10,mixedType,1
7,2,0,9,mixedType,1
6,3,0,9,mixedType,1
6,4,0,10,mixedType,1
7,1,0,8,mixedType,1
7,2,0,9,mixedType,1
6,3,0,9,mixedType,1
7,3,0,10,mixedType,1
10,4,0,14,mixedType,2
2,6,0,8,mixedType,1
2,7,0,9,mixedType,1
5,2,0,7,mixedType,0
8,3,0,11,mixedType,1
6,3,0,9,mixedType,1
5,4,0,9,mixedType,1
6,1,0,7,mixedType,0
8,2,0,10,mixedType,1
9,3,0,12,mixedType,1
6,6,0,12,mixedType,1
7,2,0,9,mixedType,1
9,2,0,11,mixedType,1
6,4,0,10,mixedType,1
1,8,0,9,mixedType,1
14,2,0,16,mixedType,2
12,4,0,16,mixedType,2
7,2,0,9,mixedType,1
14,2,0,16,mixedType,2
4,2,0,6,mixedType,0
8,1,0,9,mixedType,1
8,5,0,13,mixedType,1
12,4,0,16,mixedType,2
5,2,0,7,mixedType,0
6,1,0,7,mixedType,0
7,3,0,10,mixedType,1
8,3,0,11,mixedType,1
13,3,0,16,mixedType,2
6,4,0,10,mixedType,1
13,3,0,16,mixedType,2
6,3,0,9,mixedType,1
8,1,0,9,mixedType,1
14,2,0,16,mixedType,2
6,3,0,9,mixedType,1
6,2,0,8,mixedType,1
5,2,0,7,mixedType,0
6,3,0,9,mixedType,1
6,7,0,13,mixedType,1
2,8,0,10,mixedType,1
7,4,0,11,mixedType,1
6,4,0,10,mixedType,1
7,6,0,13,mixedType,1
6,2,0,8,mixedType,1
10,3,0,13,mixedType,1
5,4,0,9,mixedType,1
8,4,0,12,mixedType,1
6,2,0,8,mixedType,1
7,1,0,8,mixedType,1
7,3,0,10,mixedType,1
6,4,0,10,mixedType,1
6,3,0,9,mixedType,1
8,2,0,10,mixedType,1
6,3,0,9,mixedType,1
14,2,0,16,mixedType,2
5,2,0,7,mixedType,0
5,3,0,8,mixedType,1
7,3,0,10,mixedType,1
4,12,0,16,mixedType,2
7,2,0,9,mixedType,1
6,4,0,10,mixedType,1
6,6,0,12,mixedType,1
6,2,0,8,mixedType,1
1,8,0,9,mixedType,1
6,3,0,9,mixedType,1
2,6,0,8,mixedType,1
5,1,0,6,mixedType,0
4,4,0,8,mixedType,1
7,5,0,12,mixedType,1
6,4,0,10,mixedType,1
10,2,0,12,mixedType,1
6,1,0,7,mixedType,0
6,3,0,9,mixedType,1
7,3,0,10,mixedType,1
9,2,0,11,mixedType,1
8,2,0,10,mixedType,1
9,2,0,11,mixedType,1
5,1,0,6,mixedType,0
5,3,0,8,mixedType,1
6,2,0,8,mixedType,1
7,7,0,14,mixedType,2
7,2,0,9,mixedType,1
7,3,0,10,mixedType,1
7,2,0,9,mixedType,1
6,3,0,9,mixedType,1
5,2,0,7,mixedType,0
9,3,0,12,mixedType,1
6,2,0,8,mixedType,1
9,1,0,10,mixedType,1
4,8,0,12,mixedType,1
6,2,0,8,mixedType,1
4,4,0,8,mixedType,1
8,1,0,9,mixedType,1
1,8,0,9,mixedType,1
3,6,0,9,mixedType,1
5,2,0,7,mixedType,0
7,3,0,10,mixedType,1
11,3,0,14,mixedType,2
6,1,0,7,mixedType,0
6,4,0,10,mixedType,1
7,2,0,9,mixedType,1
5,3,0,8,mixedType,1
13,2,0,15,mixedType,2
4,2,0,6,mixedType,0
7,1,0,8,mixedType,1
5,3,0,8,mixedType,1
13,3,0,16,mixedType,2
5,1,0,6,mixedType,0
8,1,0,9,mixedType,1
11,1,0,12,mixedType,1
5,3,0,8,mixedType,1
6,4,0,10,mixedType,1
5,2,0,7,mixedType,0
7,2,0,9,mixedType,1
8,2,0,10,mixedType,1
11,2,1,14,mixedType,2
5,2,0,7,mixedType,0
13,2,0,15,mixedType,2
2,10,0,12,mixedType,1
6,3,0,9,mixedType,1
9,1,0,10,mixedType,1
5,1,0,6,mixedType,0
9,2,0,11,mixedType,1
14,2,0,16,mixedType,2
2,8,0,10,mixedType,1
6,3,0,9,mixedType,1
6,3,0,9,mixedType,1
8,2,0,10,mixedType,1
6,2,0,8,mixedType,1
6,4,0,10,mixedType,1
6,2,0,8,mixedType,1
10,2,0,12,mixedType,1
5,3,0,8,mixedType,1
9,2,0,11,mixedType,1
8,2,0,10,mixedType,1
14,3,0,17,mixedType,2
3,3,0,6,mixedType,0
6,1,0,7,mixedType,0
10,1,0,11,mixedType,1
14,2,0,16,mixedType,2
8,2,0,10,mixedType,1
6,2,0,8,mixedType,1
8,1,0,9,mixedType,1
6,4,0,10,mixedType,1
9,4,0,13,mixedType,1
3,9,0,12,mixedType,1
10,1,0,11,mixedType,1
6,3,0,9,mixedType,1
6,4,0,10,mixedType,1
4,4,0,8,mixedType,1
9,2,0,11,mixedType,1
1,10,0,11,mixedType,1
4,5,0,9,mixedType,1
7,2,0,9,mixedType,1
6,3,0,9,mixedType,1
4,2,0,6,mixedType,0
5,3,0,8,mixedType,1
7,3,0,10,mixedType,1
6,3,0,9,mixedType,1
14,2,0,16,mixedType,2
1,8,0,9,mixedType,1
5,2,0,7,mixedType,0
6,2,0,8,mixedType,1
9,2,0,11,mixedType,1
8,2,0,10,mixedType,1
5,3,0,8,mixedType,1
15,1,0,16,mixedType,2
7,3,0,10,mixedType,1
13,3,0,16,mixedType,2
6,4,0,10,mixedType,1
5,3,0,8,mixedType,1
2,6,0,8,mixedType,1
9,2,0,11,mixedType,1
7,3,0,10,mixedType,1
11,1,0,12,mixedType,1
10,1,0,11,mixedType,1
6,3,0,9,mixedType,1
2,9,0,11,mixedType,1
7,1,0,8,mixedType,1
12,4,0,16,mixedType,2
6,3,0,9,mixedType,1
8,2,0,10,mixedType,1
4,2,0,6,mixedType,0
5,4,0,9,mixedType,1
10,0,3,13,mixedType,1
7,3,0,10,mixedType,1
10,3,0,13,mixedType,1
1,5,0,6,mixedType,0
14,2,0,16,mixedType,2
8,3,0,11,mixedType,1
5,4,0,9,mixedType,1
8,2,0,10,mixedType,1
9,3,0,12,mixedType,1
8,2,0,10,mixedType,1
3,6,0,9,mixedType,1
9,3,0,12,mixedType,1
6,2,0,8,mixedType,1
6,3,0,9,mixedType,1
1,8,0,9,mixedType,1
8,2,0,10,mixedType,1
6,3,0,9,mixedType,1
4,7,0,11,mixedType,1
3,6,0,9,mixedType,1
1,8,0,9,mixedType,1
4,2,0,6,mixedType,0
6,3,0,9,mixedType,1
3,6,0,9,mixedType,1
13,3,0,16,mixedType,2
8,1,0,9,mixedType,1
5,4,0,9,mixedType,1
6,2,0,8,mixedType,1
1,8,0,9,mixedType,1
8,3,0,11,mixedType,1
7,3,0,10,mixedType,1
6,4,0,10,mixedType,1
5,3,0,8,mixedType,1
4,8,0,12,mixedType,1
9,3,0,12,mixedType,1
5,2,0,7,mixedType,0
11,5,0,16,mixedType,2
8,3,0,11,mixedType,1
5,0,0,5,sameType,0
5,4,0,9,mixedType,1
2,9,0,11,mixedType,1
7,3,0,10,mixedType,1
6,6,0,12,mixedType,1
9,1,0,10,mixedType,1
12,4,0,16,mixedType,2
6,2,0,8,mixedType,1
13,3,0,16,mixedType,2
9,1,0,10,mixedType,1
3,3,0,6,mixedType,0
5,1,0,6,mixedType,0
6,1,0,7,mixedType,0
8,1,0,9,mixedType,1
4,4,0,8,mixedType,1
5,5,0,10,mixedType,1
8,2,0,10,mixedType,1
8,1,0,9,mixedType,1
5,3,0,8,mixedType,1
8,1,0,9,mixedType,1
9,1,0,10,mixedType,1
2,4,0,6,mixedType,0
4,9,0,13,mixedType,1
9,1,0,10,mixedType,1
7,3,0,10,mixedType,1
9,1,0,10,mixedType,1
2,10,0,12,mixedType,1
7,1,0,8,mixedType,1
12,4,0,16,mixedType,2
13,3,0,16,mixedType,2
4,7,0,11,mixedType,1
8,1,0,9,mixedType,1
2,7,0,9,mixedType,1
7,3,0,10,mixedType,1
7,3,0,10,mixedType,1
4,6,0,10,mixedType,1
5,3,0,8,mixedType,1
5,4,0,9,mixedType,1
8,1,0,9,mixedType,1
6,3,0,9,mixedType,1
7,1,0,8,mixedType,1
7,1,0,8,mixedType,1
5,3,0,8,mixedType,1
8,2,0,10,mixedType,1
4,4,0,8,mixedType,1
3,6,0,9,mixedType,1
7,1,0,8,mixedType,1
11,1,0,12,mixedType,1
8,2,0,10,mixedType,1
5,3,0,8,mixedType,1
7,1,0,8,mixedType,1
2,7,0,9,mixedType,1
5,1,0,6,mixedType,0
8,4,0,12,mixedType,1
5,2,0,7,mixedType,0
6,1,0,7,mixedType,0
7,3,0,10,mixedType,1
8,2,0,10,mixedType,1
4,4,0,8,mixedType,1
5,8,0,13,mixedType,1
9,1,0,10,mixedType,1
1,8,0,9,mixedType,1
6,1,0,7,mixedType,0
8,2,0,10,mixedType,1
8,2,0,10,mixedType,1
12,3,0,15,mixedType,2
14,2,0,16,mixedType,2
1,7,0,8,mixedType,1
6,4,0,10,mixedType,1
13,3,0,16,mixedType,2
8,1,0,9,mixedType,1
5,3,0,8,mixedType,1
6,3,0,9,mixedType,1
8,2,0,10,mixedType,1
10,6,0,16,mixedType,2
5,1,0,6,mixedType,0
5,3,0,8,mixedType,1
6,1,0,7,mixedType,0
11,4,0,15,mixedType,2
1,7,0,8,mixedType,1
8,3,0,11,mixedType,1
4,7,0,11,mixedType,1
7,1,0,8,mixedType,1
4,6,0,10,mixedType,1
4,4,0,8,mixedType,1
14,2,0,16,mixedType,2
6,3,0,9,mixedType,1
3,10,0,13,mixedType,1
2,6,0,8,mixedType,1
6,3,0,9,mixedType,1
13,3,0,16,mixedType,2
6,4,0,10,mixedType,1
7,2,0,9,mixedType,1
3,6,0,9,mixedType,1
1,7,0,8,mixedType,1
9,3,0,12,mixedType,1
8,2,0,10,mixedType,1
6,1,0,7,mixedType,0
6,4,0,10,mixedType,1
3,5,0,8,mixedType,1
9,0,1,10,mixedType,1
5,6,0,11,mixedType,1
4,4,0,8,mixedType,1
6,4,0,10,mixedType,1
8,2,0,10,mixedType,1
3,6,0,9,mixedType,1
7,2,0,9,mixedType,1
6,2,0,8,mixedType,1
7,2,0,9,mixedType,1
4,8,0,12,mixedType,1
11,4,2,17,mixedType,2
2,6,0,8,mixedType,1
6,4,0,10,mixedType,1
11,3,0,14,mixedType,2
5,1,0,6,mixedType,0
9,2,0,11,mixedType,1
5,5,0,10,mixedType,1
7,3,0,10,mixedType,1
5,3,0,8,mixedType,1
7,5,0,12,mixedType,1
2,4,0,6,mixedType,0
2,8,0,10,mixedType,1
4,2,0,6,mixedType,0
7,1,0,8,mixedType,1
0,3,0,3,sameType,0
9,1,0,10,mixedType,1
2,8,0,10,mixedType,1
6,3,0,9,mixedType,1
8,4,0,12,mixedType,1
6,1,0,7,mixedType,0
10,4,0,14,mixedType,2
1,8,0,9,mixedType,1
6,1,0,7,mixedType,0
6,2,0,8,mixedType,1
6,3,0,9,mixedType,1
7,3,0,10,mixedType,1
7,3,0,10,mixedType,1
14,5,1,20,mixedType,2
7,3,0,10,mixedType,1
7,2,0,9,mixedType,1
1,8,0,9,mixedType,1
6,2,0,8,mixedType,1
9,1,0,10,mixedType,1
12,4,1,17,mixedType,2
6,1,0,7,mixedType,0
4,5,0,9,mixedType,1
9,3,0,12,mixedType,1
9,1,0,10,mixedType,1
3,6,0,9,mixedType,1
7,3,0,10,mixedType,1
6,6,0,12,mixedType,1
9,1,0,10,mixedType,1
7,3,0,10,mixedType,1
4,2,0,6,mixedType,0
4,2,0,6,mixedType,0
6,2,0,8,mixedType,1
6,2,0,8,mixedType,1
5,2,0,7,mixedType,0
8,2,0,10,mixedType,1
7,3,0,10,mixedType,1
3,6,0,9,mixedType,1
5,1,0,6,mixedType,0
6,3,0,9,mixedType,1
9,5,0,14,mixedType,2
7,1,0,8,mixedType,1
6,2,0,8,mixedType,1
3,6,0,9,mixedType,1
4,2,0,6,mixedType,0
11,3,0,14,mixedType,2
13,3,0,16,mixedType,2
6,2,0,8,mixedType,1
2,7,0,9,mixedType,1
5,4,0,9,mixedType,1
15,1,0,16,mixedType,2
1,7,0,8,mixedType,1
8,1,0,9,mixedType,1
6,3,0,9,mixedType,1
5,4,0,9,mixedType,1
3,3,0,6,mixedType,0
5,4,0,9,mixedType,1
1,8,0,9,mixedType,1
6,3,0,9,mixedType,1
14,2,0,16,mixedType,2
8,3,0,11,mixedType,1
7,1,0,8,mixedType,1
10,1,0,11,mixedType,1
5,3,0,8,mixedType,1
5,2,0,7,mixedType,0
7,1,0,8,mixedType,1
6,1,0,7,mixedType,0
5,3,0,8,mixedType,1
8,2,0,10,mixedType,1
11,2,0,13,mixedType,1
6,3,0,9,mixedType,1
3,6,0,9,mixedType,1
3,6,0,9,mixedType,1
6,4,0,10,mixedType,1
7,3,0,10,mixedType,1
15,1,0,16,mixedType,2
5,2,0,7,mixedType,0
6,3,0,9,mixedType,1
7,8,0,15,mixedType,2
3,4,0,7,mixedType,0
4,2,0,6,mixedType,0
5,2,0,7,mixedType,0
5,3,0,8,mixedType,1
4,2,0,6,mixedType,0
4,2,0,6,mixedType,0
5,8,0,13,mixedType,1
5,3,0,8,mixedType,1
7,4,0,11,mixedType,1
1,8,0,9,mixedType,1
7,2,0,9,mixedType,1
5,3,0,8,mixedType,1
2,6,0,8,mixedType,1
12,4,0,16,mixedType,2
6,3,0,9,mixedType,1
8,1,0,9,mixedType,1
5,1,0,6,mixedType,0
7,1,0,8,mixedType,1
13,3,0,16,mixedType,2
8,2,0,10,mixedType,1
13,3,0,16,mixedType,2
5,6,0,11,mixedType,1
3,6,0,9,mixedType,1
13,3,0,16,mixedType,2
1,8,0,9,mixedType,1
9,4,0,13,mixedType,1
5,3,0,8,mixedType,1
12,3,0,15,mixedType,2
3,6,0,9,mixedType,1
2,8,0,10,mixedType,1
6,2,0,8,mixedType,1
9,1,0,10,mixedType,1
4,8,0,12,mixedType,1
10,2,0,12,mixedType,1
8,1,0,9,mixedType,1
4,4,0,8,mixedType,1
5,4,0,9,mixedType,1
13,3,0,16,mixedType,2
7,3,0,10,mixedType,1
0,5,4,9,mixedType,1
5,3,0,8,mixedType,1
11,3,0,14,mixedType,2
8,4,0,12,mixedType,1
9,7,0,16,mixedType,2
5,4,0,9,mixedType,1
9,1,0,10,mixedType,1
6,1,0,7,mixedType,0
7,3,0,10,mixedType,1
7,3,0,10,mixedType,1
7,2,0,9,mixedType,1
7,4,0,11,mixedType,1
7,2,0,9,mixedType,1
9,1,0,10,mixedType,1
11,1,0,12,mixedType,1
6,1,0,7,mixedType,0
7,3,0,10,mixedType,1
5,4,0,9,mixedType,1
1,8,0,9,mixedType,1
4,2,0,6,mixedType,0
5,4,0,9,mixedType,1
7,3,0,10,mixedType,1
7,5,0,12,mixedType,1
10,2,0,12,mixedType,1
7,3,0,10,mixedType,1
6,2,0,8,mixedType,1
11,4,0,15,mixedType,2
1,8,0,9,mixedType,1
6,3,0,9,mixedType,1
5,3,0,8,mixedType,1
5,3,0,8,mixedType,1
8,2,0,10,mixedType,1
7,7,0,14,mixedType,2
8,1,0,9,mixedType,1
3,6,0,9,mixedType,1
7,1,0,8,mixedType,1
8,2,0,10,mixedType,1
6,2,0,8,mixedType,1
9,1,0,10,mixedType,1
8,2,0,10,mixedType,1
6,3,0,9,mixedType,1
10,1,0,11,mixedType,1
2,7,0,9,mixedType,1
2,8,0,10,mixedType,1
1,9,0,10,mixedType,1
7,3,0,10,mixedType,1
4,2,0,6,mixedType,0
6,4,0,10,mixedType,1
9,4,0,13,mixedType,1
6,4,0,10,mixedType,1
5,5,0,10,mixedType,1
14,2,0,16,mixedType,2
8,1,0,9,mixedType,1
5,4,0,9,mixedType,1
3,6,0,9,mixedType,1
4,4,0,8,mixedType,1
7,1,0,8,mixedType,1
4,2,0,6,mixedType,0
8,1,0,9,mixedType,1
7,2,0,9,mixedType,1
6,1,0,7,mixedType,0
1,7,0,8,mixedType,1
15,1,0,16,mixedType,2
5,3,0,8,mixedType,1
5,3,0,8,mixedType,1
2,6,0,8,mixedType,1
7,2,0,9,mixedType,1
6,1,0,7,mixedType,0
5,4,0,9,mixedType,1
5,6,0,11,mixedType,1
8,3,0,11,mixedType,1
6,3,0,9,mixedType,1
1,8,0,9,mixedType,1
7,1,0,8,mixedType,1
23,1,1,25,mixedType,2
9,3,0,12,mixedType,1
7,3,0,10,mixedType,1
6,4,0,10,mixedType,1
6,3,0,9,mixedType,1
8,1,0,9,mixedType,1
7,1,0,8,mixedType,1
8,2,0,10,mixedType,1
5,4,0,9,mixedType,1
5,2,0,7,mixedType,0
8,2,0,10,mixedType,1
6,2,0,8,mixedType,1
12,4,0,16,mixedType,2
11,1,0,12,mixedType,1
6,2,0,8,mixedType,1
6,2,0,8,mixedType,1
6,4,0,10,mixedType,1
10,4,0,14,mixedType,2
3,10,0,13,mixedType,1
5,1,0,6,mixedType,0
5,6,0,11,mixedType,1
8,3,0,11,mixedType,1
6,2,0,8,mixedType,1
2,4,0,6,mixedType,0
6,3,0,9,mixedType,1
14,2,0,16,mixedType,2
5,4,0,9,mixedType,1
9,1,0,10,mixedType,1
9,3,0,12,mixedType,1
9,3,0,12,mixedType,1
4,6,0,10,mixedType,1
10,2,0,12,mixedType,1
3,7,0,10,mixedType,1
6,8,0,14,mixedType,2
3,6,0,9,mixedType,1
6,2,0,8,mixedType,1
4,2,0,6,mixedType,0
6,3,0,9,mixedType,1
7,3,0,10,mixedType,1
4,4,0,8,mixedType,1
3,6,0,9,mixedType,1
6,6,0,12,mixedType,1
5,4,0,9,mixedType,1
2,6,0,8,mixedType,1
6,2,0,8,mixedType,1
5,4,0,9,mixedType,1
10,0,3,13,mixedType,1
4,2,0,6,mixedType,0
5,3,0,8,mixedType,1
4,2,0,6,mixedType,0
4,7,0,11,mixedType,1
5,3,0,8,mixedType,1
6,4,0,10,mixedType,1
4,4,0,8,mixedType,1
4,4,0,8,mixedType,1
7,3,0,10,mixedType,1
8,1,0,9,mixedType,1
6,3,0,9,mixedType,1
15,1,0,16,mixedType,2
6,1,0,7,mixedType,0
4,2,0,6,mixedType,0
5,1,0,6,mixedType,0
5,4,0,9,mixedType,1
9,1,0,10,mixedType,1
6,1,0,7,mixedType,0
11,5,0,16,mixedType,2
5,1,0,6,mixedType,0
6,2,0,8,mixedType,1
6,1,0,7,mixedType,0
9,4,0,13,mixedType,1
8,2,0,10,mixedType,1
6,4,0,10,mixedType,1
8,2,0,10,mixedType,1
5,4,0,9,mixedType,1
7,1,0,8,mixedType,1
3,8,0,11,mixedType,1
8,1,0,9,mixedType,1
11,2,2,15,mixedType,2
8,2,0,10,mixedType,1
13,3,0,16,mixedType,2
9,1,0,10,mixedType,1
5,1,0,6,mixedType,0
12,4,0,16,mixedType,2
6,3,0,9,mixedType,1
8,3,0,11,mixedType,1
6,3,0,9,mixedType,1
6,2,0,8,mixedType,1
5,3,0,8,mixedType,1
6,3,0,9,mixedType,1
6,3,0,9,mixedType,1
6,3,0,9,mixedType,1
4,7,0,11,mixedType,1
7,1,0,8,mixedType,1
4,6,0,10,mixedType,1
4,4,0,8,mixedType,1
8,1,0,9,mixedType,1
7,3,0,10,mixedType,1
7,3,0,10,mixedType,1
6,3,0,9,mixedType,1
13,3,0,16,mixedType,2
6,3,0,9,mixedType,1
3,9,0,12,mixedType,1
6,3,0,9,mixedType,1
5,3,0,8,mixedType,1
5,4,0,9,mixedType,1
6,3,0,9,mixedType,1
4,4,0,8,mixedType,1
5,2,0,7,mixedType,0
6,3,0,9,mixedType,1
7,2,0,9,mixedType,1
4,7,0,11,mixedType,1
9,4,0,13,mixedType,1
3,6,0,9,mixedType,1
8,2,0,10,mixedType,1
7,3,0,10,mixedType,1
14,2,0,16,mixedType,2
5,2,0,7,mixedType,0
10,4,0,14,mixedType,2
4,2,0,6,mixedType,0
6,2,0,8,mixedType,1
5,3,0,8,mixedType,1
5,4,0,9,mixedType,1
2,6,0,8,mixedType,1
4,6,0,10,mixedType,1
9,1,0,10,mixedType,1
4,4,0,8,mixedType,1
1,8,0,9,mixedType,1
8,2,0,10,mixedType,1
8,1,0,9,mixedType,1
5,1,0,6,mixedType,0
1,8,0,9,mixedType,1
4,4,0,8,mixedType,1
5,3,0,8,mixedType,1
4,4,0,8,mixedType,1
3,10,0,13,mixedType,1
8,1,0,9,mixedType,1
5,1,0,6,mixedType,0
7,3,0,10,mixedType,1
9,4,0,13,mixedType,1
3,6,0,9,mixedType,1
7,3,0,10,mixedType,1
2,6,0,8,mixedType,1
7,4,0,11,mixedType,1
8,2,0,10,mixedType,1
2,8,0,10,mixedType,1
6,3,0,9,mixedType,1
8,1,0,9,mixedType,1
5,4,0,9,mixedType,1
6,3,0,9,mixedType,1
13,3,0,16,mixedType,2
5,6,0,11,mixedType,1
7,2,0,9,mixedType,1
8,1,0,9,mixedType,1
15,1,0,16,mixedType,2
3,3,0,6,mixedType,0
5,3,0,8,mixedType,1
7,2,0,9,mixedType,1
2,8,0,10,mixedType,1
7,2,0,9,mixedType,1
2,6,0,8,mixedType,1
5,7,0,12,mixedType,1
5,4,0,9,mixedType,1
8,3,0,11,mixedType,1
8,2,0,10,mixedType,1
11,1,0,12,mixedType,1
8,2,0,10,mixedType,1
6,3,0,9,mixedType,1
8,2,0,10,mixedType,1
5,5,0,10,mixedType,1
3,7,0,10,mixedType,1
8,3,0,11,mixedType,1
5,4,0,9,mixedType,1
4,5,0,9,mixedType,1
4,4,0,8,mixedType,1
8,1,0,9,mixedType,1
3,7,0,10,mixedType,1
13,3,0,16,mixedType,2
8,2,0,10,mixedType,1
11,2,0,13,mixedType,1
7,2,0,9,mixedType,1
3,5,0,8,mixedType,1
11,5,0,16,mixedType,2
6,2,0,8,mixedType,1
1,11,0,12,mixedType,1
15,1,0,16,mixedType,2
4,6,0,10,mixedType,1
7,1,0,8,mixedType,1
8,1,0,9,mixedType,1
6,0,1,7,mixedType,0
10,3,0,13,mixedType,1
5,4,0,9,mixedType,1
5,4,0,9,mixedType,1
15,1,0,16,mixedType,2
8,1,0,9,mixedType,1
5,3,0,8,mixedType,1
5,2,0,7,mixedType,0
1,8,0,9,mixedType,1
7,1,0,8,mixedType,1
3,3,0,6,mixedType,0
5,4,0,9,mixedType,1
7,2,0,9,mixedType,1
8,2,0,10,mixedType,1
5,3,0,8,mixedType,1
7,1,0,8,mixedType,1
8,2,0,10,mixedType,1
3,6,0,9,mixedType,1
9,3,0,12,mixedType,1
1,8,0,9,mixedType,1
10,2,0,12,mixedType,1
7,2,0,9,mixedType,1
5,3,0,8,mixedType,1
7,1,0,8,mixedType,1
9,1,0,10,mixedType,1
8,2,0,10,mixedType,1
6,2,0,8,mixedType,1
12,3,0,15,mixedType,2
7,3,0,10,mixedType,1
4,2,0,6,mixedType,0
6,3,0,9,mixedType,1
11,3,0,14,mixedType,2
9,3,0,12,mixedType,1
6,2,0,8,mixedType,1
6,3,0,9,mixedType,1
7,3,0,10,mixedType,1
6,3,0,9,mixedType,1
2,4,0,6,mixedType,0
8,1,0,9,mixedType,1
12,1,0,13,mixedType,1
6,3,0,9,mixedType,1
1,7,0,8,mixedType,1
12,4,0,16,mixedType,2
5,1,0,6,mixedType,0
7,1,0,8,mixedType,1
6,3,0,9,mixedType,1
10,1,0,11,mixedType,1
3,8,0,11,mixedType,1
6,4,0,10,mixedType,1
7,1,0,8,mixedType,1
6,3,0,9,mixedType,1
12,4,0,16,mixedType,2
7,2,0,9,mixedType,1
6,1,0,7,mixedType,0
7,6,0,13,mixedType,1
6,4,0,10,mixedType,1
8,1,0,9,mixedType,1
6,3,0,9,mixedType,1
9,1,0,10,mixedType,1
6,1,0,7,mixedType,0
16,1,0,17,mixedType,2
10,2,0,12,mixedType,1
5,8,0,13,mixedType,1
5,2,0,7,mixedType,0
5,2,0,7,mixedType,0
5,3,0,8,mixedType,1
2,6,0,8,mixedType,1
7,1,0,8,mixedType,1
2,6,0,8,mixedType,1
1,7,0,8,mixedType,1
6,2,0,8,mixedType,1
6,3,0,9,mixedType,1
5,2,0,7,mixedType,0
4,4,0,8,mixedType,1
11,3,0,14,mixedType,2
5,6,0,11,mixedType,1
7,2,0,9,mixedType,1
9,1,0,10,mixedType,1
5,3,0,8,mixedType,1
12,4,0,16,mixedType,2
12,4,0,16,mixedType,2
13,3,0,16,mixedType,2
12,4,0,16,mixedType,2
9,6,1,16,mixedType,2
6,2,0,8,mixedType,1
6,1,0,7,mixedType,0
7,5,0,12,mixedType,1
5,4,0,9,mixedType,1
14,2,0,16,mixedType,2
2,4,0,6,mixedType,0
7,2,0,9,mixedType,1
6,1,0,7,mixedType,0
5,3,0,8,mixedType,1
7,3,0,10,mixedType,1
8,2,0,10,mixedType,1
6,3,0,9,mixedType,1
2,8,0,10,mixedType,1
5,1,0,6,mixedType,0
6,2,0,8,mixedType,1
4,2,0,6,mixedType,0
8,2,0,10,mixedType,1
6,2,0,8,mixedType,1
7,2,0,9,mixedType,1
5,2,0,7,mixedType,0
5,3,0,8,mixedType,1
7,2,0,9,mixedType,1
7,3,0,10,mixedType,1
9,3,0,12,mixedType,1
8,3,0,11,mixedType,1
10,6,0,16,mixedType,2
7,2,0,9,mixedType,1
14,6,0,20,mixedType,2
12,3,0,15,mixedType,2
10,4,0,14,mixedType,2
4,7,0,11,mixedType,1
9,3,0,12,mixedType,1
7,3,0,10,mixedType,1
2,8,0,10,mixedType,1
5,2,0,7,mixedType,0
6,3,0,9,mixedType,1
6,6,0,12,mixedType,1
11,2,0,13,mixedType,1
7,2,0,9,mixedType,1
6,6,0,12,mixedType,1
12,4,0,16,mixedType,2
5,5,0,10,mixedType,1
5,3,0,8,mixedType,1
8,4,0,12,mixedType,1
5,3,0,8,mixedType,1
1,7,0,8,mixedType,1
5,4,0,9,mixedType,1
6,3,0,9,mixedType,1
6,3,0,9,mixedType,1
12,1,0,13,mixedType,1
5,1,0,6,mixedType,0
9,2,0,11,mixedType,1
4,4,0,8,mixedType,1
15,1,0,16,mixedType,2
13,3,0,16,mixedType,2
9,2,0,11,mixedType,1
9,1,0,10,mixedType,1
5,2,0,7,mixedType,0
5,8,0,13,mixedType,1
5,2,0,7,mixedType,0
7,3,0,10,mixedType,1
5,2,0,7,mixedType,0
9,2,0,11,mixedType,1
6,2,0,8,mixedType,1
7,3,0,10,mixedType,1
7,3,0,10,mixedType,1
6,1,0,7,mixedType,0
4,2,0,6,mixedType,0
13,3,0,16,mixedType,2
11,8,0,19,mixedType,2
8,2,0,10,mixedType,1
4,2,0,6,mixedType,0
6,1,0,7,mixedType,0
7,1,0,8,mixedType,1
6,4,0,10,mixedType,1
6,6,0,12,mixedType,1
7,2,0,9,mixedType,1
4,2,0,6,mixedType,0
7,2,0,9,mixedType,1
9,2,0,11,mixedType,1
8,2,0,10,mixedType,1
7,4,0,11,mixedType,1
8,1,0,9,mixedType,1
4,2,0,6,mixedType,0
7,1,0,8,mixedType,1
7,4,0,11,mixedType,1
6,3,0,9,mixedType,1
11,2,0,13,mixedType,1
6,4,0,10,mixedType,1
12,4,0,16,mixedType,2
6,2,0,8,mixedType,1
7,1,0,8,mixedType,1
7,2,0,9,mixedType,1
5,3,0,8,mixedType,1
5,2,0,7,mixedType,0
8,1,0,9,mixedType,1
7,1,0,8,mixedType,1
5,3,0,8,mixedType,1
7,3,0,10,mixedType,1
4,4,0,8,mixedType,1
2,8,0,10,mixedType,1
9,3,0,12,mixedType,1
8,2,0,10,mixedType,1
5,2,0,7,mixedType,0
14,2,0,16,mixedType,2
7,3,0,10,mixedType,1
5,1,0,6,mixedType,0
2,4,0,6,mixedType,0
6,1,0,7,mixedType,0
4,4,0,8,mixedType,1
4,4,0,8,mixedType,1
7,2,0,9,mixedType,1
7,2,0,9,mixedType,1
1,11,0,12,mixedType,1
9,1,0,10,mixedType,1
8,2,0,10,mixedType,1
5,3,0,8,mixedType,1
3,5,0,8,mixedType,1
7,3,0,10,mixedType,1
8,4,0,12,mixedType,1
6,4,0,10,mixedType,1
9,1,0,10,mixedType,1
8,4,0,12,mixedType,1
5,1,0,6,mixedType,0
7,6,0,13,mixedType,1
6,3,0,9,mixedType,1
7,3,0,10,mixedType,1
8,2,0,10,mixedType,1
6,3,0,9,mixedType,1
4,4,0,8,mixedType,1
0,11,0,11,sameType,1
6,3,0,9,mixedType,1
8,1,0,9,mixedType,1
7,2,0,9,mixedType,1
12,1,0,13,mixedType,1
11,3,0,14,mixedType,2
5,3,0,8,mixedType,1
6,1,0,7,mixedType,0
9,1,0,10,mixedType,1
6,6,0,12,mixedType,1
4,4,0,8,mixedType,1
9,4,0,13,mixedType,1
6,3,0,9,mixedType,1
6,1,0,7,mixedType,0
14,2,0,16,mixedType,2
5,4,0,9,mixedType,1
3,6,0,9,mixedType,1
7,3,0,10,mixedType,1
5,4,0,9,mixedType,1
6,1,0,7,mixedType,0
10,2,0,12,mixedType,1
5,3,0,8,mixedType,1
6,2,0,8,mixedType,1
6,1,0,7,mixedType,0
7,2,0,9,mixedType,1
4,6,0,10,mixedType,1
5,5,0,10,mixedType,1
2,8,0,10,mixedType,1
6,3,0,9,mixedType,1
6,6,0,12,mixedType,1
9,6,0,15,mixedType,2
5,2,0,7,mixedType,0
7,2,0,9,mixedType,1
6,1,0,7,mixedType,0
6,4,0,10,mixedType,1
7,1,0,8,mixedType,1
5,3,0,8,mixedType,1
8,4,0,12,mixedType,1
4,4,0,8,mixedType,1
6,3,0,9,mixedType,1
5,3,0,8,mixedType,1
7,3,0,10,mixedType,1
2,8,0,10,mixedType,1
10,1,0,11,mixedType,1
5,3,0,8,mixedType,1
12,4,0,16,mixedType,2
5,3,0,8,mixedType,1
6,2,0,8,mixedType,1
10,2,0,12,mixedType,1
6,3,0,9,mixedType,1
6,4,0,10,mixedType,1
10,2,0,12,mixedType,1
5,2,0,7,mixedType,0
6,4,0,10,mixedType,1
3,5,0,8,mixedType,1
5,5,0,10,mixedType,1
5,1,0,6,mixedType,0
6,3,0,9,mixedType,1
8,2,0,10,mixedType,1
7,3,0,10,mixedType,1
8,3,0,11,mixedType,1
4,10,0,14,mixedType,2
9,1,0,10,mixedType,1
5,2,0,7,mixedType,0
6,2,0,8,mixedType,1
5,4,0,9,mixedType,1
11,2,1,14,mixedType,2
7,1,0,8,mixedType,1
2,4,0,6,mixedType,0
6,1,0,7,mixedType,0
7,3,0,10,mixedType,1
13,3,0,16,mixedType,2
5,4,0,9,mixedType,1
14,2,0,16,mixedType,2
9,1,0,10,mixedType,1
8,1,0,9,mixedType,1
7,3,0,10,mixedType,1
8,4,0,12,mixedType,1
1,8,0,9,mixedType,1
3,3,0,6,mixedType,0
6,3,0,9,mixedType,1
8,2,0,10,mixedType,1
5,3,0,8,mixedType,1
6,2,0,8,mixedType,1
6,3,0,9,mixedType,1
6,4,0,10,mixedType,1
15,1,0,16,mixedType,2
9,2,0,11,mixedType,1
5,1,0,6,mixedType,0
5,6,0,11,mixedType,1
15,1,0,16,mixedType,2
8,2,0,10,mixedType,1
4,4,0,8,mixedType,1
5,7,0,12,mixedType,1
6,3,0,9,mixedType,1
9,3,0,12,mixedType,1
9,2,0,11,mixedType,1
7,3,0,10,mixedType,1
5,3,0,8,mixedType,1
8,4,0,12,mixedType,1
9,2,0,11,mixedType,1
8,2,0,10,mixedType,1
6,6,0,12,mixedType,1
6,1,0,7,mixedType,0
4,2,0,6,mixedType,0
8,3,0,11,mixedType,1
9,6,1,16,mixedType,2
4,2,0,6,mixedType,0
2,9,0,11,mixedType,1
5,3,0,8,mixedType,1
11,3,0,14,mixedType,2
7,4,0,11,mixedType,1
10,2,0,12,mixedType,1
13,3,0,16,mixedType,2
7,2,0,9,mixedType,1
6,3,0,9,mixedType,1
4,2,0,6,mixedType,0
5,3,0,8,mixedType,1
5,2,0,7,mixedType,0
6,2,0,8,mixedType,1
7,2,0,9,mixedType,1
12,3,0,15,mixedType,2
6,2,0,8,mixedType,1
8,2,0,10,mixedType,1
8,2,0,10,mixedType,1
9,1,0,10,mixedType,1
3,5,0,8,mixedType,1
2,4,0,6,mixedType,0
8,2,0,10,mixedType,1
6,3,0,9,mixedType,1
6,3,0,9,mixedType,1
3,6,0,9,mixedType,1
6,3,0,9,mixedType,1
10,2,0,12,mixedType,1
7,3,0,10,mixedType,1
7,1,0,8,mixedType,1
10,1,0,11,mixedType,1
4,6,0,10,mixedType,1
14,2,0,16,mixedType,2
11,2,1,14,mixedType,2
1,7,0,8,mixedType,1
1,10,0,11,mixedType,1
7,1,0,8,mixedType,1
7,2,0,9,mixedType,1
6,2,0,8,mixedType,1
12,3,0,15,mixedType,2
8,3,0,11,mixedType,1
5,3,0,8,mixedType,1
7,3,0,10,mixedType,1
4,2,0,6,mixedType,0
14,2,0,16,mixedType,2
2,6,0,8,mixedType,1
6,3,0,9,mixedType,1
7,3,0,10,mixedType,1
6,1,0,7,mixedType,0
14,2,0,16,mixedType,2
15,1,0,16,mixedType,2
6,1,0,7,mixedType,0
9,2,0,11,mixedType,1
2,8,0,10,mixedType,1
10,1,0,11,mixedType,1
7,3,0,10,mixedType,1
5,4,0,9,mixedType,1
5,4,0,9,mixedType,1
7,2,0,9,mixedType,1
6,3,0,9,mixedType,1
7,2,0,9,mixedType,1
6,4,0,10,mixedType,1
14,2,0,16,mixedType,2
3,5,0,8,mixedType,1
12,4,0,16,mixedType,2
15,1,1,17,mixedType,2
8,4,0,12,mixedType,1
2,11,0,13,mixedType,1
1,7,0,8,mixedType,1
8,1,0,9,mixedType,1
7,3,0,10,mixedType,1
6,4,0,10,mixedType,1
2,6,0,8,mixedType,1
8,2,0,10,mixedType,1
7,3,0,10,mixedType,1
6,3,0,9,mixedType,1
10,2,0,12,mixedType,1
7,2,0,9,mixedType,1
4,8,0,12,mixedType,1
6,3,0,9,mixedType,1
4,2,0,6,mixedType,0
5,3,0,8,mixedType,1
7,2,0,9,mixedType,1
6,2,0,8,mixedType,1
11,5,0,16,mixedType,2
2,7,0,9,mixedType,1
13,3,0,16,mixedType,2
2,4,0,6,mixedType,0
8,1,0,9,mixedType,1
6,3,0,9,mixedType,1
8,2,0,10,mixedType,1
7,3,0,10,mixedType,1
7,6,0,13,mixedType,1
13,3,0,16,mixedType,2
7,1,0,8,mixedType,1
6,4,0,10,mixedType,1
7,3,0,10,mixedType,1
5,4,0,9,mixedType,1
6,3,0,9,mixedType,1
2,8,0,10,mixedType,1
5,3,0,8,mixedType,1
9,1,0,10,mixedType,1
5,1,0,6,mixedType,0
5,4,0,9,mixedType,1
5,4,0,9,mixedType,1
4,4,0,8,mixedType,1
5,3,0,8,mixedType,1
5,3,0,8,mixedType,1
5,2,0,7,mixedType,0
3,8,0,11,mixedType,1
6,3,0,9,mixedType,1
6,4,0,10,mixedType,1
5,2,0,7,mixedType,0
15,1,0,16,mixedType,2
7,2,0,9,mixedType,1
5,3,0,8,mixedType,1
8,2,0,10,mixedType,1
6,1,0,7,mixedType,0
7,2,0,9,mixedType,1
9,4,0,13,mixedType,1
4,2,0,6,mixedType,0
8,2,0,10,mixedType,1
7,1,0,8,mixedType,1
5,6,0,11,mixedType,1
10,2,0,12,mixedType,1
7,3,0,10,mixedType,1
4,6,0,10,mixedType,1
7,3,0,10,mixedType,1
6,4,0,10,mixedType,1
5,1,0,6,mixedType,0
8,4,0,12,mixedType,1
14,2,0,16,mixedType,2
5,4,0,9,mixedType,1
7,3,0,10,mixedType,1
8,1,0,9,mixedType,1
6,1,0,7,mixedType,0
7,2,0,9,mixedType,1
6,3,0,9,mixedType,1
7,2,0,9,mixedType,1
10,1,0,11,mixedType,1
4,4,0,8,mixedType,1
5,4,0,9,mixedType,1
14,5,2,21,mixedType,2
6,3,0,9,mixedType,1
6,2,0,8,mixedType,1
15,1,0,16,mixedType,2
6,1,0,7,mixedType,0
9,2,0,11,mixedType,1
7,4,0,11,mixedType,1
7,3,0,10,mixedType,1
8,2,0,10,mixedType,1
4,2,0,6,mixedType,0
6,2,0,8,mixedType,1
5,1,0,6,mixedType,0
7,2,0,9,mixedType,1
8,2,0,10,mixedType,1
9,4,0,13,mixedType,1
8,2,0,10,mixedType,1
9,1,0,10,mixedType,1
11,0,1,12,mixedType,1
7,1,0,8,mixedType,1
4,6,0,10,mixedType,1
1,7,0,8,mixedType,1
8,1,0,9,mixedType,1
9,2,0,11,mixedType,1
7,4,0,11,mixedType,1
9,1,0,10,mixedType,1
12,3,0,15,mixedType,2
9,1,0,10,mixedType,1
7,3,0,10,mixedType,1
6,4,0,10,mixedType,1
5,5,0,10,mixedType,1
6,2,0,8,mixedType,1
6,2,0,8,mixedType,1
7,3,0,10,mixedType,1
3,7,0,10,mixedType,1
10,4,0,14,mixedType,2
1,8,0,9,mixedType,1
14,2,0,16,mixedType,2
6,3,0,9,mixedType,1
8,2,0,10,mixedType,1
4,6,0,10,mixedType,1
5,3,0,8,mixedType,1
4,6,0,10,mixedType,1
1,8,0,9,mixedType,1
4,4,0,8,mixedType,1
6,1,0,7,mixedType,0
5,1,0,6,mixedType,0
6,2,0,8,mixedType,1
9,3,0,12,mixedType,1
12,3,0,15,mixedType,2
5,3,0,8,mixedType,1
7,3,0,10,mixedType,1
7,3,0,10,mixedType,1
12,4,0,16,mixedType,2
12,3,0,15,mixedType,2
7,3,0,10,mixedType,1
4,4,0,8,mixedType,1
5,1,0,6,mixedType,0
5,3,0,8,mixedType,1
4,6,0,10,mixedType,1
8,3,0,11,mixedType,1
9,1,0,10,mixedType,1
6,4,0,10,mixedType,1
6,3,0,9,mixedType,1
1,7,0,8,mixedType,1
8,1,0,9,mixedType,1
7,3,0,10,mixedType,1
6,2,0,8,mixedType,1
6,6,0,12,mixedType,1
5,3,0,8,mixedType,1
5,2,0,7,mixedType,0
8,1,0,9,mixedType,1
6,2,0,8,mixedType,1
5,4,0,9,mixedType,1
8,3,0,11,mixedType,1
13,3,0,16,mixedType,2
13,3,0,16,mixedType,2
10,2,0,12,mixedType,1
8,0,1,9,mixedType,1
10,2,0,12,mixedType,1
6,4,0,10,mixedType,1
8,4,0,12,mixedType,1
15,1,0,16,mixedType,2
7,2,0,9,mixedType,1
5,4,0,9,mixedType,1
6,3,0,9,mixedType,1
3,3,0,6,mixedType,0
2,8,0,10,mixedType,1
7,3,0,10,mixedType,1
6,2,0,8,mixedType,1
7,2,0,9,mixedType,1
8,2,0,10,mixedType,1
11,3,0,14,mixedType,2
12,4,0,16,mixedType,2
7,3,0,10,mixedType,1
7,3,0,10,mixedType,1
6,4,0,10,mixedType,1
5,5,0,10,mixedType,1
7,3,0,10,mixedType,1
2,7,0,9,mixedType,1
7,3,0,10,mixedType,1
3,7,0,10,mixedType,1
9,3,0,12,mixedType,1
7,3,0,10,mixedType,1
1,9,0,10,mixedType,1
5,3,0,8,mixedType,1
8,2,0,10,mixedType,1
9,2,0,11,mixedType,1
14,2,0,16,mixedType,2
6,4,0,10,mixedType,1
11,3,0,14,mixedType,2
8,5,1,14,mixedType,2
5,3,0,8,mixedType,1
8,4,0,12,mixedType,1
8,4,0,12,mixedType,1
6,1,0,7,mixedType,0
12,4,0,16,mixedType,2
5,2,0,7,mixedType,0
11,4,0,15,mixedType,2
5,4,0,9,mixedType,1
8,4,0,12,mixedType,1
7,1,0,8,mixedType,1
14,1,0,15,mixedType,2
7,3,0,10,mixedType,1
9,2,0,11,mixedType,1
6,2,0,8,mixedType,1
8,2,0,10,mixedType,1
6,3,0,9,mixedType,1
8,1,0,9,mixedType,1
4,8,0,12,mixedType,1
8,2,0,10,mixedType,1
13,3,0,16,mixedType,2
9,1,0,10,mixedType,1
6,3,0,9,mixedType,1
4,4,0,8,mixedType,1
9,3,0,12,mixedType,1
2,11,0,13,mixedType,1
4,2,0,6,mixedType,0
6,3,0,9,mixedType,1
8,2,0,10,mixedType,1
9,1,0,10,mixedType,1
7,3,0,10,mixedType,1
4,2,0,6,mixedType,0
9,2,0,11,mixedType,1
7,2,0,9,mixedType,1
5,1,0,6,mixedType,0
4,5,0,9,mixedType,1
8,4,0,12,mixedType,1
5,2,0,7,mixedType,0
6,4,0,10,mixedType,1
9,2,0,11,mixedType,1
9,6,2,17,mixedType,2
7,3,0,10,mixedType,1
7,1,0,8,mixedType,1
6,2,0,8,mixedType,1
5,8,0,13,mixedType,1
6,4,0,10,mixedType,1
5,3,0,8,mixedType,1
4,2,0,6,mixedType,0
12,4,0,16,mixedType,2
7,3,0,10,mixedType,1
6,3,0,9,mixedType,1
4,4,0,8,mixedType,1
7,3,0,10,mixedType,1
8,4,0,12,mixedType,1
5,2,0,7,mixedType,0
5,2,0,7,mixedType,0
7,7,0,14,mixedType,2
6,2,0,8,mixedType,1
4,4,0,8,mixedType,1
1,8,0,9,mixedType,1
7,1,0,8,mixedType,1
3,3,0,6,mixedType,0
9,1,0,10,mixedType,1
5,1,0,6,mixedType,0
7,3,0,10,mixedType,1
5,1,0,6,mixedType,0
7,4,0,11,mixedType,1
7,6,0,13,mixedType,1
5,3,0,8,mixedType,1
4,8,0,12,mixedType,1
6,2,0,8,mixedType,1
9,3,0,12,mixedType,1
12,3,0,15,mixedType,2
1,8,0,9,mixedType,1
3,6,0,9,mixedType,1
5,1,0,6,mixedType,0
6,3,0,9,mixedType,1
9,2,0,11,mixedType,1
7,3,0,10,mixedType,1
7,3,0,10,mixedType,1
7,2,0,9,mixedType,1
3,5,0,8,mixedType,1
14,2,0,16,mixedType,2
6,4,0,10,mixedType,1
6,1,0,7,mixedType,0
8,1,0,9,mixedType,1
9,2,0,11,mixedType,1
6,4,0,10,mixedType,1
5,2,0,7,mixedType,0
7,3,0,10,mixedType,1
7,3,0,10,mixedType,1
6,3,0,9,mixedType,1
4,8,0,12,mixedType,1
15,1,0,16,mixedType,2
11,5,0,16,mixedType,2
5,2,0,7,mixedType,0
8,2,0,10,mixedType,1
9,2,0,11,mixedType,1
6,6,0,12,mixedType,1
5,2,0,7,mixedType,0
8,1,0,9,mixedType,1
5,2,0,7,mixedType,0
14,2,0,16,mixedType,2
6,3,0,9,mixedType,1
4,2,0,6,mixedType,0
7,3,0,10,mixedType,1
8,3,0,11,mixedType,1
8,1,0,9,mixedType,1
3,6,0,9,mixedType,1
6,2,0,8,mixedType,1
6,4,0,10,mixedType,1
6,3,0,9,mixedType,1
7,3,0,10,mixedType,1
5,1,0,6,mixedType,0
3,9,0,12,mixedType,1
3,7,0,10,mixedType,1
12,2,3,17,mixedType,2
15,1,0,16,mixedType,2
5,1,0,6,mixedType,0
0,10,0,10,sameType,1
1,9,0,10,mixedType,1
12,4,0,16,mixedType,2
9,1,0,10,mixedType,1
5,2,0,7,mixedType,0
7,3,0,10,mixedType,1
3,9,0,12,mixedType,1
6,4,0,10,mixedType,1
8,1,0,9,mixedType,1
4,8,0,12,mixedType,1
2,6,0,8,mixedType,1
5,3,0,8,mixedType,1
6,3,0,9,mixedType,1
5,4,0,9,mixedType,1
7,2,0,9,mixedType,1
6,2,0,8,mixedType,1
2,9,0,11,mixedType,1
5,1,0,6,mixedType,0
11,2,1,14,mixedType,2
2,4,0,6,mixedType,0
1,5,0,6,mixedType,0
2,4,0,6,mixedType,0
5,7,0,12,mixedType,1
6,2,0,8,mixedType,1
5,4,0,9,mixedType,1
14,2,0,16,mixedType,2
4,6,0,10,mixedType,1
2,8,0,10,mixedType,1
9,4,0,13,mixedType,1
8,2,0,10,mixedType,1
1,11,0,12,mixedType,1
4,6,0,10,mixedType,1
4,2,0,6,mixedType,0
8,2,0,10,mixedType,1
5,2,0,7,mixedType,0
3,6,0,9,mixedType,1
7,3,0,10,mixedType,1
8,2,0,10,mixedType,1
6,1,0,7,mixedType,0
4,4,0,8,mixedType,1
7,3,0,10,mixedType,1
5,3,0,8,mixedType,1
5,4,0,9,mixedType,1
6,3,0,9,mixedType,1
6,7,0,13,mixedType,1
3,9,0,12,mixedType,1
8,4,0,12,mixedType,1
8,2,0,10,mixedType,1
4,8,0,12,mixedType,1
4,5,0,9,mixedType,1
9,1,0,10,mixedType,1
4,4,0,8,mixedType,1
3,6,0,9,mixedType,1
15,1,0,16,mixedType,2
6,3,0,9,mixedType,1
7,4,0,11,mixedType,1
5,1,0,6,mixedType,0
12,3,0,15,mixedType,2
13,3,0,16,mixedType,2
5,2,0,7,mixedType,0
5,4,0,9,mixedType,1
6,3,0,9,mixedType,1
5,4,0,9,mixedType,1
8,2,0,10,mixedType,1
7,1,0,8,mixedType,1
1,9,0,10,mixedType,1
5,3,0,8,mixedType,1
7,3,0,10,mixedType,1
8,2,0,10,mixedType,1
5,4,0,9,mixedType,1
9,1,0,10,mixedType,1
6,7,0,13,mixedType,1
5,2,0,7,mixedType,0
6,3,0,9,mixedType,1
14,2,0,16,mixedType,2
4,4,0,8,mixedType,1
6,2,0,8,mixedType,1
6,1,0,7,mixedType,0
5,8,0,13,mixedType,1
4,4,0,8,mixedType,1
6,2,0,8,mixedType,1
6,6,0,12,mixedType,1
7,4,0,11,mixedType,1
15,1,0,16,mixedType,2
8,1,0,9,mixedType,1
8,1,0,9,mixedType,1
2,10,0,12,mixedType,1
7,1,0,8,mixedType,1
7,3,0,10,mixedType,1
14,2,0,16,mixedType,2
4,4,0,8,mixedType,1
6,4,0,10,mixedType,1
14,2,0,16,mixedType,2
8,2,0,10,mixedType,1
7,3,0,10,mixedType,1
7,3,0,10,mixedType,1
8,4,0,12,mixedType,1
8,1,0,9,mixedType,1
7,2,0,9,mixedType,1
14,2,0,16,mixedType,2
7,1,0,8,mixedType,1
7,3,0,10,mixedType,1
6,3,0,9,mixedType,1
5,3,0,8,mixedType,1
10,3,0,13,mixedType,1
13,3,0,16,mixedType,2
9,3,0,12,mixedType,1
13,3,0,16,mixedType,2
8,3,0,11,mixedType,1
3,6,0,9,mixedType,1
3,6,0,9,mixedType,1
13,3,0,16,mixedType,2
1,7,0,8,mixedType,1
6,2,0,8,mixedType,1
6,2,0,8,mixedType,1
15,1,0,16,mixedType,2
5,4,0,9,mixedType,1
6,4,0,10,mixedType,1
12,4,0,16,mixedType,2
7,2,0,9,mixedType,1
4,5,0,9,mixedType,1
2,8,0,10,mixedType,1
9,1,0,10,mixedType,1
5,3,0,8,mixedType,1
3,5,0,8,mixedType,1
6,2,0,8,mixedType,1
7,3,0,10,mixedType,1
7,1,0,8,mixedType,1
6,4,0,10,mixedType,1
5,2,0,7,mixedType,0
2,8,0,10,mixedType,1
7,1,0,8,mixedType,1
8,3,0,11,mixedType,1
7,2,0,9,mixedType,1
2,8,0,10,mixedType,1
7,1,0,8,mixedType,1
8,2,0,10,mixedType,1
6,1,0,7,mixedType,0
6,2,0,8,mixedType,1
8,1,0,9,mixedType,1
8,4,0,12,mixedType,1
8,2,0,10,mixedType,1
14,2,0,16,mixedType,2
8,2,0,10,mixedType,1
8,1,0,9,mixedType,1
7,2,0,9,mixedType,1
4,4,0,8,mixedType,1
6,2,0,8,mixedType,1
12,4,0,16,mixedType,2
7,1,0,8,mixedType,1
7,3,0,10,mixedType,1
8,1,0,9,mixedType,1
4,5,0,9,mixedType,1
9,3,0,12,mixedType,1
5,3,0,8,mixedType,1
7,3,0,10,mixedType,1
8,2,0,10,mixedType,1
13,3,0,16,mixedType,2
3,6,0,9,mixedType,1
3,3,0,6,mixedType,0
15,1,0,16,mixedType,2
8,0,1,9,mixedType,1
3,3,0,6,mixedType,0
10,4,0,14,mixedType,2
1,8,0,9,mixedType,1
8,2,0,10,mixedType,1
13,3,0,16,mixedType,2
7,1,0,8,mixedType,1
7,6,0,13,mixedType,1
9,1,0,10,mixedType,1
5,6,0,11,mixedType,1
1,9,0,10,mixedType,1
6,0,1,7,mixedType,0
6,4,0,10,mixedType,1
2,7,0,9,mixedType,1
2,6,0,8,mixedType,1
6,1,0,7,mixedType,0
5,4,0,9,mixedType,1
8,3,0,11,mixedType,1
7,2,0,9,mixedType,1
8,5,0,13,mixedType,1
1,8,0,9,mixedType,1
9,1,0,10,mixedType,1
6,2,0,8,mixedType,1
6,3,0,9,mixedType,1
6,1,0,7,mixedType,0
8,2,0,10,mixedType,1
6,3,0,9,mixedType,1
7,2,0,9,mixedType,1
7,2,0,9,mixedType,1
7,2,0,9,mixedType,1
3,5,0,8,mixedType,1
9,2,0,11,mixedType,1
5,2,0,7,mixedType,0
9,1,0,10,mixedType,1
7,2,0,9,mixedType,1
5,8,0,13,mixedType,1
6,1,0,7,mixedType,0
6,3,0,9,mixedType,1
8,2,0,10,mixedType,1
12,3,0,15,mixedType,2
5,3,0,8,mixedType,1
6,3,0,9,mixedType,1
4,4,0,8,mixedType,1
7,4,0,11,mixedType,1
7,1,0,8,mixedType,1
4,6,0,10,mixedType,1
3,3,0,6,mixedType,0
9,3,0,12,mixedType,1
12,1,0,13,mixedType,1
6,4,0,10,mixedType,1
7,3,0,10,mixedType,1
12,4,0,16,mixedType,2
6,1,0,7,mixedType,0
11,3,0,14,mixedType,2
5,3,0,8,mixedType,1
8,1,0,9,mixedType,1
6,1,0,7,mixedType,0
8,2,0,10,mixedType,1
2,6,0,8,mixedType,1
1,7,0,8,mixedType,1
6,1,0,7,mixedType,0
6,3,0,9,mixedType,1
9,1,0,10,mixedType,1
5,1,0,6,mixedType,0
7,4,0,11,mixedType,1
8,1,0,9,mixedType,1
4,6,0,10,mixedType,1
13,3,0,16,mixedType,2
15,1,0,16,mixedType,2
12,4,0,16,mixedType,2
7,1,0,8,mixedType,1
10,3,0,13,mixedType,1
8,3,0,11,mixedType,1
9,4,0,13,mixedType,1
5,2,0,7,mixedType,0
8,3,0,11,mixedType,1
12,4,0,16,mixedType,2
4,2,0,6,mixedType,0
4,7,0,11,mixedType,1
5,3,0,8,mixedType,1
4,2,0,6,mixedType,0
8,2,0,10,mixedType,1
5,2,0,7,mixedType,0
2,7,0,9,mixedType,1
8,3,0,11,mixedType,1
8,3,0,11,mixedType,1
8,3,0,11,mixedType,1
9,2,0,11,mixedType,1
6,3,0,9,mixedType,1
4,2,0,6,mixedType,0
6,2,0,8,mixedType,1
3,6,0,9,mixedType,1
5,1,0,6,mixedType,0
6,2,0,8,mixedType,1
6,3,0,9,mixedType,1
6,2,0,8,mixedType,1
13,3,0,16,mixedType,2
7,1,0,8,mixedType,1
5,2,0,7,mixedType,0
9,1,0,10,mixedType,1
8,2,0,10,mixedType,1
6,3,0,9,mixedType,1
3,5,0,8,mixedType,1
4,4,0,8,mixedType,1
7,1,0,8,mixedType,1
3,6,0,9,mixedType,1
8,5,1,14,mixedType,2
1,8,0,9,mixedType,1
7,3,0,10,mixedType,1
1,8,0,9,mixedType,1
6,6,0,12,mixedType,1
5,1,0,6,mixedType,0
6,2,0,8,mixedType,1
6,3,0,9,mixedType,1
4,2,0,6,mixedType,0
9,1,0,10,mixedType,1
3,10,0,13,mixedType,1
5,2,0,7,mixedType,0
6,6,0,12,mixedType,1
9,1,0,10,mixedType,1
7,3,0,10,mixedType,1
8,1,0,9,mixedType,1
6,3,0,9,mixedType,1
6,4,0,10,mixedType,1
3,3,0,6,mixedType,0
8,1,0,9,mixedType,1
7,3,0,10,mixedType,1
5,2,0,7,mixedType,0
6,3,0,9,mixedType,1
3,6,0,9,mixedType,1
2,8,0,10,mixedType,1
13,3,0,16,mixedType,2
6,1,0,7,mixedType,0
5,2,0,7,mixedType,0
12,3,0,15,mixedType,2
6,3,0,9,mixedType,1
8,1,0,9,mixedType,1
6,3,0,9,mixedType,1
11,4,0,15,mixedType,2
4,2,0,6,mixedType,0
7,3,0,10,mixedType,1
7,6,0,13,mixedType,1
3,6,0,9,mixedType,1
6,2,0,8,mixedType,1
5,3,0,8,mixedType,1
4,2,0,6,mixedType,0
4,2,0,6,mixedType,0
7,2,0,9,mixedType,1
11,1,0,12,mixedType,1
7,1,0,8,mixedType,1
9,2,0,11,mixedType,1
7,3,0,10,mixedType,1
7,3,0,10,mixedType,1
6,4,0,10,mixedType,1
8,8,0,16,mixedType,2
7,4,0,11,mixedType,1
7,3,0,10,mixedType,1
2,6,0,8,mixedType,1
1,9,0,10,mixedType,1
8,1,0,9,mixedType,1
1,11,0,12,mixedType,1
7,4,0,11,mixedType,1
6,1,0,7,mixedType,0
4,6,0,10,mixedType,1
5,6,0,11,mixedType,1
7,3,0,10,mixedType,1
5,2,0,7,mixedType,0
5,2,0,7,mixedType,0
6,1,0,7,mixedType,0
6,3,0,9,mixedType,1
6,3,0,9,mixedType,1
6,3,0,9,mixedType,1
6,3,0,9,mixedType,1
14,2,0,16,mixedType,2
6,2,0,8,mixedType,1
9,4,0,13,mixedType,1
6,2,0,8,mixedType,1
3,7,0,10,mixedType,1
6,3,0,9,mixedType,1
5,2,0,7,mixedType,0
14,2,0,16,mixedType,2
8,2,0,10,mixedType,1
6,3,0,9,mixedType,1
4,4,0,8,mixedType,1
6,2,0,8,mixedType,1
6,1,0,7,mixedType,0
5,6,0,11,mixedType,1
7,2,0,9,mixedType,1
7,1,0,8,mixedType,1
4,4,0,8,mixedType,1
8,5,0,13,mixedType,1
8,2,0,10,mixedType,1
7,2,0,9,mixedType,1
8,4,0,12,mixedType,1
12,4,0,16,mixedType,2
1,7,0,8,mixedType,1
5,3,0,8,mixedType,1
4,2,0,6,mixedType,0
8,3,0,11,mixedType,1
6,3,0,9,mixedType,1
7,3,0,10,mixedType,1
6,4,0,10,mixedType,1
14,2,0,16,mixedType,2
4,4,0,8,mixedType,1
2,9,0,11,mixedType,1
3,6,0,9,mixedType,1
8,2,0,10,mixedType,1
8,1,0,9,mixedType,1
7,2,0,9,mixedType,1
7,3,0,10,mixedType,1
5,7,0,12,mixedType,1
4,4,0,8,mixedType,1
4,2,0,6,mixedType,0
9,2,0,11,mixedType,1
1,9,0,10,mixedType,1
7,3,0,10,mixedType,1
7,3,0,10,mixedType,1
13,3,0,16,mixedType,2
7,3,0,10,mixedType,1
7,4,0,11,mixedType,1
7,2,0,9,mixedType,1
6,4,0,10,mixedType,1
6,2,0,8,mixedType,1
9,3,0,12,mixedType,1
4,4,0,8,mixedType,1
8,1,0,9,mixedType,1
7,2,0,9,mixedType,1
10,2,0,12,mixedType,1
6,3,0,9,mixedType,1
8,1,0,9,mixedType,1
5,4,0,9,mixedType,1
6,1,0,7,mixedType,0
7,4,0,11,mixedType,1
9,1,0,10,mixedType,1
9,1,0,10,mixedType,1
11,2,0,13,mixedType,1
5,2,0,7,mixedType,0
5,3,0,8,mixedType,1
11,1,0,12,mixedType,1
14,2,0,16,mixedType,2
4,2,0,6,mixedType,0
8,4,0,12,mixedType,1
15,1,0,16,mixedType,2
7,3,0,10,mixedType,1
9,1,0,10,mixedType,1
11,3,1,15,mixedType,2
9,1,0,10,mixedType,1
6,3,0,9,mixedType,1
2,8,0,10,mixedType,1
6,2,0,8,mixedType,1
14,2,0,16,mixedType,2
5,3,0,8,mixedType,1
5,2,0,7,mixedType,0
8,2,0,10,mixedType,1
4,2,0,6,mixedType,0
7,2,0,9,mixedType,1
4,4,0,8,mixedType,1
1,9,0,10,mixedType,1
6,4,0,10,mixedType,1
6,2,0,8,mixedType,1
6,1,0,7,mixedType,0
6,4,0,10,mixedType,1
8,0,1,9,mixedType,1
12,3,0,15,mixedType,2
7,1,0,8,mixedType,1
8,2,0,10,mixedType,1
14,2,0,16,mixedType,2
7,2,0,9,mixedType,1
1,9,0,10,mixedType,1
2,8,0,10,mixedType,1
7,3,0,10,mixedType,1
7,3,0,10,mixedType,1
6,4,0,10,mixedType,1
14,2,0,16,mixedType,2
5,2,0,7,mixedType,0
9,2,0,11,mixedType,1
8,1,0,9,mixedType,1
5,3,0,8,mixedType,1
6,7,1,14,mixedType,2
5,2,0,7,mixedType,0
17,1,1,19,mixedType,2
2,6,0,8,mixedType,1
6,2,0,8,mixedType,1
8,2,0,10,mixedType,1
8,2,0,10,mixedType,1
8,1,0,9,mixedType,1
7,2,0,9,mixedType,1
9,2,0,11,mixedType,1
7,2,0,9,mixedType,1
8,3,0,11,mixedType,1
6,3,0,9,mixedType,1
14,2,0,16,mixedType,2
4,4,0,8,mixedType,1
5,3,0,8,mixedType,1
5,2,0,7,mixedType,0
8,3,0,11,mixedType,1
3,5,0,8,mixedType,1
2,4,0,6,mixedType,0
5,3,0,8,mixedType,1
6,1,0,7,mixedType,0
2,8,0,10,mixedType,1
6,2,0,8,mixedType,1
4,4,0,8,mixedType,1
8,2,0,10,mixedType,1
5,1,0,6,mixedType,0
5,3,0,8,mixedType,1
2,8,0,10,mixedType,1
7,4,0,11,mixedType,1
7,2,0,9,mixedType,1
6,3,0,9,mixedType,1
14,2,0,16,mixedType,2
4,4,0,8,mixedType,1
9,1,0,10,mixedType,1
6,3,0,9,mixedType,1
6,3,0,9,mixedType,1
6,3,0,9,mixedType,1
6,3,0,9,mixedType,1
6,2,0,8,mixedType,1
5,3,0,8,mixedType,1
6,3,0,9,mixedType,1
5,2,0,7,mixedType,0
8,2,0,10,mixedType,1
4,7,0,11,mixedType,1
5,2,0,7,mixedType,0
8,2,0,10,mixedType,1
4,4,0,8,mixedType,1
4,2,0,6,mixedType,0
11,3,0,14,mixedType,2
7,3,0,10,mixedType,1
8,4,0,12,mixedType,1
4,4,0,8,mixedType,1
4,6,0,10,mixedType,1
2,7,0,9,mixedType,1
15,1,0,16,mixedType,2
6,3,0,9,mixedType,1
6,4,0,10,mixedType,1
7,3,0,10,mixedType,1
8,1,0,9,mixedType,1
15,1,0,16,mixedType,2
7,1,0,8,mixedType,1
5,1,0,6,mixedType,0
8,4,0,12,mixedType,1
2,8,0,10,mixedType,1
2,11,0,13,mixedType,1
17,1,0,18,mixedType,2
14,2,0,16,mixedType,2
4,4,0,8,mixedType,1
14,2,0,16,mixedType,2
2,7,0,9,mixedType,1
8,5,0,13,mixedType,1
3,8,0,11,mixedType,1
5,3,0,8,mixedType,1
3,5,0,8,mixedType,1
7,1,0,8,mixedType,1
6,6,0,12,mixedType,1
7,3,0,10,mixedType,1
15,1,0,16,mixedType,2
12,4,0,16,mixedType,2
7,3,0,10,mixedType,1
8,4,0,12,mixedType,1
5,3,0,8,mixedType,1
9,1,0,10,mixedType,1
8,2,0,10,mixedType,1
8,3,0,11,mixedType,1
5,3,0,8,mixedType,1
6,3,0,9,mixedType,1
15,1,0,16,mixedType,2
6,1,0,7,mixedType,0
6,3,0,9,mixedType,1
4,6,0,10,mixedType,1
5,3,0,8,mixedType,1
4,6,0,10,mixedType,1
8,1,0,9,mixedType,1
7,2,0,9,mixedType,1
7,1,0,8,mixedType,1
5,3,0,8,mixedType,1
3,7,0,10,mixedType,1
5,1,0,6,mixedType,0
10,5,1,16,mixedType,2
7,1,0,8,mixedType,1
6,4,0,10,mixedType,1
6,3,0,9,mixedType,1
5,3,0,8,mixedType,1
7,2,0,9,mixedType,1
9,2,0,11,mixedType,1
14,2,0,16,mixedType,2
8,2,0,10,mixedType,1
6,4,0,10,mixedType,1
5,1,0,6,mixedType,0
13,3,0,16,mixedType,2
15,1,0,16,mixedType,2
9,2,0,11,mixedType,1
9,1,0,10,mixedType,1
7,8,0,15,mixedType,2
6,2,0,8,mixedType,1
5,3,0,8,mixedType,1
7,3,0,10,mixedType,1
13,3,0,16,mixedType,2
5,3,0,8,mixedType,1
4,6,0,10,mixedType,1
5,4,0,9,mixedType,1
4,5,0,9,mixedType,1
5,4,0,9,mixedType,1
7,2,0,9,mixedType,1
7,3,0,10,mixedType,1
6,4,0,10,mixedType,1
4,5,0,9,mixedType,1
6,4,0,10,mixedType,1
7,3,0,10,mixedType,1
9,3,0,12,mixedType,1
13,3,0,16,mixedType,2
7,3,0,10,mixedType,1
6,3,0,9,mixedType,1
6,1,0,7,mixedType,0
4,5,0,9,mixedType,1
8,2,0,10,mixedType,1
2,6,0,8,mixedType,1
5,5,0,10,mixedType,1
6,4,0,10,mixedType,1
6,1,0,7,mixedType,0
5,3,0,8,mixedType,1
11,5,0,16,mixedType,2
3,6,0,9,mixedType,1
7,4,0,11,mixedType,1
1,8,0,9,mixedType,1
7,2,0,9,mixedType,1
5,4,0,9,mixedType,1
14,2,0,16,mixedType,2
5,4,0,9,mixedType,1
4,2,0,6,mixedType,0
8,2,0,10,mixedType,1
3,6,0,9,mixedType,1
3,7,0,10,mixedType,1
8,3,0,11,mixedType,1
4,2,0,6,mixedType,0
9,4,1,14,mixedType,2
6,2,0,8,mixedType,1
4,2,0,6,mixedType,0
9,2,0,11,mixedType,1
1,9,0,10,mixedType,1
2,9,0,11,mixedType,1
7,2,0,9,mixedType,1
6,2,0,8,mixedType,1
4,4,0,8,mixedType,1
4,2,0,6,mixedType,0
3,6,0,9,mixedType,1
6,3,0,9,mixedType,1
6,2,2,10,mixedType,1
9,1,0,10,mixedType,1
6,3,0,9,mixedType,1
3,6,0,9,mixedType,1
11,3,0,14,mixedType,2
7,2,0,9,mixedType,1
2,8,0,10,mixedType,1
7,4,0,11,mixedType,1
16,8,0,24,mixedType,2
2,8,0,10,mixedType,1
8,3,0,11,mixedType,1
4,8,0,12,mixedType,1
3,8,0,11,mixedType,1
3,6,0,9,mixedType,1
6,3,0,9,mixedType,1
4,6,0,10,mixedType,1
1,9,0,10,mixedType,1
7,2,0,9,mixedType,1
7,3,0,10,mixedType,1
7,3,0,10,mixedType,1
9,2,0,11,mixedType,1
11,5,0,16,mixedType,2
7,1,0,8,mixedType,1
12,3,0,15,mixedType,2
12,4,0,16,mixedType,2
6,4,0,10,mixedType,1
7,1,0,8,mixedType,1
1,6,0,7,mixedType,0
8,2,0,10,mixedType,1
12,3,0,15,mixedType,2
6,3,0,9,mixedType,1
7,1,0,8,mixedType,1
6,4,0,10,mixedType,1
7,4,0,11,mixedType,1
9,0,2,11,mixedType,1
9,1,0,10,mixedType,1
8,2,0,10,mixedType,1
11,2,0,13,mixedType,1
8,2,0,10,mixedType,1
5,4,0,9,mixedType,1
10,6,0,16,mixedType,2
14,2,0,16,mixedType,2
13,3,0,16,mixedType,2
8,3,0,11,mixedType,1
11,2,0,13,mixedType,1
5,3,0,8,mixedType,1
8,3,0,11,mixedType,1
13,3,0,16,mixedType,2
7,2,0,9,mixedType,1
11,2,0,13,mixedType,1
9,2,0,11,mixedType,1
1,10,0,11,mixedType,1
7,3,0,10,mixedType,1
6,2,0,8,mixedType,1
6,2,0,8,mixedType,1
5,2,0,7,mixedType,0
9,1,0,10,mixedType,1
12,3,0,15,mixedType,2
3,3,0,6,mixedType,0
6,3,0,9,mixedType,1
6,3,0,9,mixedType,1
6,2,0,8,mixedType,1
6,3,0,9,mixedType,1
5,2,0,7,mixedType,0
14,2,0,16,mixedType,2
10,1,0,11,mixedType,1
8,1,0,9,mixedType,1
2,4,0,6,mixedType,0
7,2,0,9,mixedType,1
5,4,0,9,mixedType,1
7,2,0,9,mixedType,1
7,2,0,9,mixedType,1
6,3,0,9,mixedType,1
9,1,0,10,mixedType,1
8,2,0,10,mixedType,1
4,6,0,10,mixedType,1
5,2,0,7,mixedType,0
7,3,0,10,mixedType,1
6,1,0,7,mixedType,0
8,2,0,10,mixedType,1
3,3,0,6,mixedType,0
7,3,0,10,mixedType,1
15,1,0,16,mixedType,2
6,3,0,9,mixedType,1
6,2,0,8,mixedType,1
5,3,0,8,mixedType,1
7,1,0,8,mixedType,1
6,3,0,9,mixedType,1
7,3,0,10,mixedType,1
8,2,0,10,mixedType,1
6,2,0,8,mixedType,1
10,3,0,13,mixedType,1
12,4,0,16,mixedType,2
4,4,0,8,mixedType,1
6,2,0,8,mixedType,1
2,7,0,9,mixedType,1
11,3,0,14,mixedType,2
5,2,0,7,mixedType,0
7,3,0,10,mixedType,1
8,3,0,11,mixedType,1
6,3,0,9,mixedType,1
1,9,0,10,mixedType,1
13,3,0,16,mixedType,2
7,3,0,10,mixedType,1
5,3,0,8,mixedType,1
7,2,0,9,mixedType,1
2,8,0,10,mixedType,1
8,2,0,10,mixedType,1
6,3,0,9,mixedType,1
14,2,0,16,mixedType,2
2,7,0,9,mixedType,1
7,5,0,12,mixedType,1
9,1,0,10,mixedType,1
10,3,2,15,mixedType,2
6,1,0,7,mixedType,0
6,3,0,9,mixedType,1
12,1,2,15,mixedType,2
2,7,0,9,mixedType,1
7,2,0,9,mixedType,1
8,1,0,9,mixedType,1
6,3,0,9,mixedType,1
8,1,0,9,mixedType,1
14,1,0,15,mixedType,2
2,4,0,6,mixedType,0
11,3,0,14,mixedType,2
11,3,0,14,mixedType,2
9,2,0,11,mixedType,1
8,1,0,9,mixedType,1
3,6,0,9,mixedType,1
5,2,0,7,mixedType,0
6,3,0,9,mixedType,1
3,5,0,8,mixedType,1
6,9,3,18,mixedType,2
6,6,0,12,mixedType,1
11,1,0,12,mixedType,1
6,1,0,7,mixedType,0
12,3,0,15,mixedType,2
1,8,0,9,mixedType,1
6,2,0,8,mixedType,1
7,2,0,9,mixedType,1
2,10,0,12,mixedType,1
5,1,0,6,mixedType,0
6,4,0,10,mixedType,1
8,1,0,9,mixedType,1
5,2,0,7,mixedType,0
7,3,0,10,mixedType,1
14,2,0,16,mixedType,2
2,9,0,11,mixedType,1
13,3,0,16,mixedType,2
5,4,0,9,mixedType,1
7,2,0,9,mixedType,1
7,3,0,10,mixedType,1
6,1,0,7,mixedType,0
9,2,0,11,mixedType,1
8,1,0,9,mixedType,1
9,1,0,10,mixedType,1
9,1,0,10,mixedType,1
6,2,0,8,mixedType,1
9,2,0,11,mixedType,1
8,1,0,9,mixedType,1
15,1,0,16,mixedType,2
7,3,0,10,mixedType,1
7,2,0,9,mixedType,1
5,5,0,10,mixedType,1
10,1,0,11,mixedType,1
5,4,0,9,mixedType,1
9,2,0,11,mixedType,1
7,3,0,10,mixedType,1
9,3,0,12,mixedType,1
7,3,0,10,mixedType,1
7,2,0,9,mixedType,1
12,4,0,16,mixedType,2
6,7,0,13,mixedType,1
5,2,0,7,mixedType,0
14,2,0,16,mixedType,2
10,3,0,13,mixedType,1
6,3,0,9,mixedType,1
8,2,0,10,mixedType,1
11,3,0,14,mixedType,2
3,8,0,11,mixedType,1
4,2,0,6,mixedType,0
5,3,0,8,mixedType,1
8,3,0,11,mixedType,1
4,4,0,8,mixedType,1
7,2,0,9,mixedType,1
6,3,0,9,mixedType,1
7,2,0,9,mixedType,1
6,4,0,10,mixedType,1
10,3,0,13,mixedType,1
5,3,0,8,mixedType,1
4,6,0,10,mixedType,1
7,6,0,13,mixedType,1
6,2,0,8,mixedType,1
7,1,0,8,mixedType,1
7,2,0,9,mixedType,1
1,7,0,8,mixedType,1
7,1,0,8,mixedType,1
13,3,0,16,mixedType,2
8,2,0,10,mixedType,1
10,2,0,12,mixedType,1
5,2,0,7,mixedType,0
5,6,0,11,mixedType,1
9,3,3,15,mixedType,2
9,1,0,10,mixedType,1
11,3,0,14,mixedType,2
4,6,0,10,mixedType,1
6,4,0,10,mixedType,1
7,3,0,10,mixedType,1
9,1,0,10,mixedType,1
8,2,0,10,mixedType,1
6,1,0,7,mixedType,0
6,3,0,9,mixedType,1
8,2,0,10,mixedType,1
8,2,0,10,mixedType,1
6,4,0,10,mixedType,1
12,3,0,15,mixedType,2
8,1,0,9,mixedType,1
5,3,0,8,mixedType,1
3,3,0,6,mixedType,0
4,2,0,6,mixedType,0
7,1,0,8,mixedType,1
8,2,0,10,mixedType,1
6,2,0,8,mixedType,1
8,2,0,10,mixedType,1
15,1,0,16,mixedType,2
14,3,0,17,mixedType,2
14,2,0,16,mixedType,2
7,3,0,10,mixedType,1
4,5,0,9,mixedType,1
5,3,0,8,mixedType,1
5,4,0,9,mixedType,1
6,3,0,9,mixedType,1
1,7,0,8,mixedType,1
7,3,0,10,mixedType,1
5,6,0,11,mixedType,1
6,1,0,7,mixedType,0
1,9,0,10,mixedType,1
13,3,0,16,mixedType,2
8,0,1,9,mixedType,1
3,3,0,6,mixedType,0
5,2,0,7,mixedType,0
3,6,0,9,mixedType,1
6,3,0,9,mixedType,1
5,3,0,8,mixedType,1
7,4,0,11,mixedType,1
7,3,0,10,mixedType,1
12,3,0,15,mixedType,2
6,4,0,10,mixedType,1
4,2,0,6,mixedType,0
5,2,0,7,mixedType,0
6,2,0,8,mixedType,1
2,6,0,8,mixedType,1
7,1,0,8,mixedType,1
9,3,0,12,mixedType,1
6,1,0,7,mixedType,0
6,3,0,9,mixedType,1
5,3,0,8,mixedType,1
6,3,0,9,mixedType,1
9,1,0,10,mixedType,1
1,9,0,10,mixedType,1
16,1,1,18,mixedType,2
8,2,0,10,mixedType,1
7,1,0,8,mixedType,1
4,2,0,6,mixedType,0
5,4,0,9,mixedType,1
3,8,0,11,mixedType,1
11,4,1,16,mixedType,2
4,6,0,10,mixedType,1
6,3,0,9,mixedType,1
6,3,0,9,mixedType,1
9,1,0,10,mixedType,1
6,1,0,7,mixedType,0
8,4,0,12,mixedType,1
5,2,0,7,mixedType,0
11,1,0,12,mixedType,1
6,1,0,7,mixedType,0
10,2,0,12,mixedType,1
5,4,0,9,mixedType,1
13,3,0,16,mixedType,2
5,1,0,6,mixedType,0
7,3,0,10,mixedType,1
12,3,0,15,mixedType,2
7,3,0,10,mixedType,1
7,2,0,9,mixedType,1
8,2,0,10,mixedType,1
7,2,0,9,mixedType,1
7,4,0,11,mixedType,1
5,3,0,8,mixedType,1
4,2,0,6,mixedType,0
6,3,0,9,mixedType,1
10,3,0,13,mixedType,1
4,2,0,6,mixedType,0
7,2,0,9,mixedType,1
6,2,0,8,mixedType,1
4,4,0,8,mixedType,1
8,1,0,9,mixedType,1
6,4,0,10,mixedType,1
6,3,0,9,mixedType,1
5,1,0,6,mixedType,0
5,1,0,6,mixedType,0
6,2,0,8,mixedType,1
6,3,0,9,mixedType,1
1,6,0,7,mixedType,0
6,1,0,7,mixedType,0
2,6,0,8,mixedType,1
4,2,0,6,mixedType,0
14,2,0,16,mixedType,2
4,2,0,6,mixedType,0
7,4,0,11,mixedType,1
7,1,0,8,mixedType,1
13,3,0,16,mixedType,2
5,2,0,7,mixedType,0
14,2,0,16,mixedType,2
7,3,0,10,mixedType,1
1,10,0,11,mixedType,1
8,4,0,12,mixedType,1
5,4,0,9,mixedType,1
7,1,0,8,mixedType,1
5,3,0,8,mixedType,1
5,3,0,8,mixedType,1
12,3,0,15,mixedType,2
3,6,0,9,mixedType,1
6,4,0,10,mixedType,1
12,2,1,15,mixedType,2
2,7,0,9,mixedType,1
14,2,0,16,mixedType,2
7,3,0,10,mixedType,1
5,5,0,10,mixedType,1
7,4,3,14,mixedType,2
1,11,0,12,mixedType,1
6,2,0,8,mixedType,1
9,1,0,10,mixedType,1
2,4,0,6,mixedType,0
5,8,0,13,mixedType,1
5,3,0,8,mixedType,1
2,7,0,9,mixedType,1
9,3,0,12,mixedType,1
7,2,0,9,mixedType,1
6,2,0,8,mixedType,1
6,4,0,10,mixedType,1
7,3,0,10,mixedType,1
6,2,0,8,mixedType,1
14,2,0,16,mixedType,2
5,3,0,8,mixedType,1
8,2,0,10,mixedType,1
8,2,0,10,mixedType,1
6,3,0,9,mixedType,1
7,3,0,10,mixedType,1
15,1,0,16,mixedType,2
8,1,0,9,mixedType,1
8,2,0,10,mixedType,1
12,3,0,15,mixedType,2
6,6,0,12,mixedType,1
10,2,0,12,mixedType,1
11,3,0,14,mixedType,2
6,4,0,10,mixedType,1
5,1,0,6,mixedType,0
5,2,0,7,mixedType,0
7,2,0,9,mixedType,1
8,1,0,9,mixedType,1
8,2,0,10,mixedType,1
3,7,0,10,mixedType,1
5,3,0,8,mixedType,1
8,7,0,15,mixedType,2
5,2,0,7,mixedType,0
7,3,0,10,mixedType,1
9,2,0,11,mixedType,1
11,1,0,12,mixedType,1
4,2,0,6,mixedType,0
6,4,0,10,mixedType,1
15,1,0,16,mixedType,2
11,3,0,14,mixedType,2
12,4,0,16,mixedType,2
7,1,0,8,mixedType,1
5,3,0,8,mixedType,1
4,4,0,8,mixedType,1
6,2,0,8,mixedType,1
8,1,0,9,mixedType,1
7,4,0,11,mixedType,1
7,4,0,11,mixedType,1
7,3,0,10,mixedType,1
12,4,0,16,mixedType,2
2,6,0,8,mixedType,1
2,6,0,8,mixedType,1
6,3,0,9,mixedType,1
6,2,0,8,mixedType,1
7,3,0,10,mixedType,1
8,2,0,10,mixedType,1
4,4,0,8,mixedType,1
6,3,0,9,mixedType,1
4,5,0,9,mixedType,1
4,2,0,6,mixedType,0
7,4,0,11,mixedType,1
5,2,0,7,mixedType,0
5,2,0,7,mixedType,0
6,0,1,7,mixedType,0
4,2,0,6,mixedType,0
6,4,0,10,mixedType,1
4,2,0,6,mixedType,0
6,2,0,8,mixedType,1
7,2,0,9,mixedType,1
8,2,0,10,mixedType,1
5,4,0,9,mixedType,1
14,2,0,16,mixedType,2
3,6,0,9,mixedType,1
5,2,0,7,mixedType,0
7,3,0,10,mixedType,1
3,3,0,6,mixedType,0
4,4,0,8,mixedType,1
5,2,0,7,mixedType,0
3,6,0,9,mixedType,1
11,2,0,13,mixedType,1
6,0,1,7,mixedType,0
9,1,0,10,mixedType,1
13,3,0,16,mixedType,2
8,2,0,10,mixedType,1
4,2,0,6,mixedType,0
6,3,0,9,mixedType,1
6,3,0,9,mixedType,1
7,2,0,9,mixedType,1
9,1,0,10,mixedType,1
6,3,0,9,mixedType,1
1,9,0,10,mixedType,1
7,2,0,9,mixedType,1
5,3,0,8,mixedType,1
7,2,0,9,mixedType,1
8,3,0,11,mixedType,1
14,2,0,16,mixedType,2
14,2,0,16,mixedType,2
4,6,0,10,mixedType,1
7,3,0,10,mixedType,1
7,1,0,8,mixedType,1
7,2,0,9,mixedType,1
1,9,0,10,mixedType,1
7,3,0,10,mixedType,1
8,3,0,11,mixedType,1
7,3,0,10,mixedType,1
7,2,0,9,mixedType,1
9,2,0,11,mixedType,1
12,8,0,20,mixedType,2
5,3,0,8,mixedType,1
3,9,0,12,mixedType,1
6,4,0,10,mixedType,1
6,3,0,9,mixedType,1
6,2,0,8,mixedType,1
2,6,0,8,mixedType,1
1,8,0,9,mixedType,1
8,1,0,9,mixedType,1
6,2,0,8,mixedType,1
8,1,0,9,mixedType,1
10,2,0,12,mixedType,1
3,5,0,8,mixedType,1
5,3,0,8,mixedType,1
7,3,0,10,mixedType,1
4,6,0,10,mixedType,1
2,6,0,8,mixedType,1
7,3,0,10,mixedType,1
15,1,0,16,mixedType,2
10,1,0,11,mixedType,1
7,4,0,11,mixedType,1
8,1,0,9,mixedType,1
6,8,0,14,mixedType,2
5,2,0,7,mixedType,0
5,3,0,8,mixedType,1
7,1,0,8,mixedType,1
7,2,0,9,mixedType,1
6,1,0,7,mixedType,0
5,3,0,8,mixedType,1
6,4,0,10,mixedType,1
9,4,0,13,mixedType,1
5,3,0,8,mixedType,1
7,2,0,9,mixedType,1
7,3,0,10,mixedType,1
3,3,0,6,mixedType,0
7,2,0,9,mixedType,1
7,4,0,11,mixedType,1
6,7,0,13,mixedType,1
6,1,0,7,mixedType,0
8,2,0,10,mixedType,1
7,5,0,12,mixedType,1
14,2,0,16,mixedType,2
3,5,0,8,mixedType,1
8,2,0,10,mixedType,1
8,2,0,10,mixedType,1
7,2,0,9,mixedType,1
7,2,0,9,mixedType,1
8,4,0,12,mixedType,1
6,4,0,10,mixedType,1
7,2,0,9,mixedType,1
7,3,0,10,mixedType,1
4,4,0,8,mixedType,1
5,2,0,7,mixedType,0
6,4,0,10,mixedType,1
5,5,0,10,mixedType,1
8,2,0,10,mixedType,1
6,2,0,8,mixedType,1
4,4,0,8,mixedType,1
5,5,0,10,mixedType,1
8,1,0,9,mixedType,1
7,2,0,9,mixedType,1
6,4,0,10,mixedType,1
6,4,0,10,mixedType,1
8,2,0,10,mixedType,1
13,3,0,16,mixedType,2
9,1,0,10,mixedType,1
5,2,0,7,mixedType,0
9,1,0,10,mixedType,1
5,3,0,8,mixedType,1
6,1,0,7,mixedType,0
4,2,0,6,mixedType,0
7,2,0,9,mixedType,1
4,2,0,6,mixedType,0
5,4,0,9,mixedType,1
5,3,0,8,mixedType,1
7,4,0,11,mixedType,1
5,3,0,8,mixedType,1
6,1,0,7,mixedType,0
10,6,0,16,mixedType,2
2,6,0,8,mixedType,1
3,3,0,6,mixedType,0
3,6,0,9,mixedType,1
2,9,0,11,mixedType,1
9,2,0,11,mixedType,1
7,1,0,8,mixedType,1
4,4,0,8,mixedType,1
9,2,0,11,mixedType,1
15,5,0,20,mixedType,2
5,1,0,6,mixedType,0
9,2,0,11,mixedType,1
13,3,0,16,mixedType,2
15,1,0,16,mixedType,2
7,2,0,9,mixedType,1
4,2,0,6,mixedType,0
10,6,0,16,mixedType,2
5,4,0,9,mixedType,1
7,3,0,10,mixedType,1
1,8,0,9,mixedType,1
9,2,0,11,mixedType,1
6,2,0,8,mixedType,1
12,4,0,16,mixedType,2
6,1,0,7,mixedType,0
8,2,0,10,mixedType,1
11,1,0,12,mixedType,1
8,2,0,10,mixedType,1
6,3,0,9,mixedType,1
13,3,0,16,mixedType,2
6,3,0,9,mixedType,1
6,3,0,9,mixedType,1
1,6,0,7,mixedType,0
9,1,0,10,mixedType,1
9,4,0,13,mixedType,1
6,3,0,9,mixedType,1
0,12,1,13,mixedType,1
2,10,0,12,mixedType,1
13,3,0,16,mixedType,2
7,1,0,8,mixedType,1
9,1,0,10,mixedType,1
9,1,0,10,mixedType,1
7,3,0,10,mixedType,1
7,2,0,9,mixedType,1
7,2,0,9,mixedType,1
8,1,0,9,mixedType,1
11,5,0,16,mixedType,2
7,3,0,10,mixedType,1
5,3,0,8,mixedType,1
5,4,0,9,mixedType,1
7,1,0,8,mixedType,1
7,3,0,10,mixedType,1
7,1,0,8,mixedType,1
7,2,0,9,mixedType,1
7,3,0,10,mixedType,1
3,5,0,8,mixedType,1
7,3,0,10,mixedType,1
14,2,0,16,mixedType,2
9,2,0,11,mixedType,1
7,3,0,10,mixedType,1
5,2,0,7,mixedType,0
5,3,0,8,mixedType,1
7,3,0,10,mixedType,1
7,3,0,10,mixedType,1
3,3,0,6,mixedType,0
5,1,0,6,mixedType,0
13,3,0,16,mixedType,2
2,6,0,8,mixedType,1
8,2,0,10,mixedType,1
7,1,0,8,mixedType,1
8,2,0,10,mixedType,1
8,4,0,12,mixedType,1
8,1,0,9,mixedType,1
5,2,0,7,mixedType,0
6,3,0,9,mixedType,1
14,2,0,16,mixedType,2
9,3,0,12,mixedType,1
12,4,0,16,mixedType,2
9,1,0,10,mixedType,1
4,4,0,8,mixedType,1
5,2,0,7,mixedType,0
3,5,0,8,mixedType,1
14,2,0,16,mixedType,2
2,4,0,6,mixedType,0
6,2,0,8,mixedType,1
4,2,0,6,mixedType,0
12,3,0,15,mixedType,2
4,4,0,8,mixedType,1
12,4,0,16,mixedType,2
8,2,0,10,mixedType,1
6,1,0,7,mixedType,0
8,1,0,9,mixedType,1
14,2,0,16,mixedType,2
9,1,0,10,mixedType,1
7,2,0,9,mixedType,1
8,2,0,10,mixedType,1
7,3,0,10,mixedType,1
8,2,0,10,mixedType,1
8,1,0,9,mixedType,1
7,3,0,10,mixedType,1
7,1,0,8,mixedType,1
6,1,0,7,mixedType,0
8,1,0,9,mixedType,1
7,3,0,10,mixedType,1
8,1,0,9,mixedType,1
6,1,0,7,mixedType,0
14,2,0,16,mixedType,2
4,2,0,6,mixedType,0
8,1,0,9,mixedType,1
11,3,0,14,mixedType,2
4,4,0,8,mixedType,1
8,2,0,10,mixedType,1
7,3,0,10,mixedType,1
4,9,0,13,mixedType,1
4,2,0,6,mixedType,0
12,4,0,16,mixedType,2
6,1,0,7,mixedType,0
5,1,0,6,mixedType,0
6,4,0,10,mixedType,1
9,1,0,10,mixedType,1
5,1,0,6,mixedType,0
5,1,0,6,mixedType,0
7,1,0,8,mixedType,1
7,3,0,10,mixedType,1
7,3,0,10,mixedType,1
1,8,0,9,mixedType,1
8,1,0,9,mixedType,1
1,10,0,11,mixedType,1
8,3,0,11,mixedType,1
8,4,0,12,mixedType,1
12,4,0,16,mixedType,2
1,7,0,8,mixedType,1
8,1,0,9,mixedType,1
7,4,0,11,mixedType,1
14,2,0,16,mixedType,2
2,7,0,9,mixedType,1
5,0,1,6,mixedType,0
5,2,0,7,mixedType,0
8,1,0,9,mixedType,1
6,3,0,9,mixedType,1
8,1,0,9,mixedType,1
9,1,0,10,mixedType,1
8,2,0,10,mixedType,1
6,2,0,8,mixedType,1
8,2,0,10,mixedType,1
7,3,0,10,mixedType,1
13,3,0,16,mixedType,2
6,4,0,10,mixedType,1
2,10,0,12,mixedType,1
5,7,0,12,mixedType,1
12,1,0,13,mixedType,1
7,3,0,10,mixedType,1
1,11,0,12,mixedType,1
5,1,0,6,mixedType,0
6,3,0,9,mixedType,1
5,1,0,6,mixedType,0
6,3,0,9,mixedType,1
10,1,0,11,mixedType,1
10,3,0,13,mixedType,1
8,1,0,9,mixedType,1
10,4,0,14,mixedType,2
7,3,0,10,mixedType,1
8,2,0,10,mixedType,1
5,3,0,8,mixedType,1
6,4,0,10,mixedType,1
8,3,0,11,mixedType,1
6,4,0,10,mixedType,1
4,2,0,6,mixedType,0
6,1,0,7,mixedType,0
4,2,0,6,mixedType,0
5,3,0,8,mixedType,1
5,2,0,7,mixedType,0
4,2,0,6,mixedType,0
5,2,0,7,mixedType,0
2,6,0,8,mixedType,1
8,2,0,10,mixedType,1
7,6,0,13,mixedType,1
5,4,0,9,mixedType,1
4,4,0,8,mixedType,1
9,1,0,10,mixedType,1
10,1,0,11,mixedType,1
12,3,0,15,mixedType,2
4,2,0,6,mixedType,0
9,4,0,13,mixedType,1
14,2,0,16,mixedType,2
3,6,0,9,mixedType,1
4,6,0,10,mixedType,1
7,5,0,12,mixedType,1
12,4,0,16,mixedType,2
5,2,0,7,mixedType,0
9,3,0,12,mixedType,1
8,4,0,12,mixedType,1
4,6,0,10,mixedType,1
5,3,0,8,mixedType,1
7,2,0,9,mixedType,1
6,3,0,9,mixedType,1
7,3,0,10,mixedType,1
11,5,0,16,mixedType,2
7,1,0,8,mixedType,1
5,4,0,9,mixedType,1
13,3,0,16,mixedType,2
5,6,0,11,mixedType,1
7,2,0,9,mixedType,1
0,10,2,12,mixedType,1
6,3,0,9,mixedType,1
6,3,0,9,mixedType,1
6,2,0,8,mixedType,1
5,4,0,9,mixedType,1
8,2,0,10,mixedType,1
9,3,0,12,mixedType,1
6,4,0,10,mixedType,1
8,2,0,10,mixedType,1
3,6,0,9,mixedType,1
8,1,0,9,mixedType,1
14,2,0,16,mixedType,2
8,2,0,10,mixedType,1
11,3,0,14,mixedType,2
15,5,2,22,mixedType,2
4,6,0,10,mixedType,1
4,6,0,10,mixedType,1
10,2,0,12,mixedType,1
11,1,0,12,mixedType,1
6,2,0,8,mixedType,1
4,6,0,10,mixedType,1
7,3,0,10,mixedType,1
8,3,0,11,mixedType,1
5,1,0,6,mixedType,0
14,2,0,16,mixedType,2
10,2,0,12,mixedType,1
5,3,0,8,mixedType,1
8,1,0,9,mixedType,1
6,1,0,7,mixedType,0
7,3,0,10,mixedType,1
6,6,0,12,mixedType,1
11,2,0,13,mixedType,1
2,10,0,12,mixedType,1
7,2,0,9,mixedType,1
7,3,0,10,mixedType,1
8,4,0,12,mixedType,1
6,5,0,11,mixedType,1
6,3,0,9,mixedType,1
11,3,0,14,mixedType,2
6,4,0,10,mixedType,1
10,2,0,12,mixedType,1
8,1,0,9,mixedType,1
8,3,0,11,mixedType,1
6,1,0,7,mixedType,0
12,4,0,16,mixedType,2
7,1,0,8,mixedType,1
13,3,0,16,mixedType,2
6,3,0,9,mixedType,1
3,3,0,6,mixedType,0
6,2,0,8,mixedType,1
6,3,0,9,mixedType,1
14,2,0,16,mixedType,2
14,2,0,16,mixedType,2
4,2,0,6,mixedType,0
8,2,0,10,mixedType,1
6,3,0,9,mixedType,1
7,2,0,9,mixedType,1
5,1,0,6,mixedType,0
8,2,0,10,mixedType,1
13,3,0,16,mixedType,2
5,3,0,8,mixedType,1
7,1,0,8,mixedType,1
7,2,0,9,mixedType,1
7,2,0,9,mixedType,1
6,6,6,18,mixedType,2
8,2,0,10,mixedType,1
7,1,0,8,mixedType,1
9,2,0,11,mixedType,1
9,1,0,10,mixedType,1
6,1,0,7,mixedType,0
5,1,0,6,mixedType,0
5,2,0,7,mixedType,0
4,2,0,6,mixedType,0
2,4,0,6,mixedType,0
6,1,0,7,mixedType,0
13,3,0,16,mixedType,2
7,4,0,11,mixedType,1
4,6,0,10,mixedType,1
6,2,0,8,mixedType,1
6,1,0,7,mixedType,0
13,3,0,16,mixedType,2
9,1,0,10,mixedType,1
8,2,0,10,mixedType,1
14,2,0,16,mixedType,2
13,3,0,16,mixedType,2
11,5,0,16,mixedType,2
4,4,0,8,mixedType,1
8,2,0,10,mixedType,1
4,2,0,6,mixedType,0
5,3,0,8,mixedType,1
5,2,0,7,mixedType,0
7,2,0,9,mixedType,1
7,3,0,10,mixedType,1
6,3,0,9,mixedType,1
8,2,0,10,mixedType,1
6,2,0,8,mixedType,1
5,4,0,9,mixedType,1
4,4,0,8,mixedType,1
5,2,0,7,mixedType,0
5,2,0,7,mixedType,0
3,6,0,9,mixedType,1
8,1,0,9,mixedType,1
6,4,0,10,mixedType,1
7,3,0,10,mixedType,1
8,3,0,11,mixedType,1
14,2,0,16,mixedType,2
8,4,0,12,mixedType,1
8,1,0,9,mixedType,1
3,8,0,11,mixedType,1
1,10,0,11,mixedType,1
4,2,0,6,mixedType,0
7,3,0,10,mixedType,1
14,3,0,17,mixedType,2
12,1,1,14,mixedType,2
10,4,0,14,mixedType,2
1,9,0,10,mixedType,1
4,2,0,6,mixedType,0
4,4,0,8,mixedType,1
5,3,0,8,mixedType,1
6,3,0,9,mixedType,1
6,1,0,7,mixedType,0
8,2,0,10,mixedType,1
12,2,1,15,mixedType,2
5,4,0,9,mixedType,1
6,3,0,9,mixedType,1
3,7,0,10,mixedType,1
8,4,0,12,mixedType,1
1,8,0,9,mixedType,1
7,3,0,10,mixedType,1
6,4,0,10,mixedType,1
9,1,0,10,mixedType,1
10,1,0,11,mixedType,1
4,4,0,8,mixedType,1
6,3,0,9,mixedType,1
9,2,0,11,mixedType,1
11,3,0,14,mixedType,2
7,3,0,10,mixedType,1
6,3,0,9,mixedType,1
4,9,0,13,mixedType,1
13,3,0,16,mixedType,2
15,1,0,16,mixedType,2
6,4,0,10,mixedType,1
11,3,0,14,mixedType,2
5,6,0,11,mixedType,1
10,2,0,12,mixedType,1
1,9,0,10,mixedType,1
2,9,0,11,mixedType,1
6,2,0,8,mixedType,1
6,3,0,9,mixedType,1
8,2,0,10,mixedType,1
14,2,0,16,mixedType,2
4,5,0,9,mixedType,1
8,2,0,10,mixedType,1
7,3,0,10,mixedType,1
8,2,0,10,mixedType,1
5,3,0,8,mixedType,1
11,3,0,14,mixedType,2
6,2,0,8,mixedType,1
14,2,0,16,mixedType,2
14,2,0,16,mixedType,2
2,4,0,6,mixedType,0
11,5,0,16,mixedType,2
5,3,0,8,mixedType,1
7,3,0,10,mixedType,1
5,2,0,7,mixedType,0
10,1,0,11,mixedType,1
10,1,0,11,mixedType,1
6,2,0,8,mixedType,1
6,3,0,9,mixedType,1
2,6,0,8,mixedType,1
8,1,0,9,mixedType,1
1,8,0,9,mixedType,1
5,2,0,7,mixedType,0
10,3,0,13,mixedType,1
14,2,0,16,mixedType,2
7,4,0,11,mixedType,1
5,4,0,9,mixedType,1
6,2,0,8,mixedType,1
4,6,0,10,mixedType,1
13,3,0,16,mixedType,2
8,2,0,10,mixedType,1
14,2,0,16,mixedType,2
3,6,0,9,mixedType,1
5,2,0,7,mixedType,0
4,8,0,12,mixedType,1
15,1,2,18,mixedType,2
7,2,0,9,mixedType,1
5,3,0,8,mixedType,1
6,2,0,8,mixedType,1
4,6,0,10,mixedType,1
4,4,0,8,mixedType,1
9,1,0,10,mixedType,1
8,3,0,11,mixedType,1
5,3,0,8,mixedType,1
6,3,0,9,mixedType,1
8,3,0,11,mixedType,1
3,6,0,9,mixedType,1
5,3,0,8,mixedType,1
15,1,0,16,mixedType,2
5,3,0,8,mixedType,1
8,3,0,11,mixedType,1
5,7,0,12,mixedType,1
4,4,0,8,mixedType,1
5,2,0,7,mixedType,0
2,10,0,12,mixedType,1
5,1,0,6,mixedType,0
9,1,0,10,mixedType,1
6,2,0,8,mixedType,1
4,2,0,6,mixedType,0
3,13,0,16,mixedType,2
5,4,0,9,mixedType,1
6,1,0,7,mixedType,0
11,3,0,14,mixedType,2
6,6,0,12,mixedType,1
8,1,0,9,mixedType,1
8,4,0,12,mixedType,1
5,4,0,9,mixedType,1
8,1,0,9,mixedType,1
4,5,0,9,mixedType,1
8,1,0,9,mixedType,1
4,4,0,8,mixedType,1
7,4,0,11,mixedType,1
12,3,0,15,mixedType,2
5,2,0,7,mixedType,0
5,3,0,8,mixedType,1
7,3,0,10,mixedType,1
2,7,0,9,mixedType,1
6,1,0,7,mixedType,0
4,4,0,8,mixedType,1
2,6,0,8,mixedType,1
6,1,0,7,mixedType,0
6,4,0,10,mixedType,1
4,4,0,8,mixedType,1
4,2,0,6,mixedType,0
6,4,0,10,mixedType,1
1,8,0,9,mixedType,1
8,2,0,10,mixedType,1
7,2,0,9,mixedType,1
6,1,0,7,mixedType,0
6,2,0,8,mixedType,1
8,1,0,9,mixedType,1
3,5,0,8,mixedType,1
6,1,0,7,mixedType,0
9,1,0,10,mixedType,1
5,3,0,8,mixedType,1
6,3,0,9,mixedType,1
3,6,0,9,mixedType,1
6,3,0,9,mixedType,1
6,4,0,10,mixedType,1
2,9,0,11,mixedType,1
5,4,0,9,mixedType,1
4,2,0,6,mixedType,0
4,4,0,8,mixedType,1
8,1,0,9,mixedType,1
6,3,0,9,mixedType,1
7,0,1,8,mixedType,1
5,1,0,6,mixedType,0
6,3,0,9,mixedType,1
6,3,0,9,mixedType,1
5,3,0,8,mixedType,1
5,3,0,8,mixedType,1
5,3,0,8,mixedType,1
8,1,0,9,mixedType,1
12,4,0,16,mixedType,2
4,2,0,6,mixedType,0
13,3,0,16,mixedType,2
7,0,1,8,mixedType,1
10,1,0,11,mixedType,1
5,3,0,8,mixedType,1
12,1,1,14,mixedType,2
3,3,0,6,mixedType,0
8,2,0,10,mixedType,1
9,1,0,10,mixedType,1
6,2,0,8,mixedType,1
6,2,0,8,mixedType,1
7,2,0,9,mixedType,1
3,5,0,8,mixedType,1
5,2,0,7,mixedType,0
8,3,0,11,mixedType,1
4,2,0,6,mixedType,0
3,6,0,9,mixedType,1
8,2,0,10,mixedType,1
6,3,0,9,mixedType,1
6,3,0,9,mixedType,1
7,1,0,8,mixedType,1
5,4,0,9,mixedType,1
10,2,0,12,mixedType,1
8,2,0,10,mixedType,1
6,1,0,7,mixedType,0
10,1,0,11,mixedType,1
7,3,0,10,mixedType,1
7,3,0,10,mixedType,1
10,3,0,13,mixedType,1
7,4,0,11,mixedType,1
2,8,0,10,mixedType,1
11,5,0,16,mixedType,2
6,4,0,10,mixedType,1
6,6,0,12,mixedType,1
7,3,0,10,mixedType,1
5,2,0,7,mixedType,0
7,2,0,9,mixedType,1
16,1,1,18,mixedType,2
14,2,0,16,mixedType,2
4,4,0,8,mixedType,1
1,7,0,8,mixedType,1
11,3,0,14,mixedType,2
5,2,0,7,mixedType,0
7,3,0,10,mixedType,1
13,3,0,16,mixedType,2
10,1,0,11,mixedType,1
7,3,0,10,mixedType,1
7,1,0,8,mixedType,1
10,2,0,12,mixedType,1
8,3,0,11,mixedType,1
8,2,0,10,mixedType,1
8,2,0,10,mixedType,1
5,2,0,7,mixedType,0
2,6,0,8,mixedType,1
6,1,0,7,mixedType,0
6,4,0,10,mixedType,1
8,2,0,10,mixedType,1
6,4,0,10,mixedType,1
13,4,1,18,mixedType,2
3,8,0,11,mixedType,1
4,2,0,6,mixedType,0
15,1,0,16,mixedType,2
9,2,0,11,mixedType,1
6,2,0,8,mixedType,1
8,6,0,14,mixedType,2
9,4,0,13,mixedType,1
8,4,0,12,mixedType,1
6,3,0,9,mixedType,1
5,4,0,9,mixedType,1
4,4,0,8,mixedType,1
6,3,0,9,mixedType,1
6,4,0,10,mixedType,1
5,2,0,7,mixedType,0
8,4,0,12,mixedType,1
4,2,0,6,mixedType,0
6,2,0,8,mixedType,1
6,1,0,7,mixedType,0
5,3,0,8,mixedType,1
11,1,0,12,mixedType,1
3,5,0,8,mixedType,1
6,3,0,9,mixedType,1
7,2,0,9,mixedType,1
5,3,0,8,mixedType,1
4,6,0,10,mixedType,1
6,2,0,8,mixedType,1
7,1,0,8,mixedType,1
13,3,0,16,mixedType,2
7,3,0,10,mixedType,1
6,1,0,7,mixedType,0
7,1,0,8,mixedType,1
7,3,0,10,mixedType,1
6,3,0,9,mixedType,1
4,4,0,8,mixedType,1
15,1,0,16,mixedType,2
6,4,0,10,mixedType,1
6,4,0,10,mixedType,1
7,2,0,9,mixedType,1
3,7,0,10,mixedType,1
8,1,0,9,mixedType,1
5,1,0,6,mixedType,0
1,10,0,11,mixedType,1
7,2,0,9,mixedType,1
7,2,0,9,mixedType,1
5,3,0,8,mixedType,1
7,5,0,12,mixedType,1
9,2,0,11,mixedType,1
4,6,0,10,mixedType,1
7,3,0,10,mixedType,1
5,1,0,6,mixedType,0
6,2,0,8,mixedType,1
5,4,0,9,mixedType,1
10,1,0,11,mixedType,1
4,8,0,12,mixedType,1
6,2,0,8,mixedType,1
4,4,0,8,mixedType,1
8,4,0,12,mixedType,1
2,8,0,10,mixedType,1
7,3,0,10,mixedType,1
6,2,0,8,mixedType,1
8,1,0,9,mixedType,1
9,1,0,10,mixedType,1
11,3,0,14,mixedType,2
9,2,0,11,mixedType,1
5,4,0,9,mixedType,1
2,4,0,6,mixedType,0
6,6,0,12,mixedType,1
5,3,0,8,mixedType,1
10,2,0,12,mixedType,1
6,2,0,8,mixedType,1
4,2,0,6,mixedType,0
8,4,0,12,mixedType,1
2,4,0,6,mixedType,0
5,1,0,6,mixedType,0
8,4,0,12,mixedType,1
5,4,0,9,mixedType,1
8,3,0,11,mixedType,1
7,2,0,9,mixedType,1
6,1,0,7,mixedType,0
14,2,0,16,mixedType,2
3,6,0,9,mixedType,1
4,2,0,6,mixedType,0
5,2,0,7,mixedType,0
8,3,0,11,mixedType,1
7,2,0,9,mixedType,1
6,3,0,9,mixedType,1
9,2,0,11,mixedType,1
5,4,0,9,mixedType,1
6,3,0,9,mixedType,1
10,3,0,13,mixedType,1
8,2,0,10,mixedType,1
6,4,0,10,mixedType,1
3,6,0,9,mixedType,1
6,4,0,10,mixedType,1
4,6,0,10,mixedType,1
10,2,0,12,mixedType,1
7,3,0,10,mixedType,1
5,3,0,8,mixedType,1
7,1,0,8,mixedType,1
5,1,0,6,mixedType,0
6,3,0,9,mixedType,1
5,1,0,6,mixedType,0
8,1,0,9,mixedType,1
12,1,0,13,mixedType,1
5,3,0,8,mixedType,1
5,4,0,9,mixedType,1
5,5,0,10,mixedType,1
5,1,0,6,mixedType,0
5,4,0,9,mixedType,1
5,3,0,8,mixedType,1
8,1,0,9,mixedType,1
7,3,0,10,mixedType,1
8,1,0,9,mixedType,1
1,9,0,10,mixedType,1
9,3,0,12,mixedType,1
7,2,0,9,mixedType,1
5,3,0,8,mixedType,1
8,2,0,10,mixedType,1
7,3,0,10,mixedType,1
13,3,0,16,mixedType,2
7,3,0,10,mixedType,1
11,5,0,16,mixedType,2
15,1,0,16,mixedType,2
4,8,2,14,mixedType,2
4,4,0,8,mixedType,1
5,2,0,7,mixedType,0
6,4,0,10,mixedType,1
5,3,0,8,mixedType,1
4,4,0,8,mixedType,1
5,2,0,7,mixedType,0
4,5,0,9,mixedType,1
4,4,0,8,mixedType,1
5,4,0,9,mixedType,1
13,3,0,16,mixedType,2
8,1,0,9,mixedType,1
4,4,0,8,mixedType,1
6,3,0,9,mixedType,1
6,4,0,10,mixedType,1
10,1,0,11,mixedType,1
7,2,0,9,mixedType,1
9,3,0,12,mixedType,1
6,3,0,9,mixedType,1
8,2,0,10,mixedType,1
13,3,0,16,mixedType,2
11,2,1,14,mixedType,2
8,2,0,10,mixedType,1
15,1,0,16,mixedType,2
8,2,0,10,mixedType,1
7,2,0,9,mixedType,1
9,1,0,10,mixedType,1
6,1,0,7,mixedType,0
8,2,0,10,mixedType,1
8,3,0,11,mixedType,1
6,3,0,9,mixedType,1
8,4,0,12,mixedType,1
6,1,0,7,mixedType,0
6,1,0,7,mixedType,0
9,3,0,12,mixedType,1
15,1,0,16,mixedType,2
15,1,0,16,mixedType,2
5,2,0,7,mixedType,0
14,2,0,16,mixedType,2
7,3,0,10,mixedType,1
6,2,0,8,mixedType,1
6,3,0,9,mixedType,1
9,4,0,13,mixedType,1
8,1,0,9,mixedType,1
6,2,0,8,mixedType,1
7,3,0,10,mixedType,1
6,4,0,10,mixedType,1
7,2,0,9,mixedType,1
8,1,0,9,mixedType,1
4,6,0,10,mixedType,1
9,4,1,14,mixedType,2
8,2,0,10,mixedType,1
5,2,0,7,mixedType,0
6,1,0,7,mixedType,0
1,8,0,9,mixedType,1
5,4,0,9,mixedType,1
4,6,0,10,mixedType,1
4,2,0,6,mixedType,0
5,4,0,9,mixedType,1
7,3,0,10,mixedType,1
7,5,0,12,mixedType,1
5,8,0,13,mixedType,1
4,4,0,8,mixedType,1
5,4,0,9,mixedType,1
14,2,0,16,mixedType,2
2,7,0,9,mixedType,1
5,9,0,14,mixedType,2
13,3,0,16,mixedType,2
7,3,0,10,mixedType,1
6,2,0,8,mixedType,1
7,2,0,9,mixedType,1
8,1,0,9,mixedType,1
0,11,1,12,mixedType,1
5,3,0,8,mixedType,1
7,3,0,10,mixedType,1
9,0,1,10,mixedType,1
4,4,0,8,mixedType,1
8,2,0,10,mixedType,1
7,2,0,9,mixedType,1
5,3,0,8,mixedType,1
4,4,0,8,mixedType,1
7,2,0,9,mixedType,1
9,1,0,10,mixedType,1
8,1,0,9,mixedType,1
6,1,0,7,mixedType,0
10,2,2,14,mixedType,2
7,1,0,8,mixedType,1
7,3,0,10,mixedType,1
6,2,0,8,mixedType,1
10,2,0,12,mixedType,1
5,3,0,8,mixedType,1
7,3,0,10,mixedType,1
6,3,0,9,mixedType,1
13,3,0,16,mixedType,2
7,3,0,10,mixedType,1
8,4,0,12,mixedType,1
5,2,0,7,mixedType,0
15,1,0,16,mixedType,2
10,2,0,12,mixedType,1
4,7,0,11,mixedType,1
7,2,0,9,mixedType,1
10,1,0,11,mixedType,1
5,1,0,6,mixedType,0
7,3,0,10,mixedType,1
4,4,0,8,mixedType,1
6,2,0,8,mixedType,1
5,2,0,7,mixedType,0
7,2,0,9,mixedType,1
7,4,0,11,mixedType,1
9,1,0,10,mixedType,1
7,2,0,9,mixedType,1
14,2,0,16,mixedType,2
5,5,0,10,mixedType,1
8,1,0,9,mixedType,1
7,2,0,9,mixedType,1
5,3,0,8,mixedType,1
6,1,0,7,mixedType,0
6,2,0,8,mixedType,1
11,3,0,14,mixedType,2
5,2,0,7,mixedType,0
6,4,0,10,mixedType,1
14,2,0,16,mixedType,2
7,3,0,10,mixedType,1
6,3,0,9,mixedType,1
14,2,0,16,mixedType,2
8,3,0,11,mixedType,1
3,7,0,10,mixedType,1
8,2,0,10,mixedType,1
2,6,0,8,mixedType,1
13,3,0,16,mixedType,2
6,3,0,9,mixedType,1
13,4,2,19,mixedType,2
5,4,0,9,mixedType,1
6,1,0,7,mixedType,0
8,1,0,9,mixedType,1
7,2,0,9,mixedType,1
8,2,0,10,mixedType,1
8,3,0,11,mixedType,1
5,4,0,9,mixedType,1
7,3,0,10,mixedType,1
8,1,0,9,mixedType,1
8,2,0,10,mixedType,1
8,2,0,10,mixedType,1
5,2,0,7,mixedType,0
2,4,0,6,mixedType,0
7,3,0,10,mixedType,1
2,6,0,8,mixedType,1
6,2,0,8,mixedType,1
8,3,0,11,mixedType,1
0,8,1,9,mixedType,1
7,2,0,9,mixedType,1
8,2,0,10,mixedType,1
7,2,0,9,mixedType,1
6,3,0,9,mixedType,1
8,3,0,11,mixedType,1
5,4,0,9,mixedType,1
5,3,0,8,mixedType,1
15,1,0,16,mixedType,2
5,4,0,9,mixedType,1
8,2,0,10,mixedType,1
9,2,0,11,mixedType,1
6,3,0,9,mixedType,1
3,5,0,8,mixedType,1
6,3,0,9,mixedType,1
15,1,0,16,mixedType,2
7,3,0,10,mixedType,1
6,1,0,7,mixedType,0
8,3,0,11,mixedType,1
14,2,0,16,mixedType,2
9,1,0,10,mixedType,1
8,1,0,9,mixedType,1
5,3,0,8,mixedType,1
15,1,0,16,mixedType,2
8,2,0,10,mixedType,1
9,4,0,13,mixedType,1
8,2,0,10,mixedType,1
3,6,0,9,mixedType,1
9,1,0,10,mixedType,1
8,2,0,10,mixedType,1
5,2,0,7,mixedType,0
6,3,0,9,mixedType,1
7,3,0,10,mixedType,1
8,6,2,16,mixedType,2
7,3,0,10,mixedType,1
8,4,0,12,mixedType,1
7,2,0,9,mixedType,1
4,2,0,6,mixedType,0
12,1,0,13,mixedType,1
4,4,0,8,mixedType,1
6,2,0,8,mixedType,1
14,2,0,16,mixedType,2
4,2,0,6,mixedType,0
10,2,0,12,mixedType,1
4,6,0,10,mixedType,1
5,2,0,7,mixedType,0
5,2,0,7,mixedType,0
6,1,0,7,mixedType,0
9,2,0,11,mixedType,1
4,2,0,6,mixedType,0
7,3,0,10,mixedType,1
13,3,0,16,mixedType,2
5,2,0,7,mixedType,0
8,4,0,12,mixedType,1
3,6,0,9,mixedType,1
12,4,0,16,mixedType,2
5,4,0,9,mixedType,1
4,6,0,10,mixedType,1
6,2,0,8,mixedType,1
14,2,0,16,mixedType,2
4,6,0,10,mixedType,1
6,3,0,9,mixedType,1
8,2,0,10,mixedType,1
6,1,0,7,mixedType,0
5,4,0,9,mixedType,1
6,3,0,9,mixedType,1
9,4,1,14,mixedType,2
5,4,0,9,mixedType,1
4,2,0,6,mixedType,0
6,1,0,7,mixedType,0
9,1,0,10,mixedType,1
10,2,0,12,mixedType,1
7,1,0,8,mixedType,1
5,4,0,9,mixedType,1
6,2,0,8,mixedType,1
7,3,0,10,mixedType,1
6,3,0,9,mixedType,1
5,2,0,7,mixedType,0
4,4,0,8,mixedType,1
7,2,0,9,mixedType,1
7,3,0,10,mixedType,1
5,3,0,8,mixedType,1
8,2,0,10,mixedType,1
4,2,0,6,mixedType,0
6,3,0,9,mixedType,1
15,1,0,16,mixedType,2
5,1,0,6,mixedType,0
7,1,0,8,mixedType,1
6,2,0,8,mixedType,1
2,4,0,6,mixedType,0
9,3,0,12,mixedType,1
15,1,0,16,mixedType,2
15,3,0,18,mixedType,2
6,3,0,9,mixedType,1
3,8,0,11,mixedType,1
7,2,0,9,mixedType,1
3,6,0,9,mixedType,1
6,3,0,9,mixedType,1
5,3,0,8,mixedType,1
5,4,0,9,mixedType,1
6,3,0,9,mixedType,1
5,6,0,11,mixedType,1
12,3,0,15,mixedType,2
5,2,0,7,mixedType,0
5,2,0,7,mixedType,0
12,4,0,16,mixedType,2
14,2,0,16,mixedType,2
9,3,0,12,mixedType,1
15,1,0,16,mixedType,2
2,6,0,8,mixedType,1
9,1,0,10,mixedType,1
6,3,0,9,mixedType,1
9,1,0,10,mixedType,1
6,2,0,8,mixedType,1
6,3,0,9,mixedType,1
5,6,0,11,mixedType,1
5,6,0,11,mixedType,1
11,4,0,15,mixedType,2
7,3,0,10,mixedType,1
8,2,0,10,mixedType,1
7,3,0,10,mixedType,1
10,0,1,11,mixedType,1
2,7,0,9,mixedType,1
5,1,0,6,mixedType,0
4,4,0,8,mixedType,1
7,3,0,10,mixedType,1
8,1,0,9,mixedType,1
2,8,0,10,mixedType,1
15,1,0,16,mixedType,2
5,2,0,7,mixedType,0
6,1,0,7,mixedType,0
8,6,1,15,mixedType,2
14,2,0,16,mixedType,2
6,1,0,7,mixedType,0
4,9,0,13,mixedType,1
5,3,0,8,mixedType,1
1,8,0,9,mixedType,1
7,2,0,9,mixedType,1
5,3,0,8,mixedType,1
6,3,0,9,mixedType,1
6,3,0,9,mixedType,1
7,2,0,9,mixedType,1
6,3,0,9,mixedType,1
7,6,0,13,mixedType,1
5,3,0,8,mixedType,1
8,6,3,17,mixedType,2
8,1,0,9,mixedType,1
12,3,0,15,mixedType,2
5,4,0,9,mixedType,1
12,4,0,16,mixedType,2
9,3,0,12,mixedType,1
4,4,0,8,mixedType,1
7,3,0,10,mixedType,1
6,3,0,9,mixedType,1
8,4,0,12,mixedType,1
6,3,0,9,mixedType,1
14,2,0,16,mixedType,2
6,1,0,7,mixedType,0
14,2,0,16,mixedType,2
7,3,0,10,mixedType,1
7,2,0,9,mixedType,1
9,2,0,11,mixedType,1
5,4,0,9,mixedType,1
6,6,0,12,mixedType,1
4,8,0,12,mixedType,1
4,4,0,8,mixedType,1
7,3,0,10,mixedType,1
6,2,0,8,mixedType,1
6,1,0,7,mixedType,0
3,6,0,9,mixedType,1
7,4,0,11,mixedType,1
4,2,0,6,mixedType,0
8,3,0,11,mixedType,1
12,6,0,18,mixedType,2
5,2,0,7,mixedType,0
6,4,0,10,mixedType,1
10,1,0,11,mixedType,1
9,3,0,12,mixedType,1
8,4,0,12,mixedType,1
6,2,0,8,mixedType,1
6,3,0,9,mixedType,1
7,3,0,10,mixedType,1
7,3,0,10,mixedType,1
4,2,0,6,mixedType,0
6,1,0,7,mixedType,0
11,2,0,13,mixedType,1
6,0,1,7,mixedType,0
6,1,0,7,mixedType,0
16,1,0,17,mixedType,2
5,4,0,9,mixedType,1
8,2,0,10,mixedType,1
9,2,0,11,mixedType,1
5,2,0,7,mixedType,0
6,2,0,8,mixedType,1
1,7,0,8,mixedType,1
2,7,0,9,mixedType,1
9,2,0,11,mixedType,1
6,4,0,10,mixedType,1
1,12,0,13,mixedType,1
8,2,0,10,mixedType,1
6,6,0,12,mixedType,1
7,3,0,10,mixedType,1
13,3,0,16,mixedType,2
5,3,0,8,mixedType,1
7,4,0,11,mixedType,1
7,1,0,8,mixedType,1
10,2,0,12,mixedType,1
3,10,0,13,mixedType,1
8,1,0,9,mixedType,1
8,0,1,9,mixedType,1
9,1,0,10,mixedType,1
9,1,0,10,mixedType,1
8,2,0,10,mixedType,1
6,2,0,8,mixedType,1
4,2,0,6,mixedType,0
6,3,0,9,mixedType,1
1,8,0,9,mixedType,1
7,1,0,8,mixedType,1
5,4,0,9,mixedType,1
8,2,0,10,mixedType,1
4,2,0,6,mixedType,0
15,1,0,16,mixedType,2
13,3,0,16,mixedType,2
1,10,0,11,mixedType,1
7,2,0,9,mixedType,1
4,5,0,9,mixedType,1
8,4,0,12,mixedType,1
2,4,0,6,mixedType,0
4,6,0,10,mixedType,1
7,3,0,10,mixedType,1
4,6,0,10,mixedType,1
7,1,0,8,mixedType,1
4,2,0,6,mixedType,0
4,4,0,8,mixedType,1
11,1,0,12,mixedType,1
7,3,0,10,mixedType,1
7,3,0,10,mixedType,1
2,4,0,6,mixedType,0
9,4,0,13,mixedType,1
15,1,0,16,mixedType,2
8,1,0,9,mixedType,1
9,1,0,10,mixedType,1
7,3,0,10,mixedType,1
3,6,0,9,mixedType,1
9,2,0,11,mixedType,1
15,1,0,16,mixedType,2
7,2,0,9,mixedType,1
5,1,0,6,mixedType,0
6,4,0,10,mixedType,1
4,6,0,10,mixedType,1
8,2,0,10,mixedType,1
11,3,0,14,mixedType,2
8,4,0,12,mixedType,1
13,3,0,16,mixedType,2
6,4,0,10,mixedType,1
5,1,0,6,mixedType,0
7,2,0,9,mixedType,1
11,5,0,16,mixedType,2
6,3,0,9,mixedType,1
9,1,0,10,mixedType,1
2,7,0,9,mixedType,1
7,2,0,9,mixedType,1
6,4,0,10,mixedType,1
6,2,0,8,mixedType,1
6,3,0,9,mixedType,1
7,3,0,10,mixedType,1
3,6,0,9,mixedType,1
7,3,0,10,mixedType,1
12,4,0,16,mixedType,2
6,1,0,7,mixedType,0
5,2,0,7,mixedType,0
10,1,0,11,mixedType,1
5,2,0,7,mixedType,0
13,1,1,15,mixedType,2
6,2,0,8,mixedType,1
5,4,0,9,mixedType,1
7,7,0,14,mixedType,2
7,4,0,11,mixedType,1
5,3,0,8,mixedType,1
6,3,0,9,mixedType,1
6,2,0,8,mixedType,1
6,2,0,8,mixedType,1
7,3,0,10,mixedType,1
13,2,0,15,mixedType,2
6,3,0,9,mixedType,1
6,1,0,7,mixedType,0
8,2,0,10,mixedType,1
3,6,0,9,mixedType,1
6,2,0,8,mixedType,1
5,4,0,9,mixedType,1
7,4,0,11,mixedType,1
13,3,0,16,mixedType,2
3,6,0,9,mixedType,1
5,3,0,8,mixedType,1
6,1,0,7,mixedType,0
15,1,0,16,mixedType,2
4,2,0,6,mixedType,0
4,4,0,8,mixedType,1
7,3,0,10,mixedType,1
7,3,0,10,mixedType,1
6,3,0,9,mixedType,1
5,3,0,8,mixedType,1
8,1,0,9,mixedType,1
7,1,0,8,mixedType,1
10,4,0,14,mixedType,2
14,2,0,16,mixedType,2
14,2,0,16,mixedType,2
8,1,0,9,mixedType,1
5,5,0,10,mixedType,1
8,1,0,9,mixedType,1
7,2,0,9,mixedType,1
1,8,0,9,mixedType,1
13,3,0,16,mixedType,2
5,2,0,7,mixedType,0
7,2,0,9,mixedType,1
9,3,0,12,mixedType,1
9,2,0,11,mixedType,1
15,1,0,16,mixedType,2
6,3,0,9,mixedType,1
5,8,0,13,mixedType,1
6,1,0,7,mixedType,0
15,1,0,16,mixedType,2
7,2,0,9,mixedType,1
10,1,0,11,mixedType,1
9,2,0,11,mixedType,1
8,2,0,10,mixedType,1
5,4,0,9,mixedType,1
8,2,0,10,mixedType,1
4,2,0,6,mixedType,0
6,2,0,8,mixedType,1
6,1,0,7,mixedType,0
9,2,0,11,mixedType,1
6,6,0,12,mixedType,1
3,3,0,6,mixedType,0
4,4,0,8,mixedType,1
9,2,0,11,mixedType,1
12,4,0,16,mixedType,2
2,6,0,8,mixedType,1
6,4,0,10,mixedType,1
7,3,0,10,mixedType,1
5,4,0,9,mixedType,1
7,0,0,7,sameType,0
5,2,0,7,mixedType,0
15,1,0,16,mixedType,2
5,2,0,7,mixedType,0
4,6,0,10,mixedType,1
4,6,0,10,mixedType,1
4,4,0,8,mixedType,1
8,2,0,10,mixedType,1
7,2,0,9,mixedType,1
7,2,0,9,mixedType,1
5,2,0,7,mixedType,0
3,5,0,8,mixedType,1
9,1,0,10,mixedType,1
4,4,0,8,mixedType,1
1,7,0,8,mixedType,1
5,2,0,7,mixedType,0
2,8,0,10,mixedType,1
7,2,0,9,mixedType,1
6,7,0,13,mixedType,1
6,3,0,9,mixedType,1
2,6,0,8,mixedType,1
8,3,0,11,mixedType,1
8,1,0,9,mixedType,1
5,2,0,7,mixedType,0
5,1,0,6,mixedType,0
5,2,0,7,mixedType,0
7,3,0,10,mixedType,1
4,2,0,6,mixedType,0
6,10,1,17,mixedType,2
3,6,0,9,mixedType,1
5,2,0,7,mixedType,0
8,2,0,10,mixedType,1
10,1,0,11,mixedType,1
7,2,0,9,mixedType,1
5,5,0,10,mixedType,1
5,6,0,11,mixedType,1
10,1,0,11,mixedType,1
7,1,0,8,mixedType,1
4,4,0,8,mixedType,1
4,2,0,6,mixedType,0
13,3,0,16,mixedType,2
8,3,0,11,mixedType,1
8,4,0,12,mixedType,1
14,5,1,20,mixedType,2
6,3,0,9,mixedType,1
6,3,0,9,mixedType,1
4,2,0,6,mixedType,0
7,4,0,11,mixedType,1
9,4,0,13,mixedType,1
7,3,0,10,mixedType,1
8,2,0,10,mixedType,1
1,8,0,9,mixedType,1
4,7,0,11,mixedType,1
6,4,0,10,mixedType,1
5,8,0,13,mixedType,1
7,1,0,8,mixedType,1
2,9,0,11,mixedType,1
13,3,0,16,mixedType,2
7,3,0,10,mixedType,1
2,7,0,9,mixedType,1
5,3,0,8,mixedType,1
12,3,0,15,mixedType,2
6,1,0,7,mixedType,0
4,2,0,6,mixedType,0
7,2,0,9,mixedType,1
11,5,0,16,mixedType,2
1,7,0,8,mixedType,1
15,1,0,16,mixedType,2
7,2,0,9,mixedType,1
6,3,0,9,mixedType,1
7,2,0,9,mixedType,1
7,2,0,9,mixedType,1
8,1,0,9,mixedType,1
1,8,0,9,mixedType,1
11,1,0,12,mixedType,1
6,2,0,8,mixedType,1
12,4,0,16,mixedType,2
8,4,0,12,mixedType,1
8,1,0,9,mixedType,1
4,6,0,10,mixedType,1
5,1,0,6,mixedType,0
8,0,1,9,mixedType,1
7,4,0,11,mixedType,1
12,4,0,16,mixedType,2
6,1,0,7,mixedType,0
4,6,0,10,mixedType,1
7,1,0,8,mixedType,1
9,2,0,11,mixedType,1
6,1,0,7,mixedType,0
7,3,0,10,mixedType,1
5,2,0,7,mixedType,0
7,3,0,10,mixedType,1
9,1,0,10,mixedType,1
16,1,1,18,mixedType,2
6,2,0,8,mixedType,1
13,3,0,16,mixedType,2
5,2,0,7,mixedType,0
6,7,0,13,mixedType,1
6,4,0,10,mixedType,1
7,3,0,10,mixedType,1
6,2,0,8,mixedType,1
1,9,0,10,mixedType,1
2,7,0,9,mixedType,1
7,3,0,10,mixedType,1
5,2,0,7,mixedType,0
8,1,0,9,mixedType,1
11,2,0,13,mixedType,1
14,2,0,16,mixedType,2
5,4,0,9,mixedType,1
6,4,0,10,mixedType,1
6,4,0,10,mixedType,1
7,3,0,10,mixedType,1
4,4,0,8,mixedType,1
7,3,0,10,mixedType,1
6,3,0,9,mixedType,1
6,3,0,9,mixedType,1
8,2,0,10,mixedType,1
12,4,0,16,mixedType,2
7,3,0,10,mixedType,1
9,2,0,11,mixedType,1
9,0,1,10,mixedType,1
5,4,0,9,mixedType,1
7,3,0,10,mixedType,1
6,4,0,10,mixedType,1
5,0,2,7,mixedType,0
5,3,0,8,mixedType,1
13,3,0,16,mixedType,2
10,2,0,12,mixedType,1
6,3,0,9,mixedType,1
12,3,0,15,mixedType,2
4,4,0,8,mixedType,1
6,2,0,8,mixedType,1
5,3,0,8,mixedType,1
6,5,0,11,mixedType,1
7,1,0,8,mixedType,1
8,3,0,11,mixedType,1
10,2,0,12,mixedType,1
7,1,0,8,mixedType,1
7,4,0,11,mixedType,1
6,3,0,9,mixedType,1
6,4,0,10,mixedType,1
2,8,0,10,mixedType,1
6,3,0,9,mixedType,1
15,1,0,16,mixedType,2
6,3,0,9,mixedType,1
5,3,0,8,mixedType,1
15,1,0,16,mixedType,2
8,2,0,10,mixedType,1
5,2,0,7,mixedType,0
9,3,0,12,mixedType,1
4,4,0,8,mixedType,1
6,4,0,10,mixedType,1
13,3,0,16,mixedType,2
2,6,0,8,mixedType,1
4,4,0,8,mixedType,1
6,5,0,11,mixedType,1
5,3,0,8,mixedType,1
4,2,0,6,mixedType,0
4,4,0,8,mixedType,1
7,2,0,9,mixedType,1
7,1,0,8,mixedType,1
7,1,0,8,mixedType,1
3,3,0,6,mixedType,0
9,2,0,11,mixedType,1
7,1,0,8,mixedType,1
7,1,0,8,mixedType,1
3,6,0,9,mixedType,1
6,4,0,10,mixedType,1
5,3,0,8,mixedType,1
9,2,0,11,mixedType,1
11,2,0,13,mixedType,1
9,3,0,12,mixedType,1
14,2,0,16,mixedType,2
6,2,0,8,mixedType,1
4,2,0,6,mixedType,0
6,4,0,10,mixedType,1
5,2,0,7,mixedType,0
4,2,0,6,mixedType,0
3,6,0,9,mixedType,1
15,1,0,16,mixedType,2
6,1,0,7,mixedType,0
1,8,0,9,mixedType,1
10,2,0,12,mixedType,1
1,9,0,10,mixedType,1
5,4,0,9,mixedType,1
4,4,0,8,mixedType,1
4,2,0,6,mixedType,0
6,3,0,9,mixedType,1
7,2,0,9,mixedType,1
9,4,0,13,mixedType,1
8,1,0,9,mixedType,1
6,3,0,9,mixedType,1
5,4,0,9,mixedType,1
2,7,0,9,mixedType,1
6,3,0,9,mixedType,1
5,2,0,7,mixedType,0
7,6,0,13,mixedType,1
8,4,0,12,mixedType,1
5,4,0,9,mixedType,1
15,1,0,16,mixedType,2
9,1,0,10,mixedType,1
13,3,0,16,mixedType,2
7,2,0,9,mixedType,1
8,3,0,11,mixedType,1
12,4,0,16,mixedType,2
6,3,0,9,mixedType,1
8,2,0,10,mixedType,1
14,2,0,16,mixedType,2
2,6,0,8,mixedType,1
10,1,0,11,mixedType,1
6,1,0,7,mixedType,0
7,3,0,10,mixedType,1
5,1,0,6,mixedType,0
12,4,0,16,mixedType,2
8,1,0,9,mixedType,1
9,2,0,11,mixedType,1
6,2,0,8,mixedType,1
7,3,0,10,mixedType,1
5,3,0,8,mixedType,1
8,1,0,9,mixedType,1
6,2,0,8,mixedType,1
5,1,0,6,mixedType,0
7,2,0,9,mixedType,1
2,6,0,8,mixedType,1
9,6,0,15,mixedType,2
7,2,0,9,mixedType,1
6,2,0,8,mixedType,1
7,3,0,10,mixedType,1
1,9,0,10,mixedType,1
7,1,0,8,mixedType,1
13,5,0,18,mixedType,2
7,3,0,10,mixedType,1
6,4,0,10,mixedType,1
10,2,0,12,mixedType,1
14,2,0,16,mixedType,2
7,4,0,11,mixedType,1
9,3,0,12,mixedType,1
5,7,0,12,mixedType,1
1,7,0,8,mixedType,1
7,3,0,10,mixedType,1
8,2,0,10,mixedType,1
5,2,0,7,mixedType,0
7,6,0,13,mixedType,1
4,2,0,6,mixedType,0
6,3,0,9,mixedType,1
7,3,0,10,mixedType,1
5,3,0,8,mixedType,1
5,4,0,9,mixedType,1
6,4,0,10,mixedType,1
2,7,0,9,mixedType,1
6,2,0,8,mixedType,1
11,3,0,14,mixedType,2
8,2,0,10,mixedType,1
8,1,0,9,mixedType,1
13,3,0,16,mixedType,2
9,3,0,12,mixedType,1
6,4,0,10,mixedType,1
6,2,0,8,mixedType,1
8,4,0,12,mixedType,1
5,2,0,7,mixedType,0
8,2,0,10,mixedType,1
8,1,0,9,mixedType,1
5,3,0,8,mixedType,1
9,1,0,10,mixedType,1
1,7,0,8,mixedType,1
6,2,0,8,mixedType,1
9,2,0,11,mixedType,1
4,2,0,6,mixedType,0
4,2,0,6,mixedType,0
15,1,0,16,mixedType,2
5,7,0,12,mixedType,1
8,5,0,13,mixedType,1
7,1,0,8,mixedType,1
6,4,0,10,mixedType,1
6,3,0,9,mixedType,1
13,3,0,16,mixedType,2
6,6,0,12,mixedType,1
5,3,0,8,mixedType,1
4,4,0,8,mixedType,1
5,3,0,8,mixedType,1
13,3,0,16,mixedType,2
4,2,0,6,mixedType,0
6,2,0,8,mixedType,1
7,3,0,10,mixedType,1
5,3,0,8,mixedType,1
14,2,0,16,mixedType,2
6,4,0,10,mixedType,1
6,4,0,10,mixedType,1
12,4,0,16,mixedType,2
9,3,0,12,mixedType,1
7,3,0,10,mixedType,1
6,1,0,7,mixedType,0
7,2,0,9,mixedType,1
17,3,0,20,mixedType,2
11,1,0,12,mixedType,1
3,6,0,9,mixedType,1
14,2,0,16,mixedType,2
8,2,0,10,mixedType,1
13,2,1,16,mixedType,2
6,4,0,10,mixedType,1
4,5,0,9,mixedType,1
8,1,0,9,mixedType,1
5,3,0,8,mixedType,1
8,2,0,10,mixedType,1
8,2,0,10,mixedType,1
4,6,0,10,mixedType,1
8,3,0,11,mixedType,1
5,1,0,6,mixedType,0
15,1,0,16,mixedType,2
8,2,0,10,mixedType,1
7,3,0,10,mixedType,1
7,3,0,10,mixedType,1
15,1,0,16,mixedType,2
5,4,0,9,mixedType,1
9,4,0,13,mixedType,1
5,2,0,7,mixedType,0
6,1,0,7,mixedType,0
12,4,0,16,mixedType,2
6,4,0,10,mixedType,1
8,3,0,11,mixedType,1
5,3,0,8,mixedType,1
2,6,0,8,mixedType,1
9,1,0,10,mixedType,1
3,8,0,11,mixedType,1
11,3,0,14,mixedType,2
5,6,0,11,mixedType,1
8,2,0,10,mixedType,1
5,2,0,7,mixedType,0
7,2,0,9,mixedType,1
6,2,0,8,mixedType,1
8,4,0,12,mixedType,1
8,2,0,10,mixedType,1
6,2,0,8,mixedType,1
3,6,0,9,mixedType,1
7,2,0,9,mixedType,1
7,1,0,8,mixedType,1
6,4,0,10,mixedType,1
5,3,0,8,mixedType,1
10,2,0,12,mixedType,1
6,2,0,8,mixedType,1
7,3,0,10,mixedType,1
2,9,0,11,mixedType,1
7,4,0,11,mixedType,1
0,6,0,6,sameType,0
6,1,0,7,mixedType,0
8,4,0,12,mixedType,1
15,1,0,16,mixedType,2
5,3,0,8,mixedType,1
4,6,0,10,mixedType,1
7,1,0,8,mixedType,1
5,3,0,8,mixedType,1
9,1,0,10,mixedType,1
5,2,0,7,mixedType,0
15,1,0,16,mixedType,2
6,4,0,10,mixedType,1
5,3,0,8,mixedType,1
5,4,0,9,mixedType,1
8,2,0,10,mixedType,1
14,1,0,15,mixedType,2
4,4,0,8,mixedType,1
5,3,0,8,mixedType,1
7,1,0,8,mixedType,1
7,1,0,8,mixedType,1
7,2,0,9,mixedType,1
6,4,0,10,mixedType,1
6,4,0,10,mixedType,1
1,9,0,10,mixedType,1
3,8,0,11,mixedType,1
4,7,0,11,mixedType,1
14,4,1,19,mixedType,2
2,8,0,10,mixedType,1
7,4,0,11,mixedType,1
7,3,0,10,mixedType,1
6,2,0,8,mixedType,1
1,8,0,9,mixedType,1
3,3,0,6,mixedType,0
5,3,0,8,mixedType,1
5,3,0,8,mixedType,1
2,6,0,8,mixedType,1
7,1,0,8,mixedType,1
5,2,0,7,mixedType,0
8,3,0,11,mixedType,1
4,2,0,6,mixedType,0
7,3,0,10,mixedType,1
6,2,0,8,mixedType,1
7,3,0,10,mixedType,1
8,4,0,12,mixedType,1
12,2,3,17,mixedType,2
12,4,0,16,mixedType,2
5,2,0,7,mixedType,0
11,1,0,12,mixedType,1
7,3,0,10,mixedType,1
7,3,0,10,mixedType,1
11,1,0,12,mixedType,1
7,2,0,9,mixedType,1
2,10,0,12,mixedType,1
5,2,0,7,mixedType,0
2,4,0,6,mixedType,0
8,3,0,11,mixedType,1
8,2,0,10,mixedType,1
6,3,0,9,mixedType,1
1,11,0,12,mixedType,1
9,3,0,12,mixedType,1
3,5,0,8,mixedType,1
14,2,0,16,mixedType,2
6,3,0,9,mixedType,1
4,2,0,6,mixedType,0
6,2,0,8,mixedType,1
11,5,0,16,mixedType,2
6,1,0,7,mixedType,0
6,1,0,7,mixedType,0
6,4,0,10,mixedType,1
5,2,0,7,mixedType,0
6,1,0,7,mixedType,0
4,2,0,6,mixedType,0
5,2,0,7,mixedType,0
6,1,0,7,mixedType,0
7,1,0,8,mixedType,1
7,4,0,11,mixedType,1
6,7,0,13,mixedType,1
7,2,0,9,mixedType,1
5,2,0,7,mixedType,0
8,1,0,9,mixedType,1
5,8,0,13,mixedType,1
6,4,0,10,mixedType,1
6,3,0,9,mixedType,1
7,3,0,10,mixedType,1
11,0,1,12,mixedType,1
12,3,0,15,mixedType,2
6,3,0,9,mixedType,1
5,3,0,8,mixedType,1
6,2,0,8,mixedType,1
6,3,0,9,mixedType,1
6,1,0,7,mixedType,0
7,2,0,9,mixedType,1
7,2,0,9,mixedType,1
5,8,0,13,mixedType,1
1,7,0,8,mixedType,1
3,8,0,11,mixedType,1
7,2,0,9,mixedType,1
7,2,0,9,mixedType,1
1,10,0,11,mixedType,1
6,3,0,9,mixedType,1
7,6,1,14,mixedType,2
4,2,0,6,mixedType,0
7,3,0,10,mixedType,1
9,3,0,12,mixedType,1
12,3,0,15,mixedType,2
14,2,0,16,mixedType,2
5,3,0,8,mixedType,1
15,1,0,16,mixedType,2
6,1,0,7,mixedType,0
6,2,0,8,mixedType,1
7,3,0,10,mixedType,1
14,1,0,15,mixedType,2
8,4,0,12,mixedType,1
7,3,0,10,mixedType,1
7,4,0,11,mixedType,1
4,4,0,8,mixedType,1
7,6,0,13,mixedType,1
6,2,0,8,mixedType,1
4,2,0,6,mixedType,0
4,8,0,12,mixedType,1
4,2,0,6,mixedType,0
6,1,0,7,mixedType,0
1,10,0,11,mixedType,1
8,2,0,10,mixedType,1
7,3,0,10,mixedType,1
6,3,0,9,mixedType,1
5,4,0,9,mixedType,1
5,3,0,8,mixedType,1
3,6,0,9,mixedType,1
7,2,0,9,mixedType,1
13,3,0,16,mixedType,2
6,2,0,8,mixedType,1
4,6,0,10,mixedType,1
6,2,0,8,mixedType,1
6,4,0,10,mixedType,1
9,4,0,13,mixedType,1
4,4,0,8,mixedType,1
10,1,0,11,mixedType,1
8,3,0,11,mixedType,1
2,8,0,10,mixedType,1
7,2,0,9,mixedType,1
4,2,0,6,mixedType,0
6,4,0,10,mixedType,1
8,3,0,11,mixedType,1
8,1,0,9,mixedType,1
7,2,0,9,mixedType,1
10,3,0,13,mixedType,1
3,3,0,6,mixedType,0
10,4,0,14,mixedType,2
7,3,0,10,mixedType,1
13,3,0,16,mixedType,2
7,3,0,10,mixedType,1
6,3,0,9,mixedType,1
8,3,0,11,mixedType,1
6,3,0,9,mixedType,1
8,2,0,10,mixedType,1
5,4,0,9,mixedType,1
6,3,0,9,mixedType,1
9,2,0,11,mixedType,1
4,2,0,6,mixedType,0
6,2,0,8,mixedType,1
7,3,0,10,mixedType,1
5,2,0,7,mixedType,0
0,6,0,6,sameType,0
9,1,0,10,mixedType,1
5,2,0,7,mixedType,0
6,3,0,9,mixedType,1
13,3,0,16,mixedType,2
6,2,0,8,mixedType,1
5,3,0,8,mixedType,1
5,3,0,8,mixedType,1
6,1,0,7,mixedType,0
15,1,0,16,mixedType,2
15,1,0,16,mixedType,2
7,2,0,9,mixedType,1
9,4,1,14,mixedType,2
6,4,0,10,mixedType,1
8,1,0,9,mixedType,1
3,7,0,10,mixedType,1
10,2,0,12,mixedType,1
15,1,0,16,mixedType,2
6,3,0,9,mixedType,1
7,3,0,10,mixedType,1
5,3,0,8,mixedType,1
7,2,0,9,mixedType,1
4,6,0,10,mixedType,1
6,4,0,10,mixedType,1
3,5,0,8,mixedType,1
2,8,0,10,mixedType,1
5,9,0,14,mixedType,2
6,3,0,9,mixedType,1
6,3,0,9,mixedType,1
6,3,0,9,mixedType,1
3,7,0,10,mixedType,1
5,1,0,6,mixedType,0
11,1,0,12,mixedType,1
5,1,0,6,mixedType,0
9,1,0,10,mixedType,1
9,2,0,11,mixedType,1
11,3,0,14,mixedType,2
7,2,0,9,mixedType,1
8,2,0,10,mixedType,1
6,2,0,8,mixedType,1
3,8,0,11,mixedType,1
4,4,0,8,mixedType,1
8,1,0,9,mixedType,1
6,2,0,8,mixedType,1
4,4,0,8,mixedType,1
8,2,0,10,mixedType,1
3,6,0,9,mixedType,1
10,6,0,16,mixedType,2
13,3,0,16,mixedType,2
5,3,0,8,mixedType,1
6,2,0,8,mixedType,1
5,4,0,9,mixedType,1
6,1,0,7,mixedType,0
4,2,0,6,mixedType,0
6,4,0,10,mixedType,1
11,1,0,12,mixedType,1
4,4,0,8,mixedType,1
6,3,0,9,mixedType,1
6,4,0,10,mixedType,1
5,4,0,9,mixedType,1
7,3,0,10,mixedType,1
5,3,0,8,mixedType,1
8,5,0,13,mixedType,1
14,2,0,16,mixedType,2
8,3,0,11,mixedType,1
13,3,0,16,mixedType,2
10,6,0,16,mixedType,2
1,9,0,10,mixedType,1
6,3,0,9,mixedType,1
9,2,0,11,mixedType,1
12,3,0,15,mixedType,2
4,4,0,8,mixedType,1
6,4,0,10,mixedType,1
6,4,0,10,mixedType,1
6,3,0,9,mixedType,1
8,1,0,9,mixedType,1
5,3,0,8,mixedType,1
6,1,0,7,mixedType,0
5,8,0,13,mixedType,1
13,3,0,16,mixedType,2
7,1,0,8,mixedType,1
4,2,0,6,mixedType,0
6,1,0,7,mixedType,0
5,2,0,7,mixedType,0
3,6,0,9,mixedType,1
6,2,0,8,mixedType,1
9,4,0,13,mixedType,1
8,2,0,10,mixedType,1
9,3,0,12,mixedType,1
7,2,0,9,mixedType,1
6,3,0,9,mixedType,1
6,3,0,9,mixedType,1
14,2,0,16,mixedType,2
1,8,0,9,mixedType,1
6,1,0,7,mixedType,0
7,1,0,8,mixedType,1
14,2,0,16,mixedType,2
3,6,0,9,mixedType,1
17,1,0,18,mixedType,2
1,9,0,10,mixedType,1
11,1,0,12,mixedType,1
6,1,0,7,mixedType,0
6,3,0,9,mixedType,1
6,4,0,10,mixedType,1
11,2,0,13,mixedType,1
1,8,0,9,mixedType,1
7,4,0,11,mixedType,1
5,4,0,9,mixedType,1
7,3,0,10,mixedType,1
8,2,0,10,mixedType,1
4,4,0,8,mixedType,1
7,2,0,9,mixedType,1
6,3,0,9,mixedType,1
4,2,0,6,mixedType,0
6,3,0,9,mixedType,1
6,4,0,10,mixedType,1
6,3,0,9,mixedType,1
7,1,0,8,mixedType,1
11,1,0,12,mixedType,1
5,8,0,13,mixedType,1
7,1,0,8,mixedType,1
6,3,0,9,mixedType,1
2,8,0,10,mixedType,1
6,1,0,7,mixedType,0
8,3,0,11,mixedType,1
14,2,0,16,mixedType,2
5,2,0,7,mixedType,0
6,3,0,9,mixedType,1
14,2,0,16,mixedType,2
15,1,0,16,mixedType,2
7,2,0,9,mixedType,1
11,1,0,12,mixedType,1
8,4,0,12,mixedType,1
8,2,0,10,mixedType,1
6,3,0,9,mixedType,1
5,4,0,9,mixedType,1
11,3,0,14,mixedType,2
13,3,0,16,mixedType,2
1,7,0,8,mixedType,1
5,4,0,9,mixedType,1
7,6,0,13,mixedType,1
8,1,0,9,mixedType,1
8,2,0,10,mixedType,1
6,1,0,7,mixedType,0
13,3,0,16,mixedType,2
8,2,0,10,mixedType,1
6,3,0,9,mixedType,1
6,2,0,8,mixedType,1
5,2,0,7,mixedType,0
11,5,0,16,mixedType,2
1,7,0,8,mixedType,1
8,2,0,10,mixedType,1
11,2,0,13,mixedType,1
5,3,0,8,mixedType,1
4,2,0,6,mixedType,0
4,2,0,6,mixedType,0
4,4,0,8,mixedType,1
5,4,0,9,mixedType,1
10,2,0,12,mixedType,1
6,4,0,10,mixedType,1
5,3,0,8,mixedType,1
7,1,0,8,mixedType,1
13,3,0,16,mixedType,2
8,1,0,9,mixedType,1
10,2,0,12,mixedType,1
8,4,0,12,mixedType,1
6,4,0,10,mixedType,1
2,6,0,8,mixedType,1
4,2,0,6,mixedType,0
5,2,0,7,mixedType,0
11,3,0,14,mixedType,2
3,6,0,9,mixedType,1
6,4,0,10,mixedType,1
7,3,0,10,mixedType,1
8,1,0,9,mixedType,1
7,2,0,9,mixedType,1
6,4,0,10,mixedType,1
9,1,0,10,mixedType,1
9,2,0,11,mixedType,1
4,4,0,8,mixedType,1
6,2,0,8,mixedType,1
14,2,0,16,mixedType,2
13,3,0,16,mixedType,2
8,2,0,10,mixedType,1
15,1,0,16,mixedType,2
6,4,0,10,mixedType,1
7,3,0,10,mixedType,1
12,3,0,15,mixedType,2
6,2,0,8,mixedType,1
6,2,0,8,mixedType,1
7,2,0,9,mixedType,1
4,2,0,6,mixedType,0
6,3,0,9,mixedType,1
9,2,0,11,mixedType,1
6,2,0,8,mixedType,1
7,4,0,11,mixedType,1
6,4,0,10,mixedType,1
5,2,0,7,mixedType,0
7,2,0,9,mixedType,1
7,1,0,8,mixedType,1
8,1,0,9,mixedType,1
8,2,0,10,mixedType,1
14,2,0,16,mixedType,2
7,3,0,10,mixedType,1
1,8,0,9,mixedType,1
6,2,0,8,mixedType,1
4,6,0,10,mixedType,1
6,1,0,7,mixedType,0
8,1,0,9,mixedType,1
3,10,0,13,mixedType,1
7,3,0,10,mixedType,1
7,3,0,10,mixedType,1
4,2,0,6,mixedType,0
7,2,0,9,mixedType,1
5,2,0,7,mixedType,0
15,1,0,16,mixedType,2
7,2,0,9,mixedType,1
15,1,0,16,mixedType,2
5,3,0,8,mixedType,1
7,3,0,10,mixedType,1
3,7,0,10,mixedType,1
7,2,0,9,mixedType,1
4,4,0,8,mixedType,1
6,3,0,9,mixedType,1
9,1,0,10,mixedType,1
7,6,0,13,mixedType,1
14,2,0,16,mixedType,2
13,3,0,16,mixedType,2
9,3,0,12,mixedType,1
9,0,1,10,mixedType,1
5,3,0,8,mixedType,1
5,4,0,9,mixedType,1
6,0,0,6,sameType,0
6,2,0,8,mixedType,1
2,4,0,6,mixedType,0
5,5,0,10,mixedType,1
6,2,0,8,mixedType,1
5,2,0,7,mixedType,0
5,3,0,8,mixedType,1
5,4,0,9,mixedType,1
7,2,0,9,mixedType,1
12,4,0,16,mixedType,2
7,2,0,9,mixedType,1
6,3,0,9,mixedType,1
6,3,0,9,mixedType,1
5,2,0,7,mixedType,0
9,1,0,10,mixedType,1
11,5,0,16,mixedType,2
5,3,0,8,mixedType,1
7,3,0,10,mixedType,1
4,4,0,8,mixedType,1
7,2,0,9,mixedType,1
8,4,0,12,mixedType,1
14,2,0,16,mixedType,2
7,2,0,9,mixedType,1
3,7,0,10,mixedType,1
13,3,0,16,mixedType,2
7,4,0,11,mixedType,1
8,2,0,10,mixedType,1
6,3,0,9,mixedType,1
8,4,0,12,mixedType,1
7,6,0,13,mixedType,1
5,4,0,9,mixedType,1
8,2,0,10,mixedType,1
7,4,0,11,mixedType,1
9,1,0,10,mixedType,1
6,3,0,9,mixedType,1
5,2,0,7,mixedType,0
11,3,0,14,mixedType,2
7,3,0,10,mixedType,1
8,2,0,10,mixedType,1
8,2,0,10,mixedType,1
6,3,0,9,mixedType,1
8,2,0,10,mixedType,1
4,2,0,6,mixedType,0
8,2,0,10,mixedType,1
6,1,0,7,mixedType,0
6,1,0,7,mixedType,0
8,3,0,11,mixedType,1
7,2,0,9,mixedType,1
6,3,0,9,mixedType,1
8,1,0,9,mixedType,1
6,3,0,9,mixedType,1
4,2,0,6,mixedType,0
4,4,0,8,mixedType,1
6,3,0,9,mixedType,1
6,1,0,7,mixedType,0
5,5,0,10,mixedType,1
5,1,0,6,mixedType,0
6,1,0,7,mixedType,0
4,6,0,10,mixedType,1
1,8,0,9,mixedType,1
14,2,0,16,mixedType,2
5,6,0,11,mixedType,1
4,2,0,6,mixedType,0
8,2,0,10,mixedType,1
4,2,0,6,mixedType,0
8,4,0,12,mixedType,1
4,7,0,11,mixedType,1
7,2,0,9,mixedType,1
5,3,0,8,mixedType,1
7,2,0,9,mixedType,1
8,2,0,10,mixedType,1
3,6,0,9,mixedType,1
6,3,0,9,mixedType,1
6,4,0,10,mixedType,1
8,2,0,10,mixedType,1
1,7,0,8,mixedType,1
5,4,0,9,mixedType,1
12,1,0,13,mixedType,1
11,3,0,14,mixedType,2
4,4,0,8,mixedType,1
8,2,0,10,mixedType,1
6,5,0,11,mixedType,1
13,3,0,16,mixedType,2
6,4,0,10,mixedType,1
8,3,0,11,mixedType,1
6,3,0,9,mixedType,1
7,3,0,10,mixedType,1
5,1,0,6,mixedType,0
5,1,0,6,mixedType,0
9,3,0,12,mixedType,1
12,4,0,16,mixedType,2
5,2,0,7,mixedType,0
1,7,0,8,mixedType,1
13,3,0,16,mixedType,2
5,1,0,6,mixedType,0
6,4,0,10,mixedType,1
6,3,0,9,mixedType,1
13,3,0,16,mixedType,2
6,2,0,8,mixedType,1
15,1,0,16,mixedType,2
7,2,0,9,mixedType,1
4,8,0,12,mixedType,1
6,2,0,8,mixedType,1
10,1,0,11,mixedType,1
5,3,0,8,mixedType,1
2,9,0,11,mixedType,1
5,2,0,7,mixedType,0
8,2,0,10,mixedType,1
3,8,0,11,mixedType,1
9,1,0,10,mixedType,1
6,4,0,10,mixedType,1
6,4,0,10,mixedType,1
6,5,0,11,mixedType,1
8,2,0,10,mixedType,1
7,4,0,11,mixedType,1
8,2,0,10,mixedType,1
8,1,0,9,mixedType,1
6,3,0,9,mixedType,1
5,3,0,8,mixedType,1
15,1,0,16,mixedType,2
7,3,0,10,mixedType,1
6,4,0,10,mixedType,1
10,2,0,12,mixedType,1
5,3,0,8,mixedType,1
4,2,0,6,mixedType,0
8,4,0,12,mixedType,1
5,2,0,7,mixedType,0
8,2,0,10,mixedType,1
6,1,0,7,mixedType,0
3,3,0,6,mixedType,0
5,4,0,9,mixedType,1
6,3,0,9,mixedType,1
5,3,0,8,mixedType,1
14,2,0,16,mixedType,2
7,1,0,8,mixedType,1
8,1,0,9,mixedType,1
9,3,0,12,mixedType,1
8,3,0,11,mixedType,1
7,3,0,10,mixedType,1
6,3,0,9,mixedType,1
7,1,0,8,mixedType,1
10,2,0,12,mixedType,1
8,3,0,11,mixedType,1
4,4,0,8,mixedType,1
6,3,0,9,mixedType,1
5,3,0,8,mixedType,1
12,3,0,15,mixedType,2
6,3,0,9,mixedType,1
6,3,0,9,mixedType,1
10,2,0,12,mixedType,1
6,1,0,7,mixedType,0
1,9,0,10,mixedType,1
8,1,0,9,mixedType,1
6,2,0,8,mixedType,1
7,1,0,8,mixedType,1
5,3,0,8,mixedType,1
7,3,0,10,mixedType,1
7,3,0,10,mixedType,1
10,0,1,11,mixedType,1
7,1,0,8,mixedType,1
8,2,0,10,mixedType,1
6,4,0,10,mixedType,1
4,6,0,10,mixedType,1
4,2,0,6,mixedType,0
8,3,0,11,mixedType,1
8,2,0,10,mixedType,1
6,1,0,7,mixedType,0
3,6,0,9,mixedType,1
7,1,0,8,mixedType,1
8,1,0,9,mixedType,1
6,3,0,9,mixedType,1
14,2,0,16,mixedType,2
7,2,0,9,mixedType,1
1,8,0,9,mixedType,1
13,3,0,16,mixedType,2
1,8,0,9,mixedType,1
6,3,0,9,mixedType,1
5,3,0,8,mixedType,1
4,6,0,10,mixedType,1
4,6,0,10,mixedType,1
8,1,0,9,mixedType,1
4,4,0,8,mixedType,1
8,1,0,9,mixedType,1
3,9,0,12,mixedType,1
7,3,0,10,mixedType,1
11,2,0,13,mixedType,1
5,2,0,7,mixedType,0
7,3,0,10,mixedType,1
3,6,0,9,mixedType,1
5,6,0,11,mixedType,1
7,4,0,11,mixedType,1
6,3,0,9,mixedType,1
15,1,0,16,mixedType,2
7,3,0,10,mixedType,1
5,2,0,7,mixedType,0
8,3,0,11,mixedType,1
7,6,0,13,mixedType,1
8,1,0,9,mixedType,1
1,10,0,11,mixedType,1
3,3,0,6,mixedType,0
1,8,0,9,mixedType,1
2,8,0,10,mixedType,1
2,6,0,8,mixedType,1
7,3,0,10,mixedType,1
7,2,0,9,mixedType,1
11,5,0,16,mixedType,2
8,1,0,9,mixedType,1
5,3,0,8,mixedType,1
14,2,0,16,mixedType,2
8,4,0,12,mixedType,1
7,2,0,9,mixedType,1
1,10,0,11,mixedType,1
6,3,0,9,mixedType,1
7,1,0,8,mixedType,1
9,1,0,10,mixedType,1
5,1,0,6,mixedType,0
9,3,0,12,mixedType,1
3,6,0,9,mixedType,1
6,1,0,7,mixedType,0
6,3,0,9,mixedType,1
2,4,0,6,mixedType,0
8,1,0,9,mixedType,1
5,3,0,8,mixedType,1
9,1,0,10,mixedType,1
8,1,0,9,mixedType,1
6,3,0,9,mixedType,1
6,1,0,7,mixedType,0
6,2,0,8,mixedType,1
8,1,0,9,mixedType,1
13,1,1,15,mixedType,2
7,3,0,10,mixedType,1
10,3,0,13,mixedType,1
10,2,0,12,mixedType,1
9,3,0,12,mixedType,1
7,2,0,9,mixedType,1
8,1,0,9,mixedType,1
6,1,0,7,mixedType,0
7,6,0,13,mixedType,1
2,6,0,8,mixedType,1
8,4,0,12,mixedType,1
6,5,0,11,mixedType,1
8,3,0,11,mixedType,1
6,2,0,8,mixedType,1
5,3,0,8,mixedType,1
7,4,0,11,mixedType,1
6,1,0,7,mixedType,0
5,2,0,7,mixedType,0
9,1,0,10,mixedType,1
10,3,0,13,mixedType,1
6,3,0,9,mixedType,1
5,2,0,7,mixedType,0
3,9,0,12,mixedType,1
5,5,0,10,mixedType,1
6,3,0,9,mixedType,1
12,4,0,16,mixedType,2
5,2,0,7,mixedType,0
7,3,0,10,mixedType,1
9,3,0,12,mixedType,1
9,3,0,12,mixedType,1
6,2,0,8,mixedType,1
5,4,0,9,mixedType,1
10,2,0,12,mixedType,1
5,2,0,7,mixedType,0
6,3,0,9,mixedType,1
11,5,0,16,mixedType,2
7,3,0,10,mixedType,1
5,4,0,9,mixedType,1
8,1,0,9,mixedType,1
8,2,0,10,mixedType,1
11,1,0,12,mixedType,1
7,2,0,9,mixedType,1
15,1,1,17,mixedType,2
5,4,0,9,mixedType,1
8,2,0,10,mixedType,1
14,2,0,16,mixedType,2
6,2,0,8,mixedType,1
10,2,0,12,mixedType,1
10,5,1,16,mixedType,2
4,2,0,6,mixedType,0
9,4,0,13,mixedType,1
7,1,0,8,mixedType,1
8,1,0,9,mixedType,1
6,3,0,9,mixedType,1
8,3,0,11,mixedType,1
7,2,0,9,mixedType,1
6,3,0,9,mixedType,1
6,1,0,7,mixedType,0
6,4,0,10,mixedType,1
6,2,0,8,mixedType,1
6,4,0,10,mixedType,1
7,2,0,9,mixedType,1
3,8,0,11,mixedType,1
14,2,0,16,mixedType,2
8,1,0,9,mixedType,1
1,8,0,9,mixedType,1
5,8,0,13,mixedType,1
7,3,0,10,mixedType,1
11,3,0,14,mixedType,2
7,3,0,10,mixedType,1
6,4,0,10,mixedType,1
6,3,0,9,mixedType,1
14,2,0,16,mixedType,2
9,1,0,10,mixedType,1
7,2,0,9,mixedType,1
7,2,0,9,mixedType,1
11,3,0,14,mixedType,2
9,4,0,13,mixedType,1
7,3,0,10,mixedType,1
10,3,0,13,mixedType,1
4,4,0,8,mixedType,1
8,1,0,9,mixedType,1
12,3,0,15,mixedType,2
8,1,0,9,mixedType,1
7,1,0,8,mixedType,1
1,9,0,10,mixedType,1
2,6,0,8,mixedType,1
9,1,0,10,mixedType,1
2,10,0,12,mixedType,1
6,2,0,8,mixedType,1
6,3,0,9,mixedType,1
1,10,0,11,mixedType,1
4,4,0,8,mixedType,1
7,3,0,10,mixedType,1
9,4,0,13,mixedType,1
14,2,0,16,mixedType,2
7,3,0,10,mixedType,1
13,3,0,16,mixedType,2
7,2,0,9,mixedType,1
6,3,0,9,mixedType,1
6,4,0,10,mixedType,1
7,1,0,8,mixedType,1
9,3,0,12,mixedType,1
3,6,0,9,mixedType,1
1,9,0,10,mixedType,1
12,3,0,15,mixedType,2
7,0,1,8,mixedType,1
7,4,0,11,mixedType,1
6,2,0,8,mixedType,1
6,3,0,9,mixedType,1
15,1,0,16,mixedType,2
4,2,0,6,mixedType,0
5,4,0,9,mixedType,1
7,1,0,8,mixedType,1
6,4,0,10,mixedType,1
12,4,0,16,mixedType,2
7,3,0,10,mixedType,1
4,2,0,6,mixedType,0
10,1,0,11,mixedType,1
8,4,0,12,mixedType,1
4,4,0,8,mixedType,1
11,1,0,12,mixedType,1
8,2,0,10,mixedType,1
6,1,0,7,mixedType,0
6,2,0,8,mixedType,1
5,2,0,7,mixedType,0
14,2,0,16,mixedType,2
10,1,0,11,mixedType,1
6,1,0,7,mixedType,0
6,2,0,8,mixedType,1
11,3,0,14,mixedType,2
5,3,0,8,mixedType,1
7,2,0,9,mixedType,1
8,4,0,12,mixedType,1
8,2,0,10,mixedType,1
8,2,0,10,mixedType,1
7,3,0,10,mixedType,1
5,4,0,9,mixedType,1
4,4,0,8,mixedType,1
2,9,0,11,mixedType,1
7,2,0,9,mixedType,1
13,3,0,16,mixedType,2
8,1,0,9,mixedType,1
5,3,0,8,mixedType,1
5,4,0,9,mixedType,1
7,1,0,8,mixedType,1
5,2,0,7,mixedType,0
5,3,0,8,mixedType,1
3,3,0,6,mixedType,0
5,3,0,8,mixedType,1
7,1,0,8,mixedType,1
3,10,0,13,mixedType,1
13,3,0,16,mixedType,2
7,3,0,10,mixedType,1
5,2,0,7,mixedType,0
6,2,0,8,mixedType,1
7,3,0,10,mixedType,1
4,4,0,8,mixedType,1
3,6,0,9,mixedType,1
8,2,0,10,mixedType,1
5,2,0,7,mixedType,0
6,1,0,7,mixedType,0
7,2,0,9,mixedType,1
9,3,0,12,mixedType,1
7,3,0,10,mixedType,1
8,2,0,10,mixedType,1
5,3,0,8,mixedType,1
8,2,0,10,mixedType,1
5,6,0,11,mixedType,1
4,6,0,10,mixedType,1
13,3,0,16,mixedType,2
7,2,0,9,mixedType,1
7,3,0,10,mixedType,1
9,1,0,10,mixedType,1
5,2,0,7,mixedType,0
7,3,0,10,mixedType,1
6,1,0,7,mixedType,0
14,2,0,16,mixedType,2
8,3,0,11,mixedType,1
7,4,0,11,mixedType,1
5,1,0,6,mixedType,0
7,2,0,9,mixedType,1
7,3,0,10,mixedType,1
4,4,0,8,mixedType,1
5,1,0,6,mixedType,0
3,3,0,6,mixedType,0
9,1,0,10,mixedType,1
4,4,0,8,mixedType,1
6,2,0,8,mixedType,1
7,1,0,8,mixedType,1
4,5,0,9,mixedType,1
7,1,0,8,mixedType,1
15,3,0,18,mixedType,2
8,4,0,12,mixedType,1
7,2,0,9,mixedType,1
9,3,0,12,mixedType,1
10,1,0,11,mixedType,1
6,4,0,10,mixedType,1
6,2,0,8,mixedType,1
7,1,0,8,mixedType,1
8,1,0,9,mixedType,1
7,3,0,10,mixedType,1
6,2,0,8,mixedType,1
5,4,0,9,mixedType,1
3,5,0,8,mixedType,1
7,3,0,10,mixedType,1
6,4,0,10,mixedType,1
2,6,0,8,mixedType,1
6,1,0,7,mixedType,0
8,1,0,9,mixedType,1
5,2,0,7,mixedType,0
6,4,0,10,mixedType,1
7,3,0,10,mixedType,1
7,2,0,9,mixedType,1
7,2,0,9,mixedType,1
12,3,0,15,mixedType,2
5,2,0,7,mixedType,0
8,2,0,10,mixedType,1
4,4,0,8,mixedType,1
3,9,0,12,mixedType,1
9,1,0,10,mixedType,1
7,4,0,11,mixedType,1
6,3,0,9,mixedType,1
7,2,0,9,mixedType,1
4,4,0,8,mixedType,1
7,4,0,11,mixedType,1
5,1,0,6,mixedType,0
15,1,0,16,mixedType,2
1,8,0,9,mixedType,1
7,6,0,13,mixedType,1
8,2,0,10,mixedType,1
9,1,0,10,mixedType,1
6,2,0,8,mixedType,1
6,1,0,7,mixedType,0
5,4,0,9,mixedType,1
7,1,0,8,mixedType,1
5,8,0,13,mixedType,1
6,1,0,7,mixedType,0
7,1,0,8,mixedType,1
4,4,0,8,mixedType,1
4,4,0,8,mixedType,1
4,2,0,6,mixedType,0
6,1,0,7,mixedType,0
4,4,0,8,mixedType,1
8,2,0,10,mixedType,1
8,2,0,10,mixedType,1
6,4,0,10,mixedType,1
7,2,0,9,mixedType,1
6,4,0,10,mixedType,1
8,1,0,9,mixedType,1
3,5,0,8,mixedType,1
8,2,0,10,mixedType,1
6,1,0,7,mixedType,0
12,3,0,15,mixedType,2
15,1,0,16,mixedType,2
6,1,0,7,mixedType,0
7,1,0,8,mixedType,1
4,6,0,10,mixedType,1
4,4,0,8,mixedType,1
8,2,0,10,mixedType,1
4,4,0,8,mixedType,1
16,3,0,19,mixedType,2
5,8,0,13,mixedType,1
3,6,0,9,mixedType,1
3,5,0,8,mixedType,1
10,1,0,11,mixedType,1
13,3,0,16,mixedType,2
4,4,0,8,mixedType,1
7,3,0,10,mixedType,1
7,2,0,9,mixedType,1
4,2,0,6,mixedType,0
1,10,0,11,mixedType,1
4,4,0,8,mixedType,1
5,3,0,8,mixedType,1
6,4,0,10,mixedType,1
11,3,0,14,mixedType,2
7,2,0,9,mixedType,1
12,3,0,15,mixedType,2
5,2,0,7,mixedType,0
13,3,0,16,mixedType,2
6,4,0,10,mixedType,1
9,2,0,11,mixedType,1
8,3,0,11,mixedType,1
6,5,0,11,mixedType,1
9,2,0,11,mixedType,1
5,6,0,11,mixedType,1
3,10,0,13,mixedType,1
7,1,0,8,mixedType,1
0,2,0,2,sameType,0
4,6,0,10,mixedType,1
3,10,0,13,mixedType,1
8,2,0,10,mixedType,1
15,1,0,16,mixedType,2
12,1,0,13,mixedType,1
15,1,0,16,mixedType,2
15,1,0,16,mixedType,2
5,2,0,7,mixedType,0
6,3,0,9,mixedType,1
4,4,0,8,mixedType,1
14,2,1,17,mixedType,2
9,1,0,10,mixedType,1
14,2,0,16,mixedType,2
7,4,0,11,mixedType,1
7,3,0,10,mixedType,1
5,3,0,8,mixedType,1
5,3,0,8,mixedType,1
9,2,0,11,mixedType,1
7,1,0,8,mixedType,1
5,2,0,7,mixedType,0
6,4,0,10,mixedType,1
5,2,0,7,mixedType,0
4,2,0,6,mixedType,0
9,2,0,11,mixedType,1
6,2,0,8,mixedType,1
10,2,0,12,mixedType,1
8,2,0,10,mixedType,1
13,3,0,16,mixedType,2
13,3,0,16,mixedType,2
3,6,0,9,mixedType,1
6,1,0,7,mixedType,0
3,5,0,8,mixedType,1
7,3,0,10,mixedType,1
2,8,0,10,mixedType,1
7,3,0,10,mixedType,1
3,3,0,6,mixedType,0
6,2,0,8,mixedType,1
3,3,0,6,mixedType,0
6,3,0,9,mixedType,1
4,6,0,10,mixedType,1
9,2,0,11,mixedType,1
5,2,0,7,mixedType,0
8,1,0,9,mixedType,1
2,6,0,8,mixedType,1
7,2,0,9,mixedType,1
8,1,0,9,mixedType,1
4,8,0,12,mixedType,1
5,2,0,7,mixedType,0
5,3,0,8,mixedType,1
6,2,0,8,mixedType,1
8,1,0,9,mixedType,1
5,4,0,9,mixedType,1
7,2,0,9,mixedType,1
5,4,0,9,mixedType,1
5,1,0,6,mixedType,0
5,6,0,11,mixedType,1
1,8,0,9,mixedType,1
14,2,0,16,mixedType,2
6,2,0,8,mixedType,1
5,1,0,6,mixedType,0
12,4,0,16,mixedType,2
4,4,0,8,mixedType,1
8,1,0,9,mixedType,1
5,1,0,6,mixedType,0
2,6,0,8,mixedType,1
6,1,0,7,mixedType,0
12,4,0,16,mixedType,2
3,6,0,9,mixedType,1
1,8,0,9,mixedType,1
5,7,0,12,mixedType,1
5,1,0,6,mixedType,0
4,2,0,6,mixedType,0
8,2,0,10,mixedType,1
9,1,0,10,mixedType,1
5,2,0,7,mixedType,0
15,1,0,16,mixedType,2
6,1,0,7,mixedType,0
12,3,0,15,mixedType,2
7,2,0,9,mixedType,1
5,5,0,10,mixedType,1
3,5,0,8,mixedType,1
2,6,0,8,mixedType,1
8,2,0,10,mixedType,1
6,3,0,9,mixedType,1
7,1,0,8,mixedType,1
6,3,0,9,mixedType,1
4,5,0,9,mixedType,1
0,7,1,8,mixedType,1
5,2,0,7,mixedType,0
1,9,0,10,mixedType,1
5,3,0,8,mixedType,1
10,1,0,11,mixedType,1
13,3,0,16,mixedType,2
8,2,0,10,mixedType,1
6,3,0,9,mixedType,1
6,2,0,8,mixedType,1
8,1,0,9,mixedType,1
5,3,0,8,mixedType,1
7,3,0,10,mixedType,1
6,1,0,7,mixedType,0
6,6,0,12,mixedType,1
3,6,0,9,mixedType,1
17,6,2,25,mixedType,2
3,6,0,9,mixedType,1
4,4,0,8,mixedType,1
7,3,0,10,mixedType,1
3,11,0,14,mixedType,2
7,6,0,13,mixedType,1
6,2,0,8,mixedType,1
8,4,0,12,mixedType,1
2,8,0,10,mixedType,1
7,3,0,10,mixedType,1
4,4,0,8,mixedType,1
4,4,0,8,mixedType,1
5,2,0,7,mixedType,0
8,6,0,14,mixedType,2
2,9,0,11,mixedType,1
2,6,0,8,mixedType,1
7,1,0,8,mixedType,1
12,3,0,15,mixedType,2
5,2,0,7,mixedType,0
9,1,0,10,mixedType,1
12,4,0,16,mixedType,2
4,4,0,8,mixedType,1
9,4,0,13,mixedType,1
2,6,0,8,mixedType,1
12,3,1,16,mixedType,2
11,3,0,14,mixedType,2
6,2,0,8,mixedType,1
10,1,0,11,mixedType,1
7,3,0,10,mixedType,1
3,5,0,8,mixedType,1
2,6,0,8,mixedType,1
12,3,0,15,mixedType,2
7,4,0,11,mixedType,1
3,8,0,11,mixedType,1
14,2,0,16,mixedType,2
14,2,0,16,mixedType,2
7,2,0,9,mixedType,1
1,7,0,8,mixedType,1
6,3,0,9,mixedType,1
7,3,0,10,mixedType,1
6,1,0,7,mixedType,0
6,1,0,7,mixedType,0
8,1,0,9,mixedType,1
7,3,0,10,mixedType,1
8,1,0,9,mixedType,1
7,2,0,9,mixedType,1
6,3,0,9,mixedType,1
8,2,0,10,mixedType,1
6,3,0,9,mixedType,1
7,3,0,10,mixedType,1
7,2,0,9,mixedType,1
6,2,0,8,mixedType,1
10,4,0,14,mixedType,2
2,7,0,9,mixedType,1
7,1,0,8,mixedType,1
8,1,0,9,mixedType,1
3,5,0,8,mixedType,1
6,2,0,8,mixedType,1
9,2,0,11,mixedType,1
5,1,0,6,mixedType,0
14,2,0,16,mixedType,2
8,1,0,9,mixedType,1
6,2,0,8,mixedType,1
6,3,0,9,mixedType,1
8,2,0,10,mixedType,1
11,4,0,15,mixedType,2
8,4,0,12,mixedType,1
5,3,0,8,mixedType,1
5,1,0,6,mixedType,0
5,7,0,12,mixedType,1
4,4,0,8,mixedType,1
9,1,0,10,mixedType,1
5,4,0,9,mixedType,1
4,4,0,8,mixedType,1
11,5,0,16,mixedType,2
6,2,0,8,mixedType,1
6,3,0,9,mixedType,1
8,2,0,10,mixedType,1
7,2,0,9,mixedType,1
8,3,0,11,mixedType,1
5,1,0,6,mixedType,0
8,2,0,10,mixedType,1
11,5,0,16,mixedType,2
13,3,0,16,mixedType,2
9,1,0,10,mixedType,1
26,4,0,30,mixedType,2
12,4,0,16,mixedType,2
4,2,0,6,mixedType,0
4,2,0,6,mixedType,0
8,1,0,9,mixedType,1
14,2,0,16,mixedType,2
8,3,0,11,mixedType,1
7,2,0,9,mixedType,1
5,4,0,9,mixedType,1
9,4,0,13,mixedType,1
4,4,0,8,mixedType,1
5,3,0,8,mixedType,1
1,9,0,10,mixedType,1
7,2,0,9,mixedType,1
3,7,0,10,mixedType,1
9,1,0,10,mixedType,1
4,4,0,8,mixedType,1
12,4,0,16,mixedType,2
5,3,0,8,mixedType,1
6,4,0,10,mixedType,1
8,4,0,12,mixedType,1
3,6,0,9,mixedType,1
2,10,0,12,mixedType,1
7,4,0,11,mixedType,1
8,3,0,11,mixedType,1
7,3,0,10,mixedType,1
13,3,0,16,mixedType,2
15,1,0,16,mixedType,2
8,2,0,10,mixedType,1
6,4,0,10,mixedType,1
2,4,0,6,mixedType,0
3,8,0,11,mixedType,1
8,1,0,9,mixedType,1
15,1,0,16,mixedType,2
7,4,0,11,mixedType,1
6,2,0,8,mixedType,1
5,2,0,7,mixedType,0
5,3,0,8,mixedType,1
5,2,0,7,mixedType,0
5,8,0,13,mixedType,1
6,1,0,7,mixedType,0
6,5,0,11,mixedType,1
4,5,0,9,mixedType,1
5,3,0,8,mixedType,1
9,4,0,13,mixedType,1
9,4,0,13,mixedType,1
5,3,0,8,mixedType,1
8,4,0,12,mixedType,1
8,2,0,10,mixedType,1
5,4,0,9,mixedType,1
9,0,1,10,mixedType,1
7,5,0,12,mixedType,1
9,1,0,10,mixedType,1
6,3,0,9,mixedType,1
7,3,0,10,mixedType,1
5,3,0,8,mixedType,1
5,2,0,7,mixedType,0
8,2,0,10,mixedType,1
6,2,0,8,mixedType,1
7,3,0,10,mixedType,1
12,3,0,15,mixedType,2
5,3,0,8,mixedType,1
5,3,0,8,mixedType,1
7,3,0,10,mixedType,1
6,1,0,7,mixedType,0
7,2,0,9,mixedType,1
5,4,0,9,mixedType,1
6,3,0,9,mixedType,1
5,2,0,7,mixedType,0
7,1,0,8,mixedType,1
4,4,0,8,mixedType,1
9,1,0,10,mixedType,1
8,3,0,11,mixedType,1
11,3,0,14,mixedType,2
6,3,0,9,mixedType,1
5,2,0,7,mixedType,0
7,2,0,9,mixedType,1
2,6,0,8,mixedType,1
9,1,0,10,mixedType,1
9,2,0,11,mixedType,1
6,1,0,7,mixedType,0
6,3,0,9,mixedType,1
6,4,0,10,mixedType,1
6,3,0,9,mixedType,1
7,4,0,11,mixedType,1
7,3,0,10,mixedType,1
8,2,0,10,mixedType,1
7,1,0,8,mixedType,1
5,4,0,9,mixedType,1
7,1,0,8,mixedType,1
6,3,0,9,mixedType,1
15,1,0,16,mixedType,2
6,2,0,8,mixedType,1
6,2,0,8,mixedType,1
4,6,0,10,mixedType,1
5,6,0,11,mixedType,1
7,1,0,8,mixedType,1
3,7,0,10,mixedType,1
5,1,0,6,mixedType,0
5,3,0,8,mixedType,1
9,1,0,10,mixedType,1
6,3,0,9,mixedType,1
4,4,0,8,mixedType,1
8,2,0,10,mixedType,1
6,1,0,7,mixedType,0
9,1,0,10,mixedType,1
5,9,2,16,mixedType,2
1,8,0,9,mixedType,1
8,1,0,9,mixedType,1
8,2,0,10,mixedType,1
9,1,0,10,mixedType,1
11,2,0,13,mixedType,1
11,2,0,13,mixedType,1
9,2,0,11,mixedType,1
3,3,0,6,mixedType,0
3,5,0,8,mixedType,1
8,2,0,10,mixedType,1
6,1,0,7,mixedType,0
15,1,0,16,mixedType,2
4,2,0,6,mixedType,0
5,2,0,7,mixedType,0
8,2,0,10,mixedType,1
6,1,0,7,mixedType,0
6,3,0,9,mixedType,1
5,2,0,7,mixedType,0
1,8,0,9,mixedType,1
5,4,0,9,mixedType,1
11,2,0,13,mixedType,1
6,4,0,10,mixedType,1
5,1,0,6,mixedType,0
14,3,2,19,mixedType,2
4,7,0,11,mixedType,1
6,4,0,10,mixedType,1
14,2,0,16,mixedType,2
9,1,0,10,mixedType,1
7,2,0,9,mixedType,1
8,2,0,10,mixedType,1
5,3,0,8,mixedType,1
6,1,0,7,mixedType,0
6,4,0,10,mixedType,1
6,2,0,8,mixedType,1
6,2,0,8,mixedType,1
14,4,0,18,mixedType,2
6,4,0,10,mixedType,1
6,3,0,9,mixedType,1
4,4,0,8,mixedType,1
9,1,0,10,mixedType,1
2,4,0,6,mixedType,0
8,2,0,10,mixedType,1
7,2,0,9,mixedType,1
3,6,0,9,mixedType,1
9,1,0,10,mixedType,1
5,4,0,9,mixedType,1
14,2,0,16,mixedType,2
14,2,0,16,mixedType,2
7,3,0,10,mixedType,1
4,2,0,6,mixedType,0
7,3,0,10,mixedType,1
6,4,0,10,mixedType,1
5,2,0,7,mixedType,0
15,1,0,16,mixedType,2
4,9,0,13,mixedType,1
4,4,0,8,mixedType,1
8,4,0,12,mixedType,1
13,3,0,16,mixedType,2
6,3,0,9,mixedType,1
1,11,0,12,mixedType,1
6,4,0,10,mixedType,1
3,6,0,9,mixedType,1
9,1,0,10,mixedType,1
5,2,0,7,mixedType,0
6,3,0,9,mixedType,1
6,3,0,9,mixedType,1
7,3,0,10,mixedType,1
9,1,0,10,mixedType,1
7,1,0,8,mixedType,1
8,2,0,10,mixedType,1
6,3,0,9,mixedType,1
5,2,0,7,mixedType,0
1,8,0,9,mixedType,1
5,4,0,9,mixedType,1
5,2,0,7,mixedType,0
4,4,0,8,mixedType,1
8,1,0,9,mixedType,1
8,3,0,11,mixedType,1
10,3,0,13,mixedType,1
5,2,0,7,mixedType,0
6,2,0,8,mixedType,1
2,8,0,10,mixedType,1
3,7,0,10,mixedType,1
6,3,0,9,mixedType,1
7,6,0,13,mixedType,1
6,3,0,9,mixedType,1
2,6,0,8,mixedType,1
8,1,0,9,mixedType,1
6,1,0,7,mixedType,0
7,6,0,13,mixedType,1
6,4,0,10,mixedType,1
13,3,0,16,mixedType,2
15,1,0,16,mixedType,2
3,6,0,9,mixedType,1
6,3,0,9,mixedType,1
7,3,0,10,mixedType,1
6,2,0,8,mixedType,1
11,5,0,16,mixedType,2
5,1,0,6,mixedType,0
8,2,0,10,mixedType,1
5,2,0,7,mixedType,0
7,1,0,8,mixedType,1
9,3,0,12,mixedType,1
8,2,0,10,mixedType,1
6,1,0,7,mixedType,0
9,1,0,10,mixedType,1
7,5,0,12,mixedType,1
7,3,0,10,mixedType,1
7,1,0,8,mixedType,1
5,1,0,6,mixedType,0
2,6,0,8,mixedType,1
8,2,0,10,mixedType,1
6,3,0,9,mixedType,1
8,1,0,9,mixedType,1
9,4,0,13,mixedType,1
11,3,0,14,mixedType,2
6,4,0,10,mixedType,1
11,5,0,16,mixedType,2
5,3,0,8,mixedType,1
14,4,2,20,mixedType,2
9,4,1,14,mixedType,2
11,2,0,13,mixedType,1
6,3,0,9,mixedType,1
3,5,0,8,mixedType,1
15,1,0,16,mixedType,2
5,6,0,11,mixedType,1
7,2,0,9,mixedType,1
2,7,0,9,mixedType,1
6,2,0,8,mixedType,1
7,2,0,9,mixedType,1
6,2,0,8,mixedType,1
6,2,0,8,mixedType,1
6,3,0,9,mixedType,1
4,2,0,6,mixedType,0
4,6,0,10,mixedType,1
6,4,0,10,mixedType,1
5,2,0,7,mixedType,0
7,2,0,9,mixedType,1
3,7,0,10,mixedType,1
8,1,0,9,mixedType,1
6,1,0,7,mixedType,0
7,3,0,10,mixedType,1
6,3,0,9,mixedType,1
6,3,0,9,mixedType,1
2,8,0,10,mixedType,1
3,8,0,11,mixedType,1
8,2,0,10,mixedType,1
9,3,0,12,mixedType,1
15,1,0,16,mixedType,2
8,3,0,11,mixedType,1
0,10,1,11,mixedType,1
11,5,0,16,mixedType,2
2,8,0,10,mixedType,1
8,1,0,9,mixedType,1
12,3,0,15,mixedType,2
8,1,0,9,mixedType,1
2,4,0,6,mixedType,0
6,6,0,12,mixedType,1
6,4,0,10,mixedType,1
9,1,0,10,mixedType,1
7,6,1,14,mixedType,2
6,4,0,10,mixedType,1
6,2,0,8,mixedType,1
10,1,0,11,mixedType,1
5,6,0,11,mixedType,1
6,2,0,8,mixedType,1
5,3,0,8,mixedType,1
5,5,0,10,mixedType,1
6,1,0,7,mixedType,0
5,3,0,8,mixedType,1
6,6,0,12,mixedType,1
7,2,0,9,mixedType,1
4,6,0,10,mixedType,1
4,5,0,9,mixedType,1
6,3,0,9,mixedType,1
6,1,0,7,mixedType,0
3,7,0,10,mixedType,1
5,7,0,12,mixedType,1
6,4,0,10,mixedType,1
10,3,0,13,mixedType,1
6,4,0,10,mixedType,1
8,4,0,12,mixedType,1
7,2,0,9,mixedType,1
4,4,0,8,mixedType,1
5,4,0,9,mixedType,1
6,4,0,10,mixedType,1
2,7,0,9,mixedType,1
6,5,0,11,mixedType,1
9,2,0,11,mixedType,1
7,3,0,10,mixedType,1
6,3,0,9,mixedType,1
8,2,0,10,mixedType,1
10,6,0,16,mixedType,2
4,8,0,12,mixedType,1
6,2,0,8,mixedType,1
14,2,0,16,mixedType,2
5,1,0,6,mixedType,0
6,4,0,10,mixedType,1
5,3,0,8,mixedType,1
5,8,0,13,mixedType,1
9,1,0,10,mixedType,1
2,4,0,6,mixedType,0
6,4,0,10,mixedType,1
7,1,0,8,mixedType,1
6,6,0,12,mixedType,1
8,2,0,10,mixedType,1
5,8,0,13,mixedType,1
2,4,0,6,mixedType,0
7,1,0,8,mixedType,1
13,3,0,16,mixedType,2
6,1,0,7,mixedType,0
10,2,0,12,mixedType,1
5,5,0,10,mixedType,1
5,2,0,7,mixedType,0
6,2,0,8,mixedType,1
6,2,0,8,mixedType,1
7,1,0,8,mixedType,1
3,8,0,11,mixedType,1
6,4,0,10,mixedType,1
6,1,0,7,mixedType,0
7,3,0,10,mixedType,1
1,8,0,9,mixedType,1
7,1,0,8,mixedType,1
14,2,0,16,mixedType,2
6,7,0,13,mixedType,1
7,1,0,8,mixedType,1
7,3,0,10,mixedType,1
2,5,0,7,mixedType,0
5,4,0,9,mixedType,1
5,3,0,8,mixedType,1
7,2,0,9,mixedType,1
5,3,0,8,mixedType,1
15,1,0,16,mixedType,2
5,2,0,7,mixedType,0
1,8,0,9,mixedType,1
6,3,0,9,mixedType,1
7,3,0,10,mixedType,1
8,3,0,11,mixedType,1
6,2,0,8,mixedType,1
9,1,0,10,mixedType,1
6,3,0,9,mixedType,1
6,3,0,9,mixedType,1
12,3,1,16,mixedType,2
15,1,0,16,mixedType,2
9,2,0,11,mixedType,1
5,4,0,9,mixedType,1
8,2,0,10,mixedType,1
6,3,0,9,mixedType,1
6,1,0,7,mixedType,0
6,1,0,7,mixedType,0
6,3,0,9,mixedType,1
7,6,0,13,mixedType,1
6,1,0,7,mixedType,0
8,2,0,10,mixedType,1
1,9,0,10,mixedType,1
4,4,0,8,mixedType,1
5,3,0,8,mixedType,1
12,4,1,17,mixedType,2
4,10,0,14,mixedType,2
15,1,0,16,mixedType,2
5,3,0,8,mixedType,1
4,6,0,10,mixedType,1
4,2,0,6,mixedType,0
6,4,0,10,mixedType,1
1,7,0,8,mixedType,1
4,2,0,6,mixedType,0
8,4,0,12,mixedType,1
4,6,0,10,mixedType,1
13,3,0,16,mixedType,2
5,3,0,8,mixedType,1
11,3,0,14,mixedType,2
2,8,0,10,mixedType,1
5,4,0,9,mixedType,1
9,1,0,10,mixedType,1
8,2,0,10,mixedType,1
5,3,0,8,mixedType,1
6,1,0,7,mixedType,0
5,1,0,6,mixedType,0
7,3,0,10,mixedType,1
8,3,0,11,mixedType,1
1,10,0,11,mixedType,1
6,3,0,9,mixedType,1
8,3,0,11,mixedType,1
8,3,0,11,mixedType,1
14,2,0,16,mixedType,2
5,2,0,7,mixedType,0
7,1,0,8,mixedType,1
10,1,0,11,mixedType,1
6,1,0,7,mixedType,0
6,0,1,7,mixedType,0
6,1,0,7,mixedType,0
6,2,0,8,mixedType,1
5,3,0,8,mixedType,1
6,2,0,8,mixedType,1
14,2,0,16,mixedType,2
10,3,0,13,mixedType,1
4,8,0,12,mixedType,1
5,3,0,8,mixedType,1
5,4,0,9,mixedType,1
4,4,0,8,mixedType,1
7,3,0,10,mixedType,1
12,4,0,16,mixedType,2
11,3,0,14,mixedType,2
4,7,0,11,mixedType,1
6,1,0,7,mixedType,0
8,1,0,9,mixedType,1
6,2,0,8,mixedType,1
6,1,0,7,mixedType,0
4,2,0,6,mixedType,0
5,1,0,6,mixedType,0
5,7,0,12,mixedType,1
6,2,0,8,mixedType,1
11,2,0,13,mixedType,1
6,3,0,9,mixedType,1
7,2,0,9,mixedType,1
3,3,0,6,mixedType,0
6,1,0,7,mixedType,0
15,1,0,16,mixedType,2
13,3,0,16,mixedType,2
8,3,0,11,mixedType,1
2,6,0,8,mixedType,1
8,2,0,10,mixedType,1
4,6,0,10,mixedType,1
6,2,0,8,mixedType,1
13,3,0,16,mixedType,2
6,3,0,9,mixedType,1
6,1,0,7,mixedType,0
6,4,0,10,mixedType,1
9,4,0,13,mixedType,1
8,1,0,9,mixedType,1
5,3,0,8,mixedType,1
8,2,0,10,mixedType,1
9,1,0,10,mixedType,1
11,1,0,12,mixedType,1
6,1,0,7,mixedType,0
4,4,0,8,mixedType,1
9,2,0,11,mixedType,1
6,2,0,8,mixedType,1
6,2,0,8,mixedType,1
13,3,0,16,mixedType,2
7,3,0,10,mixedType,1
5,2,0,7,mixedType,0
5,4,0,9,mixedType,1
5,3,0,8,mixedType,1
8,1,0,9,mixedType,1
4,10,0,14,mixedType,2
5,2,0,7,mixedType,0
3,7,0,10,mixedType,1
8,2,0,10,mixedType,1
6,3,0,9,mixedType,1
5,2,0,7,mixedType,0
8,3,0,11,mixedType,1
5,3,0,8,mixedType,1
6,2,0,8,mixedType,1
9,3,0,12,mixedType,1
7,3,0,10,mixedType,1
11,3,0,14,mixedType,2
6,6,0,12,mixedType,1
10,1,0,11,mixedType,1
7,3,0,10,mixedType,1
15,1,0,16,mixedType,2
7,2,0,9,mixedType,1
9,2,0,11,mixedType,1
6,4,0,10,mixedType,1
10,2,0,12,mixedType,1
6,2,0,8,mixedType,1
5,3,0,8,mixedType,1
7,1,2,10,mixedType,1
14,2,0,16,mixedType,2
10,1,0,11,mixedType,1
6,6,0,12,mixedType,1
5,2,0,7,mixedType,0
14,2,0,16,mixedType,2
6,4,0,10,mixedType,1
15,1,0,16,mixedType,2
5,3,0,8,mixedType,1
6,6,0,12,mixedType,1
6,2,0,8,mixedType,1
6,1,0,7,mixedType,0
4,2,0,6,mixedType,0
9,1,0,10,mixedType,1
1,8,0,9,mixedType,1
13,3,0,16,mixedType,2
8,4,0,12,mixedType,1
8,2,0,10,mixedType,1
7,2,0,9,mixedType,1
5,1,0,6,mixedType,0
6,3,0,9,mixedType,1
9,5,0,14,mixedType,2
8,4,0,12,mixedType,1
10,1,0,11,mixedType,1
7,2,0,9,mixedType,1
7,4,0,11,mixedType,1
4,4,0,8,mixedType,1
8,2,0,10,mixedType,1
9,1,0,10,mixedType,1
8,1,0,9,mixedType,1
7,3,0,10,mixedType,1
8,1,0,9,mixedType,1
6,6,0,12,mixedType,1
6,4,0,10,mixedType,1
6,4,0,10,mixedType,1
4,4,0,8,mixedType,1
5,3,0,8,mixedType,1
2,6,0,8,mixedType,1
4,4,0,8,mixedType,1
6,2,0,8,mixedType,1
6,3,0,9,mixedType,1
14,2,0,16,mixedType,2
5,4,0,9,mixedType,1
2,6,0,8,mixedType,1
13,3,0,16,mixedType,2
5,4,0,9,mixedType,1
5,1,0,6,mixedType,0
3,9,0,12,mixedType,1
7,2,0,9,mixedType,1
12,4,0,16,mixedType,2
6,3,0,9,mixedType,1
8,1,0,9,mixedType,1
15,1,0,16,mixedType,2
6,3,0,9,mixedType,1
3,8,0,11,mixedType,1
6,3,0,9,mixedType,1
3,7,0,10,mixedType,1
4,5,0,9,mixedType,1
5,2,0,7,mixedType,0
7,2,0,9,mixedType,1
5,4,0,9,mixedType,1
18,1,1,20,mixedType,2
7,1,0,8,mixedType,1
8,3,0,11,mixedType,1
4,2,0,6,mixedType,0
6,2,0,8,mixedType,1
3,6,0,9,mixedType,1
8,2,0,10,mixedType,1
5,1,0,6,mixedType,0
12,4,0,16,mixedType,2
9,3,0,12,mixedType,1
7,3,0,10,mixedType,1
9,2,0,11,mixedType,1
6,1,0,7,mixedType,0
3,9,0,12,mixedType,1
3,0,2,5,mixedType,0
13,3,0,16,mixedType,2
7,2,0,9,mixedType,1
10,2,0,12,mixedType,1
5,6,0,11,mixedType,1
6,0,1,7,mixedType,0
8,3,0,11,mixedType,1
8,1,0,9,mixedType,1
6,5,0,11,mixedType,1
1,8,0,9,mixedType,1
13,3,0,16,mixedType,2
5,0,0,5,sameType,0
6,3,0,9,mixedType,1
6,4,0,10,mixedType,1
5,1,0,6,mixedType,0
5,4,0,9,mixedType,1
3,7,0,10,mixedType,1
3,7,0,10,mixedType,1
7,2,0,9,mixedType,1
7,2,0,9,mixedType,1
8,1,0,9,mixedType,1
6,4,0,10,mixedType,1
14,2,0,16,mixedType,2
12,4,0,16,mixedType,2
8,1,0,9,mixedType,1
3,10,0,13,mixedType,1
15,1,0,16,mixedType,2
8,1,0,9,mixedType,1
8,2,0,10,mixedType,1
6,4,0,10,mixedType,1
6,2,0,8,mixedType,1
9,3,0,12,mixedType,1
9,3,2,14,mixedType,2
4,2,0,6,mixedType,0
13,3,0,16,mixedType,2
6,2,0,8,mixedType,1
4,6,0,10,mixedType,1
10,6,0,16,mixedType,2
5,3,0,8,mixedType,1
5,3,0,8,mixedType,1
7,3,0,10,mixedType,1
9,3,0,12,mixedType,1
4,2,0,6,mixedType,0
6,2,0,8,mixedType,1
1,8,0,9,mixedType,1
4,0,2,6,mixedType,0
6,2,0,8,mixedType,1
8,2,0,10,mixedType,1
13,3,0,16,mixedType,2
11,4,2,17,mixedType,2
6,4,0,10,mixedType,1
6,3,0,9,mixedType,1
8,3,0,11,mixedType,1
6,3,0,9,mixedType,1
11,5,0,16,mixedType,2
4,2,0,6,mixedType,0
5,2,0,7,mixedType,0
4,4,0,8,mixedType,1
9,1,0,10,mixedType,1
1,8,0,9,mixedType,1
4,2,0,6,mixedType,0
6,2,0,8,mixedType,1
6,2,0,8,mixedType,1
6,3,0,9,mixedType,1
5,3,0,8,mixedType,1
1,7,0,8,mixedType,1
6,4,0,10,mixedType,1
6,3,0,9,mixedType,1
10,2,0,12,mixedType,1
5,8,0,13,mixedType,1
6,2,0,8,mixedType,1
7,1,0,8,mixedType,1
5,5,0,10,mixedType,1
15,1,0,16,mixedType,2
3,5,0,8,mixedType,1
3,6,0,9,mixedType,1
7,2,0,9,mixedType,1
8,1,0,9,mixedType,1
5,1,0,6,mixedType,0
11,3,0,14,mixedType,2
13,3,0,16,mixedType,2
6,4,0,10,mixedType,1
4,2,0,6,mixedType,0
6,4,0,10,mixedType,1
8,2,0,10,mixedType,1
13,3,0,16,mixedType,2
7,2,0,9,mixedType,1
7,3,0,10,mixedType,1
8,2,0,10,mixedType,1
14,2,0,16,mixedType,2
5,3,0,8,mixedType,1
3,6,0,9,mixedType,1
4,2,0,6,mixedType,0
5,6,0,11,mixedType,1
7,2,0,9,mixedType,1
12,4,0,16,mixedType,2
5,2,0,7,mixedType,0
7,3,0,10,mixedType,1
1,7,0,8,mixedType,1
5,3,0,8,mixedType,1
7,3,0,10,mixedType,1
4,4,0,8,mixedType,1
8,1,0,9,mixedType,1
13,3,0,16,mixedType,2
3,5,0,8,mixedType,1
3,5,0,8,mixedType,1
4,4,0,8,mixedType,1
9,3,0,12,mixedType,1
10,2,0,12,mixedType,1
8,2,0,10,mixedType,1
5,1,0,6,mixedType,0
7,2,0,9,mixedType,1
2,8,0,10,mixedType,1
7,3,0,10,mixedType,1
8,5,0,13,mixedType,1
7,2,0,9,mixedType,1
6,1,0,7,mixedType,0
13,3,0,16,mixedType,2
8,1,0,9,mixedType,1
7,3,0,10,mixedType,1
3,3,0,6,mixedType,0
14,2,0,16,mixedType,2
7,3,0,10,mixedType,1
7,3,0,10,mixedType,1
5,3,0,8,mixedType,1
2,6,0,8,mixedType,1
14,2,0,16,mixedType,2
14,2,0,16,mixedType,2
6,2,0,8,mixedType,1
6,3,0,9,mixedType,1
6,3,0,9,mixedType,1
4,4,0,8,mixedType,1
4,2,0,6,mixedType,0
4,6,0,10,mixedType,1
5,4,0,9,mixedType,1
6,4,0,10,mixedType,1
7,3,0,10,mixedType,1
2,6,0,8,mixedType,1
7,3,0,10,mixedType,1
1,7,0,8,mixedType,1
3,3,0,6,mixedType,0
3,6,0,9,mixedType,1
10,4,1,15,mixedType,2
6,1,0,7,mixedType,0
5,3,0,8,mixedType,1
6,3,0,9,mixedType,1
8,2,0,10,mixedType,1
3,5,0,8,mixedType,1
14,2,0,16,mixedType,2
7,2,0,9,mixedType,1
4,2,0,6,mixedType,0
5,3,0,8,mixedType,1
4,4,0,8,mixedType,1
8,1,0,9,mixedType,1
6,3,0,9,mixedType,1
7,2,0,9,mixedType,1
2,4,0,6,mixedType,0
7,3,0,10,mixedType,1
1,5,0,6,mixedType,0
8,4,0,12,mixedType,1
13,3,0,16,mixedType,2
4,2,0,6,mixedType,0
7,6,0,13,mixedType,1
8,1,0,9,mixedType,1
7,4,0,11,mixedType,1
7,3,0,10,mixedType,1
6,4,0,10,mixedType,1
7,3,0,10,mixedType,1
3,6,0,9,mixedType,1
7,2,0,9,mixedType,1
7,3,0,10,mixedType,1
7,1,0,8,mixedType,1
7,1,0,8,mixedType,1
9,1,0,10,mixedType,1
8,2,0,10,mixedType,1
5,3,0,8,mixedType,1
7,4,0,11,mixedType,1
5,3,0,8,mixedType,1
11,1,0,12,mixedType,1
6,2,0,8,mixedType,1
6,4,0,10,mixedType,1
7,3,0,10,mixedType,1
7,2,0,9,mixedType,1
7,2,0,9,mixedType,1
15,1,0,16,mixedType,2
6,2,0,8,mixedType,1
1,11,0,12,mixedType,1
9,3,0,12,mixedType,1
12,4,0,16,mixedType,2
8,2,0,10,mixedType,1
8,4,0,12,mixedType,1
7,3,0,10,mixedType,1
12,3,0,15,mixedType,2
2,7,0,9,mixedType,1
6,3,0,9,mixedType,1
5,5,0,10,mixedType,1
5,2,0,7,mixedType,0
12,4,0,16,mixedType,2
7,1,0,8,mixedType,1
7,3,0,10,mixedType,1
13,3,0,16,mixedType,2
8,2,0,10,mixedType,1
5,1,0,6,mixedType,0
5,2,0,7,mixedType,0
2,8,0,10,mixedType,1
6,1,0,7,mixedType,0
1,8,0,9,mixedType,1
5,3,0,8,mixedType,1
6,3,0,9,mixedType,1
2,4,0,6,mixedType,0
8,2,0,10,mixedType,1
6,2,0,8,mixedType,1
8,2,0,10,mixedType,1
7,2,0,9,mixedType,1
6,6,0,12,mixedType,1
5,5,0,10,mixedType,1
10,4,2,16,mixedType,2
4,9,0,13,mixedType,1
4,5,0,9,mixedType,1
14,4,1,19,mixedType,2
7,3,0,10,mixedType,1
1,8,0,9,mixedType,1
7,3,0,10,mixedType,1
6,2,0,8,mixedType,1
1,8,0,9,mixedType,1
7,2,0,9,mixedType,1
15,6,0,21,mixedType,2
9,2,0,11,mixedType,1
7,1,0,8,mixedType,1
4,2,0,6,mixedType,0
5,2,0,7,mixedType,0
6,3,0,9,mixedType,1
9,1,0,10,mixedType,1
15,1,0,16,mixedType,2
9,3,0,12,mixedType,1
8,1,0,9,mixedType,1
4,2,0,6,mixedType,0
5,3,0,8,mixedType,1
11,3,0,14,mixedType,2
15,1,0,16,mixedType,2
8,1,0,9,mixedType,1
5,3,0,8,mixedType,1
9,2,0,11,mixedType,1
2,4,0,6,mixedType,0
8,1,0,9,mixedType,1
8,3,0,11,mixedType,1
3,5,0,8,mixedType,1
6,1,0,7,mixedType,0
8,4,0,12,mixedType,1
15,1,0,16,mixedType,2
2,6,0,8,mixedType,1
14,2,0,16,mixedType,2
9,2,0,11,mixedType,1
14,2,0,16,mixedType,2
4,2,0,6,mixedType,0
7,4,0,11,mixedType,1
5,2,0,7,mixedType,0
11,3,1,15,mixedType,2
5,3,0,8,mixedType,1
11,3,0,14,mixedType,2
12,4,0,16,mixedType,2
11,1,0,12,mixedType,1
6,3,0,9,mixedType,1
8,7,1,16,mixedType,2
6,2,0,8,mixedType,1
6,2,0,8,mixedType,1
5,4,0,9,mixedType,1
6,2,0,8,mixedType,1
5,2,0,7,mixedType,0
7,1,0,8,mixedType,1
6,2,0,8,mixedType,1
1,8,0,9,mixedType,1
7,3,0,10,mixedType,1
4,4,0,8,mixedType,1
5,3,0,8,mixedType,1
9,1,0,10,mixedType,1
6,3,0,9,mixedType,1
8,2,0,10,mixedType,1
11,1,0,12,mixedType,1
6,2,0,8,mixedType,1
9,3,0,12,mixedType,1
2,6,0,8,mixedType,1
1,10,0,11,mixedType,1
6,0,0,6,sameType,0
10,1,0,11,mixedType,1
1,7,0,8,mixedType,1
9,1,0,10,mixedType,1
7,2,0,9,mixedType,1
6,1,0,7,mixedType,0
11,1,0,12,mixedType,1
1,8,0,9,mixedType,1
5,3,0,8,mixedType,1
9,1,0,10,mixedType,1
5,2,0,7,mixedType,0
3,7,0,10,mixedType,1
10,4,0,14,mixedType,2
9,2,0,11,mixedType,1
8,2,0,10,mixedType,1
5,7,0,12,mixedType,1
5,3,0,8,mixedType,1
7,2,0,9,mixedType,1
4,2,0,6,mixedType,0
6,2,0,8,mixedType,1
6,1,0,7,mixedType,0
13,4,0,17,mixedType,2
5,2,0,7,mixedType,0
7,3,0,10,mixedType,1
4,4,0,8,mixedType,1
6,1,0,7,mixedType,0
6,3,0,9,mixedType,1
1,8,0,9,mixedType,1
1,10,0,11,mixedType,1
7,2,0,9,mixedType,1
8,1,0,9,mixedType,1
6,4,0,10,mixedType,1
6,3,0,9,mixedType,1
7,1,0,8,mixedType,1
7,2,0,9,mixedType,1
5,3,0,8,mixedType,1
6,4,0,10,mixedType,1
15,1,0,16,mixedType,2
15,1,0,16,mixedType,2
3,5,0,8,mixedType,1
8,1,0,9,mixedType,1
5,4,0,9,mixedType,1
11,2,0,13,mixedType,1
6,4,0,10,mixedType,1
5,3,0,8,mixedType,1
7,2,0,9,mixedType,1
8,2,0,10,mixedType,1
8,1,0,9,mixedType,1
15,1,0,16,mixedType,2
14,2,0,16,mixedType,2
7,6,0,13,mixedType,1
4,3,2,9,mixedType,1
7,4,0,11,mixedType,1
25,3,2,30,mixedType,2
7,1,0,8,mixedType,1
12,4,0,16,mixedType,2
7,3,0,10,mixedType,1
7,1,0,8,mixedType,1
7,3,0,10,mixedType,1
3,5,0,8,mixedType,1
3,5,0,8,mixedType,1
6,4,0,10,mixedType,1
7,6,0,13,mixedType,1
5,3,0,8,mixedType,1
7,1,0,8,mixedType,1
6,4,0,10,mixedType,1
6,2,0,8,mixedType,1
7,1,0,8,mixedType,1
9,2,0,11,mixedType,1
1,10,0,11,mixedType,1
3,6,0,9,mixedType,1
6,2,0,8,mixedType,1
4,2,0,6,mixedType,0
6,1,0,7,mixedType,0
6,2,0,8,mixedType,1
13,3,0,16,mixedType,2
5,7,0,12,mixedType,1
11,2,0,13,mixedType,1
5,1,0,6,mixedType,0
6,3,0,9,mixedType,1
5,1,0,6,mixedType,0
3,6,0,9,mixedType,1
7,3,0,10,mixedType,1
8,2,0,10,mixedType,1
6,1,0,7,mixedType,0
7,3,0,10,mixedType,1
9,4,0,13,mixedType,1
7,3,0,10,mixedType,1
9,1,0,10,mixedType,1
8,1,0,9,mixedType,1
6,4,0,10,mixedType,1
1,8,0,9,mixedType,1
12,0,1,13,mixedType,1
5,1,0,6,mixedType,0
5,5,0,10,mixedType,1
7,3,0,10,mixedType,1
7,2,0,9,mixedType,1
7,2,0,9,mixedType,1
3,3,0,6,mixedType,0
8,3,0,11,mixedType,1
6,10,1,17,mixedType,2
9,2,0,11,mixedType,1
8,2,0,10,mixedType,1
8,3,0,11,mixedType,1
2,6,0,8,mixedType,1
10,1,0,11,mixedType,1
6,1,0,7,mixedType,0
7,1,0,8,mixedType,1
7,3,0,10,mixedType,1
6,3,0,9,mixedType,1
8,1,0,9,mixedType,1
4,2,0,6,mixedType,0
6,4,0,10,mixedType,1
6,1,0,7,mixedType,0
7,3,0,10,mixedType,1
1,9,0,10,mixedType,1
6,3,0,9,mixedType,1
8,4,0,12,mixedType,1
7,2,0,9,mixedType,1
6,2,0,8,mixedType,1
7,2,0,9,mixedType,1
7,2,0,9,mixedType,1
13,3,0,16,mixedType,2
15,1,0,16,mixedType,2
5,2,0,7,mixedType,0
9,1,0,10,mixedType,1
7,3,0,10,mixedType,1
6,3,0,9,mixedType,1
7,4,0,11,mixedType,1
2,4,0,6,mixedType,0
5,4,0,9,mixedType,1
5,5,0,10,mixedType,1
6,4,0,10,mixedType,1
7,1,0,8,mixedType,1
14,2,0,16,mixedType,2
4,2,0,6,mixedType,0
4,5,0,9,mixedType,1
6,4,0,10,mixedType,1
8,4,0,12,mixedType,1
7,4,0,11,mixedType,1
3,8,0,11,mixedType,1
6,3,0,9,mixedType,1
5,2,0,7,mixedType,0
5,4,0,9,mixedType,1
6,4,0,10,mixedType,1
6,3,0,9,mixedType,1
1,8,0,9,mixedType,1
11,5,0,16,mixedType,2
7,6,0,13,mixedType,1
7,2,0,9,mixedType,1
1,10,0,11,mixedType,1
6,1,0,7,mixedType,0
4,4,0,8,mixedType,1
12,3,0,15,mixedType,2
6,1,0,7,mixedType,0
5,4,0,9,mixedType,1
6,4,0,10,mixedType,1
6,1,0,7,mixedType,0
5,3,0,8,mixedType,1
6,2,0,8,mixedType,1
5,4,0,9,mixedType,1
7,1,0,8,mixedType,1
3,4,0,7,mixedType,0
6,3,0,9,mixedType,1
5,3,0,8,mixedType,1
5,3,0,8,mixedType,1
6,4,0,10,mixedType,1
5,3,0,8,mixedType,1
6,3,0,9,mixedType,1
10,3,0,13,mixedType,1
9,1,0,10,mixedType,1
7,3,0,10,mixedType,1
6,3,0,9,mixedType,1
7,2,0,9,mixedType,1
12,3,0,15,mixedType,2
5,1,0,6,mixedType,0
8,2,0,10,mixedType,1
13,3,0,16,mixedType,2
6,4,0,10,mixedType,1
5,3,0,8,mixedType,1
9,4,0,13,mixedType,1
8,1,0,9,mixedType,1
6,4,0,10,mixedType,1
9,3,0,12,mixedType,1
4,2,0,6,mixedType,0
5,1,0,6,mixedType,0
7,2,0,9,mixedType,1
6,4,0,10,mixedType,1
9,2,0,11,mixedType,1
4,4,0,8,mixedType,1
6,4,0,10,mixedType,1
6,3,0,9,mixedType,1
7,4,0,11,mixedType,1
5,6,0,11,mixedType,1
6,3,0,9,mixedType,1
7,2,0,9,mixedType,1
5,4,0,9,mixedType,1
14,2,0,16,mixedType,2
7,3,0,10,mixedType,1
11,0,1,12,mixedType,1
5,2,0,7,mixedType,0
1,8,0,9,mixedType,1
14,2,0,16,mixedType,2
7,3,0,10,mixedType,1
6,6,0,12,mixedType,1
3,10,0,13,mixedType,1
2,7,0,9,mixedType,1
6,7,0,13,mixedType,1
7,2,0,9,mixedType,1
15,1,0,16,mixedType,2
0,1,2,3,mixedType,0
3,6,0,9,mixedType,1
6,2,0,8,mixedType,1
8,3,0,11,mixedType,1
9,3,0,12,mixedType,1
9,4,1,14,mixedType,2
3,5,0,8,mixedType,1
3,6,0,9,mixedType,1
1,10,0,11,mixedType,1
8,4,0,12,mixedType,1
5,4,0,9,mixedType,1
9,4,0,13,mixedType,1
5,1,0,6,mixedType,0
7,3,0,10,mixedType,1
1,8,0,9,mixedType,1
7,2,0,9,mixedType,1
11,3,0,14,mixedType,2
5,4,0,9,mixedType,1
5,1,0,6,mixedType,0
3,3,0,6,mixedType,0
5,2,0,7,mixedType,0
5,2,0,7,mixedType,0
6,4,0,10,mixedType,1
12,3,0,15,mixedType,2
6,1,0,7,mixedType,0
5,4,0,9,mixedType,1
6,4,0,10,mixedType,1
15,1,0,16,mixedType,2
9,3,0,12,mixedType,1
1,7,0,8,mixedType,1
3,6,0,9,mixedType,1
8,1,0,9,mixedType,1
3,7,0,10,mixedType,1
5,2,0,7,mixedType,0
5,1,0,6,mixedType,0
7,3,0,10,mixedType,1
15,1,0,16,mixedType,2
8,2,0,10,mixedType,1
6,6,0,12,mixedType,1
8,3,0,11,mixedType,1
6,1,0,7,mixedType,0
5,1,0,6,mixedType,0
6,2,0,8,mixedType,1
5,3,0,8,mixedType,1
6,2,0,8,mixedType,1
4,4,0,8,mixedType,1
6,4,0,10,mixedType,1
7,2,0,9,mixedType,1
6,1,0,7,mixedType,0
7,1,0,8,mixedType,1
5,1,0,6,mixedType,0
5,2,0,7,mixedType,0
3,6,0,9,mixedType,1
5,1,0,6,mixedType,0
12,3,0,15,mixedType,2
9,2,0,11,mixedType,1
9,2,0,11,mixedType,1
9,1,0,10,mixedType,1
6,1,0,7,mixedType,0
2,4,0,6,mixedType,0
8,2,0,10,mixedType,1
6,3,0,9,mixedType,1
7,2,0,9,mixedType,1
7,4,0,11,mixedType,1
7,3,0,10,mixedType,1
9,2,0,11,mixedType,1
7,3,0,10,mixedType,1
7,4,0,11,mixedType,1
8,2,0,10,mixedType,1
12,3,0,15,mixedType,2
9,4,0,13,mixedType,1
9,0,1,10,mixedType,1
15,2,0,17,mixedType,2
14,2,0,16,mixedType,2
1,5,0,6,mixedType,0
2,8,0,10,mixedType,1
11,1,0,12,mixedType,1
6,3,0,9,mixedType,1
12,3,0,15,mixedType,2
5,2,0,7,mixedType,0
9,2,0,11,mixedType,1
7,3,0,10,mixedType,1
4,4,0,8,mixedType,1
11,3,0,14,mixedType,2
8,1,0,9,mixedType,1
9,4,0,13,mixedType,1
8,1,0,9,mixedType,1
14,2,0,16,mixedType,2
5,2,0,7,mixedType,0
7,4,0,11,mixedType,1
8,2,0,10,mixedType,1
5,2,0,7,mixedType,0
8,3,0,11,mixedType,1
3,6,0,9,mixedType,1
8,3,0,11,mixedType,1
3,8,0,11,mixedType,1
8,1,0,9,mixedType,1
6,6,0,12,mixedType,1
4,5,0,9,mixedType,1
6,4,0,10,mixedType,1
7,4,0,11,mixedType,1
5,3,0,8,mixedType,1
6,4,0,10,mixedType,1
11,1,0,12,mixedType,1
11,9,0,20,mixedType,2
7,2,0,9,mixedType,1
5,6,0,11,mixedType,1
7,3,0,10,mixedType,1
8,3,3,14,mixedType,2
17,2,0,19,mixedType,2
4,4,0,8,mixedType,1
6,4,0,10,mixedType,1
4,2,0,6,mixedType,0
5,2,0,7,mixedType,0
4,4,0,8,mixedType,1
5,3,0,8,mixedType,1
6,4,0,10,mixedType,1
8,4,0,12,mixedType,1
4,2,0,6,mixedType,0
5,3,0,8,mixedType,1
7,3,0,10,mixedType,1
5,4,0,9,mixedType,1
4,2,0,6,mixedType,0
8,2,0,10,mixedType,1
6,1,0,7,mixedType,0
7,3,0,10,mixedType,1
8,6,0,14,mixedType,2
6,4,0,10,mixedType,1
13,3,0,16,mixedType,2
14,2,0,16,mixedType,2
7,1,0,8,mixedType,1
8,2,0,10,mixedType,1
5,2,0,7,mixedType,0
4,2,0,6,mixedType,0
7,2,0,9,mixedType,1
5,1,0,6,mixedType,0
8,1,0,9,mixedType,1
3,6,0,9,mixedType,1
4,6,0,10,mixedType,1
2,4,0,6,mixedType,0
3,6,0,9,mixedType,1
6,2,0,8,mixedType,1
5,2,0,7,mixedType,0
7,1,0,8,mixedType,1
7,4,0,11,mixedType,1
6,1,0,7,mixedType,0
5,5,0,10,mixedType,1
7,3,0,10,mixedType,1
6,2,0,8,mixedType,1
1,8,0,9,mixedType,1
6,2,0,8,mixedType,1
6,2,0,8,mixedType,1
9,1,0,10,mixedType,1
2,8,0,10,mixedType,1
2,4,0,6,mixedType,0
5,2,0,7,mixedType,0
2,7,0,9,mixedType,1
4,4,0,8,mixedType,1
6,4,0,10,mixedType,1
9,1,0,10,mixedType,1
5,6,0,11,mixedType,1
6,3,0,9,mixedType,1
15,1,0,16,mixedType,2
2,6,0,8,mixedType,1
8,2,0,10,mixedType,1
4,5,0,9,mixedType,1
15,1,0,16,mixedType,2
5,6,0,11,mixedType,1
8,2,0,10,mixedType,1
15,1,0,16,mixedType,2
12,3,0,15,mixedType,2
6,3,0,9,mixedType,1
3,8,0,11,mixedType,1
14,2,0,16,mixedType,2
6,3,0,9,mixedType,1
7,3,0,10,mixedType,1
6,3,0,9,mixedType,1
7,3,0,10,mixedType,1
7,4,0,11,mixedType,1
13,3,0,16,mixedType,2
5,2,0,7,mixedType,0
6,2,0,8,mixedType,1
10,2,0,12,mixedType,1
4,2,0,6,mixedType,0
11,2,0,13,mixedType,1
7,1,0,8,mixedType,1
5,1,0,6,mixedType,0
6,4,0,10,mixedType,1
8,4,0,12,mixedType,1
10,5,0,15,mixedType,2
4,4,0,8,mixedType,1
6,2,0,8,mixedType,1
12,4,0,16,mixedType,2
9,1,0,10,mixedType,1
4,4,0,8,mixedType,1
5,4,0,9,mixedType,1
3,6,0,9,mixedType,1
4,4,0,8,mixedType,1
9,4,0,13,mixedType,1
6,6,0,12,mixedType,1
9,4,3,16,mixedType,2
12,4,0,16,mixedType,2
7,1,0,8,mixedType,1
5,8,0,13,mixedType,1
5,1,0,6,mixedType,0
8,4,0,12,mixedType,1
6,4,0,10,mixedType,1
10,2,0,12,mixedType,1
4,2,0,6,mixedType,0
5,1,0,6,mixedType,0
7,3,0,10,mixedType,1
6,6,0,12,mixedType,1
5,2,0,7,mixedType,0
5,3,0,8,mixedType,1
7,3,0,10,mixedType,1
6,3,0,9,mixedType,1
1,8,0,9,mixedType,1
9,2,0,11,mixedType,1
12,3,0,15,mixedType,2
9,1,0,10,mixedType,1
7,2,0,9,mixedType,1
3,6,0,9,mixedType,1
6,4,0,10,mixedType,1
4,2,0,6,mixedType,0
14,2,0,16,mixedType,2
7,2,0,9,mixedType,1
6,3,0,9,mixedType,1
8,1,0,9,mixedType,1
5,3,0,8,mixedType,1
5,2,0,7,mixedType,0
8,2,0,10,mixedType,1
7,3,0,10,mixedType,1
7,1,0,8,mixedType,1
7,4,0,11,mixedType,1
7,3,0,10,mixedType,1
5,4,0,9,mixedType,1
6,4,0,10,mixedType,1
7,8,0,15,mixedType,2
5,2,0,7,mixedType,0
15,1,0,16,mixedType,2
1,8,0,9,mixedType,1
9,4,0,13,mixedType,1
6,4,0,10,mixedType,1
7,3,0,10,mixedType,1
6,6,0,12,mixedType,1
6,3,0,9,mixedType,1
4,4,0,8,mixedType,1
12,4,0,16,mixedType,2
6,3,0,9,mixedType,1
14,2,0,16,mixedType,2
7,2,0,9,mixedType,1
7,2,0,9,mixedType,1
4,4,0,8,mixedType,1
11,1,0,12,mixedType,1
5,5,0,10,mixedType,1
8,1,0,9,mixedType,1
8,2,0,10,mixedType,1
15,1,0,16,mixedType,2
5,1,0,6,mixedType,0
6,4,0,10,mixedType,1
6,1,0,7,mixedType,0
12,4,0,16,mixedType,2
5,2,0,7,mixedType,0
8,1,0,9,mixedType,1
5,5,0,10,mixedType,1
6,4,0,10,mixedType,1
8,2,0,10,mixedType,1
6,3,0,9,mixedType,1
7,2,0,9,mixedType,1
7,1,0,8,mixedType,1
7,2,0,9,mixedType,1
2,6,0,8,mixedType,1
15,1,0,16,mixedType,2
12,1,0,13,mixedType,1
5,3,0,8,mixedType,1
9,1,0,10,mixedType,1
7,3,0,10,mixedType,1
5,2,0,7,mixedType,0
4,4,0,8,mixedType,1
7,3,0,10,mixedType,1
4,4,0,8,mixedType,1
9,2,0,11,mixedType,1
8,4,0,12,mixedType,1
14,2,0,16,mixedType,2
8,4,0,12,mixedType,1
4,4,0,8,mixedType,1
4,2,0,6,mixedType,0
5,2,0,7,mixedType,0
6,3,0,9,mixedType,1
1,8,0,9,mixedType,1
8,2,0,10,mixedType,1
7,3,0,10,mixedType,1
4,4,0,8,mixedType,1
5,6,0,11,mixedType,1
6,2,0,8,mixedType,1
4,2,0,6,mixedType,0
4,6,0,10,mixedType,1
11,3,0,14,mixedType,2
5,3,0,8,mixedType,1
12,4,0,16,mixedType,2
8,2,0,10,mixedType,1
6,1,0,7,mixedType,0
7,2,0,9,mixedType,1
6,2,0,8,mixedType,1
4,4,0,8,mixedType,1
4,2,0,6,mixedType,0
7,3,0,10,mixedType,1
6,2,0,8,mixedType,1
9,2,0,11,mixedType,1
13,3,0,16,mixedType,2
11,3,0,14,mixedType,2
6,3,0,9,mixedType,1
8,2,0,10,mixedType,1
5,2,0,7,mixedType,0
7,2,0,9,mixedType,1
7,3,0,10,mixedType,1
8,2,0,10,mixedType,1
9,1,0,10,mixedType,1
4,4,0,8,mixedType,1
1,8,0,9,mixedType,1
8,1,0,9,mixedType,1
5,3,0,8,mixedType,1
11,1,0,12,mixedType,1
5,2,0,7,mixedType,0
12,4,0,16,mixedType,2
9,4,0,13,mixedType,1
1,5,0,6,mixedType,0
6,3,0,9,mixedType,1
9,3,0,12,mixedType,1
2,6,0,8,mixedType,1
1,10,0,11,mixedType,1
6,4,0,10,mixedType,1
8,3,0,11,mixedType,1
14,2,0,16,mixedType,2
4,4,0,8,mixedType,1
7,6,0,13,mixedType,1
6,2,0,8,mixedType,1
13,3,0,16,mixedType,2
5,2,0,7,mixedType,0
3,7,0,10,mixedType,1
8,2,0,10,mixedType,1
9,3,0,12,mixedType,1
7,2,0,9,mixedType,1
7,4,0,11,mixedType,1
2,4,0,6,mixedType,0
7,4,0,11,mixedType,1
5,2,0,7,mixedType,0
5,3,0,8,mixedType,1
7,4,0,11,mixedType,1
5,6,0,11,mixedType,1
3,3,0,6,mixedType,0
12,3,0,15,mixedType,2
9,3,0,12,mixedType,1
11,2,0,13,mixedType,1
9,1,0,10,mixedType,1
1,8,0,9,mixedType,1
13,3,0,16,mixedType,2
6,3,0,9,mixedType,1
7,3,0,10,mixedType,1
5,1,0,6,mixedType,0
5,4,0,9,mixedType,1
2,8,0,10,mixedType,1
6,1,0,7,mixedType,0
6,3,0,9,mixedType,1
6,3,0,9,mixedType,1
8,2,0,10,mixedType,1
13,3,0,16,mixedType,2
7,3,0,10,mixedType,1
11,3,0,14,mixedType,2
8,4,0,12,mixedType,1
6,4,0,10,mixedType,1
9,1,0,10,mixedType,1
2,4,0,6,mixedType,0
2,6,0,8,mixedType,1
9,2,0,11,mixedType,1
6,4,0,10,mixedType,1
7,2,0,9,mixedType,1
5,6,0,11,mixedType,1
13,3,0,16,mixedType,2
7,1,0,8,mixedType,1
11,2,0,13,mixedType,1
17,1,1,19,mixedType,2
5,1,0,6,mixedType,0
6,3,0,9,mixedType,1
9,4,0,13,mixedType,1
7,3,0,10,mixedType,1
8,2,0,10,mixedType,1
8,2,0,10,mixedType,1
2,9,0,11,mixedType,1
7,1,0,8,mixedType,1
5,4,0,9,mixedType,1
7,1,0,8,mixedType,1
6,1,0,7,mixedType,0
14,2,0,16,mixedType,2
10,2,0,12,mixedType,1
12,4,0,16,mixedType,2
5,3,0,8,mixedType,1
5,3,0,8,mixedType,1
9,1,0,10,mixedType,1
2,8,0,10,mixedType,1
7,3,0,10,mixedType,1
7,3,0,10,mixedType,1
5,1,0,6,mixedType,0
3,9,0,12,mixedType,1
8,3,0,11,mixedType,1
6,3,0,9,mixedType,1
11,2,0,13,mixedType,1
9,1,0,10,mixedType,1
2,6,0,8,mixedType,1
5,3,0,8,mixedType,1
8,1,0,9,mixedType,1
12,4,0,16,mixedType,2
5,6,0,11,mixedType,1
2,8,0,10,mixedType,1
7,2,0,9,mixedType,1
8,2,0,10,mixedType,1
7,2,0,9,mixedType,1
5,4,0,9,mixedType,1
4,2,0,6,mixedType,0
6,1,0,7,mixedType,0
7,3,0,10,mixedType,1
7,3,0,10,mixedType,1
8,1,0,9,mixedType,1
4,7,0,11,mixedType,1
4,2,0,6,mixedType,0
2,6,0,8,mixedType,1
5,3,0,8,mixedType,1
6,2,0,8,mixedType,1
6,3,0,9,mixedType,1
8,2,0,10,mixedType,1
8,2,0,10,mixedType,1
6,3,0,9,mixedType,1
4,4,0,8,mixedType,1
5,1,0,6,mixedType,0
6,4,0,10,mixedType,1
6,2,0,8,mixedType,1
14,2,0,16,mixedType,2
4,6,0,10,mixedType,1
3,10,1,14,mixedType,2
8,2,0,10,mixedType,1
9,4,0,13,mixedType,1
6,4,0,10,mixedType,1
8,4,0,12,mixedType,1
6,2,0,8,mixedType,1
11,3,0,14,mixedType,2
8,3,0,11,mixedType,1
8,4,0,12,mixedType,1
7,1,0,8,mixedType,1
6,3,0,9,mixedType,1
2,4,0,6,mixedType,0
6,2,0,8,mixedType,1
19,2,0,21,mixedType,2
13,3,0,16,mixedType,2
7,1,0,8,mixedType,1
13,3,0,16,mixedType,2
9,2,0,11,mixedType,1
8,3,0,11,mixedType,1
7,1,0,8,mixedType,1
6,1,0,7,mixedType,0
6,2,0,8,mixedType,1
6,4,0,10,mixedType,1
7,3,0,10,mixedType,1
8,1,0,9,mixedType,1
15,1,0,16,mixedType,2
2,8,0,10,mixedType,1
7,2,0,9,mixedType,1
10,1,0,11,mixedType,1
8,1,0,9,mixedType,1
10,2,0,12,mixedType,1
5,5,0,10,mixedType,1
8,1,0,9,mixedType,1
8,2,0,10,mixedType,1
7,3,0,10,mixedType,1
9,3,0,12,mixedType,1
4,2,0,6,mixedType,0
6,3,0,9,mixedType,1
6,6,0,12,mixedType,1
6,2,0,8,mixedType,1
6,2,0,8,mixedType,1
6,2,0,8,mixedType,1
7,3,0,10,mixedType,1
8,4,0,12,mixedType,1
3,6,0,9,mixedType,1
6,1,0,7,mixedType,0
8,1,0,9,mixedType,1
1,7,0,8,mixedType,1
11,3,0,14,mixedType,2
6,2,0,8,mixedType,1
10,1,0,11,mixedType,1
5,1,0,6,mixedType,0
6,3,0,9,mixedType,1
4,4,0,8,mixedType,1
6,3,0,9,mixedType,1
8,2,0,10,mixedType,1
9,3,0,12,mixedType,1
1,9,0,10,mixedType,1
6,2,0,8,mixedType,1
7,3,0,10,mixedType,1
9,4,0,13,mixedType,1
7,3,0,10,mixedType,1
3,6,0,9,mixedType,1
14,2,0,16,mixedType,2
6,3,0,9,mixedType,1
7,3,0,10,mixedType,1
7,2,0,9,mixedType,1
7,3,0,10,mixedType,1
7,2,0,9,mixedType,1
14,2,0,16,mixedType,2
6,2,0,8,mixedType,1
6,2,0,8,mixedType,1
9,3,0,12,mixedType,1
6,2,0,8,mixedType,1
2,7,0,9,mixedType,1
7,1,0,8,mixedType,1
6,3,0,9,mixedType,1
10,2,0,12,mixedType,1
3,5,0,8,mixedType,1
14,2,0,16,mixedType,2
6,3,0,9,mixedType,1
11,5,0,16,mixedType,2
5,2,0,7,mixedType,0
13,3,0,16,mixedType,2
6,3,0,9,mixedType,1
5,4,0,9,mixedType,1
6,1,0,7,mixedType,0
9,2,0,11,mixedType,1
3,5,0,8,mixedType,1
3,3,0,6,mixedType,0
6,2,0,8,mixedType,1
4,4,0,8,mixedType,1
13,4,0,17,mixedType,2
13,3,0,16,mixedType,2
6,1,0,7,mixedType,0
6,1,0,7,mixedType,0
4,4,0,8,mixedType,1
5,4,0,9,mixedType,1
14,2,0,16,mixedType,2
8,3,0,11,mixedType,1
7,0,1,8,mixedType,1
2,10,0,12,mixedType,1
7,2,0,9,mixedType,1
10,1,0,11,mixedType,1
14,2,0,16,mixedType,2
6,3,0,9,mixedType,1
5,3,0,8,mixedType,1
14,2,0,16,mixedType,2
4,2,0,6,mixedType,0
6,3,0,9,mixedType,1
4,2,0,6,mixedType,0
5,1,0,6,mixedType,0
4,6,0,10,mixedType,1
6,5,0,11,mixedType,1
2,4,0,6,mixedType,0
8,1,0,9,mixedType,1
13,3,0,16,mixedType,2
4,7,0,11,mixedType,1
2,6,0,8,mixedType,1
6,1,0,7,mixedType,0
6,3,0,9,mixedType,1
5,3,0,8,mixedType,1
10,2,0,12,mixedType,1
8,2,0,10,mixedType,1
7,3,0,10,mixedType,1
4,4,0,8,mixedType,1
8,2,0,10,mixedType,1
9,3,0,12,mixedType,1
8,1,0,9,mixedType,1
6,3,0,9,mixedType,1
7,2,0,9,mixedType,1
9,4,0,13,mixedType,1
8,1,0,9,mixedType,1
6,4,0,10,mixedType,1
11,1,0,12,mixedType,1
7,3,0,10,mixedType,1
7,3,0,10,mixedType,1
6,3,0,9,mixedType,1
7,3,0,10,mixedType,1
5,2,0,7,mixedType,0
6,3,0,9,mixedType,1
5,3,0,8,mixedType,1
6,6,0,12,mixedType,1
5,1,0,6,mixedType,0
5,3,0,8,mixedType,1
7,3,0,10,mixedType,1
13,3,0,16,mixedType,2
6,3,0,9,mixedType,1
8,2,0,10,mixedType,1
7,5,0,12,mixedType,1
6,4,0,10,mixedType,1
8,2,0,10,mixedType,1
6,1,0,7,mixedType,0
10,2,0,12,mixedType,1
14,2,0,16,mixedType,2
6,1,0,7,mixedType,0
6,2,0,8,mixedType,1
2,8,0,10,mixedType,1
5,1,0,6,mixedType,0
6,1,0,7,mixedType,0
4,2,0,6,mixedType,0
11,2,1,14,mixedType,2
7,2,0,9,mixedType,1
6,6,0,12,mixedType,1
8,4,0,12,mixedType,1
9,5,0,14,mixedType,2
2,7,0,9,mixedType,1
7,2,0,9,mixedType,1
5,1,0,6,mixedType,0
6,2,0,8,mixedType,1
6,2,0,8,mixedType,1
6,2,0,8,mixedType,1
7,4,0,11,mixedType,1
7,2,0,9,mixedType,1
14,2,0,16,mixedType,2
9,4,0,13,mixedType,1
1,7,0,8,mixedType,1
6,2,0,8,mixedType,1
4,2,0,6,mixedType,0
5,3,0,8,mixedType,1
4,4,0,8,mixedType,1
7,2,0,9,mixedType,1
3,5,0,8,mixedType,1
14,2,0,16,mixedType,2
11,2,0,13,mixedType,1
9,4,0,13,mixedType,1
8,2,0,10,mixedType,1
6,1,0,7,mixedType,0
6,3,0,9,mixedType,1
5,3,0,8,mixedType,1
12,1,0,13,mixedType,1
12,1,0,13,mixedType,1
8,2,0,10,mixedType,1
7,3,0,10,mixedType,1
1,8,0,9,mixedType,1
7,4,0,11,mixedType,1
10,2,0,12,mixedType,1
7,1,0,8,mixedType,1
6,4,0,10,mixedType,1
14,1,1,16,mixedType,2
4,6,0,10,mixedType,1
7,3,0,10,mixedType,1
7,3,0,10,mixedType,1
3,5,0,8,mixedType,1
7,1,0,8,mixedType,1
9,4,0,13,mixedType,1
15,1,0,16,mixedType,2
1,7,0,8,mixedType,1
8,4,0,12,mixedType,1
4,8,0,12,mixedType,1
9,4,0,13,mixedType,1
8,2,0,10,mixedType,1
8,3,0,11,mixedType,1
6,4,0,10,mixedType,1
7,2,0,9,mixedType,1
8,2,0,10,mixedType,1
13,3,0,16,mixedType,2
12,3,0,15,mixedType,2
3,6,0,9,mixedType,1
5,3,0,8,mixedType,1
6,4,0,10,mixedType,1
8,3,0,11,mixedType,1
9,2,0,11,mixedType,1
8,1,0,9,mixedType,1
7,2,0,9,mixedType,1
8,1,0,9,mixedType,1
4,6,0,10,mixedType,1
6,1,0,7,mixedType,0
4,2,0,6,mixedType,0
14,2,0,16,mixedType,2
6,3,0,9,mixedType,1
6,4,0,10,mixedType,1
6,4,0,10,mixedType,1
10,0,1,11,mixedType,1
4,6,0,10,mixedType,1
7,3,0,10,mixedType,1
6,4,0,10,mixedType,1
4,6,0,10,mixedType,1
7,3,0,10,mixedType,1
1,8,0,9,mixedType,1
7,2,0,9,mixedType,1
7,1,0,8,mixedType,1
4,6,0,10,mixedType,1
9,1,0,10,mixedType,1
7,4,0,11,mixedType,1
5,2,0,7,mixedType,0
5,2,0,7,mixedType,0
2,6,0,8,mixedType,1
8,2,0,10,mixedType,1
9,2,0,11,mixedType,1
4,2,0,6,mixedType,0
8,2,0,10,mixedType,1
6,7,0,13,mixedType,1
7,4,0,11,mixedType,1
6,2,0,8,mixedType,1
7,1,0,8,mixedType,1
5,2,0,7,mixedType,0
5,1,0,6,mixedType,0
6,2,0,8,mixedType,1
8,2,0,10,mixedType,1
5,3,0,8,mixedType,1
7,2,0,9,mixedType,1
6,2,0,8,mixedType,1
5,2,0,7,mixedType,0
15,1,0,16,mixedType,2
14,2,0,16,mixedType,2
6,4,0,10,mixedType,1
3,6,0,9,mixedType,1
7,1,0,8,mixedType,1
7,3,0,10,mixedType,1
8,1,0,9,mixedType,1
11,2,0,13,mixedType,1
6,4,0,10,mixedType,1
5,3,0,8,mixedType,1
7,2,0,9,mixedType,1
6,3,0,9,mixedType,1
3,7,0,10,mixedType,1
13,3,0,16,mixedType,2
5,4,0,9,mixedType,1
2,8,0,10,mixedType,1
9,1,0,10,mixedType,1
4,7,0,11,mixedType,1
5,4,0,9,mixedType,1
11,3,1,15,mixedType,2
13,3,0,16,mixedType,2
5,3,0,8,mixedType,1
1,10,0,11,mixedType,1
8,5,0,13,mixedType,1
12,1,0,13,mixedType,1
6,3,0,9,mixedType,1
5,3,0,8,mixedType,1
9,1,0,10,mixedType,1
6,3,0,9,mixedType,1
3,8,0,11,mixedType,1
7,4,0,11,mixedType,1
5,4,0,9,mixedType,1
4,6,0,10,mixedType,1
8,1,0,9,mixedType,1
5,2,0,7,mixedType,0
6,2,0,8,mixedType,1
6,2,0,8,mixedType,1
8,1,0,9,mixedType,1
8,1,0,9,mixedType,1
14,2,0,16,mixedType,2
7,2,0,9,mixedType,1
6,2,0,8,mixedType,1
11,2,0,13,mixedType,1
7,1,0,8,mixedType,1
4,2,0,6,mixedType,0
11,1,0,12,mixedType,1
5,4,0,9,mixedType,1
5,4,0,9,mixedType,1
6,1,0,7,mixedType,0
2,6,0,8,mixedType,1
7,1,0,8,mixedType,1
6,3,0,9,mixedType,1
8,2,0,10,mixedType,1
5,2,0,7,mixedType,0
10,2,0,12,mixedType,1
5,4,0,9,mixedType,1
4,2,0,6,mixedType,0
6,2,0,8,mixedType,1
7,2,0,9,mixedType,1
7,3,0,10,mixedType,1
5,1,0,6,mixedType,0
9,3,0,12,mixedType,1
9,3,0,12,mixedType,1
13,3,0,16,mixedType,2
6,2,0,8,mixedType,1
7,4,0,11,mixedType,1
6,4,0,10,mixedType,1
5,3,0,8,mixedType,1
12,4,0,16,mixedType,2
14,2,0,16,mixedType,2
10,3,0,13,mixedType,1
6,2,0,8,mixedType,1
8,1,0,9,mixedType,1
5,1,0,6,mixedType,0
8,1,0,9,mixedType,1
8,1,0,9,mixedType,1
7,2,0,9,mixedType,1
5,7,0,12,mixedType,1
7,3,0,10,mixedType,1
6,3,0,9,mixedType,1
8,1,0,9,mixedType,1
7,1,0,8,mixedType,1
6,4,0,10,mixedType,1
8,5,0,13,mixedType,1
7,1,0,8,mixedType,1
6,3,0,9,mixedType,1
6,1,0,7,mixedType,0
2,4,0,6,mixedType,0
8,1,0,9,mixedType,1
3,5,0,8,mixedType,1
8,4,0,12,mixedType,1
5,3,0,8,mixedType,1
13,3,0,16,mixedType,2
6,3,0,9,mixedType,1
8,1,0,9,mixedType,1
2,17,0,19,mixedType,2
3,3,0,6,mixedType,0
6,2,0,8,mixedType,1
9,1,0,10,mixedType,1
6,3,0,9,mixedType,1
7,3,0,10,mixedType,1
7,3,0,10,mixedType,1
4,2,0,6,mixedType,0
5,8,0,13,mixedType,1
8,1,0,9,mixedType,1
6,3,0,9,mixedType,1
5,2,0,7,mixedType,0
7,2,0,9,mixedType,1
7,3,0,10,mixedType,1
4,4,0,8,mixedType,1
5,3,0,8,mixedType,1
1,9,0,10,mixedType,1
6,6,2,14,mixedType,2
7,5,0,12,mixedType,1
11,2,0,13,mixedType,1
15,1,0,16,mixedType,2
6,3,0,9,mixedType,1
6,1,0,7,mixedType,0
9,1,0,10,mixedType,1
3,6,0,9,mixedType,1
8,4,0,12,mixedType,1
5,0,4,9,mixedType,0
9,1,0,10,mixedType,1
4,4,0,8,mixedType,1
4,2,0,6,mixedType,0
9,2,0,11,mixedType,1
13,3,0,16,mixedType,2
12,3,0,15,mixedType,2
5,4,0,9,mixedType,1
5,8,0,13,mixedType,1
12,3,0,15,mixedType,2
6,2,0,8,mixedType,1
7,3,0,10,mixedType,1
5,4,0,9,mixedType,1
1,8,0,9,mixedType,1
14,1,1,16,mixedType,2
7,3,0,10,mixedType,1
6,3,0,9,mixedType,1
4,6,0,10,mixedType,1
5,2,0,7,mixedType,0
5,3,0,8,mixedType,1
7,3,0,10,mixedType,1
2,4,0,6,mixedType,0
6,2,0,8,mixedType,1
5,6,0,11,mixedType,1
7,1,0,8,mixedType,1
8,1,0,9,mixedType,1
6,3,0,9,mixedType,1
6,4,0,10,mixedType,1
5,3,0,8,mixedType,1
8,3,0,11,mixedType,1
6,3,0,9,mixedType,1
7,2,0,9,mixedType,1
9,3,0,12,mixedType,1
5,2,0,7,mixedType,0
14,1,0,15,mixedType,2
5,14,0,19,mixedType,2
15,1,2,18,mixedType,2
0,6,2,8,mixedType,1
5,2,0,7,mixedType,0
5,2,0,7,mixedType,0
15,1,0,16,mixedType,2
2,6,0,8,mixedType,1
5,1,0,6,mixedType,0
6,3,0,9,mixedType,1
5,4,0,9,mixedType,1
7,4,0,11,mixedType,1
9,1,0,10,mixedType,1
9,2,0,11,mixedType,1
10,4,0,14,mixedType,2
5,2,0,7,mixedType,0
3,6,0,9,mixedType,1
9,2,0,11,mixedType,1
8,2,0,10,mixedType,1
6,2,0,8,mixedType,1
6,3,0,9,mixedType,1
8,2,0,10,mixedType,1
5,2,0,7,mixedType,0
5,2,0,7,mixedType,0
7,3,0,10,mixedType,1
4,8,0,12,mixedType,1
2,9,0,11,mixedType,1
9,1,0,10,mixedType,1
9,1,0,10,mixedType,1
5,10,0,15,mixedType,2
4,6,0,10,mixedType,1
2,7,0,9,mixedType,1
10,3,0,13,mixedType,1
6,1,0,7,mixedType,0
4,2,0,6,mixedType,0
6,3,0,9,mixedType,1
7,2,0,9,mixedType,1
7,1,0,8,mixedType,1
8,2,0,10,mixedType,1
8,1,0,9,mixedType,1
2,6,0,8,mixedType,1
8,3,0,11,mixedType,1
4,2,0,6,mixedType,0
6,2,0,8,mixedType,1
6,2,0,8,mixedType,1
6,1,0,7,mixedType,0
6,2,0,8,mixedType,1
6,2,0,8,mixedType,1
5,3,0,8,mixedType,1
4,6,0,10,mixedType,1
1,11,0,12,mixedType,1
9,1,0,10,mixedType,1
6,1,0,7,mixedType,0
2,6,0,8,mixedType,1
1,9,0,10,mixedType,1
6,1,0,7,mixedType,0
4,2,0,6,mixedType,0
8,1,0,9,mixedType,1
14,2,0,16,mixedType,2
5,3,0,8,mixedType,1
7,3,0,10,mixedType,1
11,3,0,14,mixedType,2
8,2,0,10,mixedType,1
6,1,0,7,mixedType,0
6,3,0,9,mixedType,1
8,2,0,10,mixedType,1
7,3,0,10,mixedType,1
6,3,0,9,mixedType,1
2,7,0,9,mixedType,1
5,2,0,7,mixedType,0
9,1,0,10,mixedType,1
8,2,0,10,mixedType,1
6,4,0,10,mixedType,1
14,2,0,16,mixedType,2
6,7,0,13,mixedType,1
6,3,0,9,mixedType,1
6,3,0,9,mixedType,1
7,3,0,10,mixedType,1
6,1,0,7,mixedType,0
12,4,0,16,mixedType,2
7,2,0,9,mixedType,1
6,3,0,9,mixedType,1
6,1,0,7,mixedType,0
9,3,0,12,mixedType,1
9,1,0,10,mixedType,1
4,4,0,8,mixedType,1
17,2,4,23,mixedType,2
10,3,0,13,mixedType,1
3,8,0,11,mixedType,1
7,2,0,9,mixedType,1
18,1,1,20,mixedType,2
10,2,0,12,mixedType,1
7,2,0,9,mixedType,1
5,2,0,7,mixedType,0
3,3,0,6,mixedType,0
8,2,0,10,mixedType,1
7,2,0,9,mixedType,1
8,1,0,9,mixedType,1
6,4,0,10,mixedType,1
7,3,0,10,mixedType,1
6,3,0,9,mixedType,1
6,1,0,7,mixedType,0
7,1,0,8,mixedType,1
6,1,0,7,mixedType,0
4,6,0,10,mixedType,1
5,2,0,7,mixedType,0
15,1,0,16,mixedType,2
8,2,0,10,mixedType,1
11,1,0,12,mixedType,1
2,6,0,8,mixedType,1
9,2,0,11,mixedType,1
5,4,0,9,mixedType,1
6,3,0,9,mixedType,1
7,4,0,11,mixedType,1
4,2,0,6,mixedType,0
5,5,0,10,mixedType,1
5,3,0,8,mixedType,1
3,6,0,9,mixedType,1
2,6,0,8,mixedType,1
6,2,0,8,mixedType,1
6,3,0,9,mixedType,1
2,7,0,9,mixedType,1
5,3,0,8,mixedType,1
5,4,0,9,mixedType,1
6,3,0,9,mixedType,1
8,2,0,10,mixedType,1
6,2,0,8,mixedType,1
5,1,0,6,mixedType,0
6,5,0,11,mixedType,1
8,1,0,9,mixedType,1
6,1,0,7,mixedType,0
8,1,0,9,mixedType,1
7,3,0,10,mixedType,1
5,3,0,8,mixedType,1
5,3,0,8,mixedType,1
5,1,0,6,mixedType,0
8,1,0,9,mixedType,1
7,2,0,9,mixedType,1
7,3,0,10,mixedType,1
2,4,0,6,mixedType,0
6,3,0,9,mixedType,1
5,2,0,7,mixedType,0
14,2,0,16,mixedType,2
6,4,0,10,mixedType,1
6,1,0,7,mixedType,0
2,4,0,6,mixedType,0
1,8,0,9,mixedType,1
6,3,0,9,mixedType,1
9,1,0,10,mixedType,1
5,8,0,13,mixedType,1
6,6,0,12,mixedType,1
13,3,0,16,mixedType,2
11,2,0,13,mixedType,1
7,3,0,10,mixedType,1
8,2,0,10,mixedType,1
5,2,0,7,mixedType,0
1,7,0,8,mixedType,1
11,5,0,16,mixedType,2
2,7,0,9,mixedType,1
8,3,0,11,mixedType,1
7,2,0,9,mixedType,1
6,3,0,9,mixedType,1
5,4,0,9,mixedType,1
10,3,0,13,mixedType,1
9,1,0,10,mixedType,1
8,3,0,11,mixedType,1
6,3,0,9,mixedType,1
10,4,0,14,mixedType,2
5,6,0,11,mixedType,1
8,4,0,12,mixedType,1
4,4,0,8,mixedType,1
7,0,0,7,sameType,0
8,1,0,9,mixedType,1
5,2,0,7,mixedType,0
6,3,0,9,mixedType,1
3,5,0,8,mixedType,1
8,4,0,12,mixedType,1
2,7,0,9,mixedType,1
5,2,0,7,mixedType,0
3,2,0,5,mixedType,0
6,3,0,9,mixedType,1
14,2,0,16,mixedType,2
0,9,0,9,sameType,1
7,3,0,10,mixedType,1
7,3,0,10,mixedType,1
2,8,0,10,mixedType,1
12,3,0,15,mixedType,2
13,3,0,16,mixedType,2
5,1,0,6,mixedType,0
9,4,0,13,mixedType,1
4,4,0,8,mixedType,1
8,1,0,9,mixedType,1
6,3,0,9,mixedType,1
6,3,0,9,mixedType,1
14,2,0,16,mixedType,2
4,4,0,8,mixedType,1
2,6,0,8,mixedType,1
9,3,0,12,mixedType,1
7,3,0,10,mixedType,1
4,4,0,8,mixedType,1
7,2,0,9,mixedType,1
3,5,0,8,mixedType,1
5,2,0,7,mixedType,0
6,3,0,9,mixedType,1
6,3,0,9,mixedType,1
6,4,0,10,mixedType,1
7,3,0,10,mixedType,1
13,3,0,16,mixedType,2
7,3,0,10,mixedType,1
2,4,0,6,mixedType,0
5,1,0,6,mixedType,0
8,2,0,10,mixedType,1
5,3,0,8,mixedType,1
7,2,0,9,mixedType,1
5,3,0,8,mixedType,1
5,2,0,7,mixedType,0
6,4,0,10,mixedType,1
6,3,0,9,mixedType,1
8,2,0,10,mixedType,1
4,6,0,10,mixedType,1
7,1,0,8,mixedType,1
5,3,0,8,mixedType,1
9,2,0,11,mixedType,1
6,6,0,12,mixedType,1
14,2,0,16,mixedType,2
9,1,0,10,mixedType,1
6,3,0,9,mixedType,1
7,3,0,10,mixedType,1
15,1,0,16,mixedType,2
5,3,0,8,mixedType,1
5,2,0,7,mixedType,0
6,3,0,9,mixedType,1
6,2,0,8,mixedType,1
6,2,0,8,mixedType,1
1,8,0,9,mixedType,1
6,1,0,7,mixedType,0
6,4,0,10,mixedType,1
3,6,0,9,mixedType,1
2,6,0,8,mixedType,1
6,3,0,9,mixedType,1
1,7,0,8,mixedType,1
6,2,0,8,mixedType,1
8,2,0,10,mixedType,1
5,1,0,6,mixedType,0
2,8,0,10,mixedType,1
4,2,0,6,mixedType,0
5,4,0,9,mixedType,1
10,4,0,14,mixedType,2
7,2,0,9,mixedType,1
5,7,0,12,mixedType,1
2,4,0,6,mixedType,0
8,4,0,12,mixedType,1
6,3,0,9,mixedType,1
11,2,0,13,mixedType,1
5,2,0,7,mixedType,0
8,3,0,11,mixedType,1
7,2,0,9,mixedType,1
6,3,0,9,mixedType,1
9,3,0,12,mixedType,1
14,2,0,16,mixedType,2
14,2,0,16,mixedType,2
4,8,0,12,mixedType,1
8,2,0,10,mixedType,1
14,2,0,16,mixedType,2
5,3,0,8,mixedType,1
9,1,0,10,mixedType,1
5,4,0,9,mixedType,1
5,3,0,8,mixedType,1
2,7,0,9,mixedType,1
2,4,0,6,mixedType,0
4,6,0,10,mixedType,1
8,2,0,10,mixedType,1
8,3,0,11,mixedType,1
7,3,0,10,mixedType,1
5,7,0,12,mixedType,1
6,1,0,7,mixedType,0
7,6,0,13,mixedType,1
6,3,0,9,mixedType,1
2,6,0,8,mixedType,1
4,2,0,6,mixedType,0
8,4,0,12,mixedType,1
7,1,0,8,mixedType,1
5,1,0,6,mixedType,0
7,2,0,9,mixedType,1
8,2,0,10,mixedType,1
5,3,0,8,mixedType,1
8,2,0,10,mixedType,1
7,3,0,10,mixedType,1
6,3,0,9,mixedType,1
6,2,0,8,mixedType,1
6,1,0,7,mixedType,0
6,6,0,12,mixedType,1
8,1,0,9,mixedType,1
8,3,0,11,mixedType,1
13,3,0,16,mixedType,2
9,4,0,13,mixedType,1
5,1,0,6,mixedType,0
9,3,0,12,mixedType,1
7,3,0,10,mixedType,1
6,3,0,9,mixedType,1
2,6,0,8,mixedType,1
2,8,0,10,mixedType,1
6,1,0,7,mixedType,0
6,3,0,9,mixedType,1
6,2,0,8,mixedType,1
6,2,0,8,mixedType,1
9,1,0,10,mixedType,1
3,5,0,8,mixedType,1
7,3,0,10,mixedType,1
8,4,2,14,mixedType,2
3,10,0,13,mixedType,1
6,2,0,8,mixedType,1
7,2,0,9,mixedType,1
9,1,0,10,mixedType,1
19,1,1,21,mixedType,2
5,3,0,8,mixedType,1
6,1,0,7,mixedType,0
2,6,0,8,mixedType,1
3,8,0,11,mixedType,1
5,3,0,8,mixedType,1
7,2,0,9,mixedType,1
4,2,0,6,mixedType,0
6,1,0,7,mixedType,0
1,8,0,9,mixedType,1
8,2,0,10,mixedType,1
8,4,0,12,mixedType,1
6,6,0,12,mixedType,1
6,3,0,9,mixedType,1
6,1,0,7,mixedType,0
12,4,0,16,mixedType,2
5,4,0,9,mixedType,1
4,4,0,8,mixedType,1
8,4,0,12,mixedType,1
7,6,0,13,mixedType,1
14,2,0,16,mixedType,2
3,8,0,11,mixedType,1
10,1,0,11,mixedType,1
4,2,0,6,mixedType,0
6,3,0,9,mixedType,1
9,3,0,12,mixedType,1
0,6,2,8,mixedType,1
7,3,0,10,mixedType,1
6,3,0,9,mixedType,1
6,2,0,8,mixedType,1
5,11,0,16,mixedType,2
5,1,0,6,mixedType,0
7,2,0,9,mixedType,1
5,3,0,8,mixedType,1
15,1,0,16,mixedType,2
5,4,0,9,mixedType,1
7,3,0,10,mixedType,1
8,2,0,10,mixedType,1
7,3,0,10,mixedType,1
6,1,0,7,mixedType,0
9,0,1,10,mixedType,1
8,1,0,9,mixedType,1
5,2,0,7,mixedType,0
6,3,0,9,mixedType,1
1,7,0,8,mixedType,1
8,1,0,9,mixedType,1
6,3,0,9,mixedType,1
7,1,0,8,mixedType,1
7,1,0,8,mixedType,1
6,3,0,9,mixedType,1
6,2,0,8,mixedType,1
7,1,0,8,mixedType,1
8,2,0,10,mixedType,1
11,5,0,16,mixedType,2
8,1,0,9,mixedType,1
6,1,0,7,mixedType,0
11,3,0,14,mixedType,2
7,3,0,10,mixedType,1
9,1,0,10,mixedType,1
15,1,0,16,mixedType,2
4,4,0,8,mixedType,1
6,2,0,8,mixedType,1
11,3,0,14,mixedType,2
8,3,0,11,mixedType,1
10,2,0,12,mixedType,1
7,1,0,8,mixedType,1
9,3,0,12,mixedType,1
6,4,0,10,mixedType,1
13,3,0,16,mixedType,2
4,4,0,8,mixedType,1
13,3,0,16,mixedType,2
4,6,0,10,mixedType,1
4,2,0,6,mixedType,0
8,1,0,9,mixedType,1
12,4,0,16,mixedType,2
9,4,0,13,mixedType,1
14,11,0,25,mixedType,2
5,2,0,7,mixedType,0
3,6,0,9,mixedType,1
5,2,0,7,mixedType,0
9,1,0,10,mixedType,1
6,4,0,10,mixedType,1
2,6,0,8,mixedType,1
6,1,0,7,mixedType,0
9,1,0,10,mixedType,1
6,2,0,8,mixedType,1
11,3,1,15,mixedType,2
6,6,0,12,mixedType,1
9,3,0,12,mixedType,1
5,5,0,10,mixedType,1
8,2,0,10,mixedType,1
7,3,0,10,mixedType,1
2,8,0,10,mixedType,1
3,3,0,6,mixedType,0
8,1,0,9,mixedType,1
7,3,0,10,mixedType,1
8,1,0,9,mixedType,1
6,4,0,10,mixedType,1
7,1,0,8,mixedType,1
8,4,0,12,mixedType,1
4,4,0,8,mixedType,1
15,1,0,16,mixedType,2
9,1,0,10,mixedType,1
9,1,0,10,mixedType,1
8,3,0,11,mixedType,1
7,3,0,10,mixedType,1
1,8,0,9,mixedType,1
13,3,0,16,mixedType,2
7,3,0,10,mixedType,1
7,1,0,8,mixedType,1
4,4,0,8,mixedType,1
4,2,0,6,mixedType,0
8,2,0,10,mixedType,1
6,3,0,9,mixedType,1
6,3,0,9,mixedType,1
7,3,0,10,mixedType,1
9,2,0,11,mixedType,1
5,4,0,9,mixedType,1
11,1,0,12,mixedType,1
7,1,0,8,mixedType,1
1,8,0,9,mixedType,1
7,1,0,8,mixedType,1
5,5,0,10,mixedType,1
5,4,0,9,mixedType,1
6,2,0,8,mixedType,1
9,4,0,13,mixedType,1
6,3,0,9,mixedType,1
6,3,0,9,mixedType,1
12,3,0,15,mixedType,2
5,3,0,8,mixedType,1
14,2,0,16,mixedType,2
7,1,0,8,mixedType,1
6,1,0,7,mixedType,0
6,3,0,9,mixedType,1
12,1,1,14,mixedType,2
6,3,0,9,mixedType,1
7,3,0,10,mixedType,1
5,6,0,11,mixedType,1
9,2,0,11,mixedType,1
8,1,0,9,mixedType,1
3,7,0,10,mixedType,1
9,2,0,11,mixedType,1
9,1,0,10,mixedType,1
1,8,0,9,mixedType,1
7,1,0,8,mixedType,1
3,5,0,8,mixedType,1
6,4,0,10,mixedType,1
8,6,2,16,mixedType,2
6,4,0,10,mixedType,1
9,3,0,12,mixedType,1
2,6,0,8,mixedType,1
6,1,0,7,mixedType,0
6,3,0,9,mixedType,1
7,1,0,8,mixedType,1
13,3,0,16,mixedType,2
10,1,0,11,mixedType,1
6,2,0,8,mixedType,1
11,4,0,15,mixedType,2
12,3,0,15,mixedType,2
6,4,0,10,mixedType,1
4,2,0,6,mixedType,0
5,3,0,8,mixedType,1
15,1,0,16,mixedType,2
1,8,0,9,mixedType,1
5,3,0,8,mixedType,1
12,4,0,16,mixedType,2
6,3,0,9,mixedType,1
5,6,0,11,mixedType,1
6,3,0,9,mixedType,1
5,4,0,9,mixedType,1
7,2,0,9,mixedType,1
6,2,0,8,mixedType,1
7,2,0,9,mixedType,1
4,4,0,8,mixedType,1
1,9,0,10,mixedType,1
5,4,0,9,mixedType,1
7,3,0,10,mixedType,1
7,3,0,10,mixedType,1
6,1,0,7,mixedType,0
5,3,0,8,mixedType,1
9,4,0,13,mixedType,1
8,2,0,10,mixedType,1
8,4,0,12,mixedType,1
3,8,0,11,mixedType,1
8,1,0,9,mixedType,1
8,1,0,9,mixedType,1
14,2,0,16,mixedType,2
5,2,0,7,mixedType,0
10,1,0,11,mixedType,1
12,4,0,16,mixedType,2
4,2,0,6,mixedType,0
7,2,0,9,mixedType,1
15,1,0,16,mixedType,2
6,5,0,11,mixedType,1
4,2,0,6,mixedType,0
6,5,0,11,mixedType,1
6,4,0,10,mixedType,1
4,6,0,10,mixedType,1
6,1,0,7,mixedType,0
6,3,0,9,mixedType,1
8,1,0,9,mixedType,1
7,3,0,10,mixedType,1
7,3,0,10,mixedType,1
6,2,0,8,mixedType,1
3,7,0,10,mixedType,1
8,1,0,9,mixedType,1
5,6,0,11,mixedType,1
7,3,0,10,mixedType,1
9,4,0,13,mixedType,1
6,4,0,10,mixedType,1
8,2,0,10,mixedType,1
7,3,0,10,mixedType,1
6,5,0,11,mixedType,1
2,6,0,8,mixedType,1
6,4,0,10,mixedType,1
14,2,0,16,mixedType,2
9,2,0,11,mixedType,1
13,3,0,16,mixedType,2
8,1,0,9,mixedType,1
8,1,0,9,mixedType,1
7,3,0,10,mixedType,1
8,2,0,10,mixedType,1
1,8,0,9,mixedType,1
2,6,0,8,mixedType,1
11,2,0,13,mixedType,1
5,2,0,7,mixedType,0
5,1,0,6,mixedType,0
4,4,0,8,mixedType,1
7,2,0,9,mixedType,1
6,3,0,9,mixedType,1
7,3,0,10,mixedType,1
4,4,0,8,mixedType,1
9,1,0,10,mixedType,1
1,9,0,10,mixedType,1
4,5,0,9,mixedType,1
1,8,0,9,mixedType,1
11,3,0,14,mixedType,2
7,3,0,10,mixedType,1
7,1,0,8,mixedType,1
4,4,0,8,mixedType,1
8,1,0,9,mixedType,1
6,4,0,10,mixedType,1
6,4,0,10,mixedType,1
6,2,0,8,mixedType,1
6,2,0,8,mixedType,1
6,4,0,10,mixedType,1
3,5,0,8,mixedType,1
3,6,0,9,mixedType,1
1,9,0,10,mixedType,1
6,4,0,10,mixedType,1
13,3,0,16,mixedType,2
8,2,0,10,mixedType,1
8,3,0,11,mixedType,1
9,1,0,10,mixedType,1
7,3,0,10,mixedType,1
6,2,0,8,mixedType,1
10,4,0,14,mixedType,2
6,4,0,10,mixedType,1
2,6,0,8,mixedType,1
6,5,0,11,mixedType,1
5,3,0,8,mixedType,1
8,3,0,11,mixedType,1
4,5,0,9,mixedType,1
6,3,0,9,mixedType,1
7,2,0,9,mixedType,1
6,4,0,10,mixedType,1
4,2,0,6,mixedType,0
15,1,0,16,mixedType,2
13,3,0,16,mixedType,2
6,4,0,10,mixedType,1
5,2,0,7,mixedType,0
15,1,0,16,mixedType,2
6,4,0,10,mixedType,1
13,3,0,16,mixedType,2
6,2,0,8,mixedType,1
9,4,0,13,mixedType,1
6,1,0,7,mixedType,0
7,3,0,10,mixedType,1
7,1,0,8,mixedType,1
7,2,0,9,mixedType,1
7,3,0,10,mixedType,1
8,3,0,11,mixedType,1
5,2,0,7,mixedType,0
6,1,0,7,mixedType,0
11,2,0,13,mixedType,1
4,2,0,6,mixedType,0
6,4,0,10,mixedType,1
9,0,1,10,mixedType,1
7,1,0,8,mixedType,1
5,3,0,8,mixedType,1
4,6,0,10,mixedType,1
7,2,0,9,mixedType,1
4,6,0,10,mixedType,1
4,6,0,10,mixedType,1
8,1,0,9,mixedType,1
8,4,0,12,mixedType,1
1,5,0,6,mixedType,0
5,2,0,7,mixedType,0
7,3,0,10,mixedType,1
6,2,0,8,mixedType,1
6,6,0,12,mixedType,1
5,2,0,7,mixedType,0
9,2,0,11,mixedType,1
10,1,0,11,mixedType,1
1,9,0,10,mixedType,1
15,1,0,16,mixedType,2
9,2,0,11,mixedType,1
1,11,0,12,mixedType,1
7,3,0,10,mixedType,1
5,2,0,7,mixedType,0
5,3,0,8,mixedType,1
14,2,0,16,mixedType,2
7,4,0,11,mixedType,1
5,3,0,8,mixedType,1
6,1,0,7,mixedType,0
4,2,0,6,mixedType,0
6,3,0,9,mixedType,1
10,0,1,11,mixedType,1
5,4,0,9,mixedType,1
9,1,0,10,mixedType,1
5,1,0,6,mixedType,0
13,3,0,16,mixedType,2
5,4,0,9,mixedType,1
4,4,0,8,mixedType,1
15,1,0,16,mixedType,2
4,2,0,6,mixedType,0
12,1,0,13,mixedType,1
6,2,0,8,mixedType,1
3,5,0,8,mixedType,1
5,4,0,9,mixedType,1
7,3,0,10,mixedType,1
7,3,0,10,mixedType,1
19,1,0,20,mixedType,2
6,2,0,8,mixedType,1
6,2,0,8,mixedType,1
7,1,0,8,mixedType,1
13,3,0,16,mixedType,2
9,3,0,12,mixedType,1
14,2,0,16,mixedType,2
15,1,0,16,mixedType,2
6,3,0,9,mixedType,1
4,2,0,6,mixedType,0
3,7,0,10,mixedType,1
4,6,0,10,mixedType,1
5,4,0,9,mixedType,1
5,2,0,7,mixedType,0
4,4,0,8,mixedType,1
5,6,0,11,mixedType,1
6,6,0,12,mixedType,1
5,4,0,9,mixedType,1
7,3,0,10,mixedType,1
9,4,0,13,mixedType,1
6,3,0,9,mixedType,1
10,2,0,12,mixedType,1
6,6,0,12,mixedType,1
3,6,0,9,mixedType,1
4,2,0,6,mixedType,0
5,7,0,12,mixedType,1
6,3,0,9,mixedType,1
5,2,0,7,mixedType,0
6,1,0,7,mixedType,0
10,3,0,13,mixedType,1
6,3,0,9,mixedType,1
7,2,0,9,mixedType,1
7,1,0,8,mixedType,1
6,1,0,7,mixedType,0
7,2,0,9,mixedType,1
6,2,0,8,mixedType,1
6,4,0,10,mixedType,1
1,9,0,10,mixedType,1
4,4,0,8,mixedType,1
4,4,0,8,mixedType,1
3,7,0,10,mixedType,1
5,6,0,11,mixedType,1
13,3,0,16,mixedType,2
6,2,0,8,mixedType,1
13,4,1,18,mixedType,2
8,4,0,12,mixedType,1
8,2,0,10,mixedType,1
4,2,0,6,mixedType,0
6,4,0,10,mixedType,1
4,2,0,6,mixedType,0
7,4,0,11,mixedType,1
2,6,0,8,mixedType,1
4,6,0,10,mixedType,1
6,1,0,7,mixedType,0
5,6,0,11,mixedType,1
6,3,0,9,mixedType,1
4,4,0,8,mixedType,1
1,8,0,9,mixedType,1
6,3,0,9,mixedType,1
5,5,0,10,mixedType,1
7,1,0,8,mixedType,1
7,1,0,8,mixedType,1
7,3,0,10,mixedType,1
1,8,0,9,mixedType,1
5,5,0,10,mixedType,1
4,2,0,6,mixedType,0
4,2,0,6,mixedType,0
9,2,0,11,mixedType,1
6,1,0,7,mixedType,0
7,1,0,8,mixedType,1
7,4,0,11,mixedType,1
5,3,0,8,mixedType,1
15,1,0,16,mixedType,2
14,2,0,16,mixedType,2
13,3,0,16,mixedType,2
6,2,0,8,mixedType,1
2,7,0,9,mixedType,1
10,2,2,14,mixedType,2
9,2,0,11,mixedType,1
7,3,0,10,mixedType,1
4,4,0,8,mixedType,1
10,2,0,12,mixedType,1
5,4,0,9,mixedType,1
7,1,0,8,mixedType,1
9,1,0,10,mixedType,1
6,2,0,8,mixedType,1
1,7,0,8,mixedType,1
1,9,0,10,mixedType,1
4,4,0,8,mixedType,1
14,2,0,16,mixedType,2
6,3,0,9,mixedType,1
6,6,0,12,mixedType,1
8,4,0,12,mixedType,1
13,3,0,16,mixedType,2
4,2,0,6,mixedType,0
10,3,0,13,mixedType,1
7,2,0,9,mixedType,1
9,2,0,11,mixedType,1
6,4,0,10,mixedType,1
5,2,0,7,mixedType,0
8,1,0,9,mixedType,1
7,3,0,10,mixedType,1
3,7,0,10,mixedType,1
4,5,0,9,mixedType,1
6,2,0,8,mixedType,1
7,1,0,8,mixedType,1
7,1,0,8,mixedType,1
5,2,0,7,mixedType,0
3,3,0,6,mixedType,0
5,2,0,7,mixedType,0
6,2,0,8,mixedType,1
5,3,0,8,mixedType,1
1,9,0,10,mixedType,1
3,6,0,9,mixedType,1
5,5,0,10,mixedType,1
9,1,0,10,mixedType,1
2,8,0,10,mixedType,1
6,1,0,7,mixedType,0
6,2,0,8,mixedType,1
2,6,0,8,mixedType,1
6,1,0,7,mixedType,0
18,1,1,20,mixedType,2
4,4,0,8,mixedType,1
8,3,0,11,mixedType,1
7,4,0,11,mixedType,1
6,1,0,7,mixedType,0
11,2,0,13,mixedType,1
9,2,0,11,mixedType,1
10,2,0,12,mixedType,1
1,8,0,9,mixedType,1
13,3,0,16,mixedType,2
6,4,0,10,mixedType,1
4,4,0,8,mixedType,1
8,2,0,10,mixedType,1
7,3,0,10,mixedType,1
7,3,0,10,mixedType,1
8,2,0,10,mixedType,1
2,8,0,10,mixedType,1
6,3,0,9,mixedType,1
9,1,0,10,mixedType,1
7,2,0,9,mixedType,1
15,1,0,16,mixedType,2
15,1,0,16,mixedType,2
7,1,0,8,mixedType,1
1,8,0,9,mixedType,1
11,5,0,16,mixedType,2
9,1,0,10,mixedType,1
8,1,0,9,mixedType,1
7,6,0,13,mixedType,1
6,6,0,12,mixedType,1
9,1,0,10,mixedType,1
7,3,0,10,mixedType,1
15,1,0,16,mixedType,2
5,2,0,7,mixedType,0
14,2,0,16,mixedType,2
4,4,0,8,mixedType,1
10,2,0,12,mixedType,1
3,3,0,6,mixedType,0
8,2,0,10,mixedType,1
4,2,0,6,mixedType,0
7,5,0,12,mixedType,1
11,1,0,12,mixedType,1
9,1,0,10,mixedType,1
2,4,0,6,mixedType,0
5,3,0,8,mixedType,1
5,1,0,6,mixedType,0
10,3,0,13,mixedType,1
6,3,0,9,mixedType,1
9,2,0,11,mixedType,1
5,3,0,8,mixedType,1
5,4,0,9,mixedType,1
8,2,0,10,mixedType,1
6,4,0,10,mixedType,1
5,2,0,7,mixedType,0
6,2,0,8,mixedType,1
14,2,0,16,mixedType,2
5,2,0,7,mixedType,0
6,2,0,8,mixedType,1
0,8,2,10,mixedType,1
10,2,0,12,mixedType,1
8,4,0,12,mixedType,1
5,3,0,8,mixedType,1
14,2,0,16,mixedType,2
6,3,0,9,mixedType,1
12,4,0,16,mixedType,2
7,3,0,10,mixedType,1
16,2,0,18,mixedType,2
7,3,0,10,mixedType,1
6,1,0,7,mixedType,0
6,0,2,8,mixedType,0
6,2,0,8,mixedType,1
8,2,0,10,mixedType,1
9,1,0,10,mixedType,1
5,3,0,8,mixedType,1
5,3,0,8,mixedType,1
9,3,0,12,mixedType,1
6,3,0,9,mixedType,1
5,2,0,7,mixedType,0
6,4,0,10,mixedType,1
4,5,0,9,mixedType,1
5,1,0,6,mixedType,0
2,8,0,10,mixedType,1
1,7,0,8,mixedType,1
7,1,0,8,mixedType,1
8,4,0,12,mixedType,1
8,1,0,9,mixedType,1
5,3,0,8,mixedType,1
10,1,0,11,mixedType,1
5,3,0,8,mixedType,1
7,5,2,14,mixedType,2
5,2,0,7,mixedType,0
8,0,3,11,mixedType,1
8,6,0,14,mixedType,2
7,3,0,10,mixedType,1
6,3,0,9,mixedType,1
3,7,0,10,mixedType,1
6,3,0,9,mixedType,1
7,3,0,10,mixedType,1
4,4,0,8,mixedType,1
7,3,0,10,mixedType,1
5,2,0,7,mixedType,0
11,1,0,12,mixedType,1
8,2,0,10,mixedType,1
3,6,0,9,mixedType,1
8,4,0,12,mixedType,1
1,8,0,9,mixedType,1
6,3,0,9,mixedType,1
4,2,0,6,mixedType,0
4,2,0,6,mixedType,0
10,1,0,11,mixedType,1
8,1,0,9,mixedType,1
8,2,0,10,mixedType,1
8,2,0,10,mixedType,1
6,4,0,10,mixedType,1
1,7,0,8,mixedType,1
8,1,0,9,mixedType,1
12,3,0,15,mixedType,2
4,4,0,8,mixedType,1
7,2,0,9,mixedType,1
10,1,0,11,mixedType,1
5,1,0,6,mixedType,0
9,0,1,10,mixedType,1
7,4,0,11,mixedType,1
3,6,0,9,mixedType,1
3,7,0,10,mixedType,1
5,2,0,7,mixedType,0
6,3,0,9,mixedType,1
8,4,0,12,mixedType,1
10,3,0,13,mixedType,1
13,3,0,16,mixedType,2
8,3,0,11,mixedType,1
8,3,0,11,mixedType,1
8,9,0,17,mixedType,2
8,2,0,10,mixedType,1
7,1,0,8,mixedType,1
4,6,0,10,mixedType,1
3,11,1,15,mixedType,2
6,2,0,8,mixedType,1
6,3,0,9,mixedType,1
9,1,0,10,mixedType,1
7,3,0,10,mixedType,1
12,4,0,16,mixedType,2
4,2,0,6,mixedType,0
7,2,0,9,mixedType,1
7,3,0,10,mixedType,1
6,2,0,8,mixedType,1
2,7,0,9,mixedType,1
6,4,0,10,mixedType,1
6,2,0,8,mixedType,1
7,3,0,10,mixedType,1
5,4,0,9,mixedType,1
15,4,1,20,mixedType,2
12,4,0,16,mixedType,2
7,3,0,10,mixedType,1
8,1,0,9,mixedType,1
3,5,0,8,mixedType,1
9,4,0,13,mixedType,1
8,1,0,9,mixedType,1
9,2,0,11,mixedType,1
6,1,0,7,mixedType,0
5,1,0,6,mixedType,0
4,4,0,8,mixedType,1
5,2,0,7,mixedType,0
2,5,0,7,mixedType,0
6,2,0,8,mixedType,1
5,1,0,6,mixedType,0
3,6,0,9,mixedType,1
6,2,0,8,mixedType,1
8,2,0,10,mixedType,1
14,2,0,16,mixedType,2
14,2,0,16,mixedType,2
6,2,0,8,mixedType,1
5,2,0,7,mixedType,0
4,2,0,6,mixedType,0
6,2,0,8,mixedType,1
5,3,0,8,mixedType,1
10,2,0,12,mixedType,1
7,2,0,9,mixedType,1
6,3,0,9,mixedType,1
7,2,0,9,mixedType,1
2,6,0,8,mixedType,1
3,5,0,8,mixedType,1
8,4,0,12,mixedType,1
7,3,0,10,mixedType,1
12,3,0,15,mixedType,2
6,2,0,8,mixedType,1
3,6,0,9,mixedType,1
7,4,0,11,mixedType,1
5,2,0,7,mixedType,0
1,8,0,9,mixedType,1
5,2,0,7,mixedType,0
13,3,0,16,mixedType,2
7,3,0,10,mixedType,1
5,1,0,6,mixedType,0
6,1,0,7,mixedType,0
6,2,0,8,mixedType,1
12,2,1,15,mixedType,2
7,1,0,8,mixedType,1
4,2,0,6,mixedType,0
13,3,0,16,mixedType,2
7,1,0,8,mixedType,1
5,4,0,9,mixedType,1
9,0,1,10,mixedType,1
5,1,0,6,mixedType,0
5,4,0,9,mixedType,1
7,2,0,9,mixedType,1
6,6,0,12,mixedType,1
8,2,0,10,mixedType,1
6,7,1,14,mixedType,2
0,8,1,9,mixedType,1
14,2,0,16,mixedType,2
8,1,0,9,mixedType,1
8,4,0,12,mixedType,1
8,1,0,9,mixedType,1
4,6,0,10,mixedType,1
7,2,0,9,mixedType,1
2,8,0,10,mixedType,1
8,2,0,10,mixedType,1
2,6,0,8,mixedType,1
7,6,1,14,mixedType,2
10,1,0,11,mixedType,1
6,3,0,9,mixedType,1
6,3,0,9,mixedType,1
7,1,0,8,mixedType,1
6,3,0,9,mixedType,1
3,3,0,6,mixedType,0
5,4,0,9,mixedType,1
6,4,0,10,mixedType,1
6,3,0,9,mixedType,1
5,1,0,6,mixedType,0
5,4,0,9,mixedType,1
2,6,0,8,mixedType,1
5,4,0,9,mixedType,1
7,2,0,9,mixedType,1
13,3,0,16,mixedType,2
6,2,0,8,mixedType,1
8,4,0,12,mixedType,1
8,1,0,9,mixedType,1
8,3,0,11,mixedType,1
6,3,0,9,mixedType,1
1,8,0,9,mixedType,1
13,3,0,16,mixedType,2
5,4,0,9,mixedType,1
1,8,0,9,mixedType,1
8,1,0,9,mixedType,1
6,1,0,7,mixedType,0
3,7,0,10,mixedType,1
3,6,0,9,mixedType,1
5,3,0,8,mixedType,1
9,1,0,10,mixedType,1
6,3,0,9,mixedType,1
6,3,0,9,mixedType,1
5,2,0,7,mixedType,0
6,3,0,9,mixedType,1
7,4,0,11,mixedType,1
5,8,0,13,mixedType,1
13,3,0,16,mixedType,2
8,4,0,12,mixedType,1
8,3,0,11,mixedType,1
6,2,0,8,mixedType,1
8,2,0,10,mixedType,1
5,3,0,8,mixedType,1
15,1,0,16,mixedType,2
7,3,0,10,mixedType,1
6,2,0,8,mixedType,1
3,6,0,9,mixedType,1
11,3,0,14,mixedType,2
7,3,0,10,mixedType,1
8,8,2,18,mixedType,2
15,1,0,16,mixedType,2
8,2,0,10,mixedType,1
5,3,0,8,mixedType,1
5,6,0,11,mixedType,1
2,7,0,9,mixedType,1
4,6,0,10,mixedType,1
7,2,0,9,mixedType,1
14,2,0,16,mixedType,2
6,2,0,8,mixedType,1
12,4,0,16,mixedType,2
9,3,0,12,mixedType,1
6,1,0,7,mixedType,0
2,6,0,8,mixedType,1
4,4,0,8,mixedType,1
6,3,0,9,mixedType,1
9,3,0,12,mixedType,1
4,2,0,6,mixedType,0
7,2,0,9,mixedType,1
5,5,0,10,mixedType,1
4,6,0,10,mixedType,1
3,3,0,6,mixedType,0
4,4,0,8,mixedType,1
8,1,0,9,mixedType,1
9,1,0,10,mixedType,1
6,4,0,10,mixedType,1
13,3,0,16,mixedType,2
8,1,0,9,mixedType,1
4,2,0,6,mixedType,0
6,2,0,8,mixedType,1
15,1,0,16,mixedType,2
7,4,0,11,mixedType,1
6,1,0,7,mixedType,0
8,1,0,9,mixedType,1
6,3,0,9,mixedType,1
7,3,0,10,mixedType,1
8,2,0,10,mixedType,1
4,4,0,8,mixedType,1
4,6,0,10,mixedType,1
7,2,0,9,mixedType,1
6,1,0,7,mixedType,0
4,7,0,11,mixedType,1
10,2,0,12,mixedType,1
2,6,0,8,mixedType,1
8,1,0,9,mixedType,1
6,1,0,7,mixedType,0
3,8,0,11,mixedType,1
5,5,0,10,mixedType,1
8,6,0,14,mixedType,2
2,7,0,9,mixedType,1
10,4,0,14,mixedType,2
6,2,0,8,mixedType,1
7,3,0,10,mixedType,1
4,8,0,12,mixedType,1
7,2,0,9,mixedType,1
6,3,0,9,mixedType,1
6,4,0,10,mixedType,1
6,1,0,7,mixedType,0
2,6,0,8,mixedType,1
5,2,0,7,mixedType,0
5,6,0,11,mixedType,1
8,2,0,10,mixedType,1
6,2,0,8,mixedType,1
12,4,0,16,mixedType,2
4,5,0,9,mixedType,1
5,1,0,6,mixedType,0
5,3,0,8,mixedType,1
6,1,0,7,mixedType,0
1,8,0,9,mixedType,1
12,3,0,15,mixedType,2
4,2,0,6,mixedType,0
4,2,0,6,mixedType,0
7,2,0,9,mixedType,1
5,3,0,8,mixedType,1
5,3,0,8,mixedType,1
7,1,0,8,mixedType,1
9,3,0,12,mixedType,1
6,6,0,12,mixedType,1
12,2,1,15,mixedType,2
16,3,0,19,mixedType,2
10,2,0,12,mixedType,1
9,3,0,12,mixedType,1
5,4,0,9,mixedType,1
2,8,0,10,mixedType,1
11,3,0,14,mixedType,2
11,1,0,12,mixedType,1
7,3,0,10,mixedType,1
5,1,0,6,mixedType,0
9,4,0,13,mixedType,1
13,3,0,16,mixedType,2
4,2,0,6,mixedType,0
6,3,0,9,mixedType,1
8,2,0,10,mixedType,1
7,6,0,13,mixedType,1
8,1,0,9,mixedType,1
9,1,0,10,mixedType,1
5,6,0,11,mixedType,1
8,2,0,10,mixedType,1
8,2,0,10,mixedType,1
7,3,0,10,mixedType,1
5,2,0,7,mixedType,0
3,5,0,8,mixedType,1
12,1,0,13,mixedType,1
4,2,0,6,mixedType,0
5,3,0,8,mixedType,1
6,3,0,9,mixedType,1
8,1,0,9,mixedType,1
8,1,0,9,mixedType,1
13,3,0,16,mixedType,2
6,3,0,9,mixedType,1
15,1,0,16,mixedType,2
14,2,0,16,mixedType,2
7,3,0,10,mixedType,1
5,6,0,11,mixedType,1
6,6,0,12,mixedType,1
9,2,0,11,mixedType,1
13,2,0,15,mixedType,2
9,2,0,11,mixedType,1
9,2,0,11,mixedType,1
14,2,0,16,mixedType,2
5,8,0,13,mixedType,1
8,3,0,11,mixedType,1
8,1,0,9,mixedType,1
12,3,0,15,mixedType,2
6,3,0,9,mixedType,1
8,1,0,9,mixedType,1
6,2,0,8,mixedType,1
6,2,0,8,mixedType,1
2,6,0,8,mixedType,1
12,1,0,13,mixedType,1
6,3,0,9,mixedType,1
7,2,0,9,mixedType,1
8,1,0,9,mixedType,1
6,3,0,9,mixedType,1
12,3,0,15,mixedType,2
8,3,0,11,mixedType,1
4,4,0,8,mixedType,1
8,2,0,10,mixedType,1
6,2,0,8,mixedType,1
6,4,0,10,mixedType,1
8,1,0,9,mixedType,1
6,1,0,7,mixedType,0
7,2,0,9,mixedType,1
8,2,0,10,mixedType,1
1,9,0,10,mixedType,1
7,2,0,9,mixedType,1
5,4,0,9,mixedType,1
7,2,0,9,mixedType,1
6,3,0,9,mixedType,1
8,4,0,12,mixedType,1
7,2,0,9,mixedType,1
7,2,0,9,mixedType,1
5,4,0,9,mixedType,1
4,4,0,8,mixedType,1
8,3,0,11,mixedType,1
7,1,0,8,mixedType,1
1,7,0,8,mixedType,1
8,1,0,9,mixedType,1
6,1,0,7,mixedType,0
8,4,0,12,mixedType,1
8,2,0,10,mixedType,1
6,3,0,9,mixedType,1
8,2,0,10,mixedType,1
3,5,0,8,mixedType,1
8,5,0,13,mixedType,1
6,3,0,9,mixedType,1
10,1,0,11,mixedType,1
5,4,0,9,mixedType,1
9,1,0,10,mixedType,1
6,2,0,8,mixedType,1
5,1,0,6,mixedType,0
7,5,0,12,mixedType,1
6,2,0,8,mixedType,1
2,6,0,8,mixedType,1
15,1,0,16,mixedType,2
5,10,0,15,mixedType,2
7,1,0,8,mixedType,1
9,1,0,10,mixedType,1
5,2,0,7,mixedType,0
3,10,0,13,mixedType,1
6,4,0,10,mixedType,1
8,3,0,11,mixedType,1
4,2,0,6,mixedType,0
5,2,0,7,mixedType,0
13,3,0,16,mixedType,2
3,3,0,6,mixedType,0
7,2,0,9,mixedType,1
6,2,0,8,mixedType,1
2,6,0,8,mixedType,1
8,1,0,9,mixedType,1
7,2,0,9,mixedType,1
5,4,0,9,mixedType,1
4,6,0,10,mixedType,1
7,3,0,10,mixedType,1
7,4,0,11,mixedType,1
12,3,0,15,mixedType,2
7,1,0,8,mixedType,1
5,2,0,7,mixedType,0
5,1,0,6,mixedType,0
11,3,0,14,mixedType,2
4,6,0,10,mixedType,1
9,3,0,12,mixedType,1
14,2,0,16,mixedType,2
7,2,0,9,mixedType,1
4,2,0,6,mixedType,0
13,3,0,16,mixedType,2
5,3,0,8,mixedType,1
6,3,0,9,mixedType,1
7,2,0,9,mixedType,1
9,0,1,10,mixedType,1
6,4,0,10,mixedType,1
14,2,0,16,mixedType,2
5,2,0,7,mixedType,0
6,1,0,7,mixedType,0
9,2,0,11,mixedType,1
4,4,0,8,mixedType,1
5,4,0,9,mixedType,1
5,3,0,8,mixedType,1
9,1,0,10,mixedType,1
13,3,0,16,mixedType,2
4,2,0,6,mixedType,0
8,1,0,9,mixedType,1
10,4,0,14,mixedType,2
6,7,1,14,mixedType,2
12,4,0,16,mixedType,2
13,3,0,16,mixedType,2
6,2,0,8,mixedType,1
2,6,0,8,mixedType,1
4,4,0,8,mixedType,1
6,4,0,10,mixedType,1
8,2,0,10,mixedType,1
6,2,0,8,mixedType,1
9,1,0,10,mixedType,1
5,3,0,8,mixedType,1
7,7,0,14,mixedType,2
13,2,0,15,mixedType,2
3,6,0,9,mixedType,1
9,2,0,11,mixedType,1
5,4,0,9,mixedType,1
6,2,0,8,mixedType,1
10,1,0,11,mixedType,1
3,3,0,6,mixedType,0
9,3,0,12,mixedType,1
13,10,0,23,mixedType,2
8,2,0,10,mixedType,1
8,2,0,10,mixedType,1
8,5,0,13,mixedType,1
4,8,0,12,mixedType,1
5,3,0,8,mixedType,1
7,3,0,10,mixedType,1
6,3,0,9,mixedType,1
8,2,0,10,mixedType,1
14,2,0,16,mixedType,2
7,3,0,10,mixedType,1
6,3,0,9,mixedType,1
5,2,0,7,mixedType,0
9,3,0,12,mixedType,1
5,2,0,7,mixedType,0
7,2,0,9,mixedType,1
10,3,0,13,mixedType,1
8,2,0,10,mixedType,1
2,7,0,9,mixedType,1
11,1,0,12,mixedType,1
10,1,0,11,mixedType,1
3,6,0,9,mixedType,1
7,2,0,9,mixedType,1
8,1,0,9,mixedType,1
4,6,0,10,mixedType,1
8,2,0,10,mixedType,1
9,1,0,10,mixedType,1
8,2,0,10,mixedType,1
15,1,0,16,mixedType,2
7,3,0,10,mixedType,1
15,1,0,16,mixedType,2
10,3,0,13,mixedType,1
5,5,0,10,mixedType,1
6,3,0,9,mixedType,1
6,2,0,8,mixedType,1
4,2,0,6,mixedType,0
6,1,0,7,mixedType,0
6,3,0,9,mixedType,1
2,7,0,9,mixedType,1
5,0,1,6,mixedType,0
5,3,0,8,mixedType,1
3,5,0,8,mixedType,1
9,1,0,10,mixedType,1
5,2,0,7,mixedType,0
10,2,0,12,mixedType,1
3,5,0,8,mixedType,1
8,1,0,9,mixedType,1
5,3,0,8,mixedType,1
9,3,0,12,mixedType,1
9,2,0,11,mixedType,1
14,2,0,16,mixedType,2
7,6,0,13,mixedType,1
7,2,0,9,mixedType,1
5,3,0,8,mixedType,1
5,3,0,8,mixedType,1
4,2,0,6,mixedType,0
5,2,0,7,mixedType,0
6,4,0,10,mixedType,1
7,1,0,8,mixedType,1
7,2,0,9,mixedType,1
7,3,0,10,mixedType,1
5,3,0,8,mixedType,1
2,4,0,6,mixedType,0
8,2,0,10,mixedType,1
5,2,0,7,mixedType,0
14,2,0,16,mixedType,2
11,1,0,12,mixedType,1
7,3,0,10,mixedType,1
6,2,0,8,mixedType,1
12,4,0,16,mixedType,2
6,3,0,9,mixedType,1
4,6,0,10,mixedType,1
5,2,0,7,mixedType,0
5,2,0,7,mixedType,0
4,9,0,13,mixedType,1
5,2,0,7,mixedType,0
6,2,0,8,mixedType,1
7,2,0,9,mixedType,1
5,4,0,9,mixedType,1
2,10,0,12,mixedType,1
7,4,0,11,mixedType,1
6,0,1,7,mixedType,0
5,3,0,8,mixedType,1
9,3,0,12,mixedType,1
5,2,0,7,mixedType,0
5,2,0,7,mixedType,0
12,3,0,15,mixedType,2
5,3,0,8,mixedType,1
6,2,0,8,mixedType,1
5,2,0,7,mixedType,0
7,2,0,9,mixedType,1
5,4,0,9,mixedType,1
10,1,0,11,mixedType,1
3,7,0,10,mixedType,1
5,3,0,8,mixedType,1
14,2,0,16,mixedType,2
13,3,0,16,mixedType,2
7,2,0,9,mixedType,1
6,3,0,9,mixedType,1
6,2,0,8,mixedType,1
8,2,0,10,mixedType,1
5,4,0,9,mixedType,1
9,2,0,11,mixedType,1
6,1,0,7,mixedType,0
5,4,0,9,mixedType,1
5,5,0,10,mixedType,1
6,1,0,7,mixedType,0
2,8,0,10,mixedType,1
6,2,0,8,mixedType,1
5,3,0,8,mixedType,1
7,6,0,13,mixedType,1
7,1,0,8,mixedType,1
2,6,0,8,mixedType,1
11,2,0,13,mixedType,1
15,1,0,16,mixedType,2
5,3,0,8,mixedType,1
6,3,0,9,mixedType,1
5,3,0,8,mixedType,1
7,4,0,11,mixedType,1
13,3,0,16,mixedType,2
8,2,0,10,mixedType,1
5,3,0,8,mixedType,1
7,2,0,9,mixedType,1
12,4,0,16,mixedType,2
2,6,0,8,mixedType,1
11,5,0,16,mixedType,2
5,2,0,7,mixedType,0
5,4,0,9,mixedType,1
6,2,0,8,mixedType,1
4,7,0,11,mixedType,1
7,2,0,9,mixedType,1
7,3,0,10,mixedType,1
6,1,0,7,mixedType,0
5,4,0,9,mixedType,1
4,6,0,10,mixedType,1
7,3,0,10,mixedType,1
6,4,0,10,mixedType,1
3,8,0,11,mixedType,1
6,1,0,7,mixedType,0
7,2,0,9,mixedType,1
2,6,0,8,mixedType,1
6,2,0,8,mixedType,1
12,4,0,16,mixedType,2
3,7,0,10,mixedType,1
5,3,0,8,mixedType,1
6,1,0,7,mixedType,0
5,3,0,8,mixedType,1
3,5,0,8,mixedType,1
6,2,0,8,mixedType,1
8,1,0,9,mixedType,1
7,1,0,8,mixedType,1
9,2,0,11,mixedType,1
8,1,0,9,mixedType,1
8,3,0,11,mixedType,1
8,3,0,11,mixedType,1
2,8,0,10,mixedType,1
8,2,0,10,mixedType,1
4,2,0,6,mixedType,0
6,4,0,10,mixedType,1
7,3,0,10,mixedType,1
5,3,0,8,mixedType,1
10,0,5,15,mixedType,2
1,6,0,7,mixedType,0
5,2,0,7,mixedType,0
5,3,0,8,mixedType,1
11,5,0,16,mixedType,2
5,3,0,8,mixedType,1
7,2,0,9,mixedType,1
5,4,0,9,mixedType,1
2,6,0,8,mixedType,1
5,1,0,6,mixedType,0
7,1,0,8,mixedType,1
6,3,0,9,mixedType,1
6,2,0,8,mixedType,1
9,3,0,12,mixedType,1
9,3,0,12,mixedType,1
7,2,0,9,mixedType,1
6,3,0,9,mixedType,1
5,2,0,7,mixedType,0
7,3,0,10,mixedType,1
8,1,0,9,mixedType,1
7,1,0,8,mixedType,1
6,2,0,8,mixedType,1
7,1,0,8,mixedType,1
13,2,1,16,mixedType,2
7,2,0,9,mixedType,1
5,3,0,8,mixedType,1
8,3,0,11,mixedType,1
5,3,0,8,mixedType,1
8,3,0,11,mixedType,1
6,3,0,9,mixedType,1
9,3,0,12,mixedType,1
8,2,0,10,mixedType,1
8,2,0,10,mixedType,1
4,2,0,6,mixedType,0
2,9,0,11,mixedType,1
10,1,0,11,mixedType,1
8,3,0,11,mixedType,1
4,4,0,8,mixedType,1
10,3,0,13,mixedType,1
7,4,0,11,mixedType,1
8,1,0,9,mixedType,1
12,4,0,16,mixedType,2
9,1,0,10,mixedType,1
4,2,0,6,mixedType,0
6,2,0,8,mixedType,1
12,4,0,16,mixedType,2
4,2,0,6,mixedType,0
12,4,0,16,mixedType,2
5,2,0,7,mixedType,0
15,1,0,16,mixedType,2
9,2,0,11,mixedType,1
7,1,0,8,mixedType,1
8,2,0,10,mixedType,1
4,4,0,8,mixedType,1
12,3,0,15,mixedType,2
8,2,0,10,mixedType,1
9,1,0,10,mixedType,1
3,3,0,6,mixedType,0
6,1,0,7,mixedType,0
14,2,0,16,mixedType,2
6,3,0,9,mixedType,1
5,2,0,7,mixedType,0
4,2,0,6,mixedType,0
6,1,0,7,mixedType,0
10,2,0,12,mixedType,1
7,3,0,10,mixedType,1
6,2,0,8,mixedType,1
6,3,0,9,mixedType,1
7,2,0,9,mixedType,1
3,10,0,13,mixedType,1
7,1,0,8,mixedType,1
8,1,0,9,mixedType,1
5,4,0,9,mixedType,1
8,2,0,10,mixedType,1
14,2,0,16,mixedType,2
9,2,0,11,mixedType,1
7,3,0,10,mixedType,1
11,2,0,13,mixedType,1
8,1,0,9,mixedType,1
8,4,0,12,mixedType,1
3,6,0,9,mixedType,1
15,1,0,16,mixedType,2
5,2,0,7,mixedType,0
7,3,0,10,mixedType,1
6,3,0,9,mixedType,1
7,3,0,10,mixedType,1
5,3,0,8,mixedType,1
7,2,0,9,mixedType,1
1,8,0,9,mixedType,1
4,4,0,8,mixedType,1
6,3,0,9,mixedType,1
5,1,0,6,mixedType,0
6,5,0,11,mixedType,1
4,4,0,8,mixedType,1
5,2,0,7,mixedType,0
3,6,0,9,mixedType,1
7,4,0,11,mixedType,1
8,2,0,10,mixedType,1
7,2,0,9,mixedType,1
6,2,0,8,mixedType,1
4,5,0,9,mixedType,1
5,3,0,8,mixedType,1
11,2,0,13,mixedType,1
4,4,0,8,mixedType,1
6,2,0,8,mixedType,1
15,1,0,16,mixedType,2
7,3,0,10,mixedType,1
9,1,0,10,mixedType,1
6,2,0,8,mixedType,1
8,1,0,9,mixedType,1
4,4,0,8,mixedType,1
1,8,0,9,mixedType,1
7,3,0,10,mixedType,1
9,1,0,10,mixedType,1
7,2,0,9,mixedType,1
6,3,0,9,mixedType,1
6,2,0,8,mixedType,1
7,6,0,13,mixedType,1
6,5,0,11,mixedType,1
5,7,0,12,mixedType,1
4,4,0,8,mixedType,1
4,5,0,9,mixedType,1
6,4,0,10,mixedType,1
7,3,0,10,mixedType,1
6,4,0,10,mixedType,1
6,2,0,8,mixedType,1
7,3,0,10,mixedType,1
6,3,0,9,mixedType,1
9,1,0,10,mixedType,1
16,1,1,18,mixedType,2
4,0,3,7,mixedType,0
7,2,0,9,mixedType,1
3,6,0,9,mixedType,1
6,6,0,12,mixedType,1
6,2,0,8,mixedType,1
12,4,0,16,mixedType,2
7,3,0,10,mixedType,1
8,0,1,9,mixedType,1
7,3,0,10,mixedType,1
3,3,0,6,mixedType,0
6,3,0,9,mixedType,1
6,4,0,10,mixedType,1
8,2,0,10,mixedType,1
3,7,0,10,mixedType,1
14,2,0,16,mixedType,2
6,3,0,9,mixedType,1
7,3,0,10,mixedType,1
9,1,0,10,mixedType,1
6,4,0,10,mixedType,1
7,3,0,10,mixedType,1
8,1,0,9,mixedType,1
5,4,0,9,mixedType,1
5,3,0,8,mixedType,1
8,1,0,9,mixedType,1
8,2,0,10,mixedType,1
6,1,0,7,mixedType,0
1,8,0,9,mixedType,1
4,2,0,6,mixedType,0
7,3,0,10,mixedType,1
1,7,0,8,mixedType,1
5,1,0,6,mixedType,0
6,1,0,7,mixedType,0
8,2,0,10,mixedType,1
6,4,0,10,mixedType,1
3,6,0,9,mixedType,1
6,3,0,9,mixedType,1
5,2,0,7,mixedType,0
7,2,0,9,mixedType,1
8,1,0,9,mixedType,1
8,1,0,9,mixedType,1
6,2,0,8,mixedType,1
2,8,0,10,mixedType,1
5,2,0,7,mixedType,0
4,4,0,8,mixedType,1
7,2,0,9,mixedType,1
5,5,0,10,mixedType,1
4,2,0,6,mixedType,0
6,3,0,9,mixedType,1
11,3,0,14,mixedType,2
9,1,0,10,mixedType,1
8,2,0,10,mixedType,1
7,1,0,8,mixedType,1
13,3,0,16,mixedType,2
7,2,0,9,mixedType,1
8,2,0,10,mixedType,1
2,8,0,10,mixedType,1
8,1,0,9,mixedType,1
7,3,0,10,mixedType,1
6,4,0,10,mixedType,1
4,4,0,8,mixedType,1
3,5,0,8,mixedType,1
5,3,0,8,mixedType,1
8,2,0,10,mixedType,1
7,6,0,13,mixedType,1
3,6,0,9,mixedType,1
7,4,0,11,mixedType,1
7,3,0,10,mixedType,1
6,1,0,7,mixedType,0
7,1,0,8,mixedType,1
8,2,0,10,mixedType,1
3,7,0,10,mixedType,1
7,2,0,9,mixedType,1
8,1,0,9,mixedType,1
5,2,0,7,mixedType,0
7,2,0,9,mixedType,1
7,2,0,9,mixedType,1
6,3,0,9,mixedType,1
7,3,0,10,mixedType,1
6,3,0,9,mixedType,1
4,2,0,6,mixedType,0
6,3,0,9,mixedType,1
8,4,0,12,mixedType,1
7,3,0,10,mixedType,1
9,2,0,11,mixedType,1
5,5,0,10,mixedType,1
6,2,0,8,mixedType,1
4,6,0,10,mixedType,1
8,2,0,10,mixedType,1
4,4,0,8,mixedType,1
6,3,0,9,mixedType,1
5,1,0,6,mixedType,0
13,2,0,15,mixedType,2
3,6,0,9,mixedType,1
10,1,0,11,mixedType,1
4,7,0,11,mixedType,1
10,1,0,11,mixedType,1
3,3,0,6,mixedType,0
5,4,0,9,mixedType,1
7,3,0,10,mixedType,1
5,2,0,7,mixedType,0
6,6,0,12,mixedType,1
13,3,0,16,mixedType,2
7,3,0,10,mixedType,1
5,4,0,9,mixedType,1
7,3,0,10,mixedType,1
11,1,0,12,mixedType,1
9,2,0,11,mixedType,1
6,1,0,7,mixedType,0
6,6,0,12,mixedType,1
9,0,1,10,mixedType,1
6,2,0,8,mixedType,1
4,4,0,8,mixedType,1
1,7,0,8,mixedType,1
5,2,0,7,mixedType,0
7,2,0,9,mixedType,1
14,2,0,16,mixedType,2
9,1,0,10,mixedType,1
8,2,0,10,mixedType,1
6,1,0,7,mixedType,0
6,3,0,9,mixedType,1
6,3,0,9,mixedType,1
15,1,1,17,mixedType,2
4,8,0,12,mixedType,1
8,3,0,11,mixedType,1
4,4,0,8,mixedType,1
6,2,0,8,mixedType,1
7,1,0,8,mixedType,1
8,2,0,10,mixedType,1
9,3,0,12,mixedType,1
5,3,0,8,mixedType,1
7,2,0,9,mixedType,1
12,4,0,16,mixedType,2
7,3,0,10,mixedType,1
5,3,0,8,mixedType,1
9,3,0,12,mixedType,1
6,1,0,7,mixedType,0
6,3,0,9,mixedType,1
5,2,0,7,mixedType,0
9,1,0,10,mixedType,1
4,4,0,8,mixedType,1
6,3,0,9,mixedType,1
14,2,0,16,mixedType,2
6,3,0,9,mixedType,1
8,2,0,10,mixedType,1
10,3,0,13,mixedType,1
7,3,0,10,mixedType,1
5,2,0,7,mixedType,0
14,2,0,16,mixedType,2
6,2,0,8,mixedType,1
8,3,0,11,mixedType,1
5,7,0,12,mixedType,1
4,4,0,8,mixedType,1
2,7,0,9,mixedType,1
6,1,0,7,mixedType,0
3,5,0,8,mixedType,1
8,2,0,10,mixedType,1
10,1,0,11,mixedType,1
5,3,0,8,mixedType,1
5,3,0,8,mixedType,1
9,1,0,10,mixedType,1
7,1,0,8,mixedType,1
4,5,0,9,mixedType,1
6,1,0,7,mixedType,0
12,1,0,13,mixedType,1
4,2,0,6,mixedType,0
8,1,0,9,mixedType,1
6,3,0,9,mixedType,1
6,6,0,12,mixedType,1
1,8,0,9,mixedType,1
5,1,0,6,mixedType,0
5,2,0,7,mixedType,0
3,7,0,10,mixedType,1
6,4,0,10,mixedType,1
4,6,0,10,mixedType,1
7,2,0,9,mixedType,1
5,3,0,8,mixedType,1
9,3,0,12,mixedType,1
14,2,0,16,mixedType,2
5,2,0,7,mixedType,0
10,2,0,12,mixedType,1
5,4,0,9,mixedType,1
6,4,0,10,mixedType,1
14,2,0,16,mixedType,2
11,1,0,12,mixedType,1
15,1,0,16,mixedType,2
5,3,0,8,mixedType,1
9,2,0,11,mixedType,1
3,5,0,8,mixedType,1
9,1,0,10,mixedType,1
8,2,0,10,mixedType,1
6,3,0,9,mixedType,1
12,4,0,16,mixedType,2
8,2,0,10,mixedType,1
6,1,0,7,mixedType,0
6,2,0,8,mixedType,1
6,1,0,7,mixedType,0
6,3,0,9,mixedType,1
7,5,0,12,mixedType,1
5,7,0,12,mixedType,1
6,2,0,8,mixedType,1
1,5,0,6,mixedType,0
6,2,0,8,mixedType,1
6,3,0,9,mixedType,1
6,3,0,9,mixedType,1
7,3,0,10,mixedType,1
8,4,0,12,mixedType,1
1,8,0,9,mixedType,1
2,6,0,8,mixedType,1
8,1,0,9,mixedType,1
3,3,0,6,mixedType,0
3,6,0,9,mixedType,1
8,1,0,9,mixedType,1
6,4,0,10,mixedType,1
3,3,0,6,mixedType,0
8,5,0,13,mixedType,1
15,1,0,16,mixedType,2
7,3,0,10,mixedType,1
7,3,0,10,mixedType,1
5,3,0,8,mixedType,1
6,3,0,9,mixedType,1
6,4,0,10,mixedType,1
7,2,0,9,mixedType,1
6,3,0,9,mixedType,1
8,2,0,10,mixedType,1
7,4,0,11,mixedType,1
14,2,0,16,mixedType,2
6,3,0,9,mixedType,1
4,2,0,6,mixedType,0
4,4,0,8,mixedType,1
4,4,0,8,mixedType,1
15,1,0,16,mixedType,2
13,3,0,16,mixedType,2
12,0,1,13,mixedType,1
6,3,0,9,mixedType,1
5,6,0,11,mixedType,1
6,3,0,9,mixedType,1
4,2,0,6,mixedType,0
4,2,0,6,mixedType,0
5,6,0,11,mixedType,1
9,4,0,13,mixedType,1
6,3,0,9,mixedType,1
8,2,0,10,mixedType,1
8,1,0,9,mixedType,1
5,4,0,9,mixedType,1
12,3,0,15,mixedType,2
4,8,0,12,mixedType,1
5,4,0,9,mixedType,1
2,4,0,6,mixedType,0
5,2,0,7,mixedType,0
6,4,0,10,mixedType,1
4,4,0,8,mixedType,1
11,3,0,14,mixedType,2
7,2,0,9,mixedType,1
7,1,0,8,mixedType,1
7,1,0,8,mixedType,1
8,2,0,10,mixedType,1
7,3,0,10,mixedType,1
7,3,0,10,mixedType,1
6,6,0,12,mixedType,1
6,2,0,8,mixedType,1
4,4,0,8,mixedType,1
7,2,0,9,mixedType,1
6,2,0,8,mixedType,1
7,3,0,10,mixedType,1
5,3,0,8,mixedType,1
8,2,0,10,mixedType,1
9,1,0,10,mixedType,1
8,1,0,9,mixedType,1
4,2,0,6,mixedType,0
7,3,0,10,mixedType,1
9,1,0,10,mixedType,1
2,7,0,9,mixedType,1
5,2,0,7,mixedType,0
6,2,0,8,mixedType,1
3,8,0,11,mixedType,1
3,7,0,10,mixedType,1
5,4,0,9,mixedType,1
6,4,0,10,mixedType,1
8,1,0,9,mixedType,1
8,1,0,9,mixedType,1
5,2,0,7,mixedType,0
1,7,0,8,mixedType,1
4,2,0,6,mixedType,0
2,6,0,8,mixedType,1
6,2,0,8,mixedType,1
2,4,0,6,mixedType,0
7,1,0,8,mixedType,1
6,4,0,10,mixedType,1
3,8,0,11,mixedType,1
6,3,0,9,mixedType,1
3,6,0,9,mixedType,1
7,2,0,9,mixedType,1
9,1,0,10,mixedType,1
4,4,0,8,mixedType,1
8,2,0,10,mixedType,1
7,3,0,10,mixedType,1
13,3,0,16,mixedType,2
8,1,0,9,mixedType,1
5,2,0,7,mixedType,0
3,5,0,8,mixedType,1
15,1,0,16,mixedType,2
5,6,0,11,mixedType,1
8,1,0,9,mixedType,1
8,1,0,9,mixedType,1
7,3,0,10,mixedType,1
6,3,0,9,mixedType,1
5,3,0,8,mixedType,1
4,8,0,12,mixedType,1
4,7,0,11,mixedType,1
6,3,0,9,mixedType,1
14,2,0,16,mixedType,2
6,3,0,9,mixedType,1
6,4,0,10,mixedType,1
6,4,0,10,mixedType,1
6,1,0,7,mixedType,0
3,6,0,9,mixedType,1
7,3,0,10,mixedType,1
7,1,0,8,mixedType,1
6,6,0,12,mixedType,1
2,4,0,6,mixedType,0
6,2,0,8,mixedType,1
9,1,0,10,mixedType,1
7,3,0,10,mixedType,1
4,8,0,12,mixedType,1
7,2,0,9,mixedType,1
1,8,0,9,mixedType,1
6,2,0,8,mixedType,1
5,3,0,8,mixedType,1
6,3,0,9,mixedType,1
11,2,0,13,mixedType,1
8,2,0,10,mixedType,1
2,6,0,8,mixedType,1
10,2,0,12,mixedType,1
10,1,0,11,mixedType,1
11,3,0,14,mixedType,2
8,2,0,10,mixedType,1
7,2,0,9,mixedType,1
7,1,0,8,mixedType,1
9,4,0,13,mixedType,1
6,0,0,6,sameType,0
9,2,0,11,mixedType,1
7,8,7,22,mixedType,2
6,2,0,8,mixedType,1
8,1,0,9,mixedType,1
10,3,0,13,mixedType,1
6,4,0,10,mixedType,1
6,2,0,8,mixedType,1
4,2,0,6,mixedType,0
4,4,0,8,mixedType,1
5,2,0,7,mixedType,0
5,4,0,9,mixedType,1
9,2,0,11,mixedType,1
3,5,0,8,mixedType,1
6,3,0,9,mixedType,1
5,2,0,7,mixedType,0
5,3,0,8,mixedType,1
7,1,0,8,mixedType,1
10,2,0,12,mixedType,1
5,2,0,7,mixedType,0
7,3,0,10,mixedType,1
5,4,0,9,mixedType,1
9,1,0,10,mixedType,1
4,2,0,6,mixedType,0
5,5,0,10,mixedType,1
6,4,0,10,mixedType,1
9,0,1,10,mixedType,1
8,2,0,10,mixedType,1
1,5,0,6,mixedType,0
9,2,0,11,mixedType,1
7,1,0,8,mixedType,1
6,3,0,9,mixedType,1
6,4,0,10,mixedType,1
8,3,0,11,mixedType,1
8,1,0,9,mixedType,1
5,2,0,7,mixedType,0
7,3,0,10,mixedType,1
6,3,0,9,mixedType,1
9,3,0,12,mixedType,1
8,2,0,10,mixedType,1
12,4,0,16,mixedType,2
5,1,0,6,mixedType,0
9,1,0,10,mixedType,1
9,1,0,10,mixedType,1
7,2,0,9,mixedType,1
6,1,0,7,mixedType,0
7,1,0,8,mixedType,1
5,2,0,7,mixedType,0
14,2,0,16,mixedType,2
14,2,0,16,mixedType,2
6,3,0,9,mixedType,1
9,4,0,13,mixedType,1
14,1,0,15,mixedType,2
5,4,0,9,mixedType,1
6,6,0,12,mixedType,1
6,2,0,8,mixedType,1
6,1,0,7,mixedType,0
6,1,0,7,mixedType,0
6,3,0,9,mixedType,1
8,2,0,10,mixedType,1
6,4,0,10,mixedType,1
9,1,0,10,mixedType,1
5,4,0,9,mixedType,1
8,1,0,9,mixedType,1
2,6,0,8,mixedType,1
14,2,0,16,mixedType,2
6,1,0,7,mixedType,0
8,1,0,9,mixedType,1
9,3,0,12,mixedType,1
9,1,0,10,mixedType,1
7,3,0,10,mixedType,1
7,4,0,11,mixedType,1
6,1,0,7,mixedType,0
4,4,0,8,mixedType,1
8,2,0,10,mixedType,1
9,4,0,13,mixedType,1
2,6,0,8,mixedType,1
9,3,0,12,mixedType,1
4,4,0,8,mixedType,1
7,3,0,10,mixedType,1
13,3,0,16,mixedType,2
5,3,0,8,mixedType,1
8,2,0,10,mixedType,1
4,4,0,8,mixedType,1
7,2,0,9,mixedType,1
9,1,0,10,mixedType,1
8,1,0,9,mixedType,1
10,2,0,12,mixedType,1
6,3,0,9,mixedType,1
9,1,0,10,mixedType,1
8,3,0,11,mixedType,1
6,3,0,9,mixedType,1
8,3,0,11,mixedType,1
8,3,0,11,mixedType,1
4,4,0,8,mixedType,1
9,4,0,13,mixedType,1
7,2,0,9,mixedType,1
5,2,0,7,mixedType,0
9,1,0,10,mixedType,1
5,2,0,7,mixedType,0
6,3,0,9,mixedType,1
8,2,0,10,mixedType,1
12,4,0,16,mixedType,2
5,3,0,8,mixedType,1
5,4,0,9,mixedType,1
1,10,0,11,mixedType,1
4,4,0,8,mixedType,1
3,7,0,10,mixedType,1
4,4,0,8,mixedType,1
5,4,0,9,mixedType,1
8,7,5,20,mixedType,2
4,4,0,8,mixedType,1
15,1,0,16,mixedType,2
5,4,0,9,mixedType,1
6,3,0,9,mixedType,1
8,1,0,9,mixedType,1
5,2,0,7,mixedType,0
11,2,0,13,mixedType,1
6,4,0,10,mixedType,1
7,3,0,10,mixedType,1
8,1,0,9,mixedType,1
6,3,0,9,mixedType,1
5,3,0,8,mixedType,1
5,3,0,8,mixedType,1
2,8,0,10,mixedType,1
7,2,0,9,mixedType,1
5,2,0,7,mixedType,0
5,3,0,8,mixedType,1
6,1,0,7,mixedType,0
12,4,0,16,mixedType,2
1,8,0,9,mixedType,1
12,4,0,16,mixedType,2
3,3,0,6,mixedType,0
6,1,0,7,mixedType,0
11,3,0,14,mixedType,2
7,3,0,10,mixedType,1
6,1,0,7,mixedType,0
6,2,0,8,mixedType,1
7,2,0,9,mixedType,1
8,2,0,10,mixedType,1
6,3,0,9,mixedType,1
4,2,0,6,mixedType,0
5,3,0,8,mixedType,1
2,8,0,10,mixedType,1
7,1,0,8,mixedType,1
6,4,0,10,mixedType,1
9,1,0,10,mixedType,1
9,2,0,11,mixedType,1
2,6,0,8,mixedType,1
5,5,0,10,mixedType,1
7,3,0,10,mixedType,1
7,2,0,9,mixedType,1
4,4,0,8,mixedType,1
5,3,0,8,mixedType,1
14,2,0,16,mixedType,2
4,2,0,6,mixedType,0
1,9,0,10,mixedType,1
6,2,0,8,mixedType,1
12,4,0,16,mixedType,2
6,4,0,10,mixedType,1
4,4,0,8,mixedType,1
15,1,0,16,mixedType,2
7,3,0,10,mixedType,1
8,1,0,9,mixedType,1
4,2,0,6,mixedType,0
6,2,0,8,mixedType,1
6,3,0,9,mixedType,1
11,1,0,12,mixedType,1
11,5,0,16,mixedType,2
7,3,0,10,mixedType,1
6,2,0,8,mixedType,1
5,4,0,9,mixedType,1
3,6,0,9,mixedType,1
4,2,0,6,mixedType,0
1,8,0,9,mixedType,1
5,1,0,6,mixedType,0
6,1,0,7,mixedType,0
9,2,0,11,mixedType,1
11,0,1,12,mixedType,1
5,4,0,9,mixedType,1
5,2,0,7,mixedType,0
3,9,0,12,mixedType,1
5,2,0,7,mixedType,0
14,2,0,16,mixedType,2
6,2,0,8,mixedType,1
4,6,0,10,mixedType,1
8,4,0,12,mixedType,1
9,3,0,12,mixedType,1
5,1,0,6,mixedType,0
5,4,0,9,mixedType,1
1,7,0,8,mixedType,1
4,4,0,8,mixedType,1
4,2,0,6,mixedType,0
12,4,0,16,mixedType,2
8,1,0,9,mixedType,1
7,3,0,10,mixedType,1
3,5,0,8,mixedType,1
8,2,0,10,mixedType,1
13,3,0,16,mixedType,2
11,2,0,13,mixedType,1
5,4,0,9,mixedType,1
4,4,0,8,mixedType,1
6,3,0,9,mixedType,1
5,3,0,8,mixedType,1
5,6,0,11,mixedType,1
8,3,0,11,mixedType,1
5,6,0,11,mixedType,1
5,3,0,8,mixedType,1
6,3,0,9,mixedType,1
14,2,0,16,mixedType,2
8,4,0,12,mixedType,1
8,2,0,10,mixedType,1
3,9,0,12,mixedType,1
6,2,0,8,mixedType,1
8,1,0,9,mixedType,1
6,3,0,9,mixedType,1
10,3,0,13,mixedType,1
4,2,0,6,mixedType,0
8,1,0,9,mixedType,1
5,1,0,6,mixedType,0
5,1,0,6,mixedType,0
7,2,0,9,mixedType,1
3,7,0,10,mixedType,1
6,1,0,7,mixedType,0
7,3,0,10,mixedType,1
2,7,0,9,mixedType,1
9,4,0,13,mixedType,1
6,1,0,7,mixedType,0
3,5,0,8,mixedType,1
6,2,0,8,mixedType,1
6,2,0,8,mixedType,1
6,6,0,12,mixedType,1
7,4,0,11,mixedType,1
6,4,0,10,mixedType,1
8,1,0,9,mixedType,1
8,1,0,9,mixedType,1
8,2,0,10,mixedType,1
8,2,0,10,mixedType,1
8,2,0,10,mixedType,1
9,2,0,11,mixedType,1
3,6,0,9,mixedType,1
7,2,0,9,mixedType,1
6,3,0,9,mixedType,1
13,3,0,16,mixedType,2
12,1,0,13,mixedType,1
7,3,0,10,mixedType,1
9,3,0,12,mixedType,1
11,3,0,14,mixedType,2
5,4,0,9,mixedType,1
3,9,0,12,mixedType,1
5,4,0,9,mixedType,1
7,3,0,10,mixedType,1
2,4,0,6,mixedType,0
8,4,0,12,mixedType,1
6,2,0,8,mixedType,1
8,4,0,12,mixedType,1
8,1,0,9,mixedType,1
13,3,0,16,mixedType,2
6,4,0,10,mixedType,1
9,4,1,14,mixedType,2
6,3,0,9,mixedType,1
5,1,0,6,mixedType,0
6,3,0,9,mixedType,1
11,3,0,14,mixedType,2
9,3,0,12,mixedType,1
5,2,0,7,mixedType,0
10,5,0,15,mixedType,2
6,4,0,10,mixedType,1
8,2,0,10,mixedType,1
6,4,0,10,mixedType,1
9,2,0,11,mixedType,1
6,3,0,9,mixedType,1
6,3,0,9,mixedType,1
4,8,0,12,mixedType,1
4,2,0,6,mixedType,0
8,2,0,10,mixedType,1
5,3,0,8,mixedType,1
5,3,0,8,mixedType,1
7,3,0,10,mixedType,1
5,3,0,8,mixedType,1
6,4,0,10,mixedType,1
5,4,0,9,mixedType,1
7,3,0,10,mixedType,1
5,2,0,7,mixedType,0
5,5,0,10,mixedType,1
6,3,0,9,mixedType,1
7,1,0,8,mixedType,1
6,1,0,7,mixedType,0
12,3,0,15,mixedType,2
1,8,0,9,mixedType,1
7,6,0,13,mixedType,1
1,8,0,9,mixedType,1
6,2,0,8,mixedType,1
5,3,0,8,mixedType,1
6,2,0,8,mixedType,1
6,3,0,9,mixedType,1
5,3,0,8,mixedType,1
4,2,0,6,mixedType,0
4,4,0,8,mixedType,1
12,4,0,16,mixedType,2
4,4,0,8,mixedType,1
7,0,2,9,mixedType,1
5,5,0,10,mixedType,1
5,4,0,9,mixedType,1
7,1,0,8,mixedType,1
6,1,0,7,mixedType,0
4,6,0,10,mixedType,1
5,4,0,9,mixedType,1
6,7,0,13,mixedType,1
10,4,0,14,mixedType,2
5,3,0,8,mixedType,1
2,7,0,9,mixedType,1
13,3,0,16,mixedType,2
6,1,0,7,mixedType,0
4,2,0,6,mixedType,0
6,3,0,9,mixedType,1
6,2,0,8,mixedType,1
9,2,0,11,mixedType,1
5,1,0,6,mixedType,0
5,4,0,9,mixedType,1
6,3,0,9,mixedType,1
4,2,0,6,mixedType,0
4,2,0,6,mixedType,0
8,1,0,9,mixedType,1
3,3,0,6,mixedType,0
5,1,0,6,mixedType,0
3,6,0,9,mixedType,1
6,4,0,10,mixedType,1
5,4,0,9,mixedType,1
4,6,0,10,mixedType,1
15,1,0,16,mixedType,2
9,2,0,11,mixedType,1
5,1,0,6,mixedType,0
8,1,0,9,mixedType,1
13,3,0,16,mixedType,2
9,1,0,10,mixedType,1
9,2,0,11,mixedType,1
6,3,0,9,mixedType,1
8,1,0,9,mixedType,1
8,3,0,11,mixedType,1
5,3,0,8,mixedType,1
7,2,0,9,mixedType,1
5,5,0,10,mixedType,1
6,3,0,9,mixedType,1
6,2,0,8,mixedType,1
6,2,0,8,mixedType,1
6,2,0,8,mixedType,1
4,4,0,8,mixedType,1
12,4,0,16,mixedType,2
10,2,0,12,mixedType,1
8,1,0,9,mixedType,1
7,1,0,8,mixedType,1
6,1,0,7,mixedType,0
7,5,0,12,mixedType,1
15,1,0,16,mixedType,2
8,1,0,9,mixedType,1
5,3,0,8,mixedType,1
6,3,0,9,mixedType,1
20,1,1,22,mixedType,2
8,1,0,9,mixedType,1
10,3,0,13,mixedType,1
6,2,0,8,mixedType,1
5,1,0,6,mixedType,0
5,4,0,9,mixedType,1
5,4,0,9,mixedType,1
14,2,0,16,mixedType,2
14,2,0,16,mixedType,2
5,3,0,8,mixedType,1
9,4,0,13,mixedType,1
3,5,0,8,mixedType,1
3,6,0,9,mixedType,1
14,4,0,18,mixedType,2
6,4,0,10,mixedType,1
5,1,0,6,mixedType,0
4,5,0,9,mixedType,1
9,3,0,12,mixedType,1
4,4,0,8,mixedType,1
4,4,0,8,mixedType,1
6,3,0,9,mixedType,1
3,5,0,8,mixedType,1
7,2,0,9,mixedType,1
13,3,0,16,mixedType,2
7,3,0,10,mixedType,1
3,5,0,8,mixedType,1
4,2,0,6,mixedType,0
5,3,0,8,mixedType,1
6,2,0,8,mixedType,1
2,6,0,8,mixedType,1
14,2,0,16,mixedType,2
5,2,0,7,mixedType,0
6,4,0,10,mixedType,1
2,7,0,9,mixedType,1
7,1,0,8,mixedType,1
3,7,0,10,mixedType,1
8,2,0,10,mixedType,1
7,5,0,12,mixedType,1
6,4,0,10,mixedType,1
4,2,0,6,mixedType,0
6,2,0,8,mixedType,1
11,3,0,14,mixedType,2
3,6,0,9,mixedType,1
5,4,0,9,mixedType,1
5,2,0,7,mixedType,0
5,3,0,8,mixedType,1
2,6,0,8,mixedType,1
5,1,0,6,mixedType,0
12,3,0,15,mixedType,2
7,1,0,8,mixedType,1
12,1,0,13,mixedType,1
6,2,0,8,mixedType,1
6,1,0,7,mixedType,0
1,8,0,9,mixedType,1
2,11,3,16,mixedType,2
9,4,0,13,mixedType,1
13,3,0,16,mixedType,2
4,2,0,6,mixedType,0
6,4,0,10,mixedType,1
6,2,0,8,mixedType,1
6,3,0,9,mixedType,1
10,1,0,11,mixedType,1
8,2,0,10,mixedType,1
2,6,0,8,mixedType,1
6,2,0,8,mixedType,1
7,2,0,9,mixedType,1
6,6,0,12,mixedType,1
7,2,0,9,mixedType,1
8,1,0,9,mixedType,1
5,3,0,8,mixedType,1
5,3,0,8,mixedType,1
5,8,0,13,mixedType,1
6,2,0,8,mixedType,1
6,4,0,10,mixedType,1
13,3,0,16,mixedType,2
5,4,0,9,mixedType,1
4,2,0,6,mixedType,0
7,6,0,13,mixedType,1
6,3,0,9,mixedType,1
5,2,0,7,mixedType,0
8,2,0,10,mixedType,1
5,1,0,6,mixedType,0
7,1,0,8,mixedType,1
4,4,0,8,mixedType,1
3,6,0,9,mixedType,1
6,3,0,9,mixedType,1
5,3,0,8,mixedType,1
1,8,0,9,mixedType,1
7,3,0,10,mixedType,1
6,3,0,9,mixedType,1
11,5,0,16,mixedType,2
11,3,0,14,mixedType,2
8,1,0,9,mixedType,1
4,4,0,8,mixedType,1
6,3,0,9,mixedType,1
6,2,0,8,mixedType,1
13,3,0,16,mixedType,2
12,4,0,16,mixedType,2
5,2,0,7,mixedType,0
1,7,0,8,mixedType,1
6,2,0,8,mixedType,1
8,3,0,11,mixedType,1
11,1,0,12,mixedType,1
7,3,0,10,mixedType,1
5,3,0,8,mixedType,1
5,4,0,9,mixedType,1
7,1,0,8,mixedType,1
6,2,0,8,mixedType,1
14,2,0,16,mixedType,2
4,4,0,8,mixedType,1
8,3,0,11,mixedType,1
7,3,0,10,mixedType,1
6,3,0,9,mixedType,1
2,8,0,10,mixedType,1
10,2,0,12,mixedType,1
7,2,0,9,mixedType,1
7,2,0,9,mixedType,1
3,5,0,8,mixedType,1
9,2,0,11,mixedType,1
6,3,0,9,mixedType,1
4,2,0,6,mixedType,0
6,2,0,8,mixedType,1
3,5,0,8,mixedType,1
8,2,0,10,mixedType,1
2,7,0,9,mixedType,1
14,2,0,16,mixedType,2
9,4,0,13,mixedType,1
6,4,0,10,mixedType,1
7,4,0,11,mixedType,1
2,8,0,10,mixedType,1
8,2,0,10,mixedType,1
7,1,0,8,mixedType,1
8,1,0,9,mixedType,1
14,2,0,16,mixedType,2
8,1,0,9,mixedType,1
15,1,0,16,mixedType,2
3,10,2,15,mixedType,2
5,1,0,6,mixedType,0
3,3,0,6,mixedType,0
9,2,0,11,mixedType,1
6,4,0,10,mixedType,1
13,3,0,16,mixedType,2
6,1,0,7,mixedType,0
6,4,0,10,mixedType,1
6,3,0,9,mixedType,1
6,2,0,8,mixedType,1
8,1,0,9,mixedType,1
7,2,0,9,mixedType,1
4,8,0,12,mixedType,1
9,1,0,10,mixedType,1
3,10,0,13,mixedType,1
5,2,0,7,mixedType,0
9,3,0,12,mixedType,1
7,2,0,9,mixedType,1
3,5,0,8,mixedType,1
4,2,0,6,mixedType,0
4,2,0,6,mixedType,0
6,3,0,9,mixedType,1
6,3,0,9,mixedType,1
3,5,0,8,mixedType,1
6,6,0,12,mixedType,1
8,2,0,10,mixedType,1
7,3,0,10,mixedType,1
5,4,0,9,mixedType,1
7,3,0,10,mixedType,1
12,4,0,16,mixedType,2
5,2,0,7,mixedType,0
14,2,0,16,mixedType,2
9,1,0,10,mixedType,1
14,2,0,16,mixedType,2
8,1,0,9,mixedType,1
13,3,0,16,mixedType,2
11,1,0,12,mixedType,1
8,3,0,11,mixedType,1
5,6,0,11,mixedType,1
6,3,0,9,mixedType,1
8,2,0,10,mixedType,1
8,3,0,11,mixedType,1
4,2,0,6,mixedType,0
10,2,0,12,mixedType,1
6,2,0,8,mixedType,1
5,2,0,7,mixedType,0
5,3,0,8,mixedType,1
6,4,0,10,mixedType,1
7,2,0,9,mixedType,1
6,2,0,8,mixedType,1
6,3,0,9,mixedType,1
4,4,0,8,mixedType,1
7,3,0,10,mixedType,1
6,3,0,9,mixedType,1
4,4,0,8,mixedType,1
1,8,0,9,mixedType,1
9,1,0,10,mixedType,1
6,1,0,7,mixedType,0
8,4,0,12,mixedType,1
4,4,0,8,mixedType,1
5,4,0,9,mixedType,1
9,3,0,12,mixedType,1
6,2,0,8,mixedType,1
6,3,0,9,mixedType,1
4,2,0,6,mixedType,0
5,2,0,7,mixedType,0
9,1,0,10,mixedType,1
5,2,0,7,mixedType,0
5,3,0,8,mixedType,1
6,3,0,9,mixedType,1
5,1,0,6,mixedType,0
13,3,0,16,mixedType,2
8,1,0,9,mixedType,1
6,4,0,10,mixedType,1
5,4,0,9,mixedType,1
8,2,0,10,mixedType,1
6,2,0,8,mixedType,1
5,7,0,12,mixedType,1
5,2,0,7,mixedType,0
9,1,0,10,mixedType,1
7,2,0,9,mixedType,1
5,4,0,9,mixedType,1
11,3,0,14,mixedType,2
5,3,0,8,mixedType,1
7,2,0,9,mixedType,1
7,6,0,13,mixedType,1
6,3,0,9,mixedType,1
6,3,0,9,mixedType,1
6,2,0,8,mixedType,1
3,7,0,10,mixedType,1
5,2,0,7,mixedType,0
13,4,0,17,mixedType,2
5,3,0,8,mixedType,1
9,1,0,10,mixedType,1
6,1,0,7,mixedType,0
5,4,0,9,mixedType,1
15,1,0,16,mixedType,2
5,4,0,9,mixedType,1
7,2,0,9,mixedType,1
6,3,0,9,mixedType,1
10,6,0,16,mixedType,2
5,3,0,8,mixedType,1
9,3,0,12,mixedType,1
8,1,0,9,mixedType,1
5,3,0,8,mixedType,1
5,0,2,7,mixedType,0
7,6,0,13,mixedType,1
9,7,0,16,mixedType,2
9,3,0,12,mixedType,1
15,1,0,16,mixedType,2
10,1,0,11,mixedType,1
4,2,0,6,mixedType,0
5,5,0,10,mixedType,1
4,6,0,10,mixedType,1
9,1,0,10,mixedType,1
12,3,0,15,mixedType,2
12,4,0,16,mixedType,2
2,7,0,9,mixedType,1
6,3,0,9,mixedType,1
14,2,0,16,mixedType,2
13,3,0,16,mixedType,2
6,4,0,10,mixedType,1
5,4,0,9,mixedType,1
8,1,0,9,mixedType,1
5,1,0,6,mixedType,0
12,1,0,13,mixedType,1
4,4,0,8,mixedType,1
6,6,0,12,mixedType,1
7,3,0,10,mixedType,1
9,1,0,10,mixedType,1
14,2,0,16,mixedType,2
8,2,0,10,mixedType,1
4,2,0,6,mixedType,0
4,2,0,6,mixedType,0
5,3,0,8,mixedType,1
6,3,0,9,mixedType,1
5,2,0,7,mixedType,0
7,2,0,9,mixedType,1
5,1,0,6,mixedType,0
2,6,0,8,mixedType,1
7,3,0,10,mixedType,1
7,4,0,11,mixedType,1
5,1,0,6,mixedType,0
6,4,0,10,mixedType,1
5,3,0,8,mixedType,1
6,1,0,7,mixedType,0
4,4,0,8,mixedType,1
8,2,0,10,mixedType,1
6,2,0,8,mixedType,1
3,7,0,10,mixedType,1
5,3,0,8,mixedType,1
4,2,0,6,mixedType,0
8,2,0,10,mixedType,1
5,4,0,9,mixedType,1
2,8,0,10,mixedType,1
6,2,0,8,mixedType,1
5,3,0,8,mixedType,1
5,6,0,11,mixedType,1
8,2,0,10,mixedType,1
6,3,0,9,mixedType,1
6,2,0,8,mixedType,1
11,2,0,13,mixedType,1
5,3,0,8,mixedType,1
7,2,0,9,mixedType,1
14,2,0,16,mixedType,2
6,2,0,8,mixedType,1
12,3,0,15,mixedType,2
4,8,0,12,mixedType,1
14,2,0,16,mixedType,2
8,1,0,9,mixedType,1
1,9,0,10,mixedType,1
6,1,0,7,mixedType,0
5,2,0,7,mixedType,0
5,1,0,6,mixedType,0
12,4,0,16,mixedType,2
8,1,0,9,mixedType,1
5,1,0,6,mixedType,0
6,3,0,9,mixedType,1
5,2,0,7,mixedType,0
6,4,0,10,mixedType,1
6,3,0,9,mixedType,1
12,3,0,15,mixedType,2
3,6,0,9,mixedType,1
2,6,0,8,mixedType,1
12,4,0,16,mixedType,2
6,4,0,10,mixedType,1
8,2,0,10,mixedType,1
6,3,0,9,mixedType,1
6,1,0,7,mixedType,0
6,1,0,7,mixedType,0
5,2,0,7,mixedType,0
9,2,0,11,mixedType,1
6,5,0,11,mixedType,1
1,9,0,10,mixedType,1
9,1,0,10,mixedType,1
7,4,3,14,mixedType,2
5,3,0,8,mixedType,1
5,3,0,8,mixedType,1
8,4,0,12,mixedType,1
5,2,0,7,mixedType,0
4,4,0,8,mixedType,1
4,6,0,10,mixedType,1
4,4,0,8,mixedType,1
4,6,0,10,mixedType,1
6,2,0,8,mixedType,1
8,1,0,9,mixedType,1
2,8,0,10,mixedType,1
7,2,0,9,mixedType,1
4,2,0,6,mixedType,0
6,2,0,8,mixedType,1
14,2,0,16,mixedType,2
8,1,0,9,mixedType,1
5,1,0,6,mixedType,0
7,2,0,9,mixedType,1
12,4,0,16,mixedType,2
5,4,0,9,mixedType,1
10,1,0,11,mixedType,1
5,3,0,8,mixedType,1
7,4,0,11,mixedType,1
8,4,0,12,mixedType,1
9,3,0,12,mixedType,1
6,3,0,9,mixedType,1
9,1,0,10,mixedType,1
7,2,0,9,mixedType,1
6,4,0,10,mixedType,1
1,8,0,9,mixedType,1
6,0,1,7,mixedType,0
9,4,0,13,mixedType,1
12,3,0,15,mixedType,2
3,7,0,10,mixedType,1
7,3,0,10,mixedType,1
7,2,0,9,mixedType,1
6,4,0,10,mixedType,1
7,3,0,10,mixedType,1
8,3,0,11,mixedType,1
14,2,0,16,mixedType,2
6,4,0,10,mixedType,1
11,5,0,16,mixedType,2
5,5,0,10,mixedType,1
11,3,0,14,mixedType,2
6,4,0,10,mixedType,1
5,4,0,9,mixedType,1
3,5,0,8,mixedType,1
1,9,0,10,mixedType,1
5,4,0,9,mixedType,1
6,4,0,10,mixedType,1
8,2,0,10,mixedType,1
8,1,0,9,mixedType,1
4,4,0,8,mixedType,1
4,4,0,8,mixedType,1
11,5,0,16,mixedType,2
8,2,0,10,mixedType,1
7,3,0,10,mixedType,1
5,5,0,10,mixedType,1
8,3,0,11,mixedType,1
7,1,0,8,mixedType,1
5,2,0,7,mixedType,0
7,1,0,8,mixedType,1
4,2,0,6,mixedType,0
2,8,0,10,mixedType,1
6,3,0,9,mixedType,1
6,6,0,12,mixedType,1
13,3,0,16,mixedType,2
7,1,0,8,mixedType,1
7,2,0,9,mixedType,1
0,5,2,7,mixedType,0
4,4,0,8,mixedType,1
7,3,0,10,mixedType,1
4,4,0,8,mixedType,1
1,8,0,9,mixedType,1
4,4,0,8,mixedType,1
6,2,0,8,mixedType,1
1,9,0,10,mixedType,1
5,2,0,7,mixedType,0
8,2,0,10,mixedType,1
6,2,0,8,mixedType,1
7,2,0,9,mixedType,1
6,2,0,8,mixedType,1
6,4,0,10,mixedType,1
6,4,0,10,mixedType,1
6,2,0,8,mixedType,1
14,2,0,16,mixedType,2
10,3,0,13,mixedType,1
14,2,0,16,mixedType,2
14,2,0,16,mixedType,2
7,2,0,9,mixedType,1
9,2,0,11,mixedType,1
10,1,0,11,mixedType,1
7,9,0,16,mixedType,2
5,2,0,7,mixedType,0
5,3,0,8,mixedType,1
15,1,0,16,mixedType,2
6,4,0,10,mixedType,1
5,3,0,8,mixedType,1
5,3,0,8,mixedType,1
5,2,0,7,mixedType,0
6,2,0,8,mixedType,1
6,4,0,10,mixedType,1
7,3,0,10,mixedType,1
2,7,0,9,mixedType,1
6,4,0,10,mixedType,1
3,3,0,6,mixedType,0
5,3,0,8,mixedType,1
5,4,0,9,mixedType,1
7,3,0,10,mixedType,1
7,2,0,9,mixedType,1
6,3,0,9,mixedType,1
1,9,0,10,mixedType,1
6,3,0,9,mixedType,1
13,3,0,16,mixedType,2
10,8,0,18,mixedType,2
4,5,0,9,mixedType,1
8,2,0,10,mixedType,1
2,4,0,6,mixedType,0
7,3,0,10,mixedType,1
8,2,0,10,mixedType,1
5,1,0,6,mixedType,0
7,3,0,10,mixedType,1
7,2,0,9,mixedType,1
5,1,0,6,mixedType,0
8,2,0,10,mixedType,1
9,1,0,10,mixedType,1
2,4,0,6,mixedType,0
13,1,2,16,mixedType,2
13,7,0,20,mixedType,2
11,3,0,14,mixedType,2
1,9,0,10,mixedType,1
5,1,0,6,mixedType,0
5,3,0,8,mixedType,1
5,2,0,7,mixedType,0
4,6,0,10,mixedType,1
4,4,0,8,mixedType,1
2,4,0,6,mixedType,0
4,5,0,9,mixedType,1
4,2,0,6,mixedType,0
6,1,0,7,mixedType,0
14,2,0,16,mixedType,2
5,4,0,9,mixedType,1
7,1,0,8,mixedType,1
7,1,0,8,mixedType,1
2,10,0,12,mixedType,1
4,4,0,8,mixedType,1
4,2,0,6,mixedType,0
9,1,0,10,mixedType,1
12,3,0,15,mixedType,2
5,3,0,8,mixedType,1
4,2,0,6,mixedType,0
6,1,0,7,mixedType,0
6,3,0,9,mixedType,1
2,6,0,8,mixedType,1
9,2,0,11,mixedType,1
3,6,0,9,mixedType,1
9,1,0,10,mixedType,1
9,3,0,12,mixedType,1
7,3,0,10,mixedType,1
8,1,0,9,mixedType,1
8,2,0,10,mixedType,1
13,3,0,16,mixedType,2
5,6,0,11,mixedType,1
7,1,0,8,mixedType,1
15,1,0,16,mixedType,2
7,3,0,10,mixedType,1
5,6,0,11,mixedType,1
10,2,0,12,mixedType,1
5,3,0,8,mixedType,1
10,2,0,12,mixedType,1
5,4,0,9,mixedType,1
5,2,0,7,mixedType,0
14,2,0,16,mixedType,2
5,4,0,9,mixedType,1
10,2,0,12,mixedType,1
5,3,0,8,mixedType,1
6,1,0,7,mixedType,0
5,2,0,7,mixedType,0
6,2,0,8,mixedType,1
7,1,0,8,mixedType,1
6,4,0,10,mixedType,1
11,0,1,12,mixedType,1
3,10,1,14,mixedType,2
5,4,0,9,mixedType,1
6,3,0,9,mixedType,1
5,3,0,8,mixedType,1
8,2,0,10,mixedType,1
3,8,0,11,mixedType,1
15,1,0,16,mixedType,2
6,6,0,12,mixedType,1
8,2,0,10,mixedType,1
5,3,0,8,mixedType,1
5,2,0,7,mixedType,0
12,3,0,15,mixedType,2
14,2,0,16,mixedType,2
6,2,0,8,mixedType,1
1,8,0,9,mixedType,1
7,2,0,9,mixedType,1
7,6,0,13,mixedType,1
4,4,0,8,mixedType,1
4,2,0,6,mixedType,0
7,2,0,9,mixedType,1
6,4,0,10,mixedType,1
7,4,0,11,mixedType,1
8,1,0,9,mixedType,1
8,2,0,10,mixedType,1
5,3,0,8,mixedType,1
6,4,0,10,mixedType,1
5,4,0,9,mixedType,1
5,3,0,8,mixedType,1
5,3,0,8,mixedType,1
8,4,0,12,mixedType,1
8,3,0,11,mixedType,1
10,6,0,16,mixedType,2
1,11,0,12,mixedType,1
10,4,0,14,mixedType,2
6,3,0,9,mixedType,1
7,3,0,10,mixedType,1
5,1,0,6,mixedType,0
7,2,0,9,mixedType,1
3,6,0,9,mixedType,1
7,3,0,10,mixedType,1
9,7,1,17,mixedType,2
12,3,0,15,mixedType,2
6,3,0,9,mixedType,1
6,1,0,7,mixedType,0
5,3,0,8,mixedType,1
6,3,0,9,mixedType,1
9,7,0,16,mixedType,2
6,3,0,9,mixedType,1
2,4,0,6,mixedType,0
6,1,0,7,mixedType,0
5,3,0,8,mixedType,1
3,8,0,11,mixedType,1
5,4,0,9,mixedType,1
7,4,0,11,mixedType,1
7,2,0,9,mixedType,1
7,2,0,9,mixedType,1
7,2,0,9,mixedType,1
11,4,0,15,mixedType,2
8,2,0,10,mixedType,1
15,1,0,16,mixedType,2
2,8,0,10,mixedType,1
6,3,0,9,mixedType,1
1,8,0,9,mixedType,1
9,5,0,14,mixedType,2
7,3,0,10,mixedType,1
6,1,0,7,mixedType,0
5,3,0,8,mixedType,1
1,10,0,11,mixedType,1
2,7,0,9,mixedType,1
13,3,0,16,mixedType,2
12,2,1,15,mixedType,2
6,2,0,8,mixedType,1
7,3,0,10,mixedType,1
8,2,0,10,mixedType,1
6,1,0,7,mixedType,0
9,2,0,11,mixedType,1
2,10,0,12,mixedType,1
6,3,0,9,mixedType,1
14,2,0,16,mixedType,2
5,2,0,7,mixedType,0
8,2,0,10,mixedType,1
13,3,0,16,mixedType,2
7,3,0,10,mixedType,1
9,3,0,12,mixedType,1
5,1,0,6,mixedType,0
8,1,0,9,mixedType,1
8,2,0,10,mixedType,1
7,1,0,8,mixedType,1
6,1,0,7,mixedType,0
6,2,0,8,mixedType,1
5,1,0,6,mixedType,0
4,4,0,8,mixedType,1
10,0,2,12,mixedType,1
6,1,0,7,mixedType,0
3,6,0,9,mixedType,1
11,5,0,16,mixedType,2
7,4,0,11,mixedType,1
7,2,0,9,mixedType,1
1,5,0,6,mixedType,0
7,3,0,10,mixedType,1
15,1,0,16,mixedType,2
5,1,0,6,mixedType,0
4,4,0,8,mixedType,1
8,4,0,12,mixedType,1
6,3,0,9,mixedType,1
4,6,0,10,mixedType,1
7,2,0,9,mixedType,1
15,1,0,16,mixedType,2
8,3,0,11,mixedType,1
5,3,0,8,mixedType,1
6,4,0,10,mixedType,1
8,2,0,10,mixedType,1
2,6,0,8,mixedType,1
8,2,0,10,mixedType,1
9,2,0,11,mixedType,1
4,4,0,8,mixedType,1
5,4,0,9,mixedType,1
10,1,0,11,mixedType,1
8,3,0,11,mixedType,1
13,3,0,16,mixedType,2
6,4,0,10,mixedType,1
4,6,0,10,mixedType,1
15,1,0,16,mixedType,2
7,3,0,10,mixedType,1
5,3,0,8,mixedType,1
3,7,0,10,mixedType,1
6,1,0,7,mixedType,0
5,1,0,6,mixedType,0
7,3,0,10,mixedType,1
8,1,0,9,mixedType,1
14,2,0,16,mixedType,2
3,5,0,8,mixedType,1
10,1,0,11,mixedType,1
11,2,0,13,mixedType,1
5,8,0,13,mixedType,1
5,2,0,7,mixedType,0
7,2,0,9,mixedType,1
5,2,0,7,mixedType,0
4,2,0,6,mixedType,0
5,8,0,13,mixedType,1
6,2,0,8,mixedType,1
7,4,0,11,mixedType,1
6,4,0,10,mixedType,1
11,5,0,16,mixedType,2
11,1,0,12,mixedType,1
7,1,0,8,mixedType,1
6,3,0,9,mixedType,1
8,0,2,10,mixedType,1
7,2,0,9,mixedType,1
6,4,0,10,mixedType,1
15,1,0,16,mixedType,2
7,3,0,10,mixedType,1
4,2,0,6,mixedType,0
6,2,0,8,mixedType,1
3,6,0,9,mixedType,1
7,3,0,10,mixedType,1
10,6,0,16,mixedType,2
14,2,0,16,mixedType,2
7,3,0,10,mixedType,1
8,2,0,10,mixedType,1
9,1,0,10,mixedType,1
1,8,0,9,mixedType,1
1,9,0,10,mixedType,1
6,1,0,7,mixedType,0
6,1,0,7,mixedType,0
4,2,0,6,mixedType,0
1,8,0,9,mixedType,1
4,8,0,12,mixedType,1
15,1,0,16,mixedType,2
11,2,0,13,mixedType,1
13,3,0,16,mixedType,2
8,2,0,10,mixedType,1
6,4,0,10,mixedType,1
7,3,0,10,mixedType,1
14,2,0,16,mixedType,2
5,3,0,8,mixedType,1
9,1,0,10,mixedType,1
6,4,0,10,mixedType,1
9,1,0,10,mixedType,1
5,2,0,7,mixedType,0
8,1,0,9,mixedType,1
6,1,0,7,mixedType,0
0,12,1,13,mixedType,1
6,2,0,8,mixedType,1
14,2,0,16,mixedType,2
7,3,0,10,mixedType,1
6,1,0,7,mixedType,0
1,8,0,9,mixedType,1
7,2,0,9,mixedType,1
5,4,0,9,mixedType,1
8,3,0,11,mixedType,1
8,2,0,10,mixedType,1
5,3,0,8,mixedType,1
10,0,1,11,mixedType,1
3,7,0,10,mixedType,1
7,1,0,8,mixedType,1
5,3,0,8,mixedType,1
7,2,0,9,mixedType,1
12,3,0,15,mixedType,2
6,2,0,8,mixedType,1
2,4,0,6,mixedType,0
7,3,0,10,mixedType,1
6,3,0,9,mixedType,1
10,3,0,13,mixedType,1
9,2,0,11,mixedType,1
8,3,0,11,mixedType,1
7,3,0,10,mixedType,1
3,3,0,6,mixedType,0
6,5,0,11,mixedType,1
6,3,0,9,mixedType,1
5,2,0,7,mixedType,0
3,3,0,6,mixedType,0
5,2,0,7,mixedType,0
5,5,0,10,mixedType,1
8,3,0,11,mixedType,1
5,3,0,8,mixedType,1
14,2,0,16,mixedType,2
9,2,0,11,mixedType,1
13,3,1,17,mixedType,2
4,4,0,8,mixedType,1
6,3,0,9,mixedType,1
12,1,0,13,mixedType,1
9,1,0,10,mixedType,1
10,2,0,12,mixedType,1
4,2,0,6,mixedType,0
5,3,0,8,mixedType,1
5,2,0,7,mixedType,0
3,5,0,8,mixedType,1
7,2,0,9,mixedType,1
9,3,0,12,mixedType,1
7,1,0,8,mixedType,1
7,1,0,8,mixedType,1
4,5,0,9,mixedType,1
6,3,0,9,mixedType,1
6,1,0,7,mixedType,0
7,3,0,10,mixedType,1
11,5,0,16,mixedType,2
4,2,0,6,mixedType,0
6,4,0,10,mixedType,1
3,6,0,9,mixedType,1
7,1,0,8,mixedType,1
5,1,0,6,mixedType,0
7,4,0,11,mixedType,1
6,1,0,7,mixedType,0
7,3,0,10,mixedType,1
7,2,0,9,mixedType,1
7,3,0,10,mixedType,1
8,1,0,9,mixedType,1
8,3,3,14,mixedType,2
5,2,0,7,mixedType,0
5,1,0,6,mixedType,0
5,2,0,7,mixedType,0
6,3,0,9,mixedType,1
4,8,0,12,mixedType,1
6,2,0,8,mixedType,1
5,4,0,9,mixedType,1
4,5,0,9,mixedType,1
10,3,0,13,mixedType,1
6,3,0,9,mixedType,1
7,3,0,10,mixedType,1
12,3,0,15,mixedType,2
6,2,0,8,mixedType,1
14,2,0,16,mixedType,2
7,3,0,10,mixedType,1
7,3,0,10,mixedType,1
5,3,0,8,mixedType,1
5,2,0,7,mixedType,0
1,9,0,10,mixedType,1
4,2,0,6,mixedType,0
6,1,0,7,mixedType,0
4,4,0,8,mixedType,1
7,2,0,9,mixedType,1
4,2,0,6,mixedType,0
1,8,0,9,mixedType,1
6,2,0,8,mixedType,1
6,7,0,13,mixedType,1
6,6,0,12,mixedType,1
7,3,0,10,mixedType,1
4,6,0,10,mixedType,1
10,2,0,12,mixedType,1
1,7,0,8,mixedType,1
6,3,0,9,mixedType,1
5,6,0,11,mixedType,1
6,3,0,9,mixedType,1
7,2,0,9,mixedType,1
9,1,0,10,mixedType,1
12,4,0,16,mixedType,2
7,2,0,9,mixedType,1
7,4,0,11,mixedType,1
2,9,0,11,mixedType,1
4,6,0,10,mixedType,1
6,2,0,8,mixedType,1
7,2,0,9,mixedType,1
10,3,0,13,mixedType,1
6,4,0,10,mixedType,1
8,1,0,9,mixedType,1
6,2,0,8,mixedType,1
12,4,0,16,mixedType,2
7,1,0,8,mixedType,1
1,9,0,10,mixedType,1
5,4,0,9,mixedType,1
6,3,0,9,mixedType,1
7,4,0,11,mixedType,1
2,6,0,8,mixedType,1
7,3,0,10,mixedType,1
7,1,0,8,mixedType,1
5,6,0,11,mixedType,1
7,6,0,13,mixedType,1
5,4,0,9,mixedType,1
14,2,0,16,mixedType,2
7,3,0,10,mixedType,1
3,4,0,7,mixedType,0
5,4,0,9,mixedType,1
7,3,0,10,mixedType,1
2,8,0,10,mixedType,1
4,4,0,8,mixedType,1
6,2,0,8,mixedType,1
5,1,0,6,mixedType,0
5,3,0,8,mixedType,1
8,2,0,10,mixedType,1
5,2,0,7,mixedType,0
4,5,0,9,mixedType,1
4,4,0,8,mixedType,1
6,4,0,10,mixedType,1
8,4,0,12,mixedType,1
5,1,0,6,mixedType,0
9,1,0,10,mixedType,1
6,3,0,9,mixedType,1
6,4,0,10,mixedType,1
14,2,0,16,mixedType,2
11,1,0,12,mixedType,1
2,6,0,8,mixedType,1
3,8,0,11,mixedType,1
15,1,0,16,mixedType,2
7,2,0,9,mixedType,1
14,2,0,16,mixedType,2
5,3,0,8,mixedType,1
7,3,0,10,mixedType,1
9,1,0,10,mixedType,1
5,6,0,11,mixedType,1
8,1,0,9,mixedType,1
4,5,0,9,mixedType,1
9,3,0,12,mixedType,1
4,2,0,6,mixedType,0
13,3,0,16,mixedType,2
8,3,0,11,mixedType,1
6,3,0,9,mixedType,1
9,3,0,12,mixedType,1
6,6,0,12,mixedType,1
6,2,0,8,mixedType,1
4,6,0,10,mixedType,1
6,1,0,7,mixedType,0
6,4,0,10,mixedType,1
6,4,0,10,mixedType,1
4,9,0,13,mixedType,1
5,2,0,7,mixedType,0
9,3,0,12,mixedType,1
1,7,0,8,mixedType,1
6,1,0,7,mixedType,0
5,2,0,7,mixedType,0
5,3,0,8,mixedType,1
4,6,0,10,mixedType,1
7,3,0,10,mixedType,1
6,3,0,9,mixedType,1
2,4,0,6,mixedType,0
3,6,0,9,mixedType,1
7,2,0,9,mixedType,1
4,2,0,6,mixedType,0
11,3,0,14,mixedType,2
9,2,0,11,mixedType,1
5,1,0,6,mixedType,0
13,3,0,16,mixedType,2
6,1,0,7,mixedType,0
2,8,0,10,mixedType,1
3,7,0,10,mixedType,1
1,8,0,9,mixedType,1
4,4,0,8,mixedType,1
6,3,0,9,mixedType,1
4,2,0,6,mixedType,0
9,3,0,12,mixedType,1
1,9,0,10,mixedType,1
10,2,0,12,mixedType,1
9,2,0,11,mixedType,1
6,1,0,7,mixedType,0
9,3,0,12,mixedType,1
4,2,0,6,mixedType,0
5,3,0,8,mixedType,1
8,2,0,10,mixedType,1
7,3,0,10,mixedType,1
9,4,0,13,mixedType,1
2,8,0,10,mixedType,1
8,2,0,10,mixedType,1
11,5,0,16,mixedType,2
9,2,0,11,mixedType,1
9,2,0,11,mixedType,1
7,1,0,8,mixedType,1
3,6,0,9,mixedType,1
5,2,0,7,mixedType,0
9,1,0,10,mixedType,1
4,2,0,6,mixedType,0
11,2,0,13,mixedType,1
15,1,0,16,mixedType,2
12,7,1,20,mixedType,2
5,6,0,11,mixedType,1
6,2,0,8,mixedType,1
11,1,0,12,mixedType,1
4,4,0,8,mixedType,1
5,3,0,8,mixedType,1
12,1,0,13,mixedType,1
11,5,0,16,mixedType,2
7,3,0,10,mixedType,1
4,5,0,9,mixedType,1
7,2,0,9,mixedType,1
7,3,0,10,mixedType,1
7,2,0,9,mixedType,1
7,3,0,10,mixedType,1
7,3,0,10,mixedType,1
7,1,0,8,mixedType,1
8,2,0,10,mixedType,1
7,3,0,10,mixedType,1
3,6,0,9,mixedType,1
15,1,0,16,mixedType,2
7,3,0,10,mixedType,1
6,2,0,8,mixedType,1
7,5,0,12,mixedType,1
6,3,0,9,mixedType,1
5,8,0,13,mixedType,1
9,4,0,13,mixedType,1
2,6,0,8,mixedType,1
9,3,0,12,mixedType,1
14,2,0,16,mixedType,2
8,2,0,10,mixedType,1
11,3,0,14,mixedType,2
9,2,0,11,mixedType,1
5,3,0,8,mixedType,1
7,4,0,11,mixedType,1
5,3,0,8,mixedType,1
4,8,0,12,mixedType,1
5,2,0,7,mixedType,0
8,2,0,10,mixedType,1
7,2,0,9,mixedType,1
5,3,0,8,mixedType,1
11,3,0,14,mixedType,2
7,4,0,11,mixedType,1
6,2,0,8,mixedType,1
7,3,0,10,mixedType,1
8,1,0,9,mixedType,1
11,2,0,13,mixedType,1
5,2,0,7,mixedType,0
7,2,0,9,mixedType,1
1,10,0,11,mixedType,1
1,8,0,9,mixedType,1
6,4,0,10,mixedType,1
7,3,0,10,mixedType,1
7,2,0,9,mixedType,1
5,3,0,8,mixedType,1
7,1,0,8,mixedType,1
3,8,0,11,mixedType,1
5,4,0,9,mixedType,1
5,1,0,6,mixedType,0
1,10,0,11,mixedType,1
6,3,0,9,mixedType,1
6,3,0,9,mixedType,1
12,4,0,16,mixedType,2
7,1,0,8,mixedType,1
4,9,0,13,mixedType,1
5,4,0,9,mixedType,1
9,2,0,11,mixedType,1
5,2,0,7,mixedType,0
4,2,0,6,mixedType,0
8,2,0,10,mixedType,1
6,1,0,7,mixedType,0
7,3,0,10,mixedType,1
7,3,0,10,mixedType,1
6,3,0,9,mixedType,1
5,1,0,6,mixedType,0
6,4,0,10,mixedType,1
5,3,0,8,mixedType,1
6,3,0,9,mixedType,1
8,2,0,10,mixedType,1
5,3,0,8,mixedType,1
6,3,0,9,mixedType,1
3,5,0,8,mixedType,1
8,2,0,10,mixedType,1
8,2,0,10,mixedType,1
1,7,0,8,mixedType,1
9,1,0,10,mixedType,1
3,6,0,9,mixedType,1
3,3,0,6,mixedType,0
7,3,0,10,mixedType,1
8,3,0,11,mixedType,1
7,2,0,9,mixedType,1
9,4,0,13,mixedType,1
6,2,0,8,mixedType,1
6,4,0,10,mixedType,1
7,3,0,10,mixedType,1
7,1,0,8,mixedType,1
4,8,0,12,mixedType,1
9,1,0,10,mixedType,1
8,1,0,9,mixedType,1
5,2,0,7,mixedType,0
5,2,0,7,mixedType,0
1,8,0,9,mixedType,1
5,4,0,9,mixedType,1
8,1,0,9,mixedType,1
8,1,0,9,mixedType,1
8,2,0,10,mixedType,1
5,2,0,7,mixedType,0
6,2,0,8,mixedType,1
6,4,0,10,mixedType,1
7,3,0,10,mixedType,1
9,8,0,17,mixedType,2
9,1,0,10,mixedType,1
11,3,0,14,mixedType,2
7,3,0,10,mixedType,1
6,4,0,10,mixedType,1
10,2,0,12,mixedType,1
14,2,0,16,mixedType,2
7,4,0,11,mixedType,1
5,1,0,6,mixedType,0
1,7,0,8,mixedType,1
7,3,0,10,mixedType,1
6,3,0,9,mixedType,1
3,8,0,11,mixedType,1
8,2,0,10,mixedType,1
9,1,0,10,mixedType,1
5,3,0,8,mixedType,1
3,5,0,8,mixedType,1
6,3,0,9,mixedType,1
7,3,0,10,mixedType,1
7,2,0,9,mixedType,1
8,1,0,9,mixedType,1
3,7,0,10,mixedType,1
7,2,0,9,mixedType,1
7,3,0,10,mixedType,1
12,3,0,15,mixedType,2
6,2,0,8,mixedType,1
6,3,0,9,mixedType,1
6,2,0,8,mixedType,1
5,1,0,6,mixedType,0
7,2,0,9,mixedType,1
12,1,0,13,mixedType,1
7,3,0,10,mixedType,1
8,4,0,12,mixedType,1
7,3,0,10,mixedType,1
5,2,0,7,mixedType,0
6,1,0,7,mixedType,0
2,7,0,9,mixedType,1
3,6,0,9,mixedType,1
6,4,0,10,mixedType,1
5,3,0,8,mixedType,1
7,3,0,10,mixedType,1
6,4,0,10,mixedType,1
7,3,0,10,mixedType,1
4,2,0,6,mixedType,0
2,7,0,9,mixedType,1
6,1,0,7,mixedType,0
13,3,0,16,mixedType,2
8,3,0,11,mixedType,1
9,1,0,10,mixedType,1
10,3,3,16,mixedType,2
4,2,0,6,mixedType,0
8,2,0,10,mixedType,1
1,8,0,9,mixedType,1
11,1,0,12,mixedType,1
6,3,0,9,mixedType,1
6,3,0,9,mixedType,1
10,3,1,14,mixedType,2
5,1,0,6,mixedType,0
8,1,0,9,mixedType,1
4,4,0,8,mixedType,1
5,3,0,8,mixedType,1
11,2,0,13,mixedType,1
3,6,0,9,mixedType,1
7,3,0,10,mixedType,1
6,2,0,8,mixedType,1
5,3,0,8,mixedType,1
5,2,0,7,mixedType,0
3,5,0,8,mixedType,1
10,1,0,11,mixedType,1
8,5,0,13,mixedType,1
6,4,0,10,mixedType,1
13,3,0,16,mixedType,2
7,2,0,9,mixedType,1
11,1,0,12,mixedType,1
6,3,0,9,mixedType,1
6,3,0,9,mixedType,1
10,2,0,12,mixedType,1
6,2,0,8,mixedType,1
4,5,0,9,mixedType,1
6,4,0,10,mixedType,1
6,4,0,10,mixedType,1
8,3,0,11,mixedType,1
5,4,0,9,mixedType,1
5,5,0,10,mixedType,1
5,3,0,8,mixedType,1
5,4,0,9,mixedType,1
5,3,0,8,mixedType,1
9,1,0,10,mixedType,1
4,4,0,8,mixedType,1
5,1,0,6,mixedType,0
2,6,0,8,mixedType,1
11,2,0,13,mixedType,1
14,2,0,16,mixedType,2
8,3,0,11,mixedType,1
6,6,0,12,mixedType,1
9,6,0,15,mixedType,2
7,1,0,8,mixedType,1
6,3,0,9,mixedType,1
5,3,0,8,mixedType,1
8,2,0,10,mixedType,1
2,10,0,12,mixedType,1
7,1,0,8,mixedType,1
6,2,0,8,mixedType,1
7,1,0,8,mixedType,1
6,3,0,9,mixedType,1
7,3,0,10,mixedType,1
6,3,0,9,mixedType,1
7,3,0,10,mixedType,1
5,2,0,7,mixedType,0
6,1,0,7,mixedType,0
5,1,0,6,mixedType,0
6,1,0,7,mixedType,0
6,3,0,9,mixedType,1
14,2,0,16,mixedType,2
6,2,0,8,mixedType,1
9,0,1,10,mixedType,1
7,2,0,9,mixedType,1
13,3,0,16,mixedType,2
8,3,0,11,mixedType,1
4,2,0,6,mixedType,0
10,3,0,13,mixedType,1
5,2,0,7,mixedType,0
6,2,0,8,mixedType,1
9,1,0,10,mixedType,1
6,3,0,9,mixedType,1
6,3,0,9,mixedType,1
10,2,0,12,mixedType,1
5,4,0,9,mixedType,1
15,1,0,16,mixedType,2
8,4,0,12,mixedType,1
4,2,0,6,mixedType,0
9,1,0,10,mixedType,1
2,4,0,6,mixedType,0
10,4,0,14,mixedType,2
8,1,0,9,mixedType,1
7,2,0,9,mixedType,1
8,2,0,10,mixedType,1
5,3,0,8,mixedType,1
3,6,0,9,mixedType,1
12,4,0,16,mixedType,2
6,1,0,7,mixedType,0
14,2,0,16,mixedType,2
5,1,0,6,mixedType,0
4,4,0,8,mixedType,1
7,2,0,9,mixedType,1
7,2,0,9,mixedType,1
7,3,0,10,mixedType,1
12,4,0,16,mixedType,2
5,4,0,9,mixedType,1
7,3,0,10,mixedType,1
6,2,0,8,mixedType,1
7,1,0,8,mixedType,1
8,2,0,10,mixedType,1
8,1,0,9,mixedType,1
6,1,0,7,mixedType,0
7,1,0,8,mixedType,1
4,4,0,8,mixedType,1
2,6,0,8,mixedType,1
5,3,0,8,mixedType,1
6,7,0,13,mixedType,1
4,2,0,6,mixedType,0
5,0,0,5,sameType,0
10,9,2,21,mixedType,2
7,2,0,9,mixedType,1
5,2,0,7,mixedType,0
10,7,1,18,mixedType,2
5,3,0,8,mixedType,1
6,3,0,9,mixedType,1
1,9,0,10,mixedType,1
4,2,0,6,mixedType,0
5,0,1,6,mixedType,0
7,1,0,8,mixedType,1
6,3,0,9,mixedType,1
12,1,0,13,mixedType,1
7,1,0,8,mixedType,1
7,2,0,9,mixedType,1
14,2,0,16,mixedType,2
6,3,0,9,mixedType,1
9,4,0,13,mixedType,1
9,3,0,12,mixedType,1
5,4,0,9,mixedType,1
9,2,0,11,mixedType,1
13,3,0,16,mixedType,2
4,6,0,10,mixedType,1
8,2,0,10,mixedType,1
7,3,0,10,mixedType,1
10,2,0,12,mixedType,1
5,2,0,7,mixedType,0
7,1,0,8,mixedType,1
6,4,0,10,mixedType,1
8,2,0,10,mixedType,1
8,2,0,10,mixedType,1
3,6,0,9,mixedType,1
6,3,0,9,mixedType,1
6,3,0,9,mixedType,1
1,9,0,10,mixedType,1
8,2,0,10,mixedType,1
6,3,0,9,mixedType,1
4,6,0,10,mixedType,1
6,2,0,8,mixedType,1
6,4,0,10,mixedType,1
6,4,0,10,mixedType,1
4,9,0,13,mixedType,1
7,2,0,9,mixedType,1
7,2,0,9,mixedType,1
7,3,0,10,mixedType,1
8,3,0,11,mixedType,1
14,1,0,15,mixedType,2
5,2,0,7,mixedType,0
7,4,0,11,mixedType,1
4,4,0,8,mixedType,1
2,8,0,10,mixedType,1
3,6,0,9,mixedType,1
5,4,0,9,mixedType,1
14,2,0,16,mixedType,2
10,1,0,11,mixedType,1
7,3,0,10,mixedType,1
8,3,0,11,mixedType,1
4,2,0,6,mixedType,0
13,3,0,16,mixedType,2
8,1,0,9,mixedType,1
8,2,0,10,mixedType,1
3,6,0,9,mixedType,1
4,2,0,6,mixedType,0
7,5,0,12,mixedType,1
2,6,0,8,mixedType,1
5,4,0,9,mixedType,1
12,6,1,19,mixedType,2
9,3,0,12,mixedType,1
4,2,0,6,mixedType,0
7,3,0,10,mixedType,1
7,2,0,9,mixedType,1
8,3,0,11,mixedType,1
5,7,0,12,mixedType,1
6,2,0,8,mixedType,1
8,1,0,9,mixedType,1
8,1,0,9,mixedType,1
13,3,0,16,mixedType,2
4,2,0,6,mixedType,0
11,4,0,15,mixedType,2
7,2,0,9,mixedType,1
5,4,0,9,mixedType,1
5,4,0,9,mixedType,1
7,3,0,10,mixedType,1
7,2,0,9,mixedType,1
10,3,0,13,mixedType,1
8,2,0,10,mixedType,1
2,6,0,8,mixedType,1
7,2,0,9,mixedType,1
5,1,0,6,mixedType,0
7,3,0,10,mixedType,1
9,1,0,10,mixedType,1
9,3,0,12,mixedType,1
6,3,0,9,mixedType,1
5,1,0,6,mixedType,0
4,6,0,10,mixedType,1
10,3,0,13,mixedType,1
8,1,0,9,mixedType,1
3,3,0,6,mixedType,0
8,2,0,10,mixedType,1
7,5,0,12,mixedType,1
9,1,0,10,mixedType,1
5,4,0,9,mixedType,1
5,2,0,7,mixedType,0
6,2,0,8,mixedType,1
14,2,0,16,mixedType,2
5,1,0,6,mixedType,0
14,2,0,16,mixedType,2
6,4,0,10,mixedType,1
15,1,0,16,mixedType,2
5,2,0,7,mixedType,0
6,1,0,7,mixedType,0
4,4,0,8,mixedType,1
8,3,3,14,mixedType,2
5,2,0,7,mixedType,0
8,2,0,10,mixedType,1
6,3,0,9,mixedType,1
15,1,0,16,mixedType,2
9,3,0,12,mixedType,1
1,10,0,11,mixedType,1
7,1,0,8,mixedType,1
5,3,0,8,mixedType,1
7,3,0,10,mixedType,1
7,3,0,10,mixedType,1
7,4,0,11,mixedType,1
1,8,0,9,mixedType,1
5,3,0,8,mixedType,1
6,1,0,7,mixedType,0
6,3,0,9,mixedType,1
6,6,0,12,mixedType,1
5,4,0,9,mixedType,1
10,1,0,11,mixedType,1
6,2,0,8,mixedType,1
5,2,0,7,mixedType,0
8,2,0,10,mixedType,1
4,6,0,10,mixedType,1
10,0,1,11,mixedType,1
7,2,0,9,mixedType,1
6,4,0,10,mixedType,1
5,2,0,7,mixedType,0
5,3,0,8,mixedType,1
4,2,0,6,mixedType,0
7,3,0,10,mixedType,1
2,10,0,12,mixedType,1
7,3,0,10,mixedType,1
7,3,0,10,mixedType,1
4,2,0,6,mixedType,0
6,3,0,9,mixedType,1
8,2,0,10,mixedType,1
5,4,0,9,mixedType,1
8,2,0,10,mixedType,1
3,7,0,10,mixedType,1
8,2,0,10,mixedType,1
6,1,0,7,mixedType,0
6,3,0,9,mixedType,1
5,1,0,6,mixedType,0
5,4,0,9,mixedType,1
6,2,0,8,mixedType,1
3,6,0,9,mixedType,1
8,2,0,10,mixedType,1
15,1,0,16,mixedType,2
5,4,0,9,mixedType,1
4,8,0,12,mixedType,1
7,2,0,9,mixedType,1
9,4,0,13,mixedType,1
8,2,0,10,mixedType,1
6,2,0,8,mixedType,1
1,9,0,10,mixedType,1
2,8,0,10,mixedType,1
7,2,0,9,mixedType,1
5,1,0,6,mixedType,0
5,2,0,7,mixedType,0
5,3,0,8,mixedType,1
3,6,0,9,mixedType,1
16,0,1,17,mixedType,2
4,2,0,6,mixedType,0
9,3,0,12,mixedType,1
7,3,0,10,mixedType,1
7,3,0,10,mixedType,1
10,1,0,11,mixedType,1
7,2,0,9,mixedType,1
6,2,0,8,mixedType,1
6,3,0,9,mixedType,1
2,8,0,10,mixedType,1
5,1,0,6,mixedType,0
2,6,0,8,mixedType,1
6,1,0,7,mixedType,0
6,1,0,7,mixedType,0
5,3,0,8,mixedType,1
7,3,0,10,mixedType,1
5,6,0,11,mixedType,1
2,9,0,11,mixedType,1
5,5,0,10,mixedType,1
4,6,0,10,mixedType,1
14,2,0,16,mixedType,2
7,1,0,8,mixedType,1
10,6,0,16,mixedType,2
9,2,0,11,mixedType,1
6,4,0,10,mixedType,1
7,2,0,9,mixedType,1
8,1,0,9,mixedType,1
3,7,0,10,mixedType,1
3,5,0,8,mixedType,1
14,2,0,16,mixedType,2
1,9,0,10,mixedType,1
8,4,0,12,mixedType,1
4,2,0,6,mixedType,0
4,7,0,11,mixedType,1
9,1,0,10,mixedType,1
7,3,0,10,mixedType,1
7,3,0,10,mixedType,1
6,3,0,9,mixedType,1
4,6,0,10,mixedType,1
4,4,0,8,mixedType,1
2,6,0,8,mixedType,1
8,1,0,9,mixedType,1
3,10,0,13,mixedType,1
6,3,0,9,mixedType,1
7,2,0,9,mixedType,1
12,3,0,15,mixedType,2
11,5,0,16,mixedType,2
8,1,0,9,mixedType,1
9,1,0,10,mixedType,1
8,2,0,10,mixedType,1
12,1,0,13,mixedType,1
2,13,0,15,mixedType,2
7,1,0,8,mixedType,1
12,4,0,16,mixedType,2
6,3,0,9,mixedType,1
6,3,0,9,mixedType,1
7,3,0,10,mixedType,1
13,3,0,16,mixedType,2
14,2,0,16,mixedType,2
5,2,0,7,mixedType,0
2,8,0,10,mixedType,1
7,3,0,10,mixedType,1
4,8,0,12,mixedType,1
5,3,0,8,mixedType,1
5,6,0,11,mixedType,1
14,2,0,16,mixedType,2
7,3,0,10,mixedType,1
6,3,0,9,mixedType,1
6,3,0,9,mixedType,1
8,2,0,10,mixedType,1
5,4,0,9,mixedType,1
4,4,0,8,mixedType,1
14,2,0,16,mixedType,2
5,4,0,9,mixedType,1
8,1,0,9,mixedType,1
4,4,0,8,mixedType,1
12,1,0,13,mixedType,1
6,4,0,10,mixedType,1
7,2,0,9,mixedType,1
9,2,0,11,mixedType,1
1,8,0,9,mixedType,1
8,2,0,10,mixedType,1
7,3,0,10,mixedType,1
6,2,0,8,mixedType,1
5,2,0,7,mixedType,0
7,2,0,9,mixedType,1
1,8,0,9,mixedType,1
7,3,0,10,mixedType,1
5,2,0,7,mixedType,0
8,1,0,9,mixedType,1
7,3,0,10,mixedType,1
2,6,0,8,mixedType,1
6,4,0,10,mixedType,1
5,2,0,7,mixedType,0
7,2,0,9,mixedType,1
10,3,0,13,mixedType,1
0,3,3,6,mixedType,0
5,5,0,10,mixedType,1
5,6,0,11,mixedType,1
8,1,0,9,mixedType,1
9,4,0,13,mixedType,1
5,4,0,9,mixedType,1
6,4,0,10,mixedType,1
7,3,0,10,mixedType,1
6,2,0,8,mixedType,1
6,0,0,6,sameType,0
2,4,0,6,mixedType,0
12,4,0,16,mixedType,2
8,2,0,10,mixedType,1
6,2,0,8,mixedType,1
7,2,0,9,mixedType,1
7,3,0,10,mixedType,1
8,1,0,9,mixedType,1
13,3,0,16,mixedType,2
9,6,0,15,mixedType,2
5,3,0,8,mixedType,1
12,4,0,16,mixedType,2
11,1,0,12,mixedType,1
12,4,0,16,mixedType,2
1,8,0,9,mixedType,1
7,3,0,10,mixedType,1
6,2,0,8,mixedType,1
12,1,0,13,mixedType,1
13,3,0,16,mixedType,2
6,2,0,8,mixedType,1
10,1,0,11,mixedType,1
9,1,0,10,mixedType,1
8,3,0,11,mixedType,1
3,6,0,9,mixedType,1
5,1,0,6,mixedType,0
6,2,0,8,mixedType,1
4,2,0,6,mixedType,0
8,2,0,10,mixedType,1
6,4,0,10,mixedType,1
13,3,0,16,mixedType,2
4,4,0,8,mixedType,1
9,1,0,10,mixedType,1
4,4,0,8,mixedType,1
6,2,0,8,mixedType,1
6,4,0,10,mixedType,1
4,6,0,10,mixedType,1
5,2,0,7,mixedType,0
3,5,0,8,mixedType,1
4,2,0,6,mixedType,0
4,2,0,6,mixedType,0
8,3,0,11,mixedType,1
5,4,0,9,mixedType,1
6,3,0,9,mixedType,1
6,6,0,12,mixedType,1
11,0,2,13,mixedType,1
6,4,0,10,mixedType,1
9,4,0,13,mixedType,1
4,6,0,10,mixedType,1
10,2,0,12,mixedType,1
7,6,0,13,mixedType,1
3,9,0,12,mixedType,1
7,3,0,10,mixedType,1
9,3,0,12,mixedType,1
6,3,0,9,mixedType,1
5,3,0,8,mixedType,1
9,1,0,10,mixedType,1
4,2,0,6,mixedType,0
6,2,0,8,mixedType,1
12,4,0,16,mixedType,2
7,3,0,10,mixedType,1
5,2,0,7,mixedType,0
9,1,0,10,mixedType,1
9,2,0,11,mixedType,1
3,6,0,9,mixedType,1
8,4,0,12,mixedType,1
7,3,0,10,mixedType,1
6,1,0,7,mixedType,0
5,1,0,6,mixedType,0
7,2,0,9,mixedType,1
8,0,1,9,mixedType,1
10,2,0,12,mixedType,1
6,6,0,12,mixedType,1
5,2,0,7,mixedType,0
4,2,0,6,mixedType,0
7,2,0,9,mixedType,1
8,1,0,9,mixedType,1
9,1,0,10,mixedType,1
13,3,0,16,mixedType,2
5,3,0,8,mixedType,1
7,3,0,10,mixedType,1
7,3,0,10,mixedType,1
5,2,0,7,mixedType,0
9,1,0,10,mixedType,1
4,2,0,6,mixedType,0
4,4,0,8,mixedType,1
4,2,0,6,mixedType,0
8,1,0,9,mixedType,1
6,2,0,8,mixedType,1
4,2,0,6,mixedType,0
8,1,0,9,mixedType,1
9,1,0,10,mixedType,1
9,2,0,11,mixedType,1
6,3,0,9,mixedType,1
5,0,1,6,mixedType,0
9,3,0,12,mixedType,1
6,4,0,10,mixedType,1
11,1,0,12,mixedType,1
6,7,0,13,mixedType,1
5,3,0,8,mixedType,1
4,8,0,12,mixedType,1
7,2,0,9,mixedType,1
14,2,0,16,mixedType,2
7,2,0,9,mixedType,1
1,8,0,9,mixedType,1
10,1,0,11,mixedType,1
12,8,0,20,mixedType,2
5,1,0,6,mixedType,0
5,5,0,10,mixedType,1
10,2,0,12,mixedType,1
6,3,0,9,mixedType,1
3,5,0,8,mixedType,1
7,3,0,10,mixedType,1
1,8,0,9,mixedType,1
1,8,0,9,mixedType,1
7,3,0,10,mixedType,1
7,4,0,11,mixedType,1
7,2,0,9,mixedType,1
7,3,0,10,mixedType,1
4,2,0,6,mixedType,0
11,1,0,12,mixedType,1
14,2,0,16,mixedType,2
7,1,0,8,mixedType,1
5,3,0,8,mixedType,1
7,3,0,10,mixedType,1
12,4,0,16,mixedType,2
7,1,0,8,mixedType,1
7,2,0,9,mixedType,1
8,3,0,11,mixedType,1
5,2,0,7,mixedType,0
6,2,0,8,mixedType,1
7,2,0,9,mixedType,1
6,4,0,10,mixedType,1
6,1,0,7,mixedType,0
6,3,0,9,mixedType,1
5,7,0,12,mixedType,1
9,1,0,10,mixedType,1
7,2,0,9,mixedType,1
6,1,0,7,mixedType,0
6,3,0,9,mixedType,1
2,6,0,8,mixedType,1
6,4,0,10,mixedType,1
8,2,0,10,mixedType,1
5,3,0,8,mixedType,1
13,3,0,16,mixedType,2
7,3,0,10,mixedType,1
7,2,0,9,mixedType,1
8,2,0,10,mixedType,1
11,4,0,15,mixedType,2
4,2,0,6,mixedType,0
5,1,0,6,mixedType,0
15,1,0,16,mixedType,2
5,2,0,7,mixedType,0
5,3,0,8,mixedType,1
6,3,0,9,mixedType,1
6,3,0,9,mixedType,1
8,2,0,10,mixedType,1
2,8,0,10,mixedType,1
4,8,0,12,mixedType,1
10,4,1,15,mixedType,2
13,3,0,16,mixedType,2
6,2,0,8,mixedType,1
11,3,0,14,mixedType,2
5,3,0,8,mixedType,1
6,1,0,7,mixedType,0
4,5,0,9,mixedType,1
2,6,0,8,mixedType,1
7,4,0,11,mixedType,1
5,3,0,8,mixedType,1
1,10,0,11,mixedType,1
6,3,0,9,mixedType,1
6,4,0,10,mixedType,1
8,1,0,9,mixedType,1
5,2,0,7,mixedType,0
4,2,0,6,mixedType,0
9,3,0,12,mixedType,1
6,6,0,12,mixedType,1
9,1,0,10,mixedType,1
3,7,0,10,mixedType,1
6,4,0,10,mixedType,1
3,3,0,6,mixedType,0
12,4,0,16,mixedType,2
9,1,0,10,mixedType,1
12,3,0,15,mixedType,2
1,5,0,6,mixedType,0
7,2,0,9,mixedType,1
6,2,0,8,mixedType,1
4,4,0,8,mixedType,1
10,4,1,15,mixedType,2
9,5,0,14,mixedType,2
3,8,0,11,mixedType,1
15,1,0,16,mixedType,2
7,2,0,9,mixedType,1
15,1,0,16,mixedType,2
5,5,0,10,mixedType,1
7,3,0,10,mixedType,1
6,4,0,10,mixedType,1
3,7,0,10,mixedType,1
5,2,0,7,mixedType,0
6,1,0,7,mixedType,0
7,3,0,10,mixedType,1
1,9,0,10,mixedType,1
5,2,0,7,mixedType,0
6,4,0,10,mixedType,1
6,4,0,10,mixedType,1
6,3,0,9,mixedType,1
5,3,0,8,mixedType,1
7,3,0,10,mixedType,1
5,4,0,9,mixedType,1
7,2,0,9,mixedType,1
8,1,0,9,mixedType,1
7,3,0,10,mixedType,1
5,3,0,8,mixedType,1
3,9,0,12,mixedType,1
4,5,0,9,mixedType,1
4,4,0,8,mixedType,1
13,3,0,16,mixedType,2
9,0,3,12,mixedType,1
6,3,0,9,mixedType,1
7,2,0,9,mixedType,1
1,7,0,8,mixedType,1
1,5,0,6,mixedType,0
7,5,0,12,mixedType,1
7,3,0,10,mixedType,1
5,1,0,6,mixedType,0
3,6,0,9,mixedType,1
7,4,0,11,mixedType,1
1,9,0,10,mixedType,1
2,7,0,9,mixedType,1
5,3,0,8,mixedType,1
5,2,0,7,mixedType,0
8,4,0,12,mixedType,1
4,4,0,8,mixedType,1
1,6,0,7,mixedType,0
8,2,0,10,mixedType,1
6,4,0,10,mixedType,1
11,3,0,14,mixedType,2
14,2,0,16,mixedType,2
7,2,0,9,mixedType,1
8,2,0,10,mixedType,1
1,7,0,8,mixedType,1
5,2,0,7,mixedType,0
15,1,0,16,mixedType,2
1,8,0,9,mixedType,1
5,5,0,10,mixedType,1
7,3,0,10,mixedType,1
10,2,0,12,mixedType,1
2,6,0,8,mixedType,1
8,1,0,9,mixedType,1
6,2,0,8,mixedType,1
3,6,0,9,mixedType,1
14,2,0,16,mixedType,2
10,1,0,11,mixedType,1
9,0,1,10,mixedType,1
7,3,0,10,mixedType,1
10,1,0,11,mixedType,1
8,0,1,9,mixedType,1
4,4,0,8,mixedType,1
7,1,0,8,mixedType,1
1,10,0,11,mixedType,1
6,3,0,9,mixedType,1
6,1,0,7,mixedType,0
5,2,0,7,mixedType,0
7,2,0,9,mixedType,1
5,3,0,8,mixedType,1
7,1,0,8,mixedType,1
6,2,0,8,mixedType,1
7,1,0,8,mixedType,1
8,4,0,12,mixedType,1
6,2,0,8,mixedType,1
6,3,0,9,mixedType,1
6,6,0,12,mixedType,1
8,3,0,11,mixedType,1
7,3,0,10,mixedType,1
7,4,0,11,mixedType,1
1,8,0,9,mixedType,1
8,4,0,12,mixedType,1
6,3,0,9,mixedType,1
9,2,0,11,mixedType,1
7,3,0,10,mixedType,1
6,4,0,10,mixedType,1
8,4,0,12,mixedType,1
8,2,0,10,mixedType,1
4,4,0,8,mixedType,1
6,4,0,10,mixedType,1
6,2,0,8,mixedType,1
5,1,0,6,mixedType,0
6,4,0,10,mixedType,1
7,2,0,9,mixedType,1
14,2,0,16,mixedType,2
6,2,0,8,mixedType,1
6,2,0,8,mixedType,1
14,2,0,16,mixedType,2
7,3,0,10,mixedType,1
9,0,2,11,mixedType,1
7,5,0,12,mixedType,1
5,3,0,8,mixedType,1
7,2,0,9,mixedType,1
7,3,0,10,mixedType,1
8,2,0,10,mixedType,1
10,2,0,12,mixedType,1
4,4,0,8,mixedType,1
8,2,0,10,mixedType,1
8,4,0,12,mixedType,1
7,3,0,10,mixedType,1
5,1,0,6,mixedType,0
6,5,0,11,mixedType,1
3,3,0,6,mixedType,0
3,5,0,8,mixedType,1
7,2,0,9,mixedType,1
6,4,0,10,mixedType,1
5,4,0,9,mixedType,1
4,4,0,8,mixedType,1
4,4,0,8,mixedType,1
7,6,0,13,mixedType,1
12,4,0,16,mixedType,2
4,6,0,10,mixedType,1
8,4,0,12,mixedType,1
5,4,0,9,mixedType,1
7,1,0,8,mixedType,1
6,4,0,10,mixedType,1
3,5,0,8,mixedType,1
8,3,0,11,mixedType,1
4,7,0,11,mixedType,1
10,1,0,11,mixedType,1
7,3,0,10,mixedType,1
14,2,0,16,mixedType,2
2,6,0,8,mixedType,1
7,3,0,10,mixedType,1
4,4,0,8,mixedType,1
5,4,0,9,mixedType,1
7,3,0,10,mixedType,1
6,2,0,8,mixedType,1
5,4,0,9,mixedType,1
5,1,0,6,mixedType,0
10,2,0,12,mixedType,1
11,5,0,16,mixedType,2
9,7,0,16,mixedType,2
6,4,0,10,mixedType,1
6,2,0,8,mixedType,1
7,1,0,8,mixedType,1
6,4,0,10,mixedType,1
6,3,0,9,mixedType,1
5,2,0,7,mixedType,0
5,2,0,7,mixedType,0
7,2,0,9,mixedType,1
8,3,0,11,mixedType,1
7,2,0,9,mixedType,1
5,3,0,8,mixedType,1
7,3,0,10,mixedType,1
5,7,0,12,mixedType,1
5,3,0,8,mixedType,1
2,4,0,6,mixedType,0
8,1,0,9,mixedType,1
8,2,0,10,mixedType,1
2,6,0,8,mixedType,1
4,6,0,10,mixedType,1
7,6,0,13,mixedType,1
8,1,0,9,mixedType,1
6,3,0,9,mixedType,1
11,3,0,14,mixedType,2
6,6,0,12,mixedType,1
4,8,0,12,mixedType,1
13,3,0,16,mixedType,2
14,2,0,16,mixedType,2
4,2,0,6,mixedType,0
6,2,0,8,mixedType,1
7,2,0,9,mixedType,1
9,3,0,12,mixedType,1
6,1,0,7,mixedType,0
6,3,0,9,mixedType,1
7,3,0,10,mixedType,1
6,2,0,8,mixedType,1
7,2,0,9,mixedType,1
14,2,0,16,mixedType,2
6,4,0,10,mixedType,1
8,2,0,10,mixedType,1
4,2,0,6,mixedType,0
5,3,0,8,mixedType,1
7,3,0,10,mixedType,1
6,3,0,9,mixedType,1
7,3,0,10,mixedType,1
9,3,0,12,mixedType,1
8,3,0,11,mixedType,1
1,7,0,8,mixedType,1
4,4,0,8,mixedType,1
6,3,0,9,mixedType,1
13,3,0,16,mixedType,2
7,3,0,10,mixedType,1
6,2,0,8,mixedType,1
15,1,0,16,mixedType,2
8,2,0,10,mixedType,1
2,8,0,10,mixedType,1
5,4,0,9,mixedType,1
7,3,0,10,mixedType,1
11,1,0,12,mixedType,1
5,4,0,9,mixedType,1
7,3,0,10,mixedType,1
6,3,0,9,mixedType,1
10,2,0,12,mixedType,1
7,4,0,11,mixedType,1
6,2,0,8,mixedType,1
13,3,0,16,mixedType,2
6,2,0,8,mixedType,1
5,3,0,8,mixedType,1
4,6,0,10,mixedType,1
5,4,0,9,mixedType,1
8,1,0,9,mixedType,1
10,4,0,14,mixedType,2
10,3,0,13,mixedType,1
6,3,0,9,mixedType,1
6,4,0,10,mixedType,1
4,5,0,9,mixedType,1
10,3,0,13,mixedType,1
8,2,0,10,mixedType,1
6,1,0,7,mixedType,0
1,8,0,9,mixedType,1
6,3,0,9,mixedType,1
8,4,0,12,mixedType,1
6,6,0,12,mixedType,1
5,5,0,10,mixedType,1
7,2,0,9,mixedType,1
8,2,0,10,mixedType,1
5,4,0,9,mixedType,1
8,1,0,9,mixedType,1
7,3,0,10,mixedType,1
6,4,0,10,mixedType,1
16,4,0,20,mixedType,2
6,2,0,8,mixedType,1
5,3,0,8,mixedType,1
9,4,0,13,mixedType,1
13,3,0,16,mixedType,2
6,2,0,8,mixedType,1
7,5,0,12,mixedType,1
10,1,0,11,mixedType,1
5,4,0,9,mixedType,1
1,8,0,9,mixedType,1
7,3,0,10,mixedType,1
10,2,0,12,mixedType,1
9,3,0,12,mixedType,1
14,2,0,16,mixedType,2
2,4,0,6,mixedType,0
7,1,0,8,mixedType,1
5,2,0,7,mixedType,0
1,7,0,8,mixedType,1
6,4,0,10,mixedType,1
7,4,0,11,mixedType,1
9,3,0,12,mixedType,1
9,1,0,10,mixedType,1
6,2,0,8,mixedType,1
5,1,0,6,mixedType,0
9,1,0,10,mixedType,1
5,4,0,9,mixedType,1
7,3,0,10,mixedType,1
8,2,0,10,mixedType,1
11,5,0,16,mixedType,2
5,4,0,9,mixedType,1
5,4,0,9,mixedType,1
3,6,0,9,mixedType,1
4,2,0,6,mixedType,0
6,3,0,9,mixedType,1
8,2,0,10,mixedType,1
5,3,0,8,mixedType,1
5,4,0,9,mixedType,1
7,2,0,9,mixedType,1
12,4,0,16,mixedType,2
6,2,0,8,mixedType,1
7,3,0,10,mixedType,1
6,4,0,10,mixedType,1
6,2,0,8,mixedType,1
8,4,0,12,mixedType,1
5,3,0,8,mixedType,1
6,4,0,10,mixedType,1
5,2,0,7,mixedType,0
6,2,0,8,mixedType,1
7,2,0,9,mixedType,1
7,5,0,12,mixedType,1
4,4,0,8,mixedType,1
5,3,0,8,mixedType,1
6,2,0,8,mixedType,1
1,8,0,9,mixedType,1
14,2,0,16,mixedType,2
6,6,0,12,mixedType,1
6,2,0,8,mixedType,1
14,2,0,16,mixedType,2
7,3,0,10,mixedType,1
8,2,0,10,mixedType,1
6,3,0,9,mixedType,1
12,3,0,15,mixedType,2
7,4,0,11,mixedType,1
4,4,0,8,mixedType,1
6,0,0,6,sameType,0
1,8,0,9,mixedType,1
9,3,0,12,mixedType,1
7,4,0,11,mixedType,1
6,3,0,9,mixedType,1
5,3,0,8,mixedType,1
9,1,0,10,mixedType,1
7,2,0,9,mixedType,1
7,3,0,10,mixedType,1
4,2,0,6,mixedType,0
3,5,0,8,mixedType,1
4,2,0,6,mixedType,0
3,3,0,6,mixedType,0
10,1,0,11,mixedType,1
7,3,0,10,mixedType,1
7,4,0,11,mixedType,1
4,6,0,10,mixedType,1
4,6,0,10,mixedType,1
7,2,0,9,mixedType,1
9,1,0,10,mixedType,1
7,3,0,10,mixedType,1
7,4,0,11,mixedType,1
6,2,0,8,mixedType,1
8,2,0,10,mixedType,1
6,3,0,9,mixedType,1
6,4,0,10,mixedType,1
6,2,0,8,mixedType,1
5,4,0,9,mixedType,1
9,1,0,10,mixedType,1
0,6,1,7,mixedType,0
3,9,0,12,mixedType,1
3,7,0,10,mixedType,1
7,3,0,10,mixedType,1
17,3,0,20,mixedType,2
5,4,0,9,mixedType,1
14,2,0,16,mixedType,2
5,1,0,6,mixedType,0
8,2,0,10,mixedType,1
6,1,0,7,mixedType,0
3,5,0,8,mixedType,1
6,2,0,8,mixedType,1
15,1,0,16,mixedType,2
8,1,0,9,mixedType,1
7,4,0,11,mixedType,1
3,8,0,11,mixedType,1
6,2,0,8,mixedType,1
13,3,0,16,mixedType,2
15,1,0,16,mixedType,2
5,3,0,8,mixedType,1
8,3,0,11,mixedType,1
1,14,1,16,mixedType,2
10,1,0,11,mixedType,1
6,4,0,10,mixedType,1
4,4,0,8,mixedType,1
7,3,0,10,mixedType,1
5,3,0,8,mixedType,1
1,9,0,10,mixedType,1
6,2,0,8,mixedType,1
9,2,0,11,mixedType,1
5,4,0,9,mixedType,1
8,2,0,10,mixedType,1
8,2,0,10,mixedType,1
4,2,0,6,mixedType,0
4,6,0,10,mixedType,1
7,2,0,9,mixedType,1
1,8,0,9,mixedType,1
4,9,0,13,mixedType,1
3,3,0,6,mixedType,0
6,4,0,10,mixedType,1
5,3,0,8,mixedType,1
4,6,0,10,mixedType,1
5,2,0,7,mixedType,0
8,1,0,9,mixedType,1
9,1,0,10,mixedType,1
6,4,0,10,mixedType,1
5,4,0,9,mixedType,1
5,3,0,8,mixedType,1
6,3,0,9,mixedType,1
5,2,0,7,mixedType,0
10,1,0,11,mixedType,1
5,3,0,8,mixedType,1
7,3,0,10,mixedType,1
9,1,0,10,mixedType,1
1,11,0,12,mixedType,1
13,3,0,16,mixedType,2
13,3,0,16,mixedType,2
10,3,0,13,mixedType,1
7,2,0,9,mixedType,1
5,2,0,7,mixedType,0
6,1,0,7,mixedType,0
6,2,0,8,mixedType,1
1,8,0,9,mixedType,1
6,1,0,7,mixedType,0
6,2,0,8,mixedType,1
6,3,0,9,mixedType,1
3,6,0,9,mixedType,1
11,2,0,13,mixedType,1
7,4,0,11,mixedType,1
5,3,0,8,mixedType,1
7,1,0,8,mixedType,1
11,1,0,12,mixedType,1
9,4,1,14,mixedType,2
8,2,0,10,mixedType,1
2,8,0,10,mixedType,1
7,2,0,9,mixedType,1
5,2,0,7,mixedType,0
7,2,0,9,mixedType,1
9,3,0,12,mixedType,1
6,3,0,9,mixedType,1
3,6,0,9,mixedType,1
3,5,0,8,mixedType,1
5,4,0,9,mixedType,1
7,1,0,8,mixedType,1
7,4,0,11,mixedType,1
7,3,0,10,mixedType,1
11,3,0,14,mixedType,2
3,6,0,9,mixedType,1
3,5,0,8,mixedType,1
4,2,0,6,mixedType,0
4,5,0,9,mixedType,1
4,2,0,6,mixedType,0
8,4,0,12,mixedType,1
5,4,0,9,mixedType,1
5,2,0,7,mixedType,0
8,3,0,11,mixedType,1
2,8,0,10,mixedType,1
9,1,0,10,mixedType,1
8,2,0,10,mixedType,1
6,3,0,9,mixedType,1
5,4,0,9,mixedType,1
8,3,0,11,mixedType,1
7,3,0,10,mixedType,1
8,2,0,10,mixedType,1
5,2,0,7,mixedType,0
12,1,0,13,mixedType,1
12,4,0,16,mixedType,2
4,4,0,8,mixedType,1
6,4,0,10,mixedType,1
1,10,0,11,mixedType,1
7,1,0,8,mixedType,1
6,3,0,9,mixedType,1
14,2,0,16,mixedType,2
7,3,0,10,mixedType,1
6,1,0,7,mixedType,0
4,5,0,9,mixedType,1
5,2,0,7,mixedType,0
6,3,0,9,mixedType,1
8,2,0,10,mixedType,1
9,1,0,10,mixedType,1
7,3,0,10,mixedType,1
3,8,0,11,mixedType,1
7,2,0,9,mixedType,1
6,3,0,9,mixedType,1
8,1,0,9,mixedType,1
9,1,0,10,mixedType,1
6,3,0,9,mixedType,1
5,3,0,8,mixedType,1
3,6,0,9,mixedType,1
13,3,0,16,mixedType,2
5,3,0,8,mixedType,1
7,2,0,9,mixedType,1
11,2,0,13,mixedType,1
6,3,0,9,mixedType,1
9,1,0,10,mixedType,1
2,8,0,10,mixedType,1
12,1,0,13,mixedType,1
12,3,0,15,mixedType,2
4,2,0,6,mixedType,0
11,3,0,14,mixedType,2
9,5,0,14,mixedType,2
15,10,3,28,mixedType,2
5,4,0,9,mixedType,1
13,3,0,16,mixedType,2
7,4,0,11,mixedType,1
10,2,0,12,mixedType,1
4,2,0,6,mixedType,0
9,2,0,11,mixedType,1
15,1,0,16,mixedType,2
7,2,0,9,mixedType,1
7,2,0,9,mixedType,1
6,7,0,13,mixedType,1
5,2,0,7,mixedType,0
8,2,0,10,mixedType,1
8,3,0,11,mixedType,1
5,4,0,9,mixedType,1
8,1,0,9,mixedType,1
8,2,0,10,mixedType,1
4,4,0,8,mixedType,1
3,6,0,9,mixedType,1
1,9,0,10,mixedType,1
1,5,0,6,mixedType,0
7,3,0,10,mixedType,1
8,4,0,12,mixedType,1
15,1,0,16,mixedType,2
7,3,0,10,mixedType,1
6,2,0,8,mixedType,1
10,3,0,13,mixedType,1
5,3,0,8,mixedType,1
11,3,0,14,mixedType,2
7,3,0,10,mixedType,1
4,4,0,8,mixedType,1
7,4,0,11,mixedType,1
13,3,0,16,mixedType,2
14,2,0,16,mixedType,2
4,4,0,8,mixedType,1
7,4,0,11,mixedType,1
9,1,0,10,mixedType,1
6,2,0,8,mixedType,1
9,2,0,11,mixedType,1
5,4,0,9,mixedType,1
9,2,0,11,mixedType,1
6,3,0,9,mixedType,1
12,4,0,16,mixedType,2
6,3,0,9,mixedType,1
6,4,0,10,mixedType,1
5,1,0,6,mixedType,0
6,4,0,10,mixedType,1
6,1,0,7,mixedType,0
7,3,0,10,mixedType,1
5,3,0,8,mixedType,1
12,4,0,16,mixedType,2
6,4,0,10,mixedType,1
1,9,0,10,mixedType,1
2,11,0,13,mixedType,1
3,6,0,9,mixedType,1
6,3,0,9,mixedType,1
1,8,0,9,mixedType,1
10,1,0,11,mixedType,1
7,2,0,9,mixedType,1
3,3,0,6,mixedType,0
14,1,1,16,mixedType,2
5,2,0,7,mixedType,0
6,6,0,12,mixedType,1
7,2,0,9,mixedType,1
4,4,0,8,mixedType,1
6,3,0,9,mixedType,1
7,1,0,8,mixedType,1
7,3,0,10,mixedType,1
8,2,0,10,mixedType,1
9,2,0,11,mixedType,1
3,5,0,8,mixedType,1
8,1,0,9,mixedType,1
12,4,0,16,mixedType,2
6,7,0,13,mixedType,1
7,2,0,9,mixedType,1
2,6,0,8,mixedType,1
8,1,0,9,mixedType,1
4,4,0,8,mixedType,1
10,2,0,12,mixedType,1
15,7,0,22,mixedType,2
9,1,0,10,mixedType,1
7,3,0,10,mixedType,1
8,4,0,12,mixedType,1
7,2,0,9,mixedType,1
7,2,0,9,mixedType,1
7,1,0,8,mixedType,1
4,8,0,12,mixedType,1
8,1,0,9,mixedType,1
10,2,0,12,mixedType,1
7,3,0,10,mixedType,1
11,3,0,14,mixedType,2
9,1,0,10,mixedType,1
7,2,0,9,mixedType,1
7,3,0,10,mixedType,1
8,2,0,10,mixedType,1
4,6,0,10,mixedType,1
13,2,0,15,mixedType,2
14,2,0,16,mixedType,2
7,3,0,10,mixedType,1
9,2,0,11,mixedType,1
6,2,0,8,mixedType,1
7,2,0,9,mixedType,1
4,2,0,6,mixedType,0
5,2,0,7,mixedType,0
13,3,0,16,mixedType,2
9,2,0,11,mixedType,1
12,4,1,17,mixedType,2
6,2,0,8,mixedType,1
5,3,0,8,mixedType,1
5,2,0,7,mixedType,0
8,2,0,10,mixedType,1
3,8,0,11,mixedType,1
6,2,0,8,mixedType,1
4,6,0,10,mixedType,1
6,4,0,10,mixedType,1
6,1,0,7,mixedType,0
3,5,0,8,mixedType,1
8,2,0,10,mixedType,1
7,3,0,10,mixedType,1
5,1,0,6,mixedType,0
1,8,0,9,mixedType,1
2,8,0,10,mixedType,1
6,3,0,9,mixedType,1
7,3,0,10,mixedType,1
7,4,0,11,mixedType,1
6,2,0,8,mixedType,1
9,6,4,19,mixedType,2
7,2,0,9,mixedType,1
6,4,0,10,mixedType,1
9,1,0,10,mixedType,1
7,2,0,9,mixedType,1
6,2,0,8,mixedType,1
9,3,0,12,mixedType,1
6,3,0,9,mixedType,1
8,3,0,11,mixedType,1
6,4,0,10,mixedType,1
10,2,0,12,mixedType,1
7,1,0,8,mixedType,1
15,1,0,16,mixedType,2
5,1,0,6,mixedType,0
4,4,0,8,mixedType,1
5,3,0,8,mixedType,1
9,1,0,10,mixedType,1
8,3,0,11,mixedType,1
8,4,0,12,mixedType,1
7,3,0,10,mixedType,1
5,1,0,6,mixedType,0
6,2,0,8,mixedType,1
7,2,0,9,mixedType,1
8,2,0,10,mixedType,1
12,0,1,13,mixedType,1
5,2,0,7,mixedType,0
6,4,0,10,mixedType,1
5,3,0,8,mixedType,1
4,6,0,10,mixedType,1
14,2,0,16,mixedType,2
4,4,0,8,mixedType,1
6,4,0,10,mixedType,1
6,1,0,7,mixedType,0
8,1,0,9,mixedType,1
2,4,0,6,mixedType,0
7,2,0,9,mixedType,1
10,2,0,12,mixedType,1
7,3,0,10,mixedType,1
4,4,0,8,mixedType,1
3,5,0,8,mixedType,1
4,2,0,6,mixedType,0
8,1,0,9,mixedType,1
5,1,0,6,mixedType,0
7,3,0,10,mixedType,1
6,2,0,8,mixedType,1
5,6,0,11,mixedType,1
5,4,0,9,mixedType,1
6,2,0,8,mixedType,1
5,1,0,6,mixedType,0
15,1,0,16,mixedType,2
8,3,0,11,mixedType,1
4,7,0,11,mixedType,1
4,2,0,6,mixedType,0
9,1,0,10,mixedType,1
5,5,0,10,mixedType,1
14,2,0,16,mixedType,2
6,2,0,8,mixedType,1
5,2,0,7,mixedType,0
6,2,0,8,mixedType,1
5,2,0,7,mixedType,0
2,8,0,10,mixedType,1
5,5,0,10,mixedType,1
6,4,0,10,mixedType,1
1,9,0,10,mixedType,1
7,3,0,10,mixedType,1
15,1,0,16,mixedType,2
8,1,0,9,mixedType,1
9,1,0,10,mixedType,1
8,2,0,10,mixedType,1
7,2,0,9,mixedType,1
6,6,0,12,mixedType,1
7,2,0,9,mixedType,1
14,2,0,16,mixedType,2
2,7,0,9,mixedType,1
11,3,0,14,mixedType,2
14,2,0,16,mixedType,2
1,5,0,6,mixedType,0
7,3,0,10,mixedType,1
3,6,0,9,mixedType,1
5,1,0,6,mixedType,0
7,3,0,10,mixedType,1
9,2,0,11,mixedType,1
12,3,0,15,mixedType,2
6,3,0,9,mixedType,1
4,4,0,8,mixedType,1
5,4,0,9,mixedType,1
3,7,0,10,mixedType,1
4,2,0,6,mixedType,0
6,4,0,10,mixedType,1
9,1,0,10,mixedType,1
5,5,0,10,mixedType,1
10,2,0,12,mixedType,1
7,1,0,8,mixedType,1
7,3,0,10,mixedType,1
5,4,0,9,mixedType,1
6,3,0,9,mixedType,1
9,1,0,10,mixedType,1
6,1,0,7,mixedType,0
6,4,0,10,mixedType,1
8,1,0,9,mixedType,1
6,3,0,9,mixedType,1
6,4,0,10,mixedType,1
7,3,0,10,mixedType,1
10,1,0,11,mixedType,1
11,3,0,14,mixedType,2
6,2,0,8,mixedType,1
6,3,0,9,mixedType,1
6,3,0,9,mixedType,1
6,2,0,8,mixedType,1
6,2,0,8,mixedType,1
6,3,0,9,mixedType,1
11,3,0,14,mixedType,2
6,3,0,9,mixedType,1
2,4,0,6,mixedType,0
6,1,0,7,mixedType,0
6,4,0,10,mixedType,1
6,0,0,6,sameType,0
5,4,0,9,mixedType,1
8,3,0,11,mixedType,1
6,3,0,9,mixedType,1
6,2,0,8,mixedType,1
4,4,0,8,mixedType,1
6,3,0,9,mixedType,1
9,3,0,12,mixedType,1
7,1,0,8,mixedType,1
5,3,0,8,mixedType,1
5,3,0,8,mixedType,1
13,3,0,16,mixedType,2
6,3,0,9,mixedType,1
5,1,0,6,mixedType,0
5,3,0,8,mixedType,1
10,2,0,12,mixedType,1
12,3,0,15,mixedType,2
4,2,0,6,mixedType,0
5,2,0,7,mixedType,0
7,2,0,9,mixedType,1
5,4,0,9,mixedType,1
7,2,0,9,mixedType,1
7,3,0,10,mixedType,1
0,8,1,9,mixedType,1
11,4,0,15,mixedType,2
13,3,0,16,mixedType,2
6,1,0,7,mixedType,0
6,2,0,8,mixedType,1
6,2,0,8,mixedType,1
4,4,0,8,mixedType,1
4,6,0,10,mixedType,1
8,2,0,10,mixedType,1
7,2,0,9,mixedType,1
6,1,0,7,mixedType,0
12,3,0,15,mixedType,2
7,2,0,9,mixedType,1
5,3,0,8,mixedType,1
6,2,0,8,mixedType,1
15,1,0,16,mixedType,2
3,3,0,6,mixedType,0
4,6,0,10,mixedType,1
6,2,0,8,mixedType,1
6,4,0,10,mixedType,1
12,4,0,16,mixedType,2
5,1,0,6,mixedType,0
5,3,0,8,mixedType,1
6,2,0,8,mixedType,1
5,3,0,8,mixedType,1
9,1,0,10,mixedType,1
6,3,0,9,mixedType,1
8,1,0,9,mixedType,1
7,2,0,9,mixedType,1
8,1,0,9,mixedType,1
5,4,0,9,mixedType,1
6,4,0,10,mixedType,1
8,1,0,9,mixedType,1
5,2,0,7,mixedType,0
14,2,0,16,mixedType,2
4,2,0,6,mixedType,0
14,2,0,16,mixedType,2
6,4,0,10,mixedType,1
6,3,0,9,mixedType,1
3,5,0,8,mixedType,1
13,3,0,16,mixedType,2
9,1,0,10,mixedType,1
6,3,0,9,mixedType,1
6,3,0,9,mixedType,1
7,3,0,10,mixedType,1
4,4,0,8,mixedType,1
4,6,0,10,mixedType,1
5,5,0,10,mixedType,1
8,1,0,9,mixedType,1
3,7,0,10,mixedType,1
7,1,0,8,mixedType,1
1,7,0,8,mixedType,1
6,3,0,9,mixedType,1
4,2,0,6,mixedType,0
7,3,0,10,mixedType,1
5,2,0,7,mixedType,0
5,5,0,10,mixedType,1
8,2,0,10,mixedType,1
15,1,0,16,mixedType,2
10,4,0,14,mixedType,2
15,1,0,16,mixedType,2
4,2,0,6,mixedType,0
5,4,0,9,mixedType,1
7,3,0,10,mixedType,1
3,5,0,8,mixedType,1
13,3,0,16,mixedType,2
7,3,0,10,mixedType,1
6,3,0,9,mixedType,1
6,2,0,8,mixedType,1
5,2,0,7,mixedType,0
6,1,0,7,mixedType,0
6,4,0,10,mixedType,1
6,8,0,14,mixedType,2
7,1,0,8,mixedType,1
6,6,0,12,mixedType,1
6,1,0,7,mixedType,0
4,4,0,8,mixedType,1
6,3,0,9,mixedType,1
9,1,0,10,mixedType,1
11,3,0,14,mixedType,2
3,7,0,10,mixedType,1
4,4,0,8,mixedType,1
4,6,0,10,mixedType,1
7,3,0,10,mixedType,1
5,4,0,9,mixedType,1
13,3,0,16,mixedType,2
5,3,0,8,mixedType,1
8,1,0,9,mixedType,1
5,1,0,6,mixedType,0
5,3,0,8,mixedType,1
6,2,0,8,mixedType,1
6,4,0,10,mixedType,1
6,2,0,8,mixedType,1
14,2,0,16,mixedType,2
1,9,0,10,mixedType,1
3,7,0,10,mixedType,1
5,6,0,11,mixedType,1
7,3,0,10,mixedType,1
5,6,0,11,mixedType,1
9,1,0,10,mixedType,1
5,4,0,9,mixedType,1
5,3,0,8,mixedType,1
6,3,0,9,mixedType,1
6,3,0,9,mixedType,1
6,6,0,12,mixedType,1
1,7,0,8,mixedType,1
3,6,0,9,mixedType,1
15,1,0,16,mixedType,2
2,4,0,6,mixedType,0
6,2,0,8,mixedType,1
4,7,0,11,mixedType,1
7,3,0,10,mixedType,1
6,4,0,10,mixedType,1
7,3,0,10,mixedType,1
7,2,0,9,mixedType,1
7,5,0,12,mixedType,1
6,2,0,8,mixedType,1
5,1,0,6,mixedType,0
6,2,0,8,mixedType,1
3,7,0,10,mixedType,1
6,4,0,10,mixedType,1
5,3,0,8,mixedType,1
5,3,0,8,mixedType,1
7,1,0,8,mixedType,1
8,2,0,10,mixedType,1
3,6,0,9,mixedType,1
14,2,0,16,mixedType,2
5,2,0,7,mixedType,0
8,3,0,11,mixedType,1
14,2,1,17,mixedType,2
6,4,0,10,mixedType,1
13,3,0,16,mixedType,2
1,8,0,9,mixedType,1
7,2,0,9,mixedType,1
7,3,0,10,mixedType,1
6,1,0,7,mixedType,0
3,5,0,8,mixedType,1
3,7,0,10,mixedType,1
3,6,0,9,mixedType,1
6,2,0,8,mixedType,1
6,3,0,9,mixedType,1
8,1,0,9,mixedType,1
9,1,0,10,mixedType,1
9,4,0,13,mixedType,1
5,4,0,9,mixedType,1
6,1,0,7,mixedType,0
15,1,0,16,mixedType,2
5,3,0,8,mixedType,1
7,2,0,9,mixedType,1
13,3,0,16,mixedType,2
4,4,0,8,mixedType,1
5,2,0,7,mixedType,0
6,2,0,8,mixedType,1
7,1,0,8,mixedType,1
6,4,0,10,mixedType,1
2,8,0,10,mixedType,1
7,4,0,11,mixedType,1
11,2,0,13,mixedType,1
4,6,0,10,mixedType,1
10,2,0,12,mixedType,1
8,1,0,9,mixedType,1
8,4,0,12,mixedType,1
7,2,0,9,mixedType,1
7,3,0,10,mixedType,1
5,2,0,7,mixedType,0
6,4,0,10,mixedType,1
8,2,0,10,mixedType,1
6,2,0,8,mixedType,1
12,4,0,16,mixedType,2
7,4,0,11,mixedType,1
6,2,0,8,mixedType,1
7,2,0,9,mixedType,1
4,4,0,8,mixedType,1
9,1,0,10,mixedType,1
4,4,0,8,mixedType,1
5,2,0,7,mixedType,0
14,2,0,16,mixedType,2
6,2,0,8,mixedType,1
5,3,0,8,mixedType,1
8,3,0,11,mixedType,1
6,4,0,10,mixedType,1
8,4,0,12,mixedType,1
9,1,0,10,mixedType,1
2,9,0,11,mixedType,1
6,2,0,8,mixedType,1
14,2,0,16,mixedType,2
8,2,0,10,mixedType,1
9,1,0,10,mixedType,1
17,1,0,18,mixedType,2
5,2,0,7,mixedType,0
14,1,0,15,mixedType,2
7,2,0,9,mixedType,1
6,3,0,9,mixedType,1
9,3,0,12,mixedType,1
4,6,0,10,mixedType,1
6,4,0,10,mixedType,1
7,3,0,10,mixedType,1
3,6,0,9,mixedType,1
5,1,0,6,mixedType,0
4,2,0,6,mixedType,0
7,3,0,10,mixedType,1
14,2,0,16,mixedType,2
4,4,0,8,mixedType,1
4,4,0,8,mixedType,1
8,1,0,9,mixedType,1
9,2,0,11,mixedType,1
6,3,0,9,mixedType,1
7,1,0,8,mixedType,1
7,1,0,8,mixedType,1
5,3,0,8,mixedType,1
9,3,0,12,mixedType,1
4,8,0,12,mixedType,1
7,3,0,10,mixedType,1
14,2,0,16,mixedType,2
8,2,0,10,mixedType,1
6,4,0,10,mixedType,1
6,3,0,9,mixedType,1
9,4,1,14,mixedType,2
4,2,0,6,mixedType,0
8,4,0,12,mixedType,1
2,7,0,9,mixedType,1
6,2,0,8,mixedType,1
5,4,0,9,mixedType,1
5,3,0,8,mixedType,1
1,8,0,9,mixedType,1
7,3,0,10,mixedType,1
7,3,0,10,mixedType,1
4,2,0,6,mixedType,0
1,7,0,8,mixedType,1
7,1,0,8,mixedType,1
6,4,0,10,mixedType,1
7,1,0,8,mixedType,1
11,1,0,12,mixedType,1
6,3,0,9,mixedType,1
7,3,0,10,mixedType,1
3,7,0,10,mixedType,1
4,6,0,10,mixedType,1
6,4,0,10,mixedType,1
8,2,0,10,mixedType,1
8,1,0,9,mixedType,1
6,1,0,7,mixedType,0
4,6,0,10,mixedType,1
9,4,0,13,mixedType,1
7,3,0,10,mixedType,1
6,3,0,9,mixedType,1
14,2,0,16,mixedType,2
7,3,0,10,mixedType,1
15,1,0,16,mixedType,2
6,3,0,9,mixedType,1
6,6,0,12,mixedType,1
8,4,0,12,mixedType,1
15,1,0,16,mixedType,2
4,2,0,6,mixedType,0
13,3,0,16,mixedType,2
4,9,0,13,mixedType,1
4,5,0,9,mixedType,1
4,5,0,9,mixedType,1
7,3,0,10,mixedType,1
5,4,0,9,mixedType,1
7,3,0,10,mixedType,1
6,3,0,9,mixedType,1
5,3,0,8,mixedType,1
7,3,0,10,mixedType,1
5,2,0,7,mixedType,0
5,1,0,6,mixedType,0
7,5,1,13,mixedType,1
7,2,0,9,mixedType,1
7,2,0,9,mixedType,1
6,8,0,14,mixedType,2
11,2,0,13,mixedType,1
4,5,0,9,mixedType,1
6,2,0,8,mixedType,1
8,3,0,11,mixedType,1
2,6,0,8,mixedType,1
5,2,0,7,mixedType,0
7,3,0,10,mixedType,1
4,2,0,6,mixedType,0
8,3,0,11,mixedType,1
3,3,0,6,mixedType,0
1,10,0,11,mixedType,1
8,1,0,9,mixedType,1
6,3,0,9,mixedType,1
4,2,0,6,mixedType,0
13,3,0,16,mixedType,2
7,3,0,10,mixedType,1
11,3,0,14,mixedType,2
5,3,0,8,mixedType,1
6,0,2,8,mixedType,1
9,1,0,10,mixedType,1
7,1,0,8,mixedType,1
4,4,0,8,mixedType,1
8,3,0,11,mixedType,1
6,1,0,7,mixedType,0
7,3,0,10,mixedType,1
5,3,0,8,mixedType,1
9,1,0,10,mixedType,1
9,1,0,10,mixedType,1
7,3,0,10,mixedType,1
8,1,0,9,mixedType,1
2,6,0,8,mixedType,1
5,3,0,8,mixedType,1
2,6,0,8,mixedType,1
6,4,0,10,mixedType,1
7,3,0,10,mixedType,1
11,5,0,16,mixedType,2
14,2,0,16,mixedType,2
6,3,0,9,mixedType,1
7,3,0,10,mixedType,1
7,3,0,10,mixedType,1
6,3,0,9,mixedType,1
8,1,0,9,mixedType,1
1,8,0,9,mixedType,1
4,6,0,10,mixedType,1
7,2,0,9,mixedType,1
7,4,0,11,mixedType,1
5,3,0,8,mixedType,1
8,2,0,10,mixedType,1
7,3,0,10,mixedType,1
3,9,0,12,mixedType,1
7,1,0,8,mixedType,1
8,2,0,10,mixedType,1
6,3,0,9,mixedType,1
8,1,0,9,mixedType,1
4,4,0,8,mixedType,1
8,2,0,10,mixedType,1
6,3,0,9,mixedType,1
6,2,0,8,mixedType,1
13,3,0,16,mixedType,2
2,8,0,10,mixedType,1
10,3,0,13,mixedType,1
8,1,0,9,mixedType,1
14,2,0,16,mixedType,2
6,2,0,8,mixedType,1
4,4,0,8,mixedType,1
8,5,0,13,mixedType,1
6,4,0,10,mixedType,1
3,3,0,6,mixedType,0
5,3,0,8,mixedType,1
8,1,0,9,mixedType,1
4,4,0,8,mixedType,1
7,4,0,11,mixedType,1
2,11,0,13,mixedType,1
1,8,0,9,mixedType,1
7,2,0,9,mixedType,1
6,4,0,10,mixedType,1
4,2,0,6,mixedType,0
5,3,0,8,mixedType,1
8,2,0,10,mixedType,1
6,2,0,8,mixedType,1
17,1,0,18,mixedType,2
6,3,0,9,mixedType,1
8,2,0,10,mixedType,1
8,2,0,10,mixedType,1
5,2,0,7,mixedType,0
4,2,0,6,mixedType,0
10,2,0,12,mixedType,1
4,2,0,6,mixedType,0
15,1,0,16,mixedType,2
9,1,0,10,mixedType,1
12,3,0,15,mixedType,2
9,3,0,12,mixedType,1
5,2,0,7,mixedType,0
6,1,0,7,mixedType,0
13,3,0,16,mixedType,2
9,2,0,11,mixedType,1
7,3,0,10,mixedType,1
12,4,0,16,mixedType,2
8,2,0,10,mixedType,1
6,1,0,7,mixedType,0
7,2,0,9,mixedType,1
7,3,0,10,mixedType,1
5,4,0,9,mixedType,1
7,3,0,10,mixedType,1
8,1,0,9,mixedType,1
7,3,0,10,mixedType,1
7,4,0,11,mixedType,1
14,2,0,16,mixedType,2
6,3,0,9,mixedType,1
14,2,0,16,mixedType,2
6,4,0,10,mixedType,1
2,7,0,9,mixedType,1
7,3,0,10,mixedType,1
4,2,0,6,mixedType,0
5,3,0,8,mixedType,1
6,3,0,9,mixedType,1
6,3,0,9,mixedType,1
13,3,0,16,mixedType,2
10,3,0,13,mixedType,1
9,1,0,10,mixedType,1
8,2,0,10,mixedType,1
10,3,0,13,mixedType,1
6,2,0,8,mixedType,1
11,3,0,14,mixedType,2
8,2,0,10,mixedType,1
7,2,0,9,mixedType,1
5,3,0,8,mixedType,1
3,6,0,9,mixedType,1
7,3,0,10,mixedType,1
6,3,0,9,mixedType,1
6,2,0,8,mixedType,1
9,3,0,12,mixedType,1
24,3,0,27,mixedType,2
5,2,0,7,mixedType,0
7,2,0,9,mixedType,1
13,2,0,15,mixedType,2
6,4,0,10,mixedType,1
6,1,0,7,mixedType,0
7,3,0,10,mixedType,1
6,3,0,9,mixedType,1
7,0,2,9,mixedType,1
6,3,0,9,mixedType,1
7,3,0,10,mixedType,1
8,1,0,9,mixedType,1
7,1,0,8,mixedType,1
3,5,0,8,mixedType,1
5,3,0,8,mixedType,1
15,1,0,16,mixedType,2
2,4,0,6,mixedType,0
7,3,0,10,mixedType,1
6,1,0,7,mixedType,0
6,3,0,9,mixedType,1
5,4,0,9,mixedType,1
14,2,0,16,mixedType,2
7,3,0,10,mixedType,1
5,1,0,6,mixedType,0
4,2,0,6,mixedType,0
7,3,0,10,mixedType,1
10,3,0,13,mixedType,1
7,2,0,9,mixedType,1
6,1,0,7,mixedType,0
9,3,0,12,mixedType,1
2,7,0,9,mixedType,1
11,5,0,16,mixedType,2
11,3,0,14,mixedType,2
10,0,1,11,mixedType,1
8,1,0,9,mixedType,1
9,7,0,16,mixedType,2
7,1,0,8,mixedType,1
9,3,0,12,mixedType,1
10,6,0,16,mixedType,2
8,4,0,12,mixedType,1
6,3,0,9,mixedType,1
4,4,0,8,mixedType,1
6,3,0,9,mixedType,1
6,3,0,9,mixedType,1
6,1,0,7,mixedType,0
12,3,0,15,mixedType,2
3,6,0,9,mixedType,1
6,4,0,10,mixedType,1
5,2,0,7,mixedType,0
13,3,0,16,mixedType,2
9,3,0,12,mixedType,1
3,6,0,9,mixedType,1
3,7,0,10,mixedType,1
6,3,0,9,mixedType,1
2,4,0,6,mixedType,0
5,3,0,8,mixedType,1
1,10,0,11,mixedType,1
6,2,0,8,mixedType,1
7,3,0,10,mixedType,1
8,2,0,10,mixedType,1
4,4,0,8,mixedType,1
9,4,0,13,mixedType,1
6,1,0,7,mixedType,0
5,1,0,6,mixedType,0
7,3,0,10,mixedType,1
7,6,0,13,mixedType,1
2,7,0,9,mixedType,1
4,2,0,6,mixedType,0
12,4,0,16,mixedType,2
6,4,0,10,mixedType,1
7,4,0,11,mixedType,1
8,1,0,9,mixedType,1
7,1,0,8,mixedType,1
6,3,0,9,mixedType,1
5,2,0,7,mixedType,0
3,3,0,6,mixedType,0
6,3,0,9,mixedType,1
7,2,0,9,mixedType,1
5,2,0,7,mixedType,0
6,3,0,9,mixedType,1
6,3,0,9,mixedType,1
6,2,0,8,mixedType,1
3,3,0,6,mixedType,0
14,2,0,16,mixedType,2
6,2,0,8,mixedType,1
5,3,0,8,mixedType,1
6,2,0,8,mixedType,1
8,2,0,10,mixedType,1
7,3,0,10,mixedType,1
6,1,0,7,mixedType,0
6,4,0,10,mixedType,1
11,3,1,15,mixedType,2
8,2,0,10,mixedType,1
10,3,1,14,mixedType,2
7,5,0,12,mixedType,1
7,2,0,9,mixedType,1
7,1,0,8,mixedType,1
8,1,0,9,mixedType,1
8,1,0,9,mixedType,1
6,2,0,8,mixedType,1
14,2,0,16,mixedType,2
5,1,0,6,mixedType,0
4,4,0,8,mixedType,1
8,2,0,10,mixedType,1
3,6,0,9,mixedType,1
5,8,0,13,mixedType,1
5,4,0,9,mixedType,1
7,2,0,9,mixedType,1
6,4,0,10,mixedType,1
5,1,0,6,mixedType,0
1,8,0,9,mixedType,1
7,3,0,10,mixedType,1
4,2,0,6,mixedType,0
7,6,0,13,mixedType,1
6,3,0,9,mixedType,1
6,3,0,9,mixedType,1
7,2,0,9,mixedType,1
6,2,0,8,mixedType,1
4,6,0,10,mixedType,1
4,2,0,6,mixedType,0
13,3,0,16,mixedType,2
11,3,0,14,mixedType,2
6,4,0,10,mixedType,1
2,8,0,10,mixedType,1
17,3,0,20,mixedType,2
9,4,0,13,mixedType,1
10,2,0,12,mixedType,1
9,3,0,12,mixedType,1
5,2,0,7,mixedType,0
8,4,0,12,mixedType,1
6,4,0,10,mixedType,1
6,2,0,8,mixedType,1
5,1,0,6,mixedType,0
15,2,0,17,mixedType,2
6,1,0,7,mixedType,0
9,3,0,12,mixedType,1
6,2,0,8,mixedType,1
7,3,0,10,mixedType,1
5,2,0,7,mixedType,0
7,3,0,10,mixedType,1
5,3,0,8,mixedType,1
7,1,0,8,mixedType,1
2,4,0,6,mixedType,0
7,0,3,10,mixedType,1
1,10,0,11,mixedType,1
7,3,0,10,mixedType,1
14,2,0,16,mixedType,2
6,0,1,7,mixedType,0
14,2,0,16,mixedType,2
3,6,0,9,mixedType,1
4,2,0,6,mixedType,0
4,4,0,8,mixedType,1
3,5,0,8,mixedType,1
7,2,0,9,mixedType,1
2,7,0,9,mixedType,1
7,3,0,10,mixedType,1
5,3,0,8,mixedType,1
6,1,0,7,mixedType,0
13,3,0,16,mixedType,2
8,2,0,10,mixedType,1
6,3,0,9,mixedType,1
7,3,0,10,mixedType,1
5,3,0,8,mixedType,1
6,3,0,9,mixedType,1
8,1,0,9,mixedType,1
6,2,0,8,mixedType,1
9,2,0,11,mixedType,1
4,4,0,8,mixedType,1
6,2,0,8,mixedType,1
8,2,0,10,mixedType,1
7,3,0,10,mixedType,1
6,1,0,7,mixedType,0
4,6,0,10,mixedType,1
10,2,0,12,mixedType,1
6,3,0,9,mixedType,1
5,3,0,8,mixedType,1
2,10,0,12,mixedType,1
1,10,0,11,mixedType,1
4,9,0,13,mixedType,1
8,2,0,10,mixedType,1
5,4,0,9,mixedType,1
6,3,0,9,mixedType,1
10,3,0,13,mixedType,1
8,4,0,12,mixedType,1
6,2,0,8,mixedType,1
5,2,0,7,mixedType,0
6,6,0,12,mixedType,1
5,2,0,7,mixedType,0
8,3,0,11,mixedType,1
8,4,0,12,mixedType,1
8,1,0,9,mixedType,1
6,3,0,9,mixedType,1
7,3,0,10,mixedType,1
5,3,0,8,mixedType,1
6,2,0,8,mixedType,1
6,3,0,9,mixedType,1
5,4,0,9,mixedType,1
5,4,0,9,mixedType,1
6,3,0,9,mixedType,1
6,3,0,9,mixedType,1
7,1,0,8,mixedType,1
12,4,0,16,mixedType,2
9,2,0,11,mixedType,1
2,4,0,6,mixedType,0
9,1,0,10,mixedType,1
7,4,0,11,mixedType,1
3,3,0,6,mixedType,0
4,2,0,6,mixedType,0
7,3,0,10,mixedType,1
8,5,0,13,mixedType,1
7,4,0,11,mixedType,1
14,2,0,16,mixedType,2
7,2,0,9,mixedType,1
5,3,0,8,mixedType,1
4,4,0,8,mixedType,1
7,3,0,10,mixedType,1
8,2,0,10,mixedType,1
0,8,2,10,mixedType,1
7,1,0,8,mixedType,1
5,4,0,9,mixedType,1
1,9,0,10,mixedType,1
7,3,0,10,mixedType,1
6,3,0,9,mixedType,1
2,4,0,6,mixedType,0
10,3,0,13,mixedType,1
7,2,0,9,mixedType,1
9,3,0,12,mixedType,1
3,6,0,9,mixedType,1
7,2,0,9,mixedType,1
3,7,0,10,mixedType,1
8,3,0,11,mixedType,1
11,3,0,14,mixedType,2
6,3,0,9,mixedType,1
7,4,0,11,mixedType,1
6,5,0,11,mixedType,1
7,3,0,10,mixedType,1
5,3,0,8,mixedType,1
10,4,0,14,mixedType,2
6,1,0,7,mixedType,0
6,2,0,8,mixedType,1
7,2,0,9,mixedType,1
4,7,0,11,mixedType,1
6,3,0,9,mixedType,1
5,2,0,7,mixedType,0
5,2,0,7,mixedType,0
5,3,0,8,mixedType,1
1,7,0,8,mixedType,1
6,1,0,7,mixedType,0
6,3,0,9,mixedType,1
6,2,0,8,mixedType,1
6,2,0,8,mixedType,1
6,4,0,10,mixedType,1
8,2,0,10,mixedType,1
7,1,0,8,mixedType,1
4,2,0,6,mixedType,0
12,4,0,16,mixedType,2
13,3,0,16,mixedType,2
8,5,0,13,mixedType,1
6,1,0,7,mixedType,0
4,2,0,6,mixedType,0
8,4,0,12,mixedType,1
6,4,0,10,mixedType,1
8,1,0,9,mixedType,1
11,3,0,14,mixedType,2
7,2,0,9,mixedType,1
4,4,0,8,mixedType,1
5,2,0,7,mixedType,0
7,3,0,10,mixedType,1
11,3,0,14,mixedType,2
10,2,0,12,mixedType,1
2,8,0,10,mixedType,1
4,2,0,6,mixedType,0
2,6,0,8,mixedType,1
6,4,0,10,mixedType,1
6,4,0,10,mixedType,1
6,3,0,9,mixedType,1
9,1,0,10,mixedType,1
17,1,1,19,mixedType,2
4,8,3,15,mixedType,2
15,1,0,16,mixedType,2
2,4,0,6,mixedType,0
4,4,0,8,mixedType,1
5,2,0,7,mixedType,0
15,1,0,16,mixedType,2
5,4,0,9,mixedType,1
6,3,0,9,mixedType,1
9,2,0,11,mixedType,1
6,1,0,7,mixedType,0
6,4,0,10,mixedType,1
6,3,0,9,mixedType,1
5,4,0,9,mixedType,1
9,2,0,11,mixedType,1
7,2,0,9,mixedType,1
7,1,0,8,mixedType,1
9,2,0,11,mixedType,1
6,3,0,9,mixedType,1
2,8,0,10,mixedType,1
7,2,0,9,mixedType,1
7,2,0,9,mixedType,1
6,2,0,8,mixedType,1
5,3,0,8,mixedType,1
5,2,0,7,mixedType,0
1,8,0,9,mixedType,1
12,3,0,15,mixedType,2
8,10,2,20,mixedType,2
9,4,0,13,mixedType,1
6,4,0,10,mixedType,1
7,3,0,10,mixedType,1
9,2,0,11,mixedType,1
7,1,0,8,mixedType,1
11,2,1,14,mixedType,2
4,2,0,6,mixedType,0
6,1,0,7,mixedType,0
4,2,0,6,mixedType,0
5,6,0,11,mixedType,1
5,2,0,7,mixedType,0
6,3,0,9,mixedType,1
6,2,0,8,mixedType,1
6,3,0,9,mixedType,1
5,3,0,8,mixedType,1
12,4,0,16,mixedType,2
8,2,0,10,mixedType,1
14,2,0,16,mixedType,2
10,3,0,13,mixedType,1
8,4,0,12,mixedType,1
14,2,0,16,mixedType,2
10,1,0,11,mixedType,1
14,2,0,16,mixedType,2
5,2,0,7,mixedType,0
7,2,0,9,mixedType,1
6,1,0,7,mixedType,0
8,4,0,12,mixedType,1
4,10,1,15,mixedType,2
6,3,0,9,mixedType,1
6,4,0,10,mixedType,1
2,6,0,8,mixedType,1
6,0,1,7,mixedType,0
5,4,0,9,mixedType,1
10,4,0,14,mixedType,2
5,1,0,6,mixedType,0
15,1,0,16,mixedType,2
6,3,0,9,mixedType,1
7,1,0,8,mixedType,1
6,3,0,9,mixedType,1
5,4,0,9,mixedType,1
5,2,0,7,mixedType,0
7,1,0,8,mixedType,1
5,8,0,13,mixedType,1
6,3,0,9,mixedType,1
7,3,0,10,mixedType,1
6,3,0,9,mixedType,1
5,3,0,8,mixedType,1
7,3,0,10,mixedType,1
5,5,0,10,mixedType,1
18,3,2,23,mixedType,2
5,4,0,9,mixedType,1
1,7,0,8,mixedType,1
9,2,0,11,mixedType,1
7,1,0,8,mixedType,1
7,2,0,9,mixedType,1
7,3,0,10,mixedType,1
7,2,0,9,mixedType,1
4,2,0,6,mixedType,0
7,1,0,8,mixedType,1
6,1,0,7,mixedType,0
7,2,0,9,mixedType,1
11,3,0,14,mixedType,2
7,3,0,10,mixedType,1
7,3,0,10,mixedType,1
9,4,0,13,mixedType,1
7,3,0,10,mixedType,1
2,8,0,10,mixedType,1
6,3,0,9,mixedType,1
15,1,0,16,mixedType,2
9,2,0,11,mixedType,1
4,9,0,13,mixedType,1
8,2,0,10,mixedType,1
5,4,0,9,mixedType,1
4,2,0,6,mixedType,0
5,2,0,7,mixedType,0
4,2,0,6,mixedType,0
6,1,0,7,mixedType,0
7,2,0,9,mixedType,1
7,3,0,10,mixedType,1
9,1,0,10,mixedType,1
8,3,0,11,mixedType,1
6,5,0,11,mixedType,1
4,4,0,8,mixedType,1
6,2,0,8,mixedType,1
7,3,0,10,mixedType,1
6,3,0,9,mixedType,1
7,4,0,11,mixedType,1
7,3,0,10,mixedType,1
7,1,0,8,mixedType,1
5,3,0,8,mixedType,1
7,2,0,9,mixedType,1
7,3,0,10,mixedType,1
7,2,0,9,mixedType,1
6,3,0,9,mixedType,1
4,6,0,10,mixedType,1
9,1,0,10,mixedType,1
8,1,0,9,mixedType,1
4,2,0,6,mixedType,0
5,3,0,8,mixedType,1
7,1,0,8,mixedType,1
9,1,0,10,mixedType,1
5,4,0,9,mixedType,1
7,1,0,8,mixedType,1
6,3,0,9,mixedType,1
9,1,0,10,mixedType,1
3,7,0,10,mixedType,1
7,2,0,9,mixedType,1
7,3,0,10,mixedType,1
8,3,0,11,mixedType,1
1,8,0,9,mixedType,1
5,5,0,10,mixedType,1
5,4,0,9,mixedType,1
6,4,0,10,mixedType,1
6,4,0,10,mixedType,1
6,3,0,9,mixedType,1
6,3,0,9,mixedType,1
6,3,0,9,mixedType,1
14,2,0,16,mixedType,2
5,3,0,8,mixedType,1
5,4,0,9,mixedType,1
6,2,0,8,mixedType,1
6,2,0,8,mixedType,1
7,3,0,10,mixedType,1
3,6,0,9,mixedType,1
11,3,1,15,mixedType,2
7,1,0,8,mixedType,1
7,2,0,9,mixedType,1
8,2,0,10,mixedType,1
12,4,0,16,mixedType,2
11,5,0,16,mixedType,2
4,4,0,8,mixedType,1
3,5,0,8,mixedType,1
7,1,0,8,mixedType,1
6,2,0,8,mixedType,1
7,1,0,8,mixedType,1
5,2,0,7,mixedType,0
7,3,0,10,mixedType,1
5,1,0,6,mixedType,0
8,1,0,9,mixedType,1
15,1,0,16,mixedType,2
14,2,0,16,mixedType,2
2,4,0,6,mixedType,0
5,2,0,7,mixedType,0
4,4,0,8,mixedType,1
13,3,0,16,mixedType,2
6,3,0,9,mixedType,1
11,1,0,12,mixedType,1
12,3,0,15,mixedType,2
14,2,0,16,mixedType,2
5,3,0,8,mixedType,1
6,3,0,9,mixedType,1
6,2,0,8,mixedType,1
7,3,0,10,mixedType,1
7,3,0,10,mixedType,1
8,4,0,12,mixedType,1
8,4,0,12,mixedType,1
2,8,0,10,mixedType,1
6,3,0,9,mixedType,1
9,3,0,12,mixedType,1
11,5,0,16,mixedType,2
15,1,0,16,mixedType,2
6,6,0,12,mixedType,1
7,3,0,10,mixedType,1
10,3,0,13,mixedType,1
10,2,0,12,mixedType,1
9,2,0,11,mixedType,1
6,4,0,10,mixedType,1
5,1,0,6,mixedType,0
4,8,0,12,mixedType,1
10,2,0,12,mixedType,1
10,3,1,14,mixedType,2
7,3,0,10,mixedType,1
13,3,0,16,mixedType,2
5,4,0,9,mixedType,1
8,4,0,12,mixedType,1
6,3,0,9,mixedType,1
13,3,0,16,mixedType,2
27,2,0,29,mixedType,2
8,2,0,10,mixedType,1
4,6,0,10,mixedType,1
3,6,0,9,mixedType,1
4,2,0,6,mixedType,0
6,3,0,9,mixedType,1
7,2,0,9,mixedType,1
7,2,0,9,mixedType,1
7,3,0,10,mixedType,1
13,3,0,16,mixedType,2
16,4,0,20,mixedType,2
9,3,0,12,mixedType,1
6,4,0,10,mixedType,1
6,3,0,9,mixedType,1
15,2,0,17,mixedType,2
8,2,0,10,mixedType,1
14,2,0,16,mixedType,2
6,1,0,7,mixedType,0
9,3,0,12,mixedType,1
6,3,0,9,mixedType,1
7,2,0,9,mixedType,1
7,2,0,9,mixedType,1
8,4,0,12,mixedType,1
7,2,0,9,mixedType,1
10,2,0,12,mixedType,1
7,2,0,9,mixedType,1
7,2,0,9,mixedType,1
9,1,0,10,mixedType,1
7,2,0,9,mixedType,1
6,3,0,9,mixedType,1
11,3,0,14,mixedType,2
9,1,0,10,mixedType,1
14,2,0,16,mixedType,2
7,3,0,10,mixedType,1
6,2,0,8,mixedType,1
5,4,0,9,mixedType,1
6,2,0,8,mixedType,1
8,1,0,9,mixedType,1
5,3,0,8,mixedType,1
12,3,0,15,mixedType,2
8,4,0,12,mixedType,1
9,1,0,10,mixedType,1
5,1,0,6,mixedType,0
7,2,0,9,mixedType,1
7,4,0,11,mixedType,1
9,1,0,10,mixedType,1
13,3,0,16,mixedType,2
3,6,0,9,mixedType,1
7,4,0,11,mixedType,1
5,2,0,7,mixedType,0
8,3,0,11,mixedType,1
2,7,0,9,mixedType,1
2,8,0,10,mixedType,1
11,1,0,12,mixedType,1
2,4,0,6,mixedType,0
8,1,0,9,mixedType,1
3,8,0,11,mixedType,1
6,3,0,9,mixedType,1
14,2,0,16,mixedType,2
5,3,0,8,mixedType,1
6,4,0,10,mixedType,1
6,1,0,7,mixedType,0
5,5,0,10,mixedType,1
8,4,0,12,mixedType,1
6,2,0,8,mixedType,1
11,3,0,14,mixedType,2
3,6,0,9,mixedType,1
8,1,0,9,mixedType,1
5,3,0,8,mixedType,1
8,2,0,10,mixedType,1
9,1,0,10,mixedType,1
4,4,0,8,mixedType,1
15,1,0,16,mixedType,2
9,1,0,10,mixedType,1
9,2,0,11,mixedType,1
5,3,0,8,mixedType,1
14,2,0,16,mixedType,2
4,6,0,10,mixedType,1
7,3,0,10,mixedType,1
7,2,0,9,mixedType,1
12,4,0,16,mixedType,2
12,3,0,15,mixedType,2
2,8,0,10,mixedType,1
14,2,0,16,mixedType,2
8,2,0,10,mixedType,1
6,1,0,7,mixedType,0
10,5,0,15,mixedType,2
4,6,0,10,mixedType,1
7,5,0,12,mixedType,1
5,2,0,7,mixedType,0
6,3,0,9,mixedType,1
5,6,0,11,mixedType,1
9,1,0,10,mixedType,1
6,2,0,8,mixedType,1
6,2,0,8,mixedType,1
6,4,0,10,mixedType,1
9,0,1,10,mixedType,1
7,3,0,10,mixedType,1
2,6,0,8,mixedType,1
5,6,0,11,mixedType,1
14,2,0,16,mixedType,2
10,2,0,12,mixedType,1
8,4,0,12,mixedType,1
11,2,2,15,mixedType,2
6,4,0,10,mixedType,1
6,3,0,9,mixedType,1
7,3,0,10,mixedType,1
6,4,0,10,mixedType,1
6,1,0,7,mixedType,0
3,3,0,6,mixedType,0
12,4,0,16,mixedType,2
3,3,0,6,mixedType,0
1,8,0,9,mixedType,1
6,3,0,9,mixedType,1
5,5,0,10,mixedType,1
5,3,0,8,mixedType,1
9,8,0,17,mixedType,2
7,4,0,11,mixedType,1
2,6,0,8,mixedType,1
6,4,0,10,mixedType,1
4,4,0,8,mixedType,1
14,2,0,16,mixedType,2
7,3,0,10,mixedType,1
4,4,0,8,mixedType,1
6,2,0,8,mixedType,1
5,1,0,6,mixedType,0
4,4,0,8,mixedType,1
2,6,0,8,mixedType,1
5,6,0,11,mixedType,1
7,3,0,10,mixedType,1
9,4,0,13,mixedType,1
6,2,0,8,mixedType,1
15,1,0,16,mixedType,2
5,4,0,9,mixedType,1
1,11,0,12,mixedType,1
6,4,0,10,mixedType,1
4,2,0,6,mixedType,0
9,0,1,10,mixedType,1
4,4,0,8,mixedType,1
15,1,0,16,mixedType,2
6,0,2,8,mixedType,0
5,3,0,8,mixedType,1
19,1,1,21,mixedType,2
1,10,0,11,mixedType,1
5,6,0,11,mixedType,1
7,3,0,10,mixedType,1
7,6,0,13,mixedType,1
9,1,0,10,mixedType,1
14,2,0,16,mixedType,2
5,5,0,10,mixedType,1
2,6,0,8,mixedType,1
5,2,0,7,mixedType,0
9,1,0,10,mixedType,1
7,3,0,10,mixedType,1
4,5,0,9,mixedType,1
6,2,0,8,mixedType,1
5,1,0,6,mixedType,0
5,8,0,13,mixedType,1
8,1,0,9,mixedType,1
9,2,0,11,mixedType,1
6,4,0,10,mixedType,1
7,3,0,10,mixedType,1
9,3,0,12,mixedType,1
6,1,0,7,mixedType,0
2,6,0,8,mixedType,1
1,8,0,9,mixedType,1
5,3,0,8,mixedType,1
19,1,0,20,mixedType,2
4,4,0,8,mixedType,1
7,1,0,8,mixedType,1
5,4,0,9,mixedType,1
9,1,0,10,mixedType,1
7,2,0,9,mixedType,1
5,2,0,7,mixedType,0
6,5,0,11,mixedType,1
1,8,0,9,mixedType,1
1,8,0,9,mixedType,1
3,3,0,6,mixedType,0
4,2,0,6,mixedType,0
8,3,0,11,mixedType,1
5,4,0,9,mixedType,1
15,1,0,16,mixedType,2
9,1,0,10,mixedType,1
11,5,0,16,mixedType,2
8,1,0,9,mixedType,1
6,1,0,7,mixedType,0
6,1,0,7,mixedType,0
13,3,0,16,mixedType,2
5,3,0,8,mixedType,1
5,1,0,6,mixedType,0
8,2,0,10,mixedType,1
6,3,0,9,mixedType,1
6,4,0,10,mixedType,1
7,4,0,11,mixedType,1
2,10,0,12,mixedType,1
3,6,0,9,mixedType,1
7,2,0,9,mixedType,1
6,1,0,7,mixedType,0
6,2,0,8,mixedType,1
12,4,0,16,mixedType,2
9,1,0,10,mixedType,1
3,6,0,9,mixedType,1
6,3,0,9,mixedType,1
7,2,0,9,mixedType,1
1,8,0,9,mixedType,1
6,1,0,7,mixedType,0
2,6,0,8,mixedType,1
5,4,0,9,mixedType,1
6,2,0,8,mixedType,1
1,8,0,9,mixedType,1
4,2,0,6,mixedType,0
14,2,0,16,mixedType,2
9,2,0,11,mixedType,1
12,4,0,16,mixedType,2
7,3,0,10,mixedType,1
3,3,0,6,mixedType,0
11,2,0,13,mixedType,1
6,4,0,10,mixedType,1
8,3,0,11,mixedType,1
7,2,0,9,mixedType,1
8,2,0,10,mixedType,1
2,6,0,8,mixedType,1
7,6,0,13,mixedType,1
4,9,0,13,mixedType,1
14,2,0,16,mixedType,2
5,6,0,11,mixedType,1
7,1,0,8,mixedType,1
8,4,0,12,mixedType,1
8,1,0,9,mixedType,1
7,3,0,10,mixedType,1
9,3,0,12,mixedType,1
7,3,0,10,mixedType,1
8,1,0,9,mixedType,1
1,10,0,11,mixedType,1
6,6,0,12,mixedType,1
6,2,0,8,mixedType,1
7,2,0,9,mixedType,1
6,1,0,7,mixedType,0
6,4,0,10,mixedType,1
5,5,0,10,mixedType,1
7,1,0,8,mixedType,1
5,3,0,8,mixedType,1
4,8,0,12,mixedType,1
4,4,0,8,mixedType,1
9,3,0,12,mixedType,1
4,2,0,6,mixedType,0
7,1,0,8,mixedType,1
5,2,0,7,mixedType,0
5,3,0,8,mixedType,1
6,3,0,9,mixedType,1
4,2,0,6,mixedType,0
6,6,0,12,mixedType,1
7,3,0,10,mixedType,1
8,1,0,9,mixedType,1
8,2,0,10,mixedType,1
4,4,0,8,mixedType,1
10,1,0,11,mixedType,1
11,4,0,15,mixedType,2
6,2,0,8,mixedType,1
15,1,0,16,mixedType,2
7,4,0,11,mixedType,1
7,3,0,10,mixedType,1
6,1,0,7,mixedType,0
9,1,0,10,mixedType,1
13,3,0,16,mixedType,2
7,1,0,8,mixedType,1
7,6,0,13,mixedType,1
8,2,0,10,mixedType,1
5,5,0,10,mixedType,1
7,1,0,8,mixedType,1
8,4,0,12,mixedType,1
4,4,0,8,mixedType,1
18,1,1,20,mixedType,2
8,1,0,9,mixedType,1
8,2,0,10,mixedType,1
4,2,0,6,mixedType,0
3,9,0,12,mixedType,1
9,2,0,11,mixedType,1
6,3,0,9,mixedType,1
10,1,0,11,mixedType,1
2,4,0,6,mixedType,0
5,2,0,7,mixedType,0
3,9,0,12,mixedType,1
8,1,0,9,mixedType,1
7,2,0,9,mixedType,1
7,1,0,8,mixedType,1
6,4,0,10,mixedType,1
8,1,0,9,mixedType,1
3,3,0,6,mixedType,0
4,2,0,6,mixedType,0
9,1,0,10,mixedType,1
3,7,0,10,mixedType,1
7,3,0,10,mixedType,1
6,2,0,8,mixedType,1
5,4,0,9,mixedType,1
5,3,0,8,mixedType,1
7,3,0,10,mixedType,1
7,2,0,9,mixedType,1
11,2,0,13,mixedType,1
4,4,0,8,mixedType,1
7,3,0,10,mixedType,1
3,3,0,6,mixedType,0
4,9,0,13,mixedType,1
17,3,0,20,mixedType,2
7,6,0,13,mixedType,1
5,3,0,8,mixedType,1
7,5,0,12,mixedType,1
6,4,0,10,mixedType,1
7,4,0,11,mixedType,1
7,3,0,10,mixedType,1
7,3,0,10,mixedType,1
9,1,0,10,mixedType,1
5,2,0,7,mixedType,0
4,4,0,8,mixedType,1
6,3,0,9,mixedType,1
5,3,0,8,mixedType,1
9,3,3,15,mixedType,2
7,3,0,10,mixedType,1
4,6,0,10,mixedType,1
8,1,0,9,mixedType,1
12,4,0,16,mixedType,2
6,2,0,8,mixedType,1
7,2,0,9,mixedType,1
14,2,0,16,mixedType,2
4,2,0,6,mixedType,0
6,3,0,9,mixedType,1
6,3,0,9,mixedType,1
7,2,0,9,mixedType,1
11,3,0,14,mixedType,2
2,6,0,8,mixedType,1
6,3,0,9,mixedType,1
9,2,0,11,mixedType,1
6,3,0,9,mixedType,1
6,3,0,9,mixedType,1
13,3,0,16,mixedType,2
7,3,0,10,mixedType,1
6,1,0,7,mixedType,0
8,3,0,11,mixedType,1
0,6,1,7,mixedType,0
7,1,0,8,mixedType,1
3,5,0,8,mixedType,1
2,8,0,10,mixedType,1
9,4,0,13,mixedType,1
6,1,0,7,mixedType,0
5,3,0,8,mixedType,1
5,2,0,7,mixedType,0
6,3,0,9,mixedType,1
3,6,0,9,mixedType,1
9,3,0,12,mixedType,1
6,2,0,8,mixedType,1
8,3,0,11,mixedType,1
5,2,0,7,mixedType,0
3,5,0,8,mixedType,1
6,1,0,7,mixedType,0
5,4,0,9,mixedType,1
6,2,0,8,mixedType,1
8,2,0,10,mixedType,1
7,6,0,13,mixedType,1
6,3,0,9,mixedType,1
13,3,0,16,mixedType,2
8,2,0,10,mixedType,1
11,4,2,17,mixedType,2
10,4,0,14,mixedType,2
9,1,0,10,mixedType,1
7,3,0,10,mixedType,1
5,2,0,7,mixedType,0
10,4,0,14,mixedType,2
5,3,0,8,mixedType,1
7,3,0,10,mixedType,1
8,4,0,12,mixedType,1
5,2,0,7,mixedType,0
15,1,0,16,mixedType,2
5,3,0,8,mixedType,1
14,2,0,16,mixedType,2
12,3,0,15,mixedType,2
5,4,0,9,mixedType,1
7,2,0,9,mixedType,1
5,1,0,6,mixedType,0
5,4,0,9,mixedType,1
8,1,0,9,mixedType,1
10,5,0,15,mixedType,2
9,4,0,13,mixedType,1
5,4,0,9,mixedType,1
11,3,0,14,mixedType,2
3,5,0,8,mixedType,1
3,5,0,8,mixedType,1
14,2,0,16,mixedType,2
6,6,0,12,mixedType,1
14,2,0,16,mixedType,2
5,4,0,9,mixedType,1
7,3,0,10,mixedType,1
11,3,0,14,mixedType,2
6,2,0,8,mixedType,1
5,2,0,7,mixedType,0
5,3,0,8,mixedType,1
7,1,0,8,mixedType,1
4,6,0,10,mixedType,1
13,3,0,16,mixedType,2
10,2,0,12,mixedType,1
4,4,0,8,mixedType,1
2,4,0,6,mixedType,0
6,3,0,9,mixedType,1
13,3,0,16,mixedType,2
5,1,0,6,mixedType,0
4,2,0,6,mixedType,0
7,1,0,8,mixedType,1
4,2,0,6,mixedType,0
5,2,0,7,mixedType,0
6,4,0,10,mixedType,1
5,1,0,6,mixedType,0
3,7,0,10,mixedType,1
8,2,0,10,mixedType,1
6,2,0,8,mixedType,1
7,4,0,11,mixedType,1
14,2,0,16,mixedType,2
1,7,0,8,mixedType,1
5,2,0,7,mixedType,0
6,4,0,10,mixedType,1
11,3,0,14,mixedType,2
10,3,0,13,mixedType,1
7,3,0,10,mixedType,1
12,4,0,16,mixedType,2
5,5,0,10,mixedType,1
8,2,0,10,mixedType,1
6,3,0,9,mixedType,1
2,8,0,10,mixedType,1
14,2,0,16,mixedType,2
5,2,0,7,mixedType,0
7,3,0,10,mixedType,1
6,4,0,10,mixedType,1
11,2,0,13,mixedType,1
5,3,0,8,mixedType,1
2,6,0,8,mixedType,1
5,1,0,6,mixedType,0
12,4,0,16,mixedType,2
11,6,3,20,mixedType,2
6,1,0,7,mixedType,0
7,2,0,9,mixedType,1
1,7,0,8,mixedType,1
11,1,0,12,mixedType,1
5,4,0,9,mixedType,1
5,3,0,8,mixedType,1
4,6,0,10,mixedType,1
4,4,0,8,mixedType,1
7,2,0,9,mixedType,1
8,2,0,10,mixedType,1
8,2,0,10,mixedType,1
13,3,0,16,mixedType,2
3,6,0,9,mixedType,1
7,3,0,10,mixedType,1
4,2,0,6,mixedType,0
7,3,0,10,mixedType,1
7,4,0,11,mixedType,1
5,3,0,8,mixedType,1
4,5,0,9,mixedType,1
4,2,0,6,mixedType,0
7,2,0,9,mixedType,1
1,8,0,9,mixedType,1
4,2,0,6,mixedType,0
5,1,0,6,mixedType,0
8,1,0,9,mixedType,1
8,0,1,9,mixedType,1
8,2,0,10,mixedType,1
7,3,0,10,mixedType,1
14,2,0,16,mixedType,2
6,1,0,7,mixedType,0
6,3,0,9,mixedType,1
9,1,0,10,mixedType,1
7,3,0,10,mixedType,1
11,3,0,14,mixedType,2
9,4,0,13,mixedType,1
4,4,0,8,mixedType,1
13,3,0,16,mixedType,2
5,3,0,8,mixedType,1
6,2,0,8,mixedType,1
7,3,0,10,mixedType,1
9,3,0,12,mixedType,1
3,10,0,13,mixedType,1
6,1,0,7,mixedType,0
7,3,0,10,mixedType,1
4,6,0,10,mixedType,1
7,3,0,10,mixedType,1
5,1,0,6,mixedType,0
5,6,0,11,mixedType,1
5,2,0,7,mixedType,0
9,3,0,12,mixedType,1
4,4,0,8,mixedType,1
9,4,0,13,mixedType,1
9,1,0,10,mixedType,1
4,2,0,6,mixedType,0
9,2,0,11,mixedType,1
5,4,0,9,mixedType,1
4,8,0,12,mixedType,1
9,3,0,12,mixedType,1
10,2,0,12,mixedType,1
8,1,0,9,mixedType,1
4,6,0,10,mixedType,1
6,3,0,9,mixedType,1
7,3,0,10,mixedType,1
8,1,0,9,mixedType,1
5,3,0,8,mixedType,1
6,3,0,9,mixedType,1
6,3,0,9,mixedType,1
7,2,0,9,mixedType,1
5,3,0,8,mixedType,1
6,3,0,9,mixedType,1
6,3,0,9,mixedType,1
14,2,0,16,mixedType,2
8,1,0,9,mixedType,1
6,4,0,10,mixedType,1
6,2,0,8,mixedType,1
14,4,0,18,mixedType,2
9,1,0,10,mixedType,1
3,6,0,9,mixedType,1
7,4,0,11,mixedType,1
2,4,0,6,mixedType,0
9,1,0,10,mixedType,1
7,1,0,8,mixedType,1
5,3,0,8,mixedType,1
15,1,0,16,mixedType,2
5,8,0,13,mixedType,1
4,4,0,8,mixedType,1
6,3,0,9,mixedType,1
10,2,0,12,mixedType,1
7,3,0,10,mixedType,1
6,4,0,10,mixedType,1
5,5,0,10,mixedType,1
8,1,0,9,mixedType,1
6,1,0,7,mixedType,0
7,3,0,10,mixedType,1
4,4,0,8,mixedType,1
6,2,0,8,mixedType,1
7,3,0,10,mixedType,1
6,2,0,8,mixedType,1
14,2,0,16,mixedType,2
8,2,0,10,mixedType,1
9,1,0,10,mixedType,1
14,2,0,16,mixedType,2
14,2,0,16,mixedType,2
7,2,0,9,mixedType,1
5,4,0,9,mixedType,1
4,4,0,8,mixedType,1
4,8,0,12,mixedType,1
10,2,0,12,mixedType,1
15,1,0,16,mixedType,2
3,6,0,9,mixedType,1
2,4,0,6,mixedType,0
14,2,0,16,mixedType,2
2,4,0,6,mixedType,0
3,6,0,9,mixedType,1
8,1,0,9,mixedType,1
3,3,0,6,mixedType,0
6,3,0,9,mixedType,1
8,2,0,10,mixedType,1
8,3,0,11,mixedType,1
13,3,0,16,mixedType,2
7,1,0,8,mixedType,1
3,7,0,10,mixedType,1
11,3,0,14,mixedType,2
8,2,0,10,mixedType,1
7,2,0,9,mixedType,1
9,2,0,11,mixedType,1
15,1,0,16,mixedType,2
3,5,0,8,mixedType,1
9,1,0,10,mixedType,1
8,1,0,9,mixedType,1
5,3,0,8,mixedType,1
4,2,0,6,mixedType,0
6,4,0,10,mixedType,1
4,6,0,10,mixedType,1
15,1,0,16,mixedType,2
6,6,0,12,mixedType,1
5,2,0,7,mixedType,0
4,8,0,12,mixedType,1
8,2,0,10,mixedType,1
4,4,0,8,mixedType,1
4,5,0,9,mixedType,1
5,4,0,9,mixedType,1
3,5,0,8,mixedType,1
3,3,0,6,mixedType,0
7,3,0,10,mixedType,1
8,3,0,11,mixedType,1
5,4,0,9,mixedType,1
12,3,0,15,mixedType,2
6,3,0,9,mixedType,1
2,8,0,10,mixedType,1
8,1,0,9,mixedType,1
7,3,0,10,mixedType,1
2,6,0,8,mixedType,1
6,3,0,9,mixedType,1
12,4,0,16,mixedType,2
6,3,0,9,mixedType,1
8,3,0,11,mixedType,1
14,2,0,16,mixedType,2
14,2,0,16,mixedType,2
11,1,0,12,mixedType,1
5,2,0,7,mixedType,0
6,4,0,10,mixedType,1
7,2,0,9,mixedType,1
5,4,0,9,mixedType,1
7,3,0,10,mixedType,1
8,1,0,9,mixedType,1
12,3,0,15,mixedType,2
6,3,0,9,mixedType,1
3,3,0,6,mixedType,0
10,3,0,13,mixedType,1
7,2,0,9,mixedType,1
3,6,0,9,mixedType,1
5,2,0,7,mixedType,0
4,2,0,6,mixedType,0
7,1,0,8,mixedType,1
6,3,0,9,mixedType,1
1,8,0,9,mixedType,1
15,1,0,16,mixedType,2
6,4,0,10,mixedType,1
5,2,0,7,mixedType,0
4,6,0,10,mixedType,1
7,3,0,10,mixedType,1
4,5,0,9,mixedType,1
1,8,0,9,mixedType,1
8,2,0,10,mixedType,1
7,1,0,8,mixedType,1
8,1,0,9,mixedType,1
11,3,0,14,mixedType,2
4,2,0,6,mixedType,0
3,8,0,11,mixedType,1
5,8,0,13,mixedType,1
6,4,0,10,mixedType,1
6,2,0,8,mixedType,1
2,7,0,9,mixedType,1
5,1,0,6,mixedType,0
8,2,0,10,mixedType,1
3,6,0,9,mixedType,1
6,2,0,8,mixedType,1
4,6,0,10,mixedType,1
5,2,0,7,mixedType,0
8,4,0,12,mixedType,1
6,3,0,9,mixedType,1
9,4,0,13,mixedType,1
5,3,0,8,mixedType,1
7,1,0,8,mixedType,1
7,3,0,10,mixedType,1
3,3,0,6,mixedType,0
5,2,0,7,mixedType,0
9,2,0,11,mixedType,1
6,2,0,8,mixedType,1
12,4,0,16,mixedType,2
6,2,0,8,mixedType,1
6,2,0,8,mixedType,1
6,3,0,9,mixedType,1
4,6,0,10,mixedType,1
4,4,0,8,mixedType,1
4,4,0,8,mixedType,1
6,1,0,7,mixedType,0
3,6,0,9,mixedType,1
7,2,0,9,mixedType,1
8,2,0,10,mixedType,1
6,0,1,7,mixedType,0
6,3,0,9,mixedType,1
7,4,0,11,mixedType,1
13,3,0,16,mixedType,2
6,4,0,10,mixedType,1
5,4,0,9,mixedType,1
5,3,0,8,mixedType,1
9,1,0,10,mixedType,1
5,3,0,8,mixedType,1
8,1,0,9,mixedType,1
11,3,0,14,mixedType,2
6,4,0,10,mixedType,1
3,3,0,6,mixedType,0
6,1,0,7,mixedType,0
4,6,0,10,mixedType,1
6,3,0,9,mixedType,1
4,4,0,8,mixedType,1
1,8,0,9,mixedType,1
8,3,0,11,mixedType,1
4,4,0,8,mixedType,1
7,3,0,10,mixedType,1
7,1,0,8,mixedType,1
5,4,0,9,mixedType,1
6,0,1,7,mixedType,0
14,2,0,16,mixedType,2
4,2,0,6,mixedType,0
6,1,0,7,mixedType,0
4,2,0,6,mixedType,0
20,8,2,30,mixedType,2
2,7,0,9,mixedType,1
15,1,0,16,mixedType,2
10,1,0,11,mixedType,1
8,1,0,9,mixedType,1
7,1,0,8,mixedType,1
9,1,0,10,mixedType,1
4,4,0,8,mixedType,1
3,5,0,8,mixedType,1
5,3,0,8,mixedType,1
8,3,0,11,mixedType,1
6,1,0,7,mixedType,0
7,2,0,9,mixedType,1
5,1,0,6,mixedType,0
2,6,0,8,mixedType,1
6,4,0,10,mixedType,1
9,4,0,13,mixedType,1
9,1,0,10,mixedType,1
6,3,0,9,mixedType,1
1,8,0,9,mixedType,1
7,3,0,10,mixedType,1
2,10,0,12,mixedType,1
6,1,0,7,mixedType,0
2,7,0,9,mixedType,1
8,1,0,9,mixedType,1
9,1,0,10,mixedType,1
4,2,0,6,mixedType,0
6,1,0,7,mixedType,0
3,6,0,9,mixedType,1
2,4,0,6,mixedType,0
6,1,0,7,mixedType,0
9,2,0,11,mixedType,1
6,2,0,8,mixedType,1
5,3,0,8,mixedType,1
6,4,0,10,mixedType,1
1,10,0,11,mixedType,1
4,6,0,10,mixedType,1
5,5,0,10,mixedType,1
7,2,0,9,mixedType,1
6,3,0,9,mixedType,1
5,2,0,7,mixedType,0
6,1,0,7,mixedType,0
6,1,0,7,mixedType,0
6,1,0,7,mixedType,0
10,1,0,11,mixedType,1
6,3,0,9,mixedType,1
6,1,0,7,mixedType,0
3,6,0,9,mixedType,1
7,3,0,10,mixedType,1
6,2,0,8,mixedType,1
5,2,0,7,mixedType,0
5,4,0,9,mixedType,1
5,4,0,9,mixedType,1
9,4,0,13,mixedType,1
4,2,0,6,mixedType,0
14,2,0,16,mixedType,2
6,1,0,7,mixedType,0
6,6,0,12,mixedType,1
6,6,0,12,mixedType,1
8,2,0,10,mixedType,1
4,8,0,12,mixedType,1
5,4,0,9,mixedType,1
4,6,0,10,mixedType,1
5,3,0,8,mixedType,1
6,2,0,8,mixedType,1
5,3,0,8,mixedType,1
2,9,0,11,mixedType,1
7,1,0,8,mixedType,1
13,3,0,16,mixedType,2
6,3,0,9,mixedType,1
9,3,0,12,mixedType,1
5,3,0,8,mixedType,1
1,8,0,9,mixedType,1
5,4,0,9,mixedType,1
6,3,0,9,mixedType,1
7,2,0,9,mixedType,1
7,0,5,12,mixedType,1
6,2,0,8,mixedType,1
8,4,0,12,mixedType,1
1,8,0,9,mixedType,1
4,4,0,8,mixedType,1
5,4,0,9,mixedType,1
9,3,0,12,mixedType,1
2,6,0,8,mixedType,1
9,3,0,12,mixedType,1
1,8,0,9,mixedType,1
5,3,0,8,mixedType,1
14,2,0,16,mixedType,2
5,8,0,13,mixedType,1
5,2,0,7,mixedType,0
3,6,0,9,mixedType,1
8,1,0,9,mixedType,1
7,3,0,10,mixedType,1
9,1,0,10,mixedType,1
2,9,0,11,mixedType,1
6,4,0,10,mixedType,1
7,3,0,10,mixedType,1
16,4,0,20,mixedType,2
5,1,0,6,mixedType,0
6,4,0,10,mixedType,1
6,5,0,11,mixedType,1
2,4,0,6,mixedType,0
7,1,0,8,mixedType,1
5,4,0,9,mixedType,1
6,2,0,8,mixedType,1
7,2,0,9,mixedType,1
5,4,0,9,mixedType,1
11,2,0,13,mixedType,1
6,3,0,9,mixedType,1
4,4,0,8,mixedType,1
5,6,0,11,mixedType,1
13,3,0,16,mixedType,2
14,2,0,16,mixedType,2
9,1,0,10,mixedType,1
7,2,0,9,mixedType,1
7,2,0,9,mixedType,1
10,1,0,11,mixedType,1
5,1,0,6,mixedType,0
5,3,0,8,mixedType,1
1,8,0,9,mixedType,1
15,1,0,16,mixedType,2
8,4,0,12,mixedType,1
2,4,0,6,mixedType,0
5,4,0,9,mixedType,1
5,4,0,9,mixedType,1
9,3,0,12,mixedType,1
6,3,0,9,mixedType,1
9,2,0,11,mixedType,1
7,2,0,9,mixedType,1
12,3,0,15,mixedType,2
5,3,0,8,mixedType,1
5,1,0,6,mixedType,0
7,3,0,10,mixedType,1
8,3,0,11,mixedType,1
5,2,0,7,mixedType,0
5,4,0,9,mixedType,1
1,7,0,8,mixedType,1
5,1,0,6,mixedType,0
2,6,0,8,mixedType,1
9,2,0,11,mixedType,1
12,4,0,16,mixedType,2
5,1,0,6,mixedType,0
4,6,0,10,mixedType,1
5,2,0,7,mixedType,0
5,8,0,13,mixedType,1
11,3,0,14,mixedType,2
12,1,0,13,mixedType,1
7,3,0,10,mixedType,1
5,4,0,9,mixedType,1
10,1,0,11,mixedType,1
4,4,0,8,mixedType,1
6,2,0,8,mixedType,1
7,1,0,8,mixedType,1
9,1,0,10,mixedType,1
4,8,0,12,mixedType,1
7,2,0,9,mixedType,1
9,4,0,13,mixedType,1
6,4,0,10,mixedType,1
4,6,0,10,mixedType,1
4,6,0,10,mixedType,1
7,1,0,8,mixedType,1
2,4,0,6,mixedType,0
7,4,0,11,mixedType,1
4,2,0,6,mixedType,0
5,2,0,7,mixedType,0
7,3,0,10,mixedType,1
3,8,0,11,mixedType,1
11,5,0,16,mixedType,2
8,2,0,10,mixedType,1
8,1,0,9,mixedType,1
4,4,0,8,mixedType,1
1,8,0,9,mixedType,1
13,3,0,16,mixedType,2
6,1,0,7,mixedType,0
6,1,0,7,mixedType,0
2,8,0,10,mixedType,1
7,3,0,10,mixedType,1
8,2,0,10,mixedType,1
6,2,0,8,mixedType,1
5,3,0,8,mixedType,1
9,1,0,10,mixedType,1
6,4,0,10,mixedType,1
5,5,0,10,mixedType,1
4,5,0,9,mixedType,1
6,2,0,8,mixedType,1
6,1,0,7,mixedType,0
6,4,0,10,mixedType,1
8,1,0,9,mixedType,1
9,3,0,12,mixedType,1
5,2,0,7,mixedType,0
7,7,0,14,mixedType,2
5,3,0,8,mixedType,1
8,4,0,12,mixedType,1
9,1,0,10,mixedType,1
4,2,0,6,mixedType,0
5,2,0,7,mixedType,0
8,2,0,10,mixedType,1
15,1,0,16,mixedType,2
3,7,0,10,mixedType,1
3,6,0,9,mixedType,1
6,4,0,10,mixedType,1
5,4,0,9,mixedType,1
4,7,0,11,mixedType,1
6,4,0,10,mixedType,1
5,1,0,6,mixedType,0
6,4,0,10,mixedType,1
6,3,0,9,mixedType,1
4,4,0,8,mixedType,1
4,4,0,8,mixedType,1
9,3,0,12,mixedType,1
9,6,0,15,mixedType,2
6,1,0,7,mixedType,0
7,3,0,10,mixedType,1
9,6,0,15,mixedType,2
6,1,0,7,mixedType,0
1,11,0,12,mixedType,1
6,2,0,8,mixedType,1
2,8,0,10,mixedType,1
2,4,0,6,mixedType,0
8,2,0,10,mixedType,1
7,3,0,10,mixedType,1
5,3,0,8,mixedType,1
14,2,0,16,mixedType,2
5,3,0,8,mixedType,1
8,2,0,10,mixedType,1
5,4,0,9,mixedType,1
5,4,0,9,mixedType,1
8,1,0,9,mixedType,1
8,3,0,11,mixedType,1
9,2,0,11,mixedType,1
9,1,0,10,mixedType,1
6,4,0,10,mixedType,1
6,6,0,12,mixedType,1
4,2,0,6,mixedType,0
8,3,0,11,mixedType,1
8,4,0,12,mixedType,1
1,7,0,8,mixedType,1
8,4,0,12,mixedType,1
11,2,0,13,mixedType,1
14,2,0,16,mixedType,2
1,10,0,11,mixedType,1
8,1,0,9,mixedType,1
5,3,0,8,mixedType,1
9,1,0,10,mixedType,1
9,1,0,10,mixedType,1
5,3,0,8,mixedType,1
6,3,0,9,mixedType,1
6,2,0,8,mixedType,1
11,1,0,12,mixedType,1
9,3,0,12,mixedType,1
7,2,0,9,mixedType,1
12,1,1,14,mixedType,2
5,4,0,9,mixedType,1
7,4,0,11,mixedType,1
7,3,0,10,mixedType,1
7,2,0,9,mixedType,1
10,3,0,13,mixedType,1
4,2,0,6,mixedType,0
6,2,0,8,mixedType,1
4,4,0,8,mixedType,1
6,1,0,7,mixedType,0
6,1,0,7,mixedType,0
8,1,0,9,mixedType,1
5,4,0,9,mixedType,1
7,3,0,10,mixedType,1
7,3,0,10,mixedType,1
4,8,0,12,mixedType,1
1,5,0,6,mixedType,0
8,1,0,9,mixedType,1
5,4,0,9,mixedType,1
8,2,0,10,mixedType,1
7,4,0,11,mixedType,1
4,4,0,8,mixedType,1
5,3,0,8,mixedType,1
2,6,0,8,mixedType,1
9,2,0,11,mixedType,1
8,1,0,9,mixedType,1
6,1,0,7,mixedType,0
5,4,0,9,mixedType,1
6,2,0,8,mixedType,1
8,1,0,9,mixedType,1
8,4,0,12,mixedType,1
14,2,0,16,mixedType,2
8,1,0,9,mixedType,1
6,3,0,9,mixedType,1
4,4,0,8,mixedType,1
5,4,0,9,mixedType,1
4,9,0,13,mixedType,1
10,2,0,12,mixedType,1
5,3,0,8,mixedType,1
5,2,0,7,mixedType,0
9,1,0,10,mixedType,1
14,2,0,16,mixedType,2
2,6,0,8,mixedType,1
7,3,0,10,mixedType,1
7,3,0,10,mixedType,1
6,3,0,9,mixedType,1
1,8,0,9,mixedType,1
15,1,1,17,mixedType,2
15,1,0,16,mixedType,2
7,2,0,9,mixedType,1
7,6,0,13,mixedType,1
7,3,0,10,mixedType,1
8,2,0,10,mixedType,1
8,2,0,10,mixedType,1
7,3,0,10,mixedType,1
7,4,0,11,mixedType,1
13,3,0,16,mixedType,2
6,4,0,10,mixedType,1
6,2,0,8,mixedType,1
5,4,0,9,mixedType,1
7,2,0,9,mixedType,1
5,3,0,8,mixedType,1
13,3,0,16,mixedType,2
5,2,0,7,mixedType,0
14,2,0,16,mixedType,2
7,3,0,10,mixedType,1
7,1,0,8,mixedType,1
8,2,0,10,mixedType,1
12,4,0,16,mixedType,2
7,2,0,9,mixedType,1
7,3,0,10,mixedType,1
7,4,0,11,mixedType,1
12,4,0,16,mixedType,2
6,1,0,7,mixedType,0
13,3,0,16,mixedType,2
12,4,0,16,mixedType,2
5,4,0,9,mixedType,1
7,2,0,9,mixedType,1
10,2,0,12,mixedType,1
6,0,1,7,mixedType,0
11,5,0,16,mixedType,2
6,2,0,8,mixedType,1
4,6,0,10,mixedType,1
0,6,3,9,mixedType,1
6,3,0,9,mixedType,1
6,2,0,8,mixedType,1
7,3,0,10,mixedType,1
6,3,0,9,mixedType,1
7,3,0,10,mixedType,1
6,3,0,9,mixedType,1
7,3,0,10,mixedType,1
6,3,0,9,mixedType,1
11,5,0,16,mixedType,2
5,4,0,9,mixedType,1
6,2,0,8,mixedType,1
8,2,0,10,mixedType,1
5,2,0,7,mixedType,0
4,4,0,8,mixedType,1
5,3,0,8,mixedType,1
8,1,0,9,mixedType,1
6,1,0,7,mixedType,0
8,4,0,12,mixedType,1
1,11,0,12,mixedType,1
6,6,0,12,mixedType,1
2,6,0,8,mixedType,1
8,1,0,9,mixedType,1
8,1,0,9,mixedType,1
8,4,0,12,mixedType,1
7,3,0,10,mixedType,1
8,8,0,16,mixedType,2
3,6,0,9,mixedType,1
4,5,0,9,mixedType,1
7,3,0,10,mixedType,1
5,3,0,8,mixedType,1
6,4,0,10,mixedType,1
5,4,0,9,mixedType,1
4,4,0,8,mixedType,1
10,2,0,12,mixedType,1
11,2,0,13,mixedType,1
9,2,0,11,mixedType,1
8,2,0,10,mixedType,1
7,1,0,8,mixedType,1
7,1,0,8,mixedType,1
7,2,0,9,mixedType,1
9,3,0,12,mixedType,1
5,5,0,10,mixedType,1
7,3,0,10,mixedType,1
6,1,0,7,mixedType,0
9,4,0,13,mixedType,1
8,1,0,9,mixedType,1
6,3,0,9,mixedType,1
4,4,0,8,mixedType,1
4,6,0,10,mixedType,1
12,4,0,16,mixedType,2
5,3,0,8,mixedType,1
1,8,0,9,mixedType,1
3,7,0,10,mixedType,1
13,3,0,16,mixedType,2
7,2,0,9,mixedType,1
7,1,0,8,mixedType,1
6,2,0,8,mixedType,1
13,3,0,16,mixedType,2
2,4,0,6,mixedType,0
4,4,0,8,mixedType,1
10,1,0,11,mixedType,1
5,3,0,8,mixedType,1
6,3,0,9,mixedType,1
7,3,0,10,mixedType,1
6,2,0,8,mixedType,1
6,2,0,8,mixedType,1
7,3,0,10,mixedType,1
4,4,0,8,mixedType,1
9,4,0,13,mixedType,1
15,1,0,16,mixedType,2
7,3,0,10,mixedType,1
12,4,0,16,mixedType,2
2,6,0,8,mixedType,1
4,2,0,6,mixedType,0
8,1,0,9,mixedType,1
9,3,0,12,mixedType,1
9,3,0,12,mixedType,1
7,2,0,9,mixedType,1
6,1,0,7,mixedType,0
7,4,0,11,mixedType,1
11,1,0,12,mixedType,1
8,2,0,10,mixedType,1
7,5,2,14,mixedType,2
3,7,0,10,mixedType,1
5,2,0,7,mixedType,0
7,3,0,10,mixedType,1
14,2,0,16,mixedType,2
6,6,0,12,mixedType,1
7,2,0,9,mixedType,1
8,2,0,10,mixedType,1
7,3,0,10,mixedType,1
7,3,0,10,mixedType,1
12,4,0,16,mixedType,2
8,2,0,10,mixedType,1
5,3,0,8,mixedType,1
7,2,0,9,mixedType,1
11,2,0,13,mixedType,1
7,4,0,11,mixedType,1
8,2,0,10,mixedType,1
6,1,0,7,mixedType,0
6,2,0,8,mixedType,1
2,7,0,9,mixedType,1
7,2,0,9,mixedType,1
5,3,0,8,mixedType,1
13,3,0,16,mixedType,2
5,5,0,10,mixedType,1
6,4,0,10,mixedType,1
8,4,0,12,mixedType,1
6,3,0,9,mixedType,1
2,8,0,10,mixedType,1
5,1,0,6,mixedType,0
5,2,0,7,mixedType,0
5,3,0,8,mixedType,1
7,3,0,10,mixedType,1
6,3,0,9,mixedType,1
5,4,0,9,mixedType,1
6,6,0,12,mixedType,1
6,1,0,7,mixedType,0
12,4,0,16,mixedType,2
3,9,0,12,mixedType,1
9,1,0,10,mixedType,1
2,8,0,10,mixedType,1
1,8,0,9,mixedType,1
14,2,0,16,mixedType,2
5,3,0,8,mixedType,1
6,1,0,7,mixedType,0
1,8,0,9,mixedType,1
14,2,0,16,mixedType,2
8,2,0,10,mixedType,1
1,8,0,9,mixedType,1
6,4,0,10,mixedType,1
14,2,0,16,mixedType,2
6,3,0,9,mixedType,1
7,2,0,9,mixedType,1
11,4,0,15,mixedType,2
6,3,0,9,mixedType,1
5,4,0,9,mixedType,1
8,3,0,11,mixedType,1
2,8,0,10,mixedType,1
8,2,0,10,mixedType,1
1,10,0,11,mixedType,1
7,4,0,11,mixedType,1
7,1,0,8,mixedType,1
9,1,0,10,mixedType,1
5,2,0,7,mixedType,0
5,4,0,9,mixedType,1
6,4,0,10,mixedType,1
9,4,0,13,mixedType,1
4,6,0,10,mixedType,1
6,4,0,10,mixedType,1
5,4,0,9,mixedType,1
8,1,0,9,mixedType,1
3,5,0,8,mixedType,1
14,2,0,16,mixedType,2
4,9,1,14,mixedType,2
6,3,0,9,mixedType,1
8,1,0,9,mixedType,1
6,2,0,8,mixedType,1
12,3,0,15,mixedType,2
6,3,0,9,mixedType,1
6,6,0,12,mixedType,1
5,4,0,9,mixedType,1
6,3,0,9,mixedType,1
0,8,1,9,mixedType,1
5,2,0,7,mixedType,0
4,2,0,6,mixedType,0
5,4,0,9,mixedType,1
5,3,0,8,mixedType,1
4,2,0,6,mixedType,0
15,1,0,16,mixedType,2
2,9,0,11,mixedType,1
2,7,0,9,mixedType,1
14,2,0,16,mixedType,2
8,2,0,10,mixedType,1
13,2,0,15,mixedType,2
4,4,0,8,mixedType,1
6,2,0,8,mixedType,1
6,6,0,12,mixedType,1
10,2,0,12,mixedType,1
9,2,0,11,mixedType,1
5,2,0,7,mixedType,0
8,1,0,9,mixedType,1
7,3,0,10,mixedType,1
7,3,0,10,mixedType,1
7,1,0,8,mixedType,1
6,3,0,9,mixedType,1
7,2,0,9,mixedType,1
6,2,0,8,mixedType,1
2,7,0,9,mixedType,1
2,6,0,8,mixedType,1
7,2,0,9,mixedType,1
5,2,0,7,mixedType,0
3,5,0,8,mixedType,1
5,1,0,6,mixedType,0
5,1,0,6,mixedType,0
6,2,0,8,mixedType,1
5,3,0,8,mixedType,1
8,1,0,9,mixedType,1
8,4,0,12,mixedType,1
7,4,0,11,mixedType,1
8,1,0,9,mixedType,1
9,1,0,10,mixedType,1
12,4,0,16,mixedType,2
6,1,0,7,mixedType,0
6,2,0,8,mixedType,1
6,3,0,9,mixedType,1
6,6,0,12,mixedType,1
6,3,0,9,mixedType,1
7,3,0,10,mixedType,1
8,2,0,10,mixedType,1
5,2,0,7,mixedType,0
4,6,0,10,mixedType,1
6,1,0,7,mixedType,0
1,11,0,12,mixedType,1
15,1,0,16,mixedType,2
7,2,0,9,mixedType,1
6,2,0,8,mixedType,1
4,6,0,10,mixedType,1
9,1,0,10,mixedType,1
5,6,0,11,mixedType,1
5,4,0,9,mixedType,1
5,3,0,8,mixedType,1
2,4,0,6,mixedType,0
6,3,0,9,mixedType,1
7,3,0,10,mixedType,1
5,4,0,9,mixedType,1
8,2,0,10,mixedType,1
6,4,0,10,mixedType,1
6,3,0,9,mixedType,1
9,3,0,12,mixedType,1
12,3,0,15,mixedType,2
6,1,0,7,mixedType,0
15,1,0,16,mixedType,2
4,4,0,8,mixedType,1
9,1,0,10,mixedType,1
11,5,0,16,mixedType,2
2,4,0,6,mixedType,0
4,4,0,8,mixedType,1
8,1,0,9,mixedType,1
3,3,0,6,mixedType,0
4,6,0,10,mixedType,1
7,2,0,9,mixedType,1
5,3,0,8,mixedType,1
7,1,0,8,mixedType,1
4,6,0,10,mixedType,1
8,1,0,9,mixedType,1
7,2,0,9,mixedType,1
4,6,0,10,mixedType,1
6,4,0,10,mixedType,1
8,1,0,9,mixedType,1
1,8,0,9,mixedType,1
6,3,0,9,mixedType,1
1,8,0,9,mixedType,1
7,2,0,9,mixedType,1
3,6,0,9,mixedType,1
7,1,0,8,mixedType,1
5,1,0,6,mixedType,0
5,1,0,6,mixedType,0
7,1,0,8,mixedType,1
7,2,0,9,mixedType,1
6,3,0,9,mixedType,1
15,1,0,16,mixedType,2
7,4,0,11,mixedType,1
8,2,0,10,mixedType,1
10,1,0,11,mixedType,1
7,2,0,9,mixedType,1
6,1,0,7,mixedType,0
6,2,0,8,mixedType,1
6,1,0,7,mixedType,0
6,3,0,9,mixedType,1
2,4,0,6,mixedType,0
12,4,0,16,mixedType,2
5,3,0,8,mixedType,1
6,6,0,12,mixedType,1
5,3,0,8,mixedType,1
6,2,0,8,mixedType,1
2,8,0,10,mixedType,1
6,3,0,9,mixedType,1
8,2,0,10,mixedType,1
9,3,0,12,mixedType,1
6,8,0,14,mixedType,2
2,6,0,8,mixedType,1
13,3,0,16,mixedType,2
5,3,0,8,mixedType,1
14,2,0,16,mixedType,2
8,2,0,10,mixedType,1
6,6,0,12,mixedType,1
7,1,0,8,mixedType,1
8,2,0,10,mixedType,1
13,3,0,16,mixedType,2
5,3,0,8,mixedType,1
11,2,0,13,mixedType,1
11,4,0,15,mixedType,2
11,3,0,14,mixedType,2
5,3,0,8,mixedType,1
5,4,0,9,mixedType,1
10,2,0,12,mixedType,1
6,4,0,10,mixedType,1
6,2,0,8,mixedType,1
7,1,0,8,mixedType,1
5,4,0,9,mixedType,1
6,3,0,9,mixedType,1
6,2,0,8,mixedType,1
10,1,0,11,mixedType,1
7,1,0,8,mixedType,1
8,2,0,10,mixedType,1
6,3,0,9,mixedType,1
6,1,0,7,mixedType,0
4,2,0,6,mixedType,0
10,4,0,14,mixedType,2
7,6,0,13,mixedType,1
5,2,0,7,mixedType,0
5,1,0,6,mixedType,0
5,3,0,8,mixedType,1
6,1,0,7,mixedType,0
7,4,0,11,mixedType,1
7,3,0,10,mixedType,1
11,2,0,13,mixedType,1
7,3,0,10,mixedType,1
4,2,0,6,mixedType,0
2,8,0,10,mixedType,1
10,1,0,11,mixedType,1
6,1,0,7,mixedType,0
15,1,0,16,mixedType,2
7,3,0,10,mixedType,1
2,6,0,8,mixedType,1
8,2,0,10,mixedType,1
7,2,0,9,mixedType,1
15,1,0,16,mixedType,2
7,2,0,9,mixedType,1
7,2,0,9,mixedType,1
7,3,0,10,mixedType,1
2,16,0,18,mixedType,2
6,2,0,8,mixedType,1
7,3,0,10,mixedType,1
14,2,0,16,mixedType,2
2,8,0,10,mixedType,1
11,5,0,16,mixedType,2
8,2,0,10,mixedType,1
8,1,0,9,mixedType,1
3,9,0,12,mixedType,1
4,5,0,9,mixedType,1
8,3,0,11,mixedType,1
6,4,0,10,mixedType,1
4,4,0,8,mixedType,1
8,2,0,10,mixedType,1
6,3,0,9,mixedType,1
3,10,0,13,mixedType,1
5,1,0,6,mixedType,0
6,4,0,10,mixedType,1
8,2,0,10,mixedType,1
6,1,0,7,mixedType,0
7,3,0,10,mixedType,1
8,2,0,10,mixedType,1
11,3,0,14,mixedType,2
7,0,1,8,mixedType,1
8,2,0,10,mixedType,1
7,3,0,10,mixedType,1
11,3,0,14,mixedType,2
6,1,0,7,mixedType,0
3,0,3,6,mixedType,0
5,4,0,9,mixedType,1
5,4,0,9,mixedType,1
5,4,0,9,mixedType,1
8,1,0,9,mixedType,1
4,2,0,6,mixedType,0
13,3,0,16,mixedType,2
1,9,0,10,mixedType,1
8,2,0,10,mixedType,1
5,4,0,9,mixedType,1
6,1,0,7,mixedType,0
15,1,0,16,mixedType,2
6,3,0,9,mixedType,1
2,8,0,10,mixedType,1
6,2,0,8,mixedType,1
6,6,0,12,mixedType,1
6,4,0,10,mixedType,1
6,8,0,14,mixedType,2
7,4,0,11,mixedType,1
6,4,0,10,mixedType,1
8,2,0,10,mixedType,1
7,3,0,10,mixedType,1
8,1,0,9,mixedType,1
12,4,0,16,mixedType,2
4,8,0,12,mixedType,1
5,3,0,8,mixedType,1
11,5,0,16,mixedType,2
11,1,0,12,mixedType,1
9,1,0,10,mixedType,1
8,3,0,11,mixedType,1
7,3,0,10,mixedType,1
7,2,0,9,mixedType,1
2,8,0,10,mixedType,1
7,4,0,11,mixedType,1
8,4,0,12,mixedType,1
5,3,0,8,mixedType,1
5,3,0,8,mixedType,1
8,2,0,10,mixedType,1
8,3,0,11,mixedType,1
6,3,0,9,mixedType,1
3,5,0,8,mixedType,1
8,0,3,11,mixedType,1
6,3,0,9,mixedType,1
5,2,0,7,mixedType,0
8,4,0,12,mixedType,1
8,2,0,10,mixedType,1
4,2,0,6,mixedType,0
1,9,0,10,mixedType,1
7,1,0,8,mixedType,1
7,2,0,9,mixedType,1
6,3,0,9,mixedType,1
3,6,0,9,mixedType,1
6,2,0,8,mixedType,1
7,4,0,11,mixedType,1
4,2,0,6,mixedType,0
14,2,0,16,mixedType,2
5,3,0,8,mixedType,1
8,1,0,9,mixedType,1
1,7,0,8,mixedType,1
2,6,0,8,mixedType,1
11,3,0,14,mixedType,2
5,7,0,12,mixedType,1
13,3,0,16,mixedType,2
5,4,0,9,mixedType,1
7,2,0,9,mixedType,1
6,6,0,12,mixedType,1
2,7,0,9,mixedType,1
5,2,0,7,mixedType,0
5,1,0,6,mixedType,0
8,1,0,9,mixedType,1
6,3,0,9,mixedType,1
12,4,0,16,mixedType,2
6,3,0,9,mixedType,1
7,3,0,10,mixedType,1
5,2,0,7,mixedType,0
8,2,0,10,mixedType,1
5,3,0,8,mixedType,1
1,8,0,9,mixedType,1
7,2,0,9,mixedType,1
6,4,0,10,mixedType,1
1,8,0,9,mixedType,1
6,2,0,8,mixedType,1
4,4,0,8,mixedType,1
6,3,0,9,mixedType,1
15,1,0,16,mixedType,2
15,1,0,16,mixedType,2
5,4,0,9,mixedType,1
6,3,0,9,mixedType,1
5,2,0,7,mixedType,0
6,4,0,10,mixedType,1
4,5,0,9,mixedType,1
8,2,0,10,mixedType,1
8,1,0,9,mixedType,1
5,4,0,9,mixedType,1
7,3,0,10,mixedType,1
12,5,1,18,mixedType,2
8,2,0,10,mixedType,1
8,1,0,9,mixedType,1
8,2,0,10,mixedType,1
6,2,0,8,mixedType,1
7,2,0,9,mixedType,1
4,2,0,6,mixedType,0
9,4,0,13,mixedType,1
6,3,0,9,mixedType,1
6,3,0,9,mixedType,1
7,3,0,10,mixedType,1
5,1,0,6,mixedType,0
14,2,0,16,mixedType,2
6,4,0,10,mixedType,1
7,3,0,10,mixedType,1
6,3,0,9,mixedType,1
7,2,0,9,mixedType,1
13,3,0,16,mixedType,2
5,2,0,7,mixedType,0
13,3,0,16,mixedType,2
13,3,0,16,mixedType,2
8,3,0,11,mixedType,1
8,2,0,10,mixedType,1
8,2,0,10,mixedType,1
7,7,0,14,mixedType,2
4,4,0,8,mixedType,1
5,2,0,7,mixedType,0
4,8,0,12,mixedType,1
7,3,0,10,mixedType,1
14,2,0,16,mixedType,2
2,8,0,10,mixedType,1
3,6,0,9,mixedType,1
12,2,1,15,mixedType,2
12,3,0,15,mixedType,2
9,1,0,10,mixedType,1
6,3,0,9,mixedType,1
8,1,0,9,mixedType,1
6,3,0,9,mixedType,1
1,8,0,9,mixedType,1
7,2,0,9,mixedType,1
7,3,0,10,mixedType,1
8,2,0,10,mixedType,1
14,3,0,17,mixedType,2
11,5,0,16,mixedType,2
8,4,0,12,mixedType,1
5,3,0,8,mixedType,1
8,1,0,9,mixedType,1
16,1,1,18,mixedType,2
2,4,0,6,mixedType,0
6,1,0,7,mixedType,0
6,3,0,9,mixedType,1
12,4,0,16,mixedType,2
2,10,0,12,mixedType,1
4,8,0,12,mixedType,1
1,8,0,9,mixedType,1
3,3,0,6,mixedType,0
7,1,0,8,mixedType,1
4,2,0,6,mixedType,0
10,2,0,12,mixedType,1
7,3,0,10,mixedType,1
9,1,0,10,mixedType,1
1,12,0,13,mixedType,1
5,6,0,11,mixedType,1
5,4,0,9,mixedType,1
5,1,0,6,mixedType,0
7,3,0,10,mixedType,1
5,2,0,7,mixedType,0
12,3,0,15,mixedType,2
12,3,0,15,mixedType,2
5,2,0,7,mixedType,0
13,3,0,16,mixedType,2
8,1,0,9,mixedType,1
8,4,0,12,mixedType,1
6,2,0,8,mixedType,1
4,2,0,6,mixedType,0
4,2,0,6,mixedType,0
14,2,0,16,mixedType,2
7,1,3,11,mixedType,1
6,3,0,9,mixedType,1
7,3,0,10,mixedType,1
6,1,0,7,mixedType,0
5,3,0,8,mixedType,1
5,4,0,9,mixedType,1
8,3,0,11,mixedType,1
8,2,0,10,mixedType,1
2,7,0,9,mixedType,1
5,4,0,9,mixedType,1
5,2,0,7,mixedType,0
8,1,0,9,mixedType,1
5,2,0,7,mixedType,0
8,2,0,10,mixedType,1
6,4,0,10,mixedType,1
5,4,0,9,mixedType,1
4,6,0,10,mixedType,1
1,8,0,9,mixedType,1
9,3,0,12,mixedType,1
10,2,0,12,mixedType,1
1,8,0,9,mixedType,1
6,4,0,10,mixedType,1
8,2,0,10,mixedType,1
8,3,0,11,mixedType,1
12,4,0,16,mixedType,2
1,9,0,10,mixedType,1
15,1,0,16,mixedType,2
5,6,0,11,mixedType,1
5,2,0,7,mixedType,0
1,6,0,7,mixedType,0
13,3,0,16,mixedType,2
5,3,0,8,mixedType,1
4,4,0,8,mixedType,1
9,2,0,11,mixedType,1
5,3,0,8,mixedType,1
6,1,0,7,mixedType,0
7,3,0,10,mixedType,1
4,2,0,6,mixedType,0
7,1,0,8,mixedType,1
8,2,0,10,mixedType,1
9,1,0,10,mixedType,1
8,1,0,9,mixedType,1
5,2,0,7,mixedType,0
8,3,0,11,mixedType,1
2,6,0,8,mixedType,1
6,4,0,10,mixedType,1
13,3,0,16,mixedType,2
14,4,0,18,mixedType,2
12,4,0,16,mixedType,2
7,1,0,8,mixedType,1
5,2,0,7,mixedType,0
10,3,0,13,mixedType,1
12,4,0,16,mixedType,2
9,2,0,11,mixedType,1
13,3,0,16,mixedType,2
7,3,0,10,mixedType,1
6,3,0,9,mixedType,1
9,1,0,10,mixedType,1
6,3,0,9,mixedType,1
6,4,0,10,mixedType,1
5,3,0,8,mixedType,1
13,3,0,16,mixedType,2
1,8,0,9,mixedType,1
14,2,0,16,mixedType,2
3,6,0,9,mixedType,1
5,4,0,9,mixedType,1
6,3,0,9,mixedType,1
5,3,0,8,mixedType,1
8,1,0,9,mixedType,1
2,8,0,10,mixedType,1
6,3,0,9,mixedType,1
15,1,0,16,mixedType,2
2,6,0,8,mixedType,1
3,5,0,8,mixedType,1
8,2,0,10,mixedType,1
7,2,0,9,mixedType,1
4,5,0,9,mixedType,1
6,2,0,8,mixedType,1
7,2,0,9,mixedType,1
3,6,0,9,mixedType,1
5,4,0,9,mixedType,1
6,4,0,10,mixedType,1
8,1,0,9,mixedType,1
5,5,0,10,mixedType,1
8,2,0,10,mixedType,1
7,3,0,10,mixedType,1
10,2,0,12,mixedType,1
8,1,0,9,mixedType,1
5,4,0,9,mixedType,1
8,4,0,12,mixedType,1
6,3,0,9,mixedType,1
5,3,0,8,mixedType,1
9,1,0,10,mixedType,1
6,1,0,7,mixedType,0
5,4,0,9,mixedType,1
6,1,0,7,mixedType,0
12,4,0,16,mixedType,2
11,3,0,14,mixedType,2
8,3,0,11,mixedType,1
5,2,0,7,mixedType,0
4,0,3,7,mixedType,0
7,2,0,9,mixedType,1
6,4,0,10,mixedType,1
5,3,0,8,mixedType,1
8,2,0,10,mixedType,1
15,1,0,16,mixedType,2
6,3,0,9,mixedType,1
5,4,0,9,mixedType,1
7,6,0,13,mixedType,1
9,1,0,10,mixedType,1
5,8,0,13,mixedType,1
9,1,0,10,mixedType,1
4,9,0,13,mixedType,1
2,11,0,13,mixedType,1
8,2,0,10,mixedType,1
8,8,0,16,mixedType,2
8,1,0,9,mixedType,1
6,4,0,10,mixedType,1
7,2,0,9,mixedType,1
2,6,0,8,mixedType,1
1,8,0,9,mixedType,1
14,2,0,16,mixedType,2
1,10,0,11,mixedType,1
3,6,0,9,mixedType,1
8,1,0,9,mixedType,1
4,4,0,8,mixedType,1
5,2,0,7,mixedType,0
4,9,0,13,mixedType,1
7,2,0,9,mixedType,1
6,1,0,7,mixedType,0
7,2,0,9,mixedType,1
9,0,1,10,mixedType,1
7,3,0,10,mixedType,1
9,3,0,12,mixedType,1
7,3,0,10,mixedType,1
7,3,0,10,mixedType,1
11,2,0,13,mixedType,1
14,2,0,16,mixedType,2
6,3,0,9,mixedType,1
6,4,0,10,mixedType,1
8,4,0,12,mixedType,1
5,4,0,9,mixedType,1
6,3,0,9,mixedType,1
8,2,0,10,mixedType,1
6,4,0,10,mixedType,1
13,3,0,16,mixedType,2
5,2,0,7,mixedType,0
2,8,0,10,mixedType,1
9,3,2,14,mixedType,2
4,4,0,8,mixedType,1
15,1,0,16,mixedType,2
9,1,0,10,mixedType,1
8,2,0,10,mixedType,1
15,1,0,16,mixedType,2
8,3,0,11,mixedType,1
9,3,0,12,mixedType,1
6,4,0,10,mixedType,1
6,4,0,10,mixedType,1
5,5,0,10,mixedType,1
6,4,0,10,mixedType,1
7,3,0,10,mixedType,1
1,8,0,9,mixedType,1
10,4,1,15,mixedType,2
1,6,0,7,mixedType,0
8,1,0,9,mixedType,1
6,2,0,8,mixedType,1
9,4,0,13,mixedType,1
6,3,0,9,mixedType,1
6,4,0,10,mixedType,1
8,3,0,11,mixedType,1
3,8,0,11,mixedType,1
5,3,0,8,mixedType,1
8,2,0,10,mixedType,1
3,6,0,9,mixedType,1
4,4,0,8,mixedType,1
4,6,0,10,mixedType,1
7,2,0,9,mixedType,1
6,4,0,10,mixedType,1
6,2,0,8,mixedType,1
6,2,0,8,mixedType,1
15,1,0,16,mixedType,2
1,8,0,9,mixedType,1
2,4,0,6,mixedType,0
4,4,0,8,mixedType,1
9,1,0,10,mixedType,1
10,2,0,12,mixedType,1
7,2,0,9,mixedType,1
13,3,0,16,mixedType,2
9,2,0,11,mixedType,1
5,5,0,10,mixedType,1
1,9,0,10,mixedType,1
2,6,0,8,mixedType,1
2,8,0,10,mixedType,1
8,1,0,9,mixedType,1
6,1,0,7,mixedType,0
12,3,0,15,mixedType,2
5,0,4,9,mixedType,0
7,2,0,9,mixedType,1
8,1,0,9,mixedType,1
7,6,1,14,mixedType,2
4,4,0,8,mixedType,1
12,3,0,15,mixedType,2
8,2,0,10,mixedType,1
6,3,0,9,mixedType,1
7,1,0,8,mixedType,1
4,2,0,6,mixedType,0
5,2,0,7,mixedType,0
10,2,0,12,mixedType,1
9,3,0,12,mixedType,1
6,3,0,9,mixedType,1
1,8,0,9,mixedType,1
4,6,0,10,mixedType,1
8,2,0,10,mixedType,1
2,8,0,10,mixedType,1
6,3,0,9,mixedType,1
6,2,0,8,mixedType,1
6,2,0,8,mixedType,1
7,3,0,10,mixedType,1
8,1,0,9,mixedType,1
7,2,0,9,mixedType,1
4,6,0,10,mixedType,1
7,2,0,9,mixedType,1
7,3,0,10,mixedType,1
4,6,0,10,mixedType,1
4,4,0,8,mixedType,1
14,2,0,16,mixedType,2
6,1,0,7,mixedType,0
2,7,0,9,mixedType,1
9,3,0,12,mixedType,1
8,1,0,9,mixedType,1
5,2,0,7,mixedType,0
6,3,0,9,mixedType,1
7,3,0,10,mixedType,1
6,4,0,10,mixedType,1
6,4,0,10,mixedType,1
7,6,0,13,mixedType,1
6,1,0,7,mixedType,0
6,4,0,10,mixedType,1
3,6,0,9,mixedType,1
3,6,0,9,mixedType,1
6,3,0,9,mixedType,1
2,8,0,10,mixedType,1
8,4,0,12,mixedType,1
7,3,0,10,mixedType,1
8,1,0,9,mixedType,1
3,6,0,9,mixedType,1
6,2,0,8,mixedType,1
9,3,0,12,mixedType,1
5,7,0,12,mixedType,1
8,2,0,10,mixedType,1
8,2,0,10,mixedType,1
2,6,0,8,mixedType,1
5,9,0,14,mixedType,2
3,6,0,9,mixedType,1
6,3,0,9,mixedType,1
6,3,0,9,mixedType,1
3,3,0,6,mixedType,0
6,3,0,9,mixedType,1
6,3,0,9,mixedType,1
6,1,0,7,mixedType,0
10,1,0,11,mixedType,1
7,2,0,9,mixedType,1
7,2,0,9,mixedType,1
5,3,0,8,mixedType,1
6,1,0,7,mixedType,0
7,3,0,10,mixedType,1
6,3,0,9,mixedType,1
8,2,0,10,mixedType,1
8,4,0,12,mixedType,1
15,1,0,16,mixedType,2
3,6,0,9,mixedType,1
4,6,0,10,mixedType,1
5,6,0,11,mixedType,1
6,2,0,8,mixedType,1
8,2,0,10,mixedType,1
4,5,0,9,mixedType,1
8,2,0,10,mixedType,1
1,8,0,9,mixedType,1
15,4,0,19,mixedType,2
4,6,0,10,mixedType,1
7,3,0,10,mixedType,1
3,3,0,6,mixedType,0
4,2,0,6,mixedType,0
4,2,0,6,mixedType,0
2,8,0,10,mixedType,1
5,3,0,8,mixedType,1
6,1,0,7,mixedType,0
15,1,0,16,mixedType,2
6,2,0,8,mixedType,1
5,3,0,8,mixedType,1
6,10,1,17,mixedType,2
8,2,0,10,mixedType,1
5,3,0,8,mixedType,1
13,3,0,16,mixedType,2
7,3,0,10,mixedType,1
6,4,0,10,mixedType,1
4,5,0,9,mixedType,1
0,8,1,9,mixedType,1
3,6,0,9,mixedType,1
12,3,0,15,mixedType,2
4,2,0,6,mixedType,0
7,2,0,9,mixedType,1
7,2,0,9,mixedType,1
8,1,0,9,mixedType,1
5,2,0,7,mixedType,0
10,2,0,12,mixedType,1
7,3,0,10,mixedType,1
5,2,0,7,mixedType,0
7,1,0,8,mixedType,1
6,2,0,8,mixedType,1
6,1,0,7,mixedType,0
10,1,0,11,mixedType,1
11,5,0,16,mixedType,2
7,3,0,10,mixedType,1
9,2,0,11,mixedType,1
7,2,0,9,mixedType,1
1,8,0,9,mixedType,1
8,2,0,10,mixedType,1
6,3,0,9,mixedType,1
7,2,0,9,mixedType,1
8,1,0,9,mixedType,1
14,2,0,16,mixedType,2
7,2,0,9,mixedType,1
5,3,0,8,mixedType,1
6,4,0,10,mixedType,1
8,4,0,12,mixedType,1
6,4,0,10,mixedType,1
8,1,0,9,mixedType,1
4,4,0,8,mixedType,1
8,2,0,10,mixedType,1
3,7,0,10,mixedType,1
6,2,0,8,mixedType,1
8,2,0,10,mixedType,1
5,2,0,7,mixedType,0
7,1,0,8,mixedType,1
4,5,0,9,mixedType,1
6,1,0,7,mixedType,0
7,3,0,10,mixedType,1
4,2,0,6,mixedType,0
9,2,0,11,mixedType,1
7,2,0,9,mixedType,1
6,3,0,9,mixedType,1
2,6,0,8,mixedType,1
7,2,0,9,mixedType,1
8,2,0,10,mixedType,1
4,6,0,10,mixedType,1
5,4,0,9,mixedType,1
4,4,0,8,mixedType,1
6,4,0,10,mixedType,1
9,2,0,11,mixedType,1
13,3,0,16,mixedType,2
8,2,0,10,mixedType,1
7,2,0,9,mixedType,1
2,8,0,10,mixedType,1
14,2,0,16,mixedType,2
8,1,0,9,mixedType,1
6,4,0,10,mixedType,1
4,8,0,12,mixedType,1
6,5,0,11,mixedType,1
6,2,0,8,mixedType,1
4,2,0,6,mixedType,0
7,0,1,8,mixedType,1
7,2,0,9,mixedType,1
9,1,0,10,mixedType,1
4,8,0,12,mixedType,1
8,4,0,12,mixedType,1
11,5,0,16,mixedType,2
9,1,0,10,mixedType,1
7,1,0,8,mixedType,1
3,5,0,8,mixedType,1
7,2,0,9,mixedType,1
6,4,0,10,mixedType,1
9,2,0,11,mixedType,1
7,2,0,9,mixedType,1
6,2,0,8,mixedType,1
6,4,0,10,mixedType,1
8,2,0,10,mixedType,1
1,8,0,9,mixedType,1
7,3,0,10,mixedType,1
8,1,0,9,mixedType,1
5,4,0,9,mixedType,1
5,2,0,7,mixedType,0
6,3,0,9,mixedType,1
6,3,0,9,mixedType,1
5,4,0,9,mixedType,1
6,3,0,9,mixedType,1
4,5,0,9,mixedType,1
5,4,0,9,mixedType,1
11,1,0,12,mixedType,1
8,4,0,12,mixedType,1
1,7,0,8,mixedType,1
7,3,0,10,mixedType,1
6,4,0,10,mixedType,1
5,3,0,8,mixedType,1
9,3,0,12,mixedType,1
4,6,0,10,mixedType,1
6,3,0,9,mixedType,1
5,3,0,8,mixedType,1
13,3,0,16,mixedType,2
8,1,0,9,mixedType,1
6,2,0,8,mixedType,1
5,3,0,8,mixedType,1
5,3,0,8,mixedType,1
5,3,0,8,mixedType,1
6,2,0,8,mixedType,1
8,1,0,9,mixedType,1
7,3,0,10,mixedType,1
8,3,0,11,mixedType,1
6,3,0,9,mixedType,1
5,2,0,7,mixedType,0
5,4,0,9,mixedType,1
12,4,0,16,mixedType,2
7,2,0,9,mixedType,1
5,3,0,8,mixedType,1
9,2,0,11,mixedType,1
8,2,0,10,mixedType,1
1,9,0,10,mixedType,1
7,2,0,9,mixedType,1
7,6,0,13,mixedType,1
7,3,0,10,mixedType,1
11,1,0,12,mixedType,1
7,3,0,10,mixedType,1
11,2,0,13,mixedType,1
3,6,0,9,mixedType,1
6,3,0,9,mixedType,1
3,8,0,11,mixedType,1
7,3,0,10,mixedType,1
4,7,0,11,mixedType,1
7,2,0,9,mixedType,1
4,2,0,6,mixedType,0
13,3,0,16,mixedType,2
9,1,0,10,mixedType,1
6,4,0,10,mixedType,1
5,6,0,11,mixedType,1
8,4,0,12,mixedType,1
10,4,0,14,mixedType,2
14,2,0,16,mixedType,2
14,2,0,16,mixedType,2
9,1,0,10,mixedType,1
6,3,0,9,mixedType,1
9,3,0,12,mixedType,1
8,4,0,12,mixedType,1
10,3,0,13,mixedType,1
5,2,0,7,mixedType,0
5,2,0,7,mixedType,0
6,1,0,7,mixedType,0
14,2,0,16,mixedType,2
5,2,0,7,mixedType,0
7,1,0,8,mixedType,1
7,3,0,10,mixedType,1
2,8,0,10,mixedType,1
8,2,0,10,mixedType,1
5,2,0,7,mixedType,0
7,3,0,10,mixedType,1
5,3,0,8,mixedType,1
1,8,0,9,mixedType,1
5,3,0,8,mixedType,1
15,1,0,16,mixedType,2
7,4,0,11,mixedType,1
8,1,0,9,mixedType,1
4,6,0,10,mixedType,1
9,2,0,11,mixedType,1
5,6,0,11,mixedType,1
14,2,0,16,mixedType,2
13,3,0,16,mixedType,2
12,4,0,16,mixedType,2
5,2,0,7,mixedType,0
5,3,0,8,mixedType,1
5,1,0,6,mixedType,0
1,9,0,10,mixedType,1
7,2,0,9,mixedType,1
6,3,0,9,mixedType,1
3,6,0,9,mixedType,1
7,2,0,9,mixedType,1
5,2,0,7,mixedType,0
6,2,0,8,mixedType,1
6,2,0,8,mixedType,1
8,3,0,11,mixedType,1
6,1,0,7,mixedType,0
8,0,1,9,mixedType,1
13,3,0,16,mixedType,2
13,3,0,16,mixedType,2
9,1,0,10,mixedType,1
6,2,0,8,mixedType,1
4,2,0,6,mixedType,0
10,2,0,12,mixedType,1
7,2,0,9,mixedType,1
5,1,0,6,mixedType,0
9,3,0,12,mixedType,1
5,1,0,6,mixedType,0
6,4,0,10,mixedType,1
7,3,0,10,mixedType,1
14,5,6,25,mixedType,2
5,6,0,11,mixedType,1
7,2,0,9,mixedType,1
6,3,0,9,mixedType,1
12,4,0,16,mixedType,2
4,4,0,8,mixedType,1
8,3,0,11,mixedType,1
4,5,0,9,mixedType,1
3,6,0,9,mixedType,1
7,2,0,9,mixedType,1
7,3,0,10,mixedType,1
6,4,0,10,mixedType,1
5,4,0,9,mixedType,1
8,2,0,10,mixedType,1
7,3,0,10,mixedType,1
11,4,1,16,mixedType,2
2,4,0,6,mixedType,0
6,2,0,8,mixedType,1
10,3,0,13,mixedType,1
8,1,0,9,mixedType,1
8,2,0,10,mixedType,1
14,2,0,16,mixedType,2
10,2,0,12,mixedType,1
2,11,0,13,mixedType,1
9,3,0,12,mixedType,1
14,2,0,16,mixedType,2
3,7,0,10,mixedType,1
7,3,0,10,mixedType,1
10,6,0,16,mixedType,2
7,2,0,9,mixedType,1
15,1,0,16,mixedType,2
5,1,0,6,mixedType,0
2,9,0,11,mixedType,1
4,8,0,12,mixedType,1
7,2,0,9,mixedType,1
8,2,0,10,mixedType,1
7,4,0,11,mixedType,1
3,6,0,9,mixedType,1
8,1,0,9,mixedType,1
6,2,0,8,mixedType,1
11,3,0,14,mixedType,2
7,2,0,9,mixedType,1
7,1,0,8,mixedType,1
8,1,0,9,mixedType,1
7,3,0,10,mixedType,1
2,10,2,14,mixedType,2
7,2,0,9,mixedType,1
7,1,0,8,mixedType,1
8,3,0,11,mixedType,1
13,2,0,15,mixedType,2
6,3,0,9,mixedType,1
6,0,1,7,mixedType,0
1,8,0,9,mixedType,1
12,3,0,15,mixedType,2
5,3,0,8,mixedType,1
5,4,0,9,mixedType,1
5,3,0,8,mixedType,1
3,6,0,9,mixedType,1
8,2,0,10,mixedType,1
4,8,0,12,mixedType,1
7,0,1,8,mixedType,1
6,4,0,10,mixedType,1
8,1,0,9,mixedType,1
6,3,0,9,mixedType,1
7,2,0,9,mixedType,1
5,4,0,9,mixedType,1
15,1,0,16,mixedType,2
8,3,0,11,mixedType,1
6,6,0,12,mixedType,1
5,1,0,6,mixedType,0
8,2,0,10,mixedType,1
4,4,0,8,mixedType,1
6,1,0,7,mixedType,0
8,4,0,12,mixedType,1
11,3,0,14,mixedType,2
6,4,0,10,mixedType,1
12,4,0,16,mixedType,2
2,7,0,9,mixedType,1
3,6,0,9,mixedType,1
5,0,1,6,mixedType,0
6,4,0,10,mixedType,1
6,3,0,9,mixedType,1
6,3,0,9,mixedType,1
4,8,0,12,mixedType,1
6,3,0,9,mixedType,1
7,2,0,9,mixedType,1
5,2,0,7,mixedType,0
8,2,0,10,mixedType,1
7,1,0,8,mixedType,1
5,3,0,8,mixedType,1
1,8,0,9,mixedType,1
8,2,0,10,mixedType,1
9,3,0,12,mixedType,1
6,4,0,10,mixedType,1
11,2,0,13,mixedType,1
7,4,0,11,mixedType,1
14,2,0,16,mixedType,2
5,4,0,9,mixedType,1
5,1,0,6,mixedType,0
9,3,0,12,mixedType,1
5,6,0,11,mixedType,1
9,1,0,10,mixedType,1
6,4,0,10,mixedType,1
2,7,0,9,mixedType,1
14,2,0,16,mixedType,2
3,8,0,11,mixedType,1
1,8,0,9,mixedType,1
3,6,0,9,mixedType,1
5,4,0,9,mixedType,1
12,3,0,15,mixedType,2
10,0,1,11,mixedType,1
15,1,0,16,mixedType,2
10,1,0,11,mixedType,1
5,3,0,8,mixedType,1
5,3,0,8,mixedType,1
4,2,0,6,mixedType,0
7,4,0,11,mixedType,1
5,4,0,9,mixedType,1
6,4,0,10,mixedType,1
3,6,0,9,mixedType,1
8,2,0,10,mixedType,1
8,4,0,12,mixedType,1
4,4,0,8,mixedType,1
11,5,0,16,mixedType,2
7,3,0,10,mixedType,1
11,3,0,14,mixedType,2
8,2,0,10,mixedType,1
6,4,0,10,mixedType,1
8,2,0,10,mixedType,1
6,4,0,10,mixedType,1
7,3,0,10,mixedType,1
5,4,0,9,mixedType,1
3,6,0,9,mixedType,1
8,3,0,11,mixedType,1
12,4,0,16,mixedType,2
7,2,0,9,mixedType,1
7,2,0,9,mixedType,1
10,2,0,12,mixedType,1
7,2,0,9,mixedType,1
12,3,0,15,mixedType,2
6,2,0,8,mixedType,1
8,2,0,10,mixedType,1
1,7,0,8,mixedType,1
6,3,0,9,mixedType,1
13,3,0,16,mixedType,2
8,2,0,10,mixedType,1
7,3,0,10,mixedType,1
1,9,0,10,mixedType,1
8,1,0,9,mixedType,1
9,1,0,10,mixedType,1
6,3,0,9,mixedType,1
7,4,0,11,mixedType,1
9,4,0,13,mixedType,1
4,6,0,10,mixedType,1
14,2,0,16,mixedType,2
3,6,0,9,mixedType,1
4,7,0,11,mixedType,1
3,6,0,9,mixedType,1
5,2,0,7,mixedType,0
7,3,0,10,mixedType,1
8,4,0,12,mixedType,1
9,4,0,13,mixedType,1
6,4,0,10,mixedType,1
5,2,0,7,mixedType,0
4,4,0,8,mixedType,1
2,4,0,6,mixedType,0
6,3,0,9,mixedType,1
4,2,0,6,mixedType,0
14,2,0,16,mixedType,2
5,2,0,7,mixedType,0
8,2,0,10,mixedType,1
6,1,0,7,mixedType,0
5,2,0,7,mixedType,0
8,2,0,10,mixedType,1
7,4,0,11,mixedType,1
11,5,0,16,mixedType,2
7,1,0,8,mixedType,1
5,2,0,7,mixedType,0
4,2,0,6,mixedType,0
14,2,0,16,mixedType,2
1,10,0,11,mixedType,1
5,1,0,6,mixedType,0
12,4,0,16,mixedType,2
14,2,0,16,mixedType,2
5,3,0,8,mixedType,1
6,2,0,8,mixedType,1
9,4,0,13,mixedType,1
7,2,0,9,mixedType,1
4,2,0,6,mixedType,0
6,2,0,8,mixedType,1
7,3,0,10,mixedType,1
4,6,0,10,mixedType,1
5,5,0,10,mixedType,1
5,6,0,11,mixedType,1
1,11,0,12,mixedType,1
6,5,0,11,mixedType,1
4,2,0,6,mixedType,0
9,2,0,11,mixedType,1
6,3,0,9,mixedType,1
3,6,0,9,mixedType,1
1,8,0,9,mixedType,1
7,3,0,10,mixedType,1
6,4,0,10,mixedType,1
4,2,0,6,mixedType,0
6,1,0,7,mixedType,0
4,2,0,6,mixedType,0
6,2,0,8,mixedType,1
10,1,0,11,mixedType,1
6,4,0,10,mixedType,1
6,1,0,7,mixedType,0
3,7,0,10,mixedType,1
8,3,0,11,mixedType,1
11,4,0,15,mixedType,2
6,3,0,9,mixedType,1
10,3,1,14,mixedType,2
12,3,0,15,mixedType,2
6,3,0,9,mixedType,1
5,2,0,7,mixedType,0
15,1,0,16,mixedType,2
5,3,0,8,mixedType,1
8,1,0,9,mixedType,1
7,2,0,9,mixedType,1
9,4,2,15,mixedType,2
6,2,0,8,mixedType,1
6,4,0,10,mixedType,1
5,2,0,7,mixedType,0
9,1,0,10,mixedType,1
8,3,0,11,mixedType,1
3,5,0,8,mixedType,1
9,2,0,11,mixedType,1
15,1,0,16,mixedType,2
4,4,0,8,mixedType,1
8,2,0,10,mixedType,1
6,2,0,8,mixedType,1
10,4,0,14,mixedType,2
5,7,0,12,mixedType,1
6,1,0,7,mixedType,0
4,4,0,8,mixedType,1
8,1,0,9,mixedType,1
9,1,0,10,mixedType,1
8,2,0,10,mixedType,1
5,2,0,7,mixedType,0
4,4,0,8,mixedType,1
1,8,0,9,mixedType,1
8,2,0,10,mixedType,1
7,2,0,9,mixedType,1
7,3,0,10,mixedType,1
4,6,0,10,mixedType,1
6,3,0,9,mixedType,1
6,1,0,7,mixedType,0
9,1,0,10,mixedType,1
5,4,0,9,mixedType,1
5,3,0,8,mixedType,1
9,1,0,10,mixedType,1
7,3,0,10,mixedType,1
8,1,0,9,mixedType,1
4,2,0,6,mixedType,0
9,3,3,15,mixedType,2
8,2,0,10,mixedType,1
6,1,0,7,mixedType,0
6,2,0,8,mixedType,1
1,8,0,9,mixedType,1
1,8,0,9,mixedType,1
4,6,0,10,mixedType,1
7,2,0,9,mixedType,1
8,3,0,11,mixedType,1
5,3,0,8,mixedType,1
8,1,0,9,mixedType,1
7,2,0,9,mixedType,1
5,4,0,9,mixedType,1
7,10,0,17,mixedType,2
8,2,0,10,mixedType,1
6,2,0,8,mixedType,1
1,8,0,9,mixedType,1
4,6,0,10,mixedType,1
7,3,0,10,mixedType,1
7,4,0,11,mixedType,1
4,2,0,6,mixedType,0
8,1,0,9,mixedType,1
5,2,0,7,mixedType,0
6,1,0,7,mixedType,0
6,4,0,10,mixedType,1
6,4,0,10,mixedType,1
3,10,0,13,mixedType,1
8,1,0,9,mixedType,1
4,2,0,6,mixedType,0
8,3,0,11,mixedType,1
10,1,0,11,mixedType,1
8,1,0,9,mixedType,1
14,2,0,16,mixedType,2
9,1,0,10,mixedType,1
12,4,0,16,mixedType,2
8,2,0,10,mixedType,1
4,6,0,10,mixedType,1
14,2,0,16,mixedType,2
4,5,0,9,mixedType,1
6,4,0,10,mixedType,1
6,1,0,7,mixedType,0
4,2,0,6,mixedType,0
5,2,0,7,mixedType,0
8,5,0,13,mixedType,1
8,4,0,12,mixedType,1
6,3,0,9,mixedType,1
2,4,0,6,mixedType,0
6,4,0,10,mixedType,1
14,2,0,16,mixedType,2
5,2,0,7,mixedType,0
8,4,0,12,mixedType,1
5,5,0,10,mixedType,1
7,2,0,9,mixedType,1
15,1,0,16,mixedType,2
4,2,0,6,mixedType,0
5,3,0,8,mixedType,1
2,9,0,11,mixedType,1
6,2,0,8,mixedType,1
6,2,0,8,mixedType,1
13,3,0,16,mixedType,2
11,1,0,12,mixedType,1
6,1,0,7,mixedType,0
7,2,0,9,mixedType,1
5,3,0,8,mixedType,1
8,1,0,9,mixedType,1
6,2,0,8,mixedType,1
3,6,0,9,mixedType,1
2,8,0,10,mixedType,1
9,1,0,10,mixedType,1
7,2,0,9,mixedType,1
6,2,0,8,mixedType,1
4,6,0,10,mixedType,1
3,6,0,9,mixedType,1
5,2,0,7,mixedType,0
4,2,0,6,mixedType,0
6,3,0,9,mixedType,1
7,4,0,11,mixedType,1
1,8,0,9,mixedType,1
10,6,0,16,mixedType,2
5,3,0,8,mixedType,1
6,2,0,8,mixedType,1
6,3,0,9,mixedType,1
5,8,0,13,mixedType,1
4,2,0,6,mixedType,0
7,3,0,10,mixedType,1
3,5,0,8,mixedType,1
6,1,0,7,mixedType,0
6,3,0,9,mixedType,1
3,7,0,10,mixedType,1
6,2,0,8,mixedType,1
4,2,0,6,mixedType,0
8,2,0,10,mixedType,1
8,1,0,9,mixedType,1
6,1,0,7,mixedType,0
8,4,0,12,mixedType,1
6,3,0,9,mixedType,1
13,3,0,16,mixedType,2
4,8,0,12,mixedType,1
9,1,0,10,mixedType,1
5,1,0,6,mixedType,0
1,8,0,9,mixedType,1
5,2,0,7,mixedType,0
6,2,0,8,mixedType,1
8,1,0,9,mixedType,1
15,1,0,16,mixedType,2
6,2,0,8,mixedType,1
12,4,0,16,mixedType,2
8,1,0,9,mixedType,1
6,3,0,9,mixedType,1
7,4,0,11,mixedType,1
4,4,0,8,mixedType,1
11,2,0,13,mixedType,1
4,5,0,9,mixedType,1
8,2,0,10,mixedType,1
6,3,0,9,mixedType,1
6,6,0,12,mixedType,1
3,5,0,8,mixedType,1
8,3,0,11,mixedType,1
2,7,0,9,mixedType,1
7,6,1,14,mixedType,2
6,3,0,9,mixedType,1
6,4,0,10,mixedType,1
6,2,0,8,mixedType,1
2,6,0,8,mixedType,1
7,2,0,9,mixedType,1
5,3,0,8,mixedType,1
2,8,0,10,mixedType,1
6,2,0,8,mixedType,1
9,3,0,12,mixedType,1
4,4,0,8,mixedType,1
12,3,0,15,mixedType,2
5,4,0,9,mixedType,1
3,0,3,6,mixedType,0
6,3,0,9,mixedType,1
2,6,0,8,mixedType,1
14,2,0,16,mixedType,2
5,4,0,9,mixedType,1
12,1,0,13,mixedType,1
13,3,0,16,mixedType,2
3,4,1,8,mixedType,1
7,3,0,10,mixedType,1
8,3,0,11,mixedType,1
7,3,0,10,mixedType,1
4,2,0,6,mixedType,0
6,1,0,7,mixedType,0
14,2,0,16,mixedType,2
4,6,0,10,mixedType,1
10,6,1,17,mixedType,2
7,3,0,10,mixedType,1
6,4,0,10,mixedType,1
2,6,0,8,mixedType,1
5,3,0,8,mixedType,1
6,2,0,8,mixedType,1
10,6,0,16,mixedType,2
11,4,1,16,mixedType,2
15,1,0,16,mixedType,2
6,3,0,9,mixedType,1
7,3,0,10,mixedType,1
7,3,0,10,mixedType,1
5,1,0,6,mixedType,0
11,3,0,14,mixedType,2
5,2,0,7,mixedType,0
6,3,0,9,mixedType,1
15,1,0,16,mixedType,2
5,4,0,9,mixedType,1
11,3,0,14,mixedType,2
10,3,0,13,mixedType,1
8,2,0,10,mixedType,1
6,3,0,9,mixedType,1
2,7,0,9,mixedType,1
15,1,0,16,mixedType,2
7,0,1,8,mixedType,1
6,3,0,9,mixedType,1
8,2,0,10,mixedType,1
6,3,0,9,mixedType,1
8,4,0,12,mixedType,1
7,4,0,11,mixedType,1
6,3,0,9,mixedType,1
8,1,0,9,mixedType,1
7,2,0,9,mixedType,1
3,3,0,6,mixedType,0
5,3,0,8,mixedType,1
9,3,0,12,mixedType,1
11,2,0,13,mixedType,1
4,4,0,8,mixedType,1
14,2,0,16,mixedType,2
7,3,0,10,mixedType,1
8,1,0,9,mixedType,1
5,3,0,8,mixedType,1
6,3,0,9,mixedType,1
5,3,0,8,mixedType,1
1,9,0,10,mixedType,1
13,3,0,16,mixedType,2
7,2,0,9,mixedType,1
8,2,0,10,mixedType,1
10,1,0,11,mixedType,1
6,6,0,12,mixedType,1
5,3,0,8,mixedType,1
8,3,0,11,mixedType,1
8,2,0,10,mixedType,1
6,4,0,10,mixedType,1
9,1,0,10,mixedType,1
8,1,0,9,mixedType,1
6,4,0,10,mixedType,1
7,3,0,10,mixedType,1
6,5,0,11,mixedType,1
5,2,0,7,mixedType,0
12,3,0,15,mixedType,2
13,3,0,16,mixedType,2
5,6,0,11,mixedType,1
8,4,0,12,mixedType,1
7,3,0,10,mixedType,1
9,3,0,12,mixedType,1
5,3,0,8,mixedType,1
5,1,0,6,mixedType,0
5,3,0,8,mixedType,1
11,3,0,14,mixedType,2
3,10,1,14,mixedType,2
6,4,0,10,mixedType,1
1,7,0,8,mixedType,1
7,2,0,9,mixedType,1
7,2,0,9,mixedType,1
10,2,0,12,mixedType,1
1,7,0,8,mixedType,1
9,1,0,10,mixedType,1
5,2,0,7,mixedType,0
8,1,0,9,mixedType,1
6,2,0,8,mixedType,1
6,3,0,9,mixedType,1
11,4,0,15,mixedType,2
6,3,0,9,mixedType,1
3,3,0,6,mixedType,0
7,3,0,10,mixedType,1
8,1,0,9,mixedType,1
8,0,2,10,mixedType,1
6,3,0,9,mixedType,1
9,1,0,10,mixedType,1
4,2,0,6,mixedType,0
8,4,0,12,mixedType,1
6,2,0,8,mixedType,1
1,8,0,9,mixedType,1
9,1,0,10,mixedType,1
5,3,0,8,mixedType,1
6,6,0,12,mixedType,1
7,3,0,10,mixedType,1
6,1,0,7,mixedType,0
3,7,0,10,mixedType,1
12,1,0,13,mixedType,1
8,1,0,9,mixedType,1
8,1,0,9,mixedType,1
6,2,0,8,mixedType,1
4,4,0,8,mixedType,1
8,2,0,10,mixedType,1
14,2,0,16,mixedType,2
4,4,0,8,mixedType,1
8,2,0,10,mixedType,1
7,3,0,10,mixedType,1
8,3,0,11,mixedType,1
5,3,0,8,mixedType,1
4,2,0,6,mixedType,0
10,2,0,12,mixedType,1
6,2,0,8,mixedType,1
12,1,0,13,mixedType,1
8,3,0,11,mixedType,1
7,4,0,11,mixedType,1
8,1,0,9,mixedType,1
7,2,0,9,mixedType,1
6,2,0,8,mixedType,1
5,6,0,11,mixedType,1
10,8,0,18,mixedType,2
6,3,0,9,mixedType,1
6,4,0,10,mixedType,1
6,3,0,9,mixedType,1
4,2,0,6,mixedType,0
15,1,0,16,mixedType,2
7,2,0,9,mixedType,1
4,4,0,8,mixedType,1
4,2,0,6,mixedType,0
13,3,0,16,mixedType,2
7,2,0,9,mixedType,1
5,2,0,7,mixedType,0
9,1,0,10,mixedType,1
5,3,0,8,mixedType,1
5,3,0,8,mixedType,1
6,4,0,10,mixedType,1
7,1,0,8,mixedType,1
11,2,0,13,mixedType,1
10,4,1,15,mixedType,2
7,3,0,10,mixedType,1
9,3,0,12,mixedType,1
5,5,0,10,mixedType,1
3,6,0,9,mixedType,1
5,1,0,6,mixedType,0
4,4,0,8,mixedType,1
5,4,0,9,mixedType,1
5,4,0,9,mixedType,1
7,2,0,9,mixedType,1
7,3,0,10,mixedType,1
4,4,0,8,mixedType,1
15,1,0,16,mixedType,2
8,1,0,9,mixedType,1
8,4,0,12,mixedType,1
7,4,0,11,mixedType,1
11,5,0,16,mixedType,2
5,3,0,8,mixedType,1
1,8,0,9,mixedType,1
13,3,0,16,mixedType,2
1,8,0,9,mixedType,1
3,7,0,10,mixedType,1
7,3,0,10,mixedType,1
6,2,0,8,mixedType,1
2,6,0,8,mixedType,1
6,3,0,9,mixedType,1
4,6,0,10,mixedType,1
7,2,0,9,mixedType,1
7,2,0,9,mixedType,1
6,2,0,8,mixedType,1
7,2,0,9,mixedType,1
6,4,0,10,mixedType,1
11,1,0,12,mixedType,1
5,2,0,7,mixedType,0
1,10,0,11,mixedType,1
7,4,0,11,mixedType,1
8,3,0,11,mixedType,1
9,2,0,11,mixedType,1
8,1,0,9,mixedType,1
7,2,0,9,mixedType,1
6,1,0,7,mixedType,0
8,2,0,10,mixedType,1
6,7,0,13,mixedType,1
6,3,0,9,mixedType,1
5,4,0,9,mixedType,1
7,3,0,10,mixedType,1
4,2,0,6,mixedType,0
5,2,0,7,mixedType,0
8,2,0,10,mixedType,1
6,3,0,9,mixedType,1
6,2,0,8,mixedType,1
7,2,0,9,mixedType,1
5,2,0,7,mixedType,0
7,1,0,8,mixedType,1
4,4,0,8,mixedType,1
4,6,0,10,mixedType,1
9,4,0,13,mixedType,1
9,0,1,10,mixedType,1
6,4,0,10,mixedType,1
6,3,0,9,mixedType,1
14,2,0,16,mixedType,2
2,4,0,6,mixedType,0
3,10,0,13,mixedType,1
5,3,0,8,mixedType,1
9,2,0,11,mixedType,1
2,7,0,9,mixedType,1
6,3,0,9,mixedType,1
5,3,0,8,mixedType,1
5,3,0,8,mixedType,1
2,6,0,8,mixedType,1
7,3,0,10,mixedType,1
2,6,0,8,mixedType,1
5,2,0,7,mixedType,0
6,4,0,10,mixedType,1
8,3,0,11,mixedType,1
11,3,1,15,mixedType,2
6,3,0,9,mixedType,1
7,3,0,10,mixedType,1
10,2,0,12,mixedType,1
6,3,0,9,mixedType,1
4,4,0,8,mixedType,1
9,4,0,13,mixedType,1
6,4,0,10,mixedType,1
9,1,0,10,mixedType,1
7,2,0,9,mixedType,1
18,2,0,20,mixedType,2
5,4,0,9,mixedType,1
8,1,0,9,mixedType,1
4,6,0,10,mixedType,1
8,1,0,9,mixedType,1
5,2,0,7,mixedType,0
5,10,1,16,mixedType,2
8,3,0,11,mixedType,1
8,1,0,9,mixedType,1
2,4,0,6,mixedType,0
8,1,0,9,mixedType,1
5,2,0,7,mixedType,0
4,6,0,10,mixedType,1
6,3,0,9,mixedType,1
5,4,0,9,mixedType,1
7,3,0,10,mixedType,1
6,6,0,12,mixedType,1
9,1,0,10,mixedType,1
7,2,0,9,mixedType,1
5,1,0,6,mixedType,0
6,2,0,8,mixedType,1
14,2,0,16,mixedType,2
7,3,0,10,mixedType,1
7,4,0,11,mixedType,1
5,3,0,8,mixedType,1
4,6,0,10,mixedType,1
6,4,0,10,mixedType,1
9,3,0,12,mixedType,1
6,4,0,10,mixedType,1
15,1,0,16,mixedType,2
5,5,0,10,mixedType,1
5,3,0,8,mixedType,1
7,3,0,10,mixedType,1
6,3,0,9,mixedType,1
7,3,0,10,mixedType,1
14,2,0,16,mixedType,2
8,2,0,10,mixedType,1
7,2,0,9,mixedType,1
7,1,0,8,mixedType,1
6,2,0,8,mixedType,1
7,3,0,10,mixedType,1
7,1,0,8,mixedType,1
8,4,0,12,mixedType,1
6,2,0,8,mixedType,1
10,1,0,11,mixedType,1
12,4,0,16,mixedType,2
7,1,0,8,mixedType,1
4,5,0,9,mixedType,1
14,2,0,16,mixedType,2
1,8,0,9,mixedType,1
8,2,0,10,mixedType,1
10,2,0,12,mixedType,1
3,5,0,8,mixedType,1
14,2,0,16,mixedType,2
14,2,0,16,mixedType,2
8,2,0,10,mixedType,1
8,2,0,10,mixedType,1
4,4,0,8,mixedType,1
5,6,0,11,mixedType,1
7,2,0,9,mixedType,1
11,3,0,14,mixedType,2
2,11,0,13,mixedType,1
6,3,0,9,mixedType,1
5,3,0,8,mixedType,1
8,3,0,11,mixedType,1
8,4,0,12,mixedType,1
5,1,0,6,mixedType,0
6,3,0,9,mixedType,1
2,7,0,9,mixedType,1
2,6,0,8,mixedType,1
6,3,0,9,mixedType,1
7,2,0,9,mixedType,1
15,1,0,16,mixedType,2
1,8,0,9,mixedType,1
4,2,0,6,mixedType,0
8,2,0,10,mixedType,1
6,3,0,9,mixedType,1
4,2,0,6,mixedType,0
6,4,0,10,mixedType,1
15,1,0,16,mixedType,2
14,2,0,16,mixedType,2
6,3,0,9,mixedType,1
9,5,0,14,mixedType,2
5,2,0,7,mixedType,0
2,8,0,10,mixedType,1
8,6,0,14,mixedType,2
10,1,0,11,mixedType,1
10,2,0,12,mixedType,1
7,3,0,10,mixedType,1
11,1,0,12,mixedType,1
14,2,0,16,mixedType,2
8,5,0,13,mixedType,1
4,4,0,8,mixedType,1
9,3,0,12,mixedType,1
5,4,0,9,mixedType,1
1,8,0,9,mixedType,1
6,2,0,8,mixedType,1
2,7,0,9,mixedType,1
5,4,0,9,mixedType,1
9,2,0,11,mixedType,1
4,4,0,8,mixedType,1
4,4,0,8,mixedType,1
10,1,0,11,mixedType,1
3,3,0,6,mixedType,0
4,4,0,8,mixedType,1
8,1,0,9,mixedType,1
7,2,0,9,mixedType,1
4,5,0,9,mixedType,1
2,8,0,10,mixedType,1
5,2,0,7,mixedType,0
7,2,0,9,mixedType,1
5,1,0,6,mixedType,0
10,2,0,12,mixedType,1
9,5,0,14,mixedType,2
7,1,0,8,mixedType,1
3,5,0,8,mixedType,1
11,3,0,14,mixedType,2
6,1,0,7,mixedType,0
8,1,0,9,mixedType,1
8,2,0,10,mixedType,1
14,2,0,16,mixedType,2
8,1,0,9,mixedType,1
8,2,0,10,mixedType,1
5,4,0,9,mixedType,1
9,2,0,11,mixedType,1
7,3,0,10,mixedType,1
2,7,0,9,mixedType,1
5,1,0,6,mixedType,0
5,2,0,7,mixedType,0
4,9,0,13,mixedType,1
5,2,0,7,mixedType,0
7,3,0,10,mixedType,1
2,8,0,10,mixedType,1
12,2,1,15,mixedType,2
5,4,0,9,mixedType,1
18,1,1,20,mixedType,2
6,1,0,7,mixedType,0
7,3,0,10,mixedType,1
13,3,0,16,mixedType,2
5,3,0,8,mixedType,1
1,7,0,8,mixedType,1
5,2,0,7,mixedType,0
5,5,0,10,mixedType,1
4,2,0,6,mixedType,0
5,5,0,10,mixedType,1
3,7,0,10,mixedType,1
9,2,0,11,mixedType,1
7,3,0,10,mixedType,1
5,1,0,6,mixedType,0
9,4,0,13,mixedType,1
8,4,0,12,mixedType,1
8,1,0,9,mixedType,1
5,1,0,6,mixedType,0
1,7,0,8,mixedType,1
7,3,0,10,mixedType,1
4,4,0,8,mixedType,1
7,2,0,9,mixedType,1
2,8,0,10,mixedType,1
6,1,0,7,mixedType,0
12,4,0,16,mixedType,2
4,6,0,10,mixedType,1
6,3,0,9,mixedType,1
7,4,0,11,mixedType,1
8,2,0,10,mixedType,1
7,3,0,10,mixedType,1
8,3,0,11,mixedType,1
9,2,0,11,mixedType,1
8,2,0,10,mixedType,1
6,4,0,10,mixedType,1
3,3,0,6,mixedType,0
9,3,0,12,mixedType,1
1,10,0,11,mixedType,1
5,3,0,8,mixedType,1
4,2,0,6,mixedType,0
6,3,0,9,mixedType,1
6,2,0,8,mixedType,1
6,1,0,7,mixedType,0
8,4,0,12,mixedType,1
15,1,0,16,mixedType,2
8,3,0,11,mixedType,1
15,1,1,17,mixedType,2
6,1,0,7,mixedType,0
7,6,0,13,mixedType,1
8,4,0,12,mixedType,1
7,2,0,9,mixedType,1
8,1,0,9,mixedType,1
13,3,0,16,mixedType,2
6,8,1,15,mixedType,2
6,1,0,7,mixedType,0
5,2,0,7,mixedType,0
3,3,0,6,mixedType,0
8,2,0,10,mixedType,1
6,2,0,8,mixedType,1
5,4,0,9,mixedType,1
15,1,1,17,mixedType,2
5,1,0,6,mixedType,0
6,2,0,8,mixedType,1
7,4,0,11,mixedType,1
5,4,0,9,mixedType,1
7,3,0,10,mixedType,1
9,1,0,10,mixedType,1
4,2,0,6,mixedType,0
9,2,0,11,mixedType,1
6,2,0,8,mixedType,1
9,2,0,11,mixedType,1
9,2,0,11,mixedType,1
10,1,0,11,mixedType,1
4,4,0,8,mixedType,1
2,6,0,8,mixedType,1
7,1,0,8,mixedType,1
12,4,0,16,mixedType,2
7,2,0,9,mixedType,1
7,3,0,10,mixedType,1
5,2,0,7,mixedType,0
6,3,0,9,mixedType,1
7,3,0,10,mixedType,1
3,8,0,11,mixedType,1
3,7,0,10,mixedType,1
3,3,0,6,mixedType,0
6,0,4,10,mixedType,1
9,1,0,10,mixedType,1
6,6,0,12,mixedType,1
10,2,0,12,mixedType,1
4,2,0,6,mixedType,0
6,4,0,10,mixedType,1
9,1,0,10,mixedType,1
6,1,0,7,mixedType,0
1,7,0,8,mixedType,1
11,5,0,16,mixedType,2
3,5,0,8,mixedType,1
6,2,0,8,mixedType,1
6,6,0,12,mixedType,1
7,3,0,10,mixedType,1
4,6,0,10,mixedType,1
6,2,0,8,mixedType,1
13,3,0,16,mixedType,2
15,1,0,16,mixedType,2
8,2,0,10,mixedType,1
3,9,0,12,mixedType,1
5,3,0,8,mixedType,1
10,3,0,13,mixedType,1
5,2,0,7,mixedType,0
3,6,0,9,mixedType,1
8,2,0,10,mixedType,1
2,8,0,10,mixedType,1
6,1,0,7,mixedType,0
6,1,0,7,mixedType,0
7,3,0,10,mixedType,1
8,1,0,9,mixedType,1
11,5,0,16,mixedType,2
11,5,0,16,mixedType,2
5,4,0,9,mixedType,1
14,1,0,15,mixedType,2
7,6,0,13,mixedType,1
11,3,0,14,mixedType,2
6,2,0,8,mixedType,1
15,10,0,25,mixedType,2
5,4,0,9,mixedType,1
4,6,0,10,mixedType,1
15,1,0,16,mixedType,2
1,9,0,10,mixedType,1
8,2,0,10,mixedType,1
8,4,0,12,mixedType,1
4,2,0,6,mixedType,0
8,2,0,10,mixedType,1
5,4,0,9,mixedType,1
3,9,0,12,mixedType,1
14,2,0,16,mixedType,2
4,6,0,10,mixedType,1
8,5,1,14,mixedType,2
13,4,1,18,mixedType,2
7,4,0,11,mixedType,1
5,2,0,7,mixedType,0
6,2,0,8,mixedType,1
5,3,0,8,mixedType,1
14,2,0,16,mixedType,2
5,4,0,9,mixedType,1
8,1,0,9,mixedType,1
8,2,0,10,mixedType,1
8,2,0,10,mixedType,1
7,1,0,8,mixedType,1
5,4,0,9,mixedType,1
7,3,0,10,mixedType,1
5,1,0,6,mixedType,0
3,5,0,8,mixedType,1
15,1,0,16,mixedType,2
6,2,0,8,mixedType,1
8,4,0,12,mixedType,1
2,6,0,8,mixedType,1
6,2,0,8,mixedType,1
6,2,0,8,mixedType,1
15,1,0,16,mixedType,2
8,1,0,9,mixedType,1
8,3,0,11,mixedType,1
14,1,0,15,mixedType,2
5,4,0,9,mixedType,1
5,3,0,8,mixedType,1
6,2,0,8,mixedType,1
8,1,0,9,mixedType,1
13,3,0,16,mixedType,2
5,3,0,8,mixedType,1
6,2,0,8,mixedType,1
7,2,0,9,mixedType,1
14,2,0,16,mixedType,2
1,7,0,8,mixedType,1
9,1,0,10,mixedType,1
3,6,0,9,mixedType,1
13,3,0,16,mixedType,2
7,4,0,11,mixedType,1
9,2,0,11,mixedType,1
5,4,0,9,mixedType,1
5,5,0,10,mixedType,1
5,2,0,7,mixedType,0
6,3,0,9,mixedType,1
8,4,0,12,mixedType,1
7,2,0,9,mixedType,1
9,1,0,10,mixedType,1
5,4,0,9,mixedType,1
8,1,0,9,mixedType,1
7,2,0,9,mixedType,1
4,4,0,8,mixedType,1
8,4,0,12,mixedType,1
9,4,0,13,mixedType,1
14,2,0,16,mixedType,2
8,6,0,14,mixedType,2
6,1,0,7,mixedType,0
5,1,0,6,mixedType,0
8,4,3,15,mixedType,2
6,4,0,10,mixedType,1
7,2,0,9,mixedType,1
6,4,0,10,mixedType,1
4,6,0,10,mixedType,1
5,4,0,9,mixedType,1
15,1,0,16,mixedType,2
7,2,0,9,mixedType,1
7,4,0,11,mixedType,1
5,3,0,8,mixedType,1
6,6,0,12,mixedType,1
5,3,0,8,mixedType,1
7,1,0,8,mixedType,1
12,4,0,16,mixedType,2
8,4,0,12,mixedType,1
7,3,0,10,mixedType,1
3,3,0,6,mixedType,0
5,3,0,8,mixedType,1
6,3,0,9,mixedType,1
8,2,0,10,mixedType,1
7,3,0,10,mixedType,1
5,2,0,7,mixedType,0
1,7,0,8,mixedType,1
3,6,0,9,mixedType,1
8,1,0,9,mixedType,1
7,3,0,10,mixedType,1
5,2,0,7,mixedType,0
9,1,0,10,mixedType,1
5,3,0,8,mixedType,1
7,4,0,11,mixedType,1
5,1,0,6,mixedType,0
5,3,0,8,mixedType,1
15,1,0,16,mixedType,2
2,4,0,6,mixedType,0
5,3,0,8,mixedType,1
9,1,0,10,mixedType,1
7,3,0,10,mixedType,1
13,3,0,16,mixedType,2
5,4,0,9,mixedType,1
9,1,0,10,mixedType,1
8,4,0,12,mixedType,1
2,8,0,10,mixedType,1
14,2,0,16,mixedType,2
7,2,0,9,mixedType,1
9,1,0,10,mixedType,1
7,3,0,10,mixedType,1
6,3,0,9,mixedType,1
7,2,0,9,mixedType,1
6,3,0,9,mixedType,1
10,2,0,12,mixedType,1
5,4,0,9,mixedType,1
8,2,0,10,mixedType,1
6,1,0,7,mixedType,0
7,3,0,10,mixedType,1
6,1,0,7,mixedType,0
9,1,0,10,mixedType,1
7,1,0,8,mixedType,1
2,6,0,8,mixedType,1
7,2,0,9,mixedType,1
4,4,0,8,mixedType,1
7,3,0,10,mixedType,1
6,3,0,9,mixedType,1
11,3,0,14,mixedType,2
5,1,0,6,mixedType,0
6,4,0,10,mixedType,1
16,3,2,21,mixedType,2
8,1,0,9,mixedType,1
4,6,0,10,mixedType,1
7,3,0,10,mixedType,1
14,2,0,16,mixedType,2
19,3,2,24,mixedType,2
6,4,0,10,mixedType,1
5,3,0,8,mixedType,1
3,6,0,9,mixedType,1
8,8,0,16,mixedType,2
6,6,0,12,mixedType,1
5,4,0,9,mixedType,1
6,2,0,8,mixedType,1
7,2,0,9,mixedType,1
7,3,0,10,mixedType,1
7,3,0,10,mixedType,1
9,2,0,11,mixedType,1
1,7,0,8,mixedType,1
4,4,0,8,mixedType,1
18,1,1,20,mixedType,2
7,3,0,10,mixedType,1
8,4,0,12,mixedType,1
7,3,0,10,mixedType,1
7,1,0,8,mixedType,1
7,3,0,10,mixedType,1
5,2,0,7,mixedType,0
6,3,0,9,mixedType,1
7,6,0,13,mixedType,1
6,1,0,7,mixedType,0
6,2,0,8,mixedType,1
7,2,0,9,mixedType,1
9,4,0,13,mixedType,1
11,0,1,12,mixedType,1
7,3,0,10,mixedType,1
6,1,0,7,mixedType,0
5,4,0,9,mixedType,1
6,1,0,7,mixedType,0
11,2,0,13,mixedType,1
5,3,0,8,mixedType,1
11,2,0,13,mixedType,1
15,1,0,16,mixedType,2
9,2,0,11,mixedType,1
1,9,0,10,mixedType,1
2,6,0,8,mixedType,1
8,2,0,10,mixedType,1
6,2,0,8,mixedType,1
7,1,0,8,mixedType,1
8,1,0,9,mixedType,1
2,8,0,10,mixedType,1
7,2,0,9,mixedType,1
7,3,0,10,mixedType,1
6,3,0,9,mixedType,1
5,2,0,7,mixedType,0
6,3,0,9,mixedType,1
6,3,0,9,mixedType,1
3,7,0,10,mixedType,1
9,1,0,10,mixedType,1
3,7,0,10,mixedType,1
6,1,0,7,mixedType,0
6,2,0,8,mixedType,1
6,3,0,9,mixedType,1
1,8,0,9,mixedType,1
9,1,0,10,mixedType,1
5,4,0,9,mixedType,1
6,4,0,10,mixedType,1
5,3,0,8,mixedType,1
5,4,0,9,mixedType,1
5,2,0,7,mixedType,0
2,12,0,14,mixedType,2
6,2,0,8,mixedType,1
6,4,0,10,mixedType,1
7,1,0,8,mixedType,1
5,4,0,9,mixedType,1
6,2,0,8,mixedType,1
7,2,0,9,mixedType,1
7,1,0,8,mixedType,1
12,3,1,16,mixedType,2
7,2,0,9,mixedType,1
2,6,0,8,mixedType,1
5,2,0,7,mixedType,0
6,1,0,7,mixedType,0
6,1,0,7,mixedType,0
5,2,0,7,mixedType,0
3,6,0,9,mixedType,1
6,4,0,10,mixedType,1
7,1,0,8,mixedType,1
8,1,0,9,mixedType,1
5,1,0,6,mixedType,0
6,1,0,7,mixedType,0
8,2,0,10,mixedType,1
15,1,0,16,mixedType,2
4,6,0,10,mixedType,1
9,5,0,14,mixedType,2
4,2,0,6,mixedType,0
8,3,0,11,mixedType,1
14,2,1,17,mixedType,2
9,2,0,11,mixedType,1
7,3,0,10,mixedType,1
7,2,0,9,mixedType,1
5,4,0,9,mixedType,1
6,1,0,7,mixedType,0
7,2,0,9,mixedType,1
4,8,0,12,mixedType,1
6,1,0,7,mixedType,0
11,5,0,16,mixedType,2
4,2,0,6,mixedType,0
9,1,0,10,mixedType,1
7,3,0,10,mixedType,1
7,3,0,10,mixedType,1
6,1,0,7,mixedType,0
7,4,0,11,mixedType,1
9,3,0,12,mixedType,1
4,2,0,6,mixedType,0
8,2,0,10,mixedType,1
5,4,0,9,mixedType,1
6,2,0,8,mixedType,1
1,8,0,9,mixedType,1
8,2,0,10,mixedType,1
7,3,0,10,mixedType,1
7,2,0,9,mixedType,1
10,2,0,12,mixedType,1
7,3,0,10,mixedType,1
9,1,0,10,mixedType,1
9,1,0,10,mixedType,1
7,5,0,12,mixedType,1
6,6,0,12,mixedType,1
8,3,0,11,mixedType,1
5,4,0,9,mixedType,1
4,2,0,6,mixedType,0
2,8,0,10,mixedType,1
4,2,0,6,mixedType,0
5,3,0,8,mixedType,1
11,3,0,14,mixedType,2
9,1,0,10,mixedType,1
2,7,0,9,mixedType,1
8,1,0,9,mixedType,1
8,1,0,9,mixedType,1
9,2,0,11,mixedType,1
7,2,0,9,mixedType,1
6,4,0,10,mixedType,1
8,3,0,11,mixedType,1
5,1,0,6,mixedType,0
6,2,0,8,mixedType,1
5,5,0,10,mixedType,1
7,3,0,10,mixedType,1
5,6,0,11,mixedType,1
7,1,0,8,mixedType,1
8,2,0,10,mixedType,1
3,3,0,6,mixedType,0
1,7,0,8,mixedType,1
5,4,0,9,mixedType,1
7,2,0,9,mixedType,1
6,2,0,8,mixedType,1
8,2,0,10,mixedType,1
6,3,0,9,mixedType,1
6,3,0,9,mixedType,1
8,2,0,10,mixedType,1
8,3,0,11,mixedType,1
6,2,0,8,mixedType,1
13,3,0,16,mixedType,2
14,2,0,16,mixedType,2
8,6,3,17,mixedType,2
7,5,0,12,mixedType,1
8,1,0,9,mixedType,1
5,3,0,8,mixedType,1
14,2,1,17,mixedType,2
14,2,0,16,mixedType,2
7,3,0,10,mixedType,1
5,3,0,8,mixedType,1
7,3,0,10,mixedType,1
6,4,0,10,mixedType,1
11,3,0,14,mixedType,2
9,1,0,10,mixedType,1
5,3,0,8,mixedType,1
7,1,0,8,mixedType,1
7,3,0,10,mixedType,1
3,3,0,6,mixedType,0
7,1,0,8,mixedType,1
6,3,0,9,mixedType,1
7,1,0,8,mixedType,1
6,2,0,8,mixedType,1
7,3,0,10,mixedType,1
3,6,0,9,mixedType,1
4,2,0,6,mixedType,0
6,0,1,7,mixedType,0
5,3,0,8,mixedType,1
5,3,0,8,mixedType,1
12,4,0,16,mixedType,2
7,1,0,8,mixedType,1
1,8,0,9,mixedType,1
6,3,0,9,mixedType,1
14,2,0,16,mixedType,2
8,1,0,9,mixedType,1
7,4,0,11,mixedType,1
4,4,0,8,mixedType,1
9,4,0,13,mixedType,1
6,2,0,8,mixedType,1
6,1,0,7,mixedType,0
9,1,0,10,mixedType,1
8,2,0,10,mixedType,1
5,4,0,9,mixedType,1
10,1,0,11,mixedType,1
7,2,0,9,mixedType,1
3,6,0,9,mixedType,1
5,3,0,8,mixedType,1
5,2,0,7,mixedType,0
6,1,0,7,mixedType,0
8,1,0,9,mixedType,1
2,10,0,12,mixedType,1
10,1,0,11,mixedType,1
6,4,0,10,mixedType,1
8,2,0,10,mixedType,1
7,3,0,10,mixedType,1
6,2,0,8,mixedType,1
7,5,0,12,mixedType,1
6,3,0,9,mixedType,1
4,2,0,6,mixedType,0
13,3,0,16,mixedType,2
5,2,0,7,mixedType,0
9,1,0,10,mixedType,1
6,3,0,9,mixedType,1
6,3,0,9,mixedType,1
19,1,1,21,mixedType,2
6,4,0,10,mixedType,1
4,2,0,6,mixedType,0
5,4,0,9,mixedType,1
6,2,0,8,mixedType,1
14,2,0,16,mixedType,2
8,3,0,11,mixedType,1
5,4,0,9,mixedType,1
3,3,0,6,mixedType,0
7,4,0,11,mixedType,1
12,3,0,15,mixedType,2
11,3,0,14,mixedType,2
6,2,0,8,mixedType,1
1,7,0,8,mixedType,1
13,3,0,16,mixedType,2
4,4,0,8,mixedType,1
9,1,0,10,mixedType,1
5,3,0,8,mixedType,1
5,3,0,8,mixedType,1
7,3,0,10,mixedType,1
7,3,0,10,mixedType,1
8,2,0,10,mixedType,1
5,2,0,7,mixedType,0
6,3,0,9,mixedType,1
7,2,0,9,mixedType,1
5,2,0,7,mixedType,0
3,9,0,12,mixedType,1
3,5,0,8,mixedType,1
14,2,0,16,mixedType,2
7,2,0,9,mixedType,1
7,4,0,11,mixedType,1
7,1,0,8,mixedType,1
5,2,0,7,mixedType,0
13,3,0,16,mixedType,2
3,6,0,9,mixedType,1
6,3,0,9,mixedType,1
4,2,0,6,mixedType,0
7,1,0,8,mixedType,1
5,1,0,6,mixedType,0
4,2,0,6,mixedType,0
0,8,1,9,mixedType,1
7,2,0,9,mixedType,1
2,10,0,12,mixedType,1
9,4,0,13,mixedType,1
6,2,0,8,mixedType,1
6,3,0,9,mixedType,1
8,2,0,10,mixedType,1
2,9,0,11,mixedType,1
6,3,0,9,mixedType,1
8,2,0,10,mixedType,1
2,4,0,6,mixedType,0
9,1,0,10,mixedType,1
3,6,0,9,mixedType,1
8,2,0,10,mixedType,1
7,3,0,10,mixedType,1
11,3,0,14,mixedType,2
8,3,0,11,mixedType,1
6,3,0,9,mixedType,1
6,1,0,7,mixedType,0
7,3,0,10,mixedType,1
6,1,0,7,mixedType,0
8,2,0,10,mixedType,1
5,3,0,8,mixedType,1
1,5,0,6,mixedType,0
2,8,0,10,mixedType,1
5,2,0,7,mixedType,0
8,4,0,12,mixedType,1
6,1,0,7,mixedType,0
9,1,0,10,mixedType,1
1,8,0,9,mixedType,1
6,2,0,8,mixedType,1
7,3,0,10,mixedType,1
7,1,0,8,mixedType,1
11,3,0,14,mixedType,2
7,4,0,11,mixedType,1
5,3,0,8,mixedType,1
8,2,0,10,mixedType,1
5,2,0,7,mixedType,0
6,3,0,9,mixedType,1
8,1,0,9,mixedType,1
6,3,0,9,mixedType,1
8,2,0,10,mixedType,1
9,1,0,10,mixedType,1
12,3,0,15,mixedType,2
5,3,0,8,mixedType,1
5,2,0,7,mixedType,0
6,2,0,8,mixedType,1
7,4,0,11,mixedType,1
6,3,0,9,mixedType,1
9,4,0,13,mixedType,1
7,1,0,8,mixedType,1
4,4,0,8,mixedType,1
5,3,0,8,mixedType,1
2,7,0,9,mixedType,1
2,8,0,10,mixedType,1
8,2,0,10,mixedType,1
7,4,0,11,mixedType,1
8,2,0,10,mixedType,1
5,2,0,7,mixedType,0
9,3,0,12,mixedType,1
1,5,0,6,mixedType,0
2,7,0,9,mixedType,1
9,3,0,12,mixedType,1
15,1,0,16,mixedType,2
6,3,0,9,mixedType,1
5,4,0,9,mixedType,1
5,3,0,8,mixedType,1
12,4,0,16,mixedType,2
6,4,0,10,mixedType,1
4,2,0,6,mixedType,0
5,3,0,8,mixedType,1
8,3,0,11,mixedType,1
8,2,0,10,mixedType,1
15,1,0,16,mixedType,2
14,2,0,16,mixedType,2
3,5,0,8,mixedType,1
8,1,0,9,mixedType,1
13,3,0,16,mixedType,2
6,4,0,10,mixedType,1
3,6,0,9,mixedType,1
13,3,0,16,mixedType,2
3,5,0,8,mixedType,1
8,2,0,10,mixedType,1
3,7,0,10,mixedType,1
7,3,0,10,mixedType,1
6,2,0,8,mixedType,1
1,8,0,9,mixedType,1
4,4,0,8,mixedType,1
6,6,0,12,mixedType,1
7,2,0,9,mixedType,1
10,4,0,14,mixedType,2
6,3,0,9,mixedType,1
7,2,0,9,mixedType,1
6,4,0,10,mixedType,1
4,7,0,11,mixedType,1
6,3,0,9,mixedType,1
5,3,0,8,mixedType,1
9,2,0,11,mixedType,1
8,2,0,10,mixedType,1
6,4,0,10,mixedType,1
8,2,0,10,mixedType,1
6,2,0,8,mixedType,1
8,1,0,9,mixedType,1
9,1,0,10,mixedType,1
8,1,0,9,mixedType,1
6,4,0,10,mixedType,1
11,2,0,13,mixedType,1
7,3,0,10,mixedType,1
8,2,0,10,mixedType,1
1,10,0,11,mixedType,1
6,3,0,9,mixedType,1
8,1,0,9,mixedType,1
1,7,0,8,mixedType,1
11,3,0,14,mixedType,2
4,4,0,8,mixedType,1
15,1,0,16,mixedType,2
13,3,0,16,mixedType,2
5,3,0,8,mixedType,1
7,3,0,10,mixedType,1
4,2,0,6,mixedType,0
7,1,0,8,mixedType,1
4,9,0,13,mixedType,1
1,8,0,9,mixedType,1
9,2,0,11,mixedType,1
5,3,0,8,mixedType,1
14,2,0,16,mixedType,2
7,3,0,10,mixedType,1
6,4,0,10,mixedType,1
6,3,0,9,mixedType,1
6,3,0,9,mixedType,1
14,2,0,16,mixedType,2
6,3,0,9,mixedType,1
7,2,0,9,mixedType,1
8,2,0,10,mixedType,1
7,3,0,10,mixedType,1
7,2,0,9,mixedType,1
5,3,0,8,mixedType,1
6,1,0,7,mixedType,0
3,9,0,12,mixedType,1
5,2,0,7,mixedType,0
7,2,0,9,mixedType,1
4,2,0,6,mixedType,0
14,2,0,16,mixedType,2
6,2,0,8,mixedType,1
4,6,0,10,mixedType,1
8,4,0,12,mixedType,1
1,8,0,9,mixedType,1
6,2,0,8,mixedType,1
13,3,0,16,mixedType,2
8,1,0,9,mixedType,1
6,4,0,10,mixedType,1
5,1,0,6,mixedType,0
8,1,0,9,mixedType,1
8,2,0,10,mixedType,1
8,3,0,11,mixedType,1
8,1,0,9,mixedType,1
3,6,0,9,mixedType,1
14,2,0,16,mixedType,2
6,2,0,8,mixedType,1
6,3,0,9,mixedType,1
8,4,0,12,mixedType,1
4,2,0,6,mixedType,0
15,1,0,16,mixedType,2
7,1,0,8,mixedType,1
6,4,0,10,mixedType,1
7,3,0,10,mixedType,1
7,1,0,8,mixedType,1
7,2,0,9,mixedType,1
6,2,0,8,mixedType,1
7,3,0,10,mixedType,1
7,6,0,13,mixedType,1
7,3,0,10,mixedType,1
7,2,0,9,mixedType,1
9,2,0,11,mixedType,1
9,1,0,10,mixedType,1
1,8,0,9,mixedType,1
5,4,0,9,mixedType,1
5,3,0,8,mixedType,1
7,1,0,8,mixedType,1
4,2,0,6,mixedType,0
6,3,0,9,mixedType,1
10,2,0,12,mixedType,1
9,3,0,12,mixedType,1
4,5,0,9,mixedType,1
6,2,0,8,mixedType,1
6,2,0,8,mixedType,1
7,3,0,10,mixedType,1
6,2,0,8,mixedType,1
5,10,0,15,mixedType,2
9,1,0,10,mixedType,1
7,2,0,9,mixedType,1
6,3,0,9,mixedType,1
13,3,0,16,mixedType,2
14,2,0,16,mixedType,2
10,6,0,16,mixedType,2
6,3,0,9,mixedType,1
1,10,0,11,mixedType,1
7,3,0,10,mixedType,1
9,1,0,10,mixedType,1
3,7,0,10,mixedType,1
4,4,0,8,mixedType,1
5,1,0,6,mixedType,0
5,1,0,6,mixedType,0
6,1,0,7,mixedType,0
7,2,0,9,mixedType,1
3,9,0,12,mixedType,1
6,3,0,9,mixedType,1
10,3,0,13,mixedType,1
9,2,0,11,mixedType,1
13,3,0,16,mixedType,2
7,1,0,8,mixedType,1
16,2,0,18,mixedType,2
6,6,0,12,mixedType,1
14,2,0,16,mixedType,2
7,2,0,9,mixedType,1
8,1,0,9,mixedType,1
1,9,0,10,mixedType,1
6,3,0,9,mixedType,1
12,3,0,15,mixedType,2
5,3,0,8,mixedType,1
7,8,0,15,mixedType,2
8,4,0,12,mixedType,1
5,3,0,8,mixedType,1
6,1,0,7,mixedType,0
8,1,0,9,mixedType,1
7,3,0,10,mixedType,1
3,7,0,10,mixedType,1
7,3,0,10,mixedType,1
8,2,0,10,mixedType,1
5,4,0,9,mixedType,1
6,3,0,9,mixedType,1
8,1,0,9,mixedType,1
9,2,0,11,mixedType,1
6,2,0,8,mixedType,1
4,3,0,7,mixedType,0
7,3,0,10,mixedType,1
8,2,0,10,mixedType,1
8,2,0,10,mixedType,1
7,4,0,11,mixedType,1
8,2,0,10,mixedType,1
10,2,0,12,mixedType,1
7,4,0,11,mixedType,1
11,3,0,14,mixedType,2
5,1,0,6,mixedType,0
8,1,0,9,mixedType,1
6,2,0,8,mixedType,1
6,2,0,8,mixedType,1
6,3,0,9,mixedType,1
5,2,0,7,mixedType,0
5,4,0,9,mixedType,1
8,2,0,10,mixedType,1
5,3,0,8,mixedType,1
15,1,0,16,mixedType,2
2,9,0,11,mixedType,1
9,4,0,13,mixedType,1
13,3,0,16,mixedType,2
7,2,0,9,mixedType,1
7,2,0,9,mixedType,1
7,2,0,9,mixedType,1
6,3,0,9,mixedType,1
2,6,0,8,mixedType,1
8,1,0,9,mixedType,1
5,4,0,9,mixedType,1
4,4,0,8,mixedType,1
9,4,0,13,mixedType,1
5,4,0,9,mixedType,1
4,6,0,10,mixedType,1
4,2,0,6,mixedType,0
9,2,0,11,mixedType,1
7,2,0,9,mixedType,1
6,1,0,7,mixedType,0
8,3,0,11,mixedType,1
7,2,0,9,mixedType,1
4,2,0,6,mixedType,0
9,1,0,10,mixedType,1
3,5,0,8,mixedType,1
5,1,0,6,mixedType,0
14,2,0,16,mixedType,2
8,5,0,13,mixedType,1
8,4,0,12,mixedType,1
8,1,0,9,mixedType,1
4,4,0,8,mixedType,1
8,1,0,9,mixedType,1
13,3,0,16,mixedType,2
7,4,0,11,mixedType,1
10,1,0,11,mixedType,1
5,2,0,7,mixedType,0
5,4,0,9,mixedType,1
6,3,0,9,mixedType,1
6,3,0,9,mixedType,1
7,1,0,8,mixedType,1
6,1,0,7,mixedType,0
4,2,0,6,mixedType,0
6,2,0,8,mixedType,1
8,1,0,9,mixedType,1
4,4,0,8,mixedType,1
3,6,0,9,mixedType,1
4,4,0,8,mixedType,1
8,1,0,9,mixedType,1
4,2,0,6,mixedType,0
5,4,0,9,mixedType,1
8,2,0,10,mixedType,1
8,3,0,11,mixedType,1
14,2,0,16,mixedType,2
2,4,0,6,mixedType,0
4,4,0,8,mixedType,1
6,3,0,9,mixedType,1
2,6,0,8,mixedType,1
5,2,0,7,mixedType,0
5,1,0,6,mixedType,0
5,3,0,8,mixedType,1
12,0,3,15,mixedType,2
7,3,0,10,mixedType,1
9,2,0,11,mixedType,1
1,12,0,13,mixedType,1
12,4,0,16,mixedType,2
14,2,0,16,mixedType,2
14,2,0,16,mixedType,2
6,3,0,9,mixedType,1
8,2,0,10,mixedType,1
7,1,0,8,mixedType,1
4,5,0,9,mixedType,1
5,4,0,9,mixedType,1
4,7,0,11,mixedType,1
8,2,0,10,mixedType,1
9,2,0,11,mixedType,1
6,1,0,7,mixedType,0
4,4,0,8,mixedType,1
6,3,0,9,mixedType,1
11,2,0,13,mixedType,1
8,2,0,10,mixedType,1
3,7,0,10,mixedType,1
8,1,0,9,mixedType,1
6,1,0,7,mixedType,0
5,3,0,8,mixedType,1
8,2,0,10,mixedType,1
8,2,0,10,mixedType,1
1,12,0,13,mixedType,1
6,4,0,10,mixedType,1
8,1,0,9,mixedType,1
5,7,0,12,mixedType,1
8,1,0,9,mixedType,1
6,2,0,8,mixedType,1
1,8,0,9,mixedType,1
3,6,0,9,mixedType,1
4,6,0,10,mixedType,1
12,4,0,16,mixedType,2
3,6,0,9,mixedType,1
7,3,0,10,mixedType,1
4,2,0,6,mixedType,0
7,1,0,8,mixedType,1
6,1,0,7,mixedType,0
8,1,0,9,mixedType,1
12,3,0,15,mixedType,2
7,4,0,11,mixedType,1
7,3,0,10,mixedType,1
1,7,0,8,mixedType,1
7,3,0,10,mixedType,1
1,8,0,9,mixedType,1
7,3,0,10,mixedType,1
7,2,0,9,mixedType,1
7,1,0,8,mixedType,1
7,3,0,10,mixedType,1
7,2,0,9,mixedType,1
8,4,0,12,mixedType,1
5,1,0,6,mixedType,0
4,6,0,10,mixedType,1
8,2,0,10,mixedType,1
6,2,0,8,mixedType,1
8,2,0,10,mixedType,1
4,2,0,6,mixedType,0
12,3,0,15,mixedType,2
6,3,0,9,mixedType,1
6,3,0,9,mixedType,1
4,8,0,12,mixedType,1
6,3,0,9,mixedType,1
6,3,0,9,mixedType,1
6,1,0,7,mixedType,0
3,3,0,6,mixedType,0
1,8,0,9,mixedType,1
5,3,0,8,mixedType,1
6,3,0,9,mixedType,1
6,1,0,7,mixedType,0
5,7,0,12,mixedType,1
8,1,0,9,mixedType,1
6,1,0,7,mixedType,0
7,3,0,10,mixedType,1
3,7,0,10,mixedType,1
5,1,0,6,mixedType,0
6,4,0,10,mixedType,1
6,3,0,9,mixedType,1
3,5,0,8,mixedType,1
6,2,0,8,mixedType,1
9,1,0,10,mixedType,1
8,3,0,11,mixedType,1
9,4,0,13,mixedType,1
6,3,0,9,mixedType,1
13,3,0,16,mixedType,2
10,3,0,13,mixedType,1
7,3,0,10,mixedType,1
6,1,0,7,mixedType,0
7,3,0,10,mixedType,1
11,5,0,16,mixedType,2
5,2,0,7,mixedType,0
8,2,0,10,mixedType,1
2,6,0,8,mixedType,1
12,3,0,15,mixedType,2
4,4,0,8,mixedType,1
3,6,0,9,mixedType,1
6,3,0,9,mixedType,1
7,3,0,10,mixedType,1
7,4,0,11,mixedType,1
5,6,0,11,mixedType,1
7,2,0,9,mixedType,1
4,2,0,6,mixedType,0
15,1,0,16,mixedType,2
3,6,0,9,mixedType,1
8,3,0,11,mixedType,1
5,1,0,6,mixedType,0
7,2,0,9,mixedType,1
8,3,0,11,mixedType,1
8,1,0,9,mixedType,1
6,1,0,7,mixedType,0
16,6,0,22,mixedType,2
5,4,0,9,mixedType,1
4,4,0,8,mixedType,1
9,1,0,10,mixedType,1
8,1,0,9,mixedType,1
6,4,0,10,mixedType,1
1,8,0,9,mixedType,1
5,2,0,7,mixedType,0
7,3,0,10,mixedType,1
7,4,0,11,mixedType,1
2,8,0,10,mixedType,1
4,6,0,10,mixedType,1
5,3,0,8,mixedType,1
8,2,0,10,mixedType,1
6,5,0,11,mixedType,1
8,4,0,12,mixedType,1
5,2,0,7,mixedType,0
7,4,0,11,mixedType,1
6,4,0,10,mixedType,1
10,3,0,13,mixedType,1
6,2,0,8,mixedType,1
5,4,0,9,mixedType,1
6,7,0,13,mixedType,1
8,3,0,11,mixedType,1
7,3,0,10,mixedType,1
3,6,0,9,mixedType,1
4,4,0,8,mixedType,1
5,3,0,8,mixedType,1
6,1,0,7,mixedType,0
8,1,0,9,mixedType,1
8,4,0,12,mixedType,1
8,3,0,11,mixedType,1
8,2,0,10,mixedType,1
2,6,0,8,mixedType,1
4,4,0,8,mixedType,1
5,2,0,7,mixedType,0
5,3,0,8,mixedType,1
1,11,0,12,mixedType,1
3,7,0,10,mixedType,1
7,2,0,9,mixedType,1
2,8,0,10,mixedType,1
4,7,0,11,mixedType,1
6,3,0,9,mixedType,1
7,3,0,10,mixedType,1
1,9,0,10,mixedType,1
5,3,0,8,mixedType,1
4,4,0,8,mixedType,1
1,7,0,8,mixedType,1
7,2,0,9,mixedType,1
8,2,0,10,mixedType,1
4,7,0,11,mixedType,1
2,6,0,8,mixedType,1
15,1,0,16,mixedType,2
6,4,0,10,mixedType,1
7,2,0,9,mixedType,1
7,1,0,8,mixedType,1
6,3,0,9,mixedType,1
12,4,0,16,mixedType,2
8,2,0,10,mixedType,1
6,4,0,10,mixedType,1
7,2,0,9,mixedType,1
4,4,0,8,mixedType,1
8,2,0,10,mixedType,1
6,4,0,10,mixedType,1
9,1,0,10,mixedType,1
8,1,0,9,mixedType,1
4,2,0,6,mixedType,0
7,2,0,9,mixedType,1
13,3,0,16,mixedType,2
1,9,0,10,mixedType,1
7,3,0,10,mixedType,1
8,1,0,9,mixedType,1
6,3,0,9,mixedType,1
1,8,0,9,mixedType,1
5,2,0,7,mixedType,0
7,2,0,9,mixedType,1
14,2,0,16,mixedType,2
7,2,0,9,mixedType,1
4,8,0,12,mixedType,1
4,6,0,10,mixedType,1
8,3,0,11,mixedType,1
7,3,0,10,mixedType,1
5,2,0,7,mixedType,0
11,2,0,13,mixedType,1
8,2,0,10,mixedType,1
11,1,0,12,mixedType,1
5,4,0,9,mixedType,1
6,4,0,10,mixedType,1
4,2,0,6,mixedType,0
12,4,0,16,mixedType,2
10,3,0,13,mixedType,1
6,3,0,9,mixedType,1
6,3,0,9,mixedType,1
8,1,0,9,mixedType,1
8,8,0,16,mixedType,2
5,2,0,7,mixedType,0
14,2,0,16,mixedType,2
6,1,0,7,mixedType,0
8,1,0,9,mixedType,1
5,3,0,8,mixedType,1
4,4,0,8,mixedType,1
7,3,0,10,mixedType,1
6,1,0,7,mixedType,0
7,3,0,10,mixedType,1
7,2,0,9,mixedType,1
6,1,0,7,mixedType,0
8,1,0,9,mixedType,1
3,3,0,6,mixedType,0
3,5,0,8,mixedType,1
7,2,0,9,mixedType,1
6,1,0,7,mixedType,0
13,3,0,16,mixedType,2
10,4,0,14,mixedType,2
14,2,0,16,mixedType,2
4,2,0,6,mixedType,0
8,2,0,10,mixedType,1
5,3,0,8,mixedType,1
7,3,0,10,mixedType,1
8,2,0,10,mixedType,1
5,8,0,13,mixedType,1
6,1,0,7,mixedType,0
11,3,0,14,mixedType,2
13,3,0,16,mixedType,2
9,3,0,12,mixedType,1
5,4,0,9,mixedType,1
6,3,0,9,mixedType,1
6,1,0,7,mixedType,0
5,2,0,7,mixedType,0
5,1,0,6,mixedType,0
6,4,0,10,mixedType,1
6,1,0,7,mixedType,0
1,9,0,10,mixedType,1
11,2,0,13,mixedType,1
8,2,0,10,mixedType,1
6,3,0,9,mixedType,1
7,3,0,10,mixedType,1
8,2,0,10,mixedType,1
9,2,0,11,mixedType,1
9,4,1,14,mixedType,2
8,1,0,9,mixedType,1
9,4,0,13,mixedType,1
6,1,0,7,mixedType,0
14,2,0,16,mixedType,2
7,1,0,8,mixedType,1
7,3,0,10,mixedType,1
6,1,0,7,mixedType,0
7,3,0,10,mixedType,1
6,2,0,8,mixedType,1
5,2,0,7,mixedType,0
7,1,0,8,mixedType,1
5,2,0,7,mixedType,0
6,3,0,9,mixedType,1
5,6,0,11,mixedType,1
6,4,0,10,mixedType,1
5,2,0,7,mixedType,0
3,3,0,6,mixedType,0
12,4,0,16,mixedType,2
6,1,0,7,mixedType,0
9,1,0,10,mixedType,1
6,3,0,9,mixedType,1
6,0,3,9,mixedType,1
6,3,0,9,mixedType,1
6,1,0,7,mixedType,0
12,1,0,13,mixedType,1
2,6,0,8,mixedType,1
3,8,0,11,mixedType,1
13,3,0,16,mixedType,2
7,1,0,8,mixedType,1
5,4,0,9,mixedType,1
6,3,0,9,mixedType,1
5,4,0,9,mixedType,1
7,3,0,10,mixedType,1
8,1,0,9,mixedType,1
10,1,0,11,mixedType,1
7,1,0,8,mixedType,1
14,2,0,16,mixedType,2
6,4,0,10,mixedType,1
6,3,0,9,mixedType,1
6,1,0,7,mixedType,0
7,2,0,9,mixedType,1
6,3,0,9,mixedType,1
11,2,0,13,mixedType,1
13,3,0,16,mixedType,2
13,3,0,16,mixedType,2
15,1,0,16,mixedType,2
15,1,0,16,mixedType,2
5,4,0,9,mixedType,1
5,4,0,9,mixedType,1
6,4,0,10,mixedType,1
4,2,0,6,mixedType,0
8,1,0,9,mixedType,1
6,1,0,7,mixedType,0
11,1,0,12,mixedType,1
6,3,0,9,mixedType,1
6,3,0,9,mixedType,1
8,3,0,11,mixedType,1
3,3,0,6,mixedType,0
9,1,0,10,mixedType,1
4,4,0,8,mixedType,1
7,2,0,9,mixedType,1
4,2,0,6,mixedType,0
1,8,0,9,mixedType,1
5,3,0,8,mixedType,1
7,2,0,9,mixedType,1
3,8,0,11,mixedType,1
5,2,0,7,mixedType,0
6,1,0,7,mixedType,0
1,7,0,8,mixedType,1
7,2,0,9,mixedType,1
7,2,0,9,mixedType,1
3,3,0,6,mixedType,0
8,2,0,10,mixedType,1
8,3,0,11,mixedType,1
7,3,0,10,mixedType,1
6,1,0,7,mixedType,0
6,5,0,11,mixedType,1
11,4,0,15,mixedType,2
8,2,0,10,mixedType,1
5,4,0,9,mixedType,1
4,2,0,6,mixedType,0
3,7,0,10,mixedType,1
5,2,0,7,mixedType,0
10,2,0,12,mixedType,1
6,1,0,7,mixedType,0
4,4,0,8,mixedType,1
14,2,0,16,mixedType,2
9,1,0,10,mixedType,1
6,1,0,7,mixedType,0
6,1,0,7,mixedType,0
10,3,0,13,mixedType,1
9,3,0,12,mixedType,1
11,2,0,13,mixedType,1
12,3,0,15,mixedType,2
8,2,0,10,mixedType,1
8,1,0,9,mixedType,1
6,4,0,10,mixedType,1
9,1,0,10,mixedType,1
4,2,0,6,mixedType,0
4,4,0,8,mixedType,1
7,3,0,10,mixedType,1
1,5,0,6,mixedType,0
5,1,0,6,mixedType,0
8,4,0,12,mixedType,1
6,3,0,9,mixedType,1
6,1,0,7,mixedType,0
6,3,0,9,mixedType,1
6,1,0,7,mixedType,0
6,4,0,10,mixedType,1
6,2,0,8,mixedType,1
8,2,0,10,mixedType,1
5,3,0,8,mixedType,1
11,2,0,13,mixedType,1
4,8,0,12,mixedType,1
7,3,0,10,mixedType,1
5,3,0,8,mixedType,1
7,2,0,9,mixedType,1
7,2,0,9,mixedType,1
9,7,0,16,mixedType,2
15,1,0,16,mixedType,2
1,8,0,9,mixedType,1
6,5,0,11,mixedType,1
15,1,0,16,mixedType,2
5,2,0,7,mixedType,0
5,2,0,7,mixedType,0
8,2,0,10,mixedType,1
7,2,0,9,mixedType,1
5,4,0,9,mixedType,1
5,2,0,7,mixedType,0
4,4,0,8,mixedType,1
7,3,0,10,mixedType,1
2,6,0,8,mixedType,1
7,3,0,10,mixedType,1
9,3,0,12,mixedType,1
6,2,0,8,mixedType,1
6,1,0,7,mixedType,0
6,3,0,9,mixedType,1
9,2,0,11,mixedType,1
8,1,0,9,mixedType,1
4,4,0,8,mixedType,1
6,3,0,9,mixedType,1
5,4,0,9,mixedType,1
8,2,0,10,mixedType,1
7,1,0,8,mixedType,1
7,1,0,8,mixedType,1
6,1,0,7,mixedType,0
8,2,0,10,mixedType,1
4,4,0,8,mixedType,1
5,2,0,7,mixedType,0
4,4,0,8,mixedType,1
4,2,0,6,mixedType,0
6,3,0,9,mixedType,1
4,4,0,8,mixedType,1
12,4,0,16,mixedType,2
10,2,0,12,mixedType,1
5,7,0,12,mixedType,1
8,1,0,9,mixedType,1
5,3,0,8,mixedType,1
6,2,0,8,mixedType,1
10,1,0,11,mixedType,1
8,4,0,12,mixedType,1
6,3,0,9,mixedType,1
5,3,0,8,mixedType,1
2,8,0,10,mixedType,1
4,6,0,10,mixedType,1
6,0,1,7,mixedType,0
6,2,0,8,mixedType,1
3,6,0,9,mixedType,1
8,2,0,10,mixedType,1
6,1,0,7,mixedType,0
4,4,0,8,mixedType,1
5,3,0,8,mixedType,1
5,2,0,7,mixedType,0
9,2,0,11,mixedType,1
5,2,0,7,mixedType,0
4,4,0,8,mixedType,1
10,2,0,12,mixedType,1
12,4,0,16,mixedType,2
5,1,0,6,mixedType,0
8,3,0,11,mixedType,1
6,1,0,7,mixedType,0
5,3,0,8,mixedType,1
10,4,2,16,mixedType,2
2,6,0,8,mixedType,1
2,2,0,4,mixedType,0
9,1,0,10,mixedType,1
6,3,0,9,mixedType,1
10,1,0,11,mixedType,1
6,3,0,9,mixedType,1
7,4,0,11,mixedType,1
5,2,0,7,mixedType,0
12,4,0,16,mixedType,2
4,4,0,8,mixedType,1
11,2,0,13,mixedType,1
5,4,0,9,mixedType,1
9,1,0,10,mixedType,1
5,1,0,6,mixedType,0
5,1,0,6,mixedType,0
3,6,0,9,mixedType,1
5,4,0,9,mixedType,1
7,2,0,9,mixedType,1
13,3,0,16,mixedType,2
6,4,0,10,mixedType,1
6,2,0,8,mixedType,1
9,1,0,10,mixedType,1
2,6,0,8,mixedType,1
8,2,0,10,mixedType,1
9,3,0,12,mixedType,1
6,6,0,12,mixedType,1
1,7,0,8,mixedType,1
6,3,0,9,mixedType,1
7,3,0,10,mixedType,1
6,3,0,9,mixedType,1
8,2,0,10,mixedType,1
5,2,0,7,mixedType,0
6,2,0,8,mixedType,1
6,3,0,9,mixedType,1
6,1,0,7,mixedType,0
4,4,0,8,mixedType,1
6,1,0,7,mixedType,0
13,3,0,16,mixedType,2
7,2,0,9,mixedType,1
5,2,0,7,mixedType,0
7,3,0,10,mixedType,1
5,2,0,7,mixedType,0
4,2,0,6,mixedType,0
6,1,0,7,mixedType,0
5,4,0,9,mixedType,1
4,2,0,6,mixedType,0
9,1,0,10,mixedType,1
6,2,0,8,mixedType,1
5,5,0,10,mixedType,1
8,2,0,10,mixedType,1
4,2,0,6,mixedType,0
7,3,0,10,mixedType,1
10,4,0,14,mixedType,2
7,3,0,10,mixedType,1
6,5,0,11,mixedType,1
6,2,0,8,mixedType,1
6,2,0,8,mixedType,1
14,2,0,16,mixedType,2
7,4,0,11,mixedType,1
1,8,0,9,mixedType,1
6,2,0,8,mixedType,1
3,6,0,9,mixedType,1
6,3,0,9,mixedType,1
3,6,0,9,mixedType,1
7,4,0,11,mixedType,1
5,3,0,8,mixedType,1
8,1,0,9,mixedType,1
4,4,0,8,mixedType,1
5,2,0,7,mixedType,0
4,2,0,6,mixedType,0
15,1,0,16,mixedType,2
7,3,0,10,mixedType,1
10,4,0,14,mixedType,2
8,2,0,10,mixedType,1
13,3,0,16,mixedType,2
9,2,0,11,mixedType,1
14,2,0,16,mixedType,2
9,2,0,11,mixedType,1
6,2,0,8,mixedType,1
5,3,0,8,mixedType,1
1,9,0,10,mixedType,1
5,4,0,9,mixedType,1
5,4,0,9,mixedType,1
5,8,0,13,mixedType,1
8,2,0,10,mixedType,1
6,1,0,7,mixedType,0
9,3,0,12,mixedType,1
4,4,0,8,mixedType,1
5,2,0,7,mixedType,0
8,4,0,12,mixedType,1
11,3,0,14,mixedType,2
8,2,0,10,mixedType,1
8,1,0,9,mixedType,1
1,8,0,9,mixedType,1
14,2,0,16,mixedType,2
6,1,0,7,mixedType,0
5,2,0,7,mixedType,0
7,1,0,8,mixedType,1
2,6,0,8,mixedType,1
8,1,0,9,mixedType,1
4,6,0,10,mixedType,1
8,2,0,10,mixedType,1
6,4,0,10,mixedType,1
5,3,0,8,mixedType,1
7,3,0,10,mixedType,1
9,2,0,11,mixedType,1
7,2,0,9,mixedType,1
4,2,0,6,mixedType,0
5,1,0,6,mixedType,0
9,1,0,10,mixedType,1
2,4,0,6,mixedType,0
8,1,0,9,mixedType,1
5,2,0,7,mixedType,0
1,8,0,9,mixedType,1
8,2,0,10,mixedType,1
5,5,0,10,mixedType,1
12,1,0,13,mixedType,1
9,3,0,12,mixedType,1
4,7,0,11,mixedType,1
5,4,0,9,mixedType,1
6,2,0,8,mixedType,1
8,4,0,12,mixedType,1
5,3,0,8,mixedType,1
6,2,0,8,mixedType,1
7,5,0,12,mixedType,1
9,0,1,10,mixedType,1
3,10,0,13,mixedType,1
13,3,0,16,mixedType,2
6,4,0,10,mixedType,1
6,2,0,8,mixedType,1
7,2,0,9,mixedType,1
7,3,0,10,mixedType,1
6,2,0,8,mixedType,1
9,3,0,12,mixedType,1
4,2,0,6,mixedType,0
6,2,0,8,mixedType,1
3,5,0,8,mixedType,1
6,3,0,9,mixedType,1
8,6,2,16,mixedType,2
3,5,0,8,mixedType,1
1,9,0,10,mixedType,1
9,3,0,12,mixedType,1
8,1,0,9,mixedType,1
6,1,0,7,mixedType,0
10,6,0,16,mixedType,2
14,2,0,16,mixedType,2
6,2,0,8,mixedType,1
6,2,0,8,mixedType,1
9,2,0,11,mixedType,1
8,3,0,11,mixedType,1
6,3,0,9,mixedType,1
9,1,0,10,mixedType,1
7,3,0,10,mixedType,1
8,2,0,10,mixedType,1
13,3,0,16,mixedType,2
5,3,0,8,mixedType,1
14,2,0,16,mixedType,2
5,7,0,12,mixedType,1
1,9,0,10,mixedType,1
9,5,0,14,mixedType,2
6,2,0,8,mixedType,1
9,3,0,12,mixedType,1
3,6,0,9,mixedType,1
7,2,0,9,mixedType,1
5,2,0,7,mixedType,0
2,6,0,8,mixedType,1
4,7,0,11,mixedType,1
7,1,0,8,mixedType,1
13,3,0,16,mixedType,2
10,3,0,13,mixedType,1
12,1,1,14,mixedType,2
5,1,0,6,mixedType,0
7,2,0,9,mixedType,1
1,5,0,6,mixedType,0
4,6,0,10,mixedType,1
4,4,0,8,mixedType,1
13,3,0,16,mixedType,2
7,3,0,10,mixedType,1
1,8,0,9,mixedType,1
4,2,0,6,mixedType,0
8,2,0,10,mixedType,1
6,3,0,9,mixedType,1
1,8,0,9,mixedType,1
14,1,0,15,mixedType,2
8,2,0,10,mixedType,1
6,3,0,9,mixedType,1
5,3,0,8,mixedType,1
2,6,0,8,mixedType,1
6,4,0,10,mixedType,1
5,4,0,9,mixedType,1
5,3,0,8,mixedType,1
4,2,0,6,mixedType,0
14,2,0,16,mixedType,2
10,6,0,16,mixedType,2
9,1,0,10,mixedType,1
6,4,0,10,mixedType,1
5,5,0,10,mixedType,1
5,2,0,7,mixedType,0
8,3,0,11,mixedType,1
14,2,0,16,mixedType,2
6,3,0,9,mixedType,1
3,5,0,8,mixedType,1
7,2,0,9,mixedType,1
2,6,0,8,mixedType,1
6,3,0,9,mixedType,1
7,4,0,11,mixedType,1
5,2,0,7,mixedType,0
6,1,0,7,mixedType,0
7,1,0,8,mixedType,1
5,1,0,6,mixedType,0
15,1,0,16,mixedType,2
7,1,0,8,mixedType,1
5,4,0,9,mixedType,1
6,4,0,10,mixedType,1
11,3,0,14,mixedType,2
9,1,0,10,mixedType,1
7,3,0,10,mixedType,1
6,1,0,7,mixedType,0
8,4,2,14,mixedType,2
4,4,0,8,mixedType,1
4,2,0,6,mixedType,0
5,6,0,11,mixedType,1
12,1,0,13,mixedType,1
5,1,0,6,mixedType,0
8,4,0,12,mixedType,1
4,4,0,8,mixedType,1
8,3,0,11,mixedType,1
6,3,0,9,mixedType,1
6,4,0,10,mixedType,1
9,1,0,10,mixedType,1
7,3,0,10,mixedType,1
7,3,0,10,mixedType,1
7,3,0,10,mixedType,1
0,6,1,7,mixedType,0
5,4,0,9,mixedType,1
4,4,0,8,mixedType,1
4,6,0,10,mixedType,1
6,2,0,8,mixedType,1
6,3,0,9,mixedType,1
14,2,0,16,mixedType,2
6,4,0,10,mixedType,1
14,2,0,16,mixedType,2
13,3,0,16,mixedType,2
15,1,0,16,mixedType,2
1,9,0,10,mixedType,1
8,2,0,10,mixedType,1
7,3,0,10,mixedType,1
6,4,0,10,mixedType,1
6,2,0,8,mixedType,1
7,2,0,9,mixedType,1
4,6,0,10,mixedType,1
5,1,0,6,mixedType,0
9,4,0,13,mixedType,1
5,6,0,11,mixedType,1
7,3,0,10,mixedType,1
6,1,0,7,mixedType,0
9,3,0,12,mixedType,1
7,3,0,10,mixedType,1
5,5,0,10,mixedType,1
7,2,0,9,mixedType,1
8,3,0,11,mixedType,1
5,3,0,8,mixedType,1
4,2,0,6,mixedType,0
1,8,0,9,mixedType,1
8,2,0,10,mixedType,1
7,2,0,9,mixedType,1
7,2,0,9,mixedType,1
11,3,0,14,mixedType,2
14,2,0,16,mixedType,2
4,4,0,8,mixedType,1
9,3,0,12,mixedType,1
6,2,0,8,mixedType,1
3,6,0,9,mixedType,1
11,5,0,16,mixedType,2
6,10,1,17,mixedType,2
13,3,0,16,mixedType,2
6,2,0,8,mixedType,1
1,8,0,9,mixedType,1
2,4,0,6,mixedType,0
5,5,0,10,mixedType,1
6,4,0,10,mixedType,1
3,5,0,8,mixedType,1
4,6,0,10,mixedType,1
7,1,0,8,mixedType,1
6,6,0,12,mixedType,1
7,3,0,10,mixedType,1
9,1,0,10,mixedType,1
5,0,2,7,mixedType,0
7,2,0,9,mixedType,1
8,2,0,10,mixedType,1
6,2,0,8,mixedType,1
13,3,0,16,mixedType,2
4,2,0,6,mixedType,0
8,2,0,10,mixedType,1
6,4,0,10,mixedType,1
4,2,0,6,mixedType,0
6,2,0,8,mixedType,1
11,3,0,14,mixedType,2
5,2,0,7,mixedType,0
3,6,0,9,mixedType,1
6,3,0,9,mixedType,1
8,2,0,10,mixedType,1
5,2,0,7,mixedType,0
5,3,0,8,mixedType,1
7,6,0,13,mixedType,1
5,2,0,7,mixedType,0
7,2,0,9,mixedType,1
1,7,0,8,mixedType,1
2,6,0,8,mixedType,1
8,2,0,10,mixedType,1
1,8,0,9,mixedType,1
8,1,0,9,mixedType,1
1,8,0,9,mixedType,1
6,3,0,9,mixedType,1
11,2,0,13,mixedType,1
6,4,0,10,mixedType,1
8,3,0,11,mixedType,1
8,1,0,9,mixedType,1
5,4,0,9,mixedType,1
5,2,0,7,mixedType,0
6,2,0,8,mixedType,1
6,3,0,9,mixedType,1
3,6,0,9,mixedType,1
4,4,0,8,mixedType,1
1,8,0,9,mixedType,1
7,3,0,10,mixedType,1
8,1,0,9,mixedType,1
8,3,0,11,mixedType,1
7,3,0,10,mixedType,1
7,2,0,9,mixedType,1
6,3,0,9,mixedType,1
6,4,0,10,mixedType,1
8,4,0,12,mixedType,1
7,2,0,9,mixedType,1
7,1,0,8,mixedType,1
8,1,0,9,mixedType,1
6,1,0,7,mixedType,0
15,3,2,20,mixedType,2
5,2,0,7,mixedType,0
9,2,0,11,mixedType,1
1,9,0,10,mixedType,1
8,2,0,10,mixedType,1
5,2,0,7,mixedType,0
5,4,0,9,mixedType,1
8,2,0,10,mixedType,1
7,2,0,9,mixedType,1
3,7,0,10,mixedType,1
7,1,0,8,mixedType,1
7,4,0,11,mixedType,1
5,3,0,8,mixedType,1
9,2,0,11,mixedType,1
8,2,0,10,mixedType,1
15,1,0,16,mixedType,2
7,3,0,10,mixedType,1
7,2,0,9,mixedType,1
4,6,0,10,mixedType,1
7,2,0,9,mixedType,1
7,2,0,9,mixedType,1
3,6,0,9,mixedType,1
6,3,0,9,mixedType,1
1,8,0,9,mixedType,1
5,3,0,8,mixedType,1
7,2,0,9,mixedType,1
7,3,0,10,mixedType,1
7,4,0,11,mixedType,1
7,2,0,9,mixedType,1
12,4,0,16,mixedType,2
6,1,0,7,mixedType,0
5,4,0,9,mixedType,1
6,2,0,8,mixedType,1
14,2,0,16,mixedType,2
6,4,0,10,mixedType,1
4,2,0,6,mixedType,0
13,3,0,16,mixedType,2
3,3,0,6,mixedType,0
14,2,0,16,mixedType,2
5,1,0,6,mixedType,0
21,2,0,23,mixedType,2
7,3,0,10,mixedType,1
5,4,0,9,mixedType,1
8,1,0,9,mixedType,1
5,3,0,8,mixedType,1
6,2,0,8,mixedType,1
8,3,0,11,mixedType,1
10,2,0,12,mixedType,1
7,1,0,8,mixedType,1
7,3,0,10,mixedType,1
7,2,0,9,mixedType,1
6,3,0,9,mixedType,1
6,3,0,9,mixedType,1
6,4,0,10,mixedType,1
8,1,0,9,mixedType,1
6,5,0,11,mixedType,1
4,2,0,6,mixedType,0
9,3,0,12,mixedType,1
7,2,0,9,mixedType,1
5,2,0,7,mixedType,0
10,1,0,11,mixedType,1
5,5,0,10,mixedType,1
11,1,0,12,mixedType,1
4,4,0,8,mixedType,1
6,3,0,9,mixedType,1
7,3,0,10,mixedType,1
6,3,0,9,mixedType,1
9,1,0,10,mixedType,1
5,1,0,6,mixedType,0
6,3,0,9,mixedType,1
3,3,0,6,mixedType,0
7,1,0,8,mixedType,1
12,3,0,15,mixedType,2
5,4,0,9,mixedType,1
9,3,0,12,mixedType,1
9,4,0,13,mixedType,1
6,3,0,9,mixedType,1
3,3,0,6,mixedType,0
5,4,0,9,mixedType,1
15,1,0,16,mixedType,2
7,2,0,9,mixedType,1
6,1,0,7,mixedType,0
5,4,0,9,mixedType,1
14,2,0,16,mixedType,2
15,1,0,16,mixedType,2
10,6,1,17,mixedType,2
7,3,0,10,mixedType,1
7,3,0,10,mixedType,1
6,3,0,9,mixedType,1
6,6,0,12,mixedType,1
5,4,0,9,mixedType,1
9,1,0,10,mixedType,1
6,3,0,9,mixedType,1
8,0,1,9,mixedType,1
11,5,0,16,mixedType,2
6,2,0,8,mixedType,1
5,3,0,8,mixedType,1
5,4,0,9,mixedType,1
3,7,0,10,mixedType,1
7,3,0,10,mixedType,1
6,2,0,8,mixedType,1
7,5,0,12,mixedType,1
4,2,0,6,mixedType,0
14,2,0,16,mixedType,2
5,6,0,11,mixedType,1
1,7,0,8,mixedType,1
8,6,0,14,mixedType,2
7,3,0,10,mixedType,1
7,3,0,10,mixedType,1
6,3,0,9,mixedType,1
6,2,0,8,mixedType,1
6,2,0,8,mixedType,1
7,3,0,10,mixedType,1
7,3,0,10,mixedType,1
6,3,0,9,mixedType,1
1,8,0,9,mixedType,1
10,2,0,12,mixedType,1
1,9,0,10,mixedType,1
5,5,0,10,mixedType,1
11,4,0,15,mixedType,2
8,3,0,11,mixedType,1
9,1,0,10,mixedType,1
2,4,0,6,mixedType,0
8,4,0,12,mixedType,1
9,1,0,10,mixedType,1
9,3,0,12,mixedType,1
6,3,0,9,mixedType,1
9,4,0,13,mixedType,1
15,1,0,16,mixedType,2
7,3,0,10,mixedType,1
6,4,0,10,mixedType,1
7,1,0,8,mixedType,1
7,1,0,8,mixedType,1
8,2,0,10,mixedType,1
4,4,0,8,mixedType,1
5,3,0,8,mixedType,1
7,3,0,10,mixedType,1
13,3,0,16,mixedType,2
7,3,0,10,mixedType,1
8,2,0,10,mixedType,1
7,2,0,9,mixedType,1
5,2,0,7,mixedType,0
4,5,0,9,mixedType,1
7,4,0,11,mixedType,1
8,2,0,10,mixedType,1
9,2,0,11,mixedType,1
7,4,0,11,mixedType,1
6,4,0,10,mixedType,1
6,3,0,9,mixedType,1
11,3,0,14,mixedType,2
3,3,0,6,mixedType,0
4,6,0,10,mixedType,1
9,2,0,11,mixedType,1
6,3,0,9,mixedType,1
3,6,0,9,mixedType,1
7,3,0,10,mixedType,1
7,8,0,15,mixedType,2
6,4,0,10,mixedType,1
15,1,0,16,mixedType,2
14,2,0,16,mixedType,2
6,4,0,10,mixedType,1
6,2,0,8,mixedType,1
9,1,0,10,mixedType,1
5,3,0,8,mixedType,1
8,1,0,9,mixedType,1
4,2,0,6,mixedType,0
10,2,0,12,mixedType,1
6,5,0,11,mixedType,1
7,3,0,10,mixedType,1
6,1,0,7,mixedType,0
7,3,0,10,mixedType,1
8,2,0,10,mixedType,1
7,1,0,8,mixedType,1
5,3,0,8,mixedType,1
7,1,0,8,mixedType,1
15,1,0,16,mixedType,2
1,7,0,8,mixedType,1
5,2,0,7,mixedType,0
11,3,0,14,mixedType,2
2,7,0,9,mixedType,1
5,2,0,7,mixedType,0
5,4,0,9,mixedType,1
7,4,0,11,mixedType,1
4,4,0,8,mixedType,1
5,3,0,8,mixedType,1
4,4,0,8,mixedType,1
4,5,0,9,mixedType,1
6,5,0,11,mixedType,1
6,3,0,9,mixedType,1
5,4,0,9,mixedType,1
5,2,0,7,mixedType,0
2,10,0,12,mixedType,1
5,2,0,7,mixedType,0
15,1,0,16,mixedType,2
7,3,0,10,mixedType,1
7,3,0,10,mixedType,1
4,2,0,6,mixedType,0
9,2,0,11,mixedType,1
9,1,0,10,mixedType,1
6,3,0,9,mixedType,1
7,1,0,8,mixedType,1
6,4,0,10,mixedType,1
14,2,0,16,mixedType,2
1,9,0,10,mixedType,1
11,2,1,14,mixedType,2
6,2,0,8,mixedType,1
4,2,0,6,mixedType,0
2,7,0,9,mixedType,1
6,2,0,8,mixedType,1
4,6,0,10,mixedType,1
14,2,0,16,mixedType,2
3,6,0,9,mixedType,1
1,8,0,9,mixedType,1
4,4,0,8,mixedType,1
9,1,0,10,mixedType,1
8,2,0,10,mixedType,1
7,2,0,9,mixedType,1
5,2,0,7,mixedType,0
1,7,0,8,mixedType,1
6,6,0,12,mixedType,1
7,1,0,8,mixedType,1
8,2,0,10,mixedType,1
6,3,0,9,mixedType,1
5,5,0,10,mixedType,1
8,1,0,9,mixedType,1
2,4,0,6,mixedType,0
8,4,0,12,mixedType,1
7,0,1,8,mixedType,1
7,3,0,10,mixedType,1
14,2,0,16,mixedType,2
7,3,0,10,mixedType,1
5,2,0,7,mixedType,0
13,3,0,16,mixedType,2
7,3,0,10,mixedType,1
8,2,0,10,mixedType,1
7,3,0,10,mixedType,1
3,6,0,9,mixedType,1
6,3,0,9,mixedType,1
7,2,0,9,mixedType,1
7,3,0,10,mixedType,1
12,3,0,15,mixedType,2
1,5,0,6,mixedType,0
6,3,0,9,mixedType,1
6,4,0,10,mixedType,1
6,3,0,9,mixedType,1
5,4,0,9,mixedType,1
4,2,0,6,mixedType,0
4,8,0,12,mixedType,1
7,2,0,9,mixedType,1
7,1,0,8,mixedType,1
6,3,0,9,mixedType,1
4,2,0,6,mixedType,0
7,2,0,9,mixedType,1
7,4,0,11,mixedType,1
12,3,0,15,mixedType,2
4,6,0,10,mixedType,1
4,2,0,6,mixedType,0
14,2,0,16,mixedType,2
2,6,0,8,mixedType,1
8,1,0,9,mixedType,1
7,3,0,10,mixedType,1
4,6,0,10,mixedType,1
6,2,0,8,mixedType,1
2,6,0,8,mixedType,1
8,1,0,9,mixedType,1
6,3,0,9,mixedType,1
5,5,0,10,mixedType,1
9,1,0,10,mixedType,1
4,4,0,8,mixedType,1
8,2,0,10,mixedType,1
11,5,0,16,mixedType,2
7,3,0,10,mixedType,1
11,4,0,15,mixedType,2
6,4,0,10,mixedType,1
7,3,0,10,mixedType,1
5,4,0,9,mixedType,1
5,3,0,8,mixedType,1
15,1,0,16,mixedType,2
8,1,0,9,mixedType,1
12,4,0,16,mixedType,2
7,6,0,13,mixedType,1
6,3,0,9,mixedType,1
7,3,0,10,mixedType,1
6,2,0,8,mixedType,1
6,4,0,10,mixedType,1
4,2,0,6,mixedType,0
12,1,0,13,mixedType,1
5,3,0,8,mixedType,1
6,1,0,7,mixedType,0
8,3,0,11,mixedType,1
7,3,0,10,mixedType,1
15,1,0,16,mixedType,2
3,6,0,9,mixedType,1
7,3,0,10,mixedType,1
4,7,0,11,mixedType,1
8,1,0,9,mixedType,1
5,5,0,10,mixedType,1
6,3,0,9,mixedType,1
7,1,0,8,mixedType,1
13,3,0,16,mixedType,2
6,3,0,9,mixedType,1
5,1,0,6,mixedType,0
15,1,0,16,mixedType,2
6,2,0,8,mixedType,1
10,2,0,12,mixedType,1
5,2,0,7,mixedType,0
5,6,0,11,mixedType,1
7,4,0,11,mixedType,1
8,1,0,9,mixedType,1
15,1,0,16,mixedType,2
8,1,0,9,mixedType,1
6,6,0,12,mixedType,1
0,8,1,9,mixedType,1
5,3,0,8,mixedType,1
5,4,0,9,mixedType,1
10,13,7,30,mixedType,2
8,2,0,10,mixedType,1
9,4,0,13,mixedType,1
7,2,0,9,mixedType,1
14,2,0,16,mixedType,2
12,4,0,16,mixedType,2
1,8,0,9,mixedType,1
4,4,0,8,mixedType,1
6,3,0,9,mixedType,1
4,2,0,6,mixedType,0
9,4,0,13,mixedType,1
14,2,0,16,mixedType,2
8,4,0,12,mixedType,1
5,3,0,8,mixedType,1
11,5,0,16,mixedType,2
7,3,0,10,mixedType,1
4,4,0,8,mixedType,1
11,3,0,14,mixedType,2
3,5,0,8,mixedType,1
4,4,0,8,mixedType,1
8,2,0,10,mixedType,1
5,6,0,11,mixedType,1
5,3,0,8,mixedType,1
2,8,0,10,mixedType,1
12,4,0,16,mixedType,2
9,2,0,11,mixedType,1
6,2,0,8,mixedType,1
7,2,0,9,mixedType,1
6,3,0,9,mixedType,1
5,5,0,10,mixedType,1
7,2,0,9,mixedType,1
8,2,0,10,mixedType,1
5,4,0,9,mixedType,1
12,4,0,16,mixedType,2
3,7,0,10,mixedType,1
13,3,0,16,mixedType,2
13,3,0,16,mixedType,2
5,4,0,9,mixedType,1
6,3,0,9,mixedType,1
6,3,0,9,mixedType,1
11,0,1,12,mixedType,1
3,8,0,11,mixedType,1
3,3,0,6,mixedType,0
7,3,0,10,mixedType,1
9,2,0,11,mixedType,1
8,2,0,10,mixedType,1
5,2,0,7,mixedType,0
1,8,0,9,mixedType,1
4,2,0,6,mixedType,0
5,1,0,6,mixedType,0
11,3,0,14,mixedType,2
6,4,0,10,mixedType,1
6,2,0,8,mixedType,1
7,2,0,9,mixedType,1
5,1,0,6,mixedType,0
6,2,0,8,mixedType,1
3,5,0,8,mixedType,1
5,6,0,11,mixedType,1
6,3,0,9,mixedType,1
6,3,0,9,mixedType,1
5,5,0,10,mixedType,1
6,2,0,8,mixedType,1
6,3,0,9,mixedType,1
6,4,0,10,mixedType,1
7,2,0,9,mixedType,1
7,1,0,8,mixedType,1
4,2,0,6,mixedType,0
6,1,0,7,mixedType,0
7,1,0,8,mixedType,1
9,1,0,10,mixedType,1
13,3,0,16,mixedType,2
2,6,0,8,mixedType,1
6,3,0,9,mixedType,1
9,1,0,10,mixedType,1
6,2,0,8,mixedType,1
5,3,0,8,mixedType,1
5,6,0,11,mixedType,1
5,1,0,6,mixedType,0
12,3,0,15,mixedType,2
6,1,0,7,mixedType,0
5,4,0,9,mixedType,1
2,11,0,13,mixedType,1
4,9,0,13,mixedType,1
6,4,0,10,mixedType,1
7,3,0,10,mixedType,1
3,6,0,9,mixedType,1
7,3,0,10,mixedType,1
7,2,0,9,mixedType,1
6,3,0,9,mixedType,1
4,2,0,6,mixedType,0
8,4,0,12,mixedType,1
6,1,0,7,mixedType,0
12,3,0,15,mixedType,2
7,4,0,11,mixedType,1
6,1,0,7,mixedType,0
8,2,0,10,mixedType,1
7,2,0,9,mixedType,1
8,2,0,10,mixedType,1
4,4,0,8,mixedType,1
10,1,0,11,mixedType,1
7,2,0,9,mixedType,1
6,3,0,9,mixedType,1
8,1,0,9,mixedType,1
9,1,0,10,mixedType,1
7,4,0,11,mixedType,1
10,2,0,12,mixedType,1
12,4,0,16,mixedType,2
4,2,0,6,mixedType,0
8,2,0,10,mixedType,1
1,9,0,10,mixedType,1
1,7,0,8,mixedType,1
12,4,0,16,mixedType,2
8,2,0,10,mixedType,1
7,3,0,10,mixedType,1
3,4,0,7,mixedType,0
5,2,0,7,mixedType,0
7,4,0,11,mixedType,1
5,3,0,8,mixedType,1
4,2,0,6,mixedType,0
6,1,0,7,mixedType,0
15,1,0,16,mixedType,2
8,1,0,9,mixedType,1
1,8,0,9,mixedType,1
6,1,0,7,mixedType,0
6,1,0,7,mixedType,0
15,1,0,16,mixedType,2
6,3,0,9,mixedType,1
6,3,0,9,mixedType,1
7,3,0,10,mixedType,1
6,4,0,10,mixedType,1
15,1,0,16,mixedType,2
6,2,0,8,mixedType,1
4,5,0,9,mixedType,1
7,2,0,9,mixedType,1
6,3,0,9,mixedType,1
5,1,0,6,mixedType,0
3,6,0,9,mixedType,1
2,8,0,10,mixedType,1
9,3,0,12,mixedType,1
11,3,0,14,mixedType,2
13,3,0,16,mixedType,2
8,4,0,12,mixedType,1
3,10,0,13,mixedType,1
6,2,0,8,mixedType,1
5,1,0,6,mixedType,0
13,3,0,16,mixedType,2
7,5,0,12,mixedType,1
4,4,0,8,mixedType,1
8,1,0,9,mixedType,1
3,5,0,8,mixedType,1
3,6,0,9,mixedType,1
6,2,0,8,mixedType,1
5,3,0,8,mixedType,1
7,3,0,10,mixedType,1
8,2,0,10,mixedType,1
5,4,0,9,mixedType,1
5,4,0,9,mixedType,1
8,2,0,10,mixedType,1
11,1,0,12,mixedType,1
6,2,0,8,mixedType,1
5,3,0,8,mixedType,1
7,2,0,9,mixedType,1
3,7,0,10,mixedType,1
7,2,0,9,mixedType,1
5,4,0,9,mixedType,1
4,2,0,6,mixedType,0
6,2,0,8,mixedType,1
6,3,0,9,mixedType,1
15,1,0,16,mixedType,2
8,2,0,10,mixedType,1
8,2,0,10,mixedType,1
7,1,0,8,mixedType,1
5,3,0,8,mixedType,1
4,2,0,6,mixedType,0
8,3,0,11,mixedType,1
3,7,0,10,mixedType,1
7,1,0,8,mixedType,1
4,4,0,8,mixedType,1
7,3,0,10,mixedType,1
4,4,0,8,mixedType,1
1,8,0,9,mixedType,1
8,2,0,10,mixedType,1
6,3,0,9,mixedType,1
4,4,0,8,mixedType,1
8,1,0,9,mixedType,1
5,2,0,7,mixedType,0
8,3,0,11,mixedType,1
5,4,0,9,mixedType,1
5,4,0,9,mixedType,1
9,3,0,12,mixedType,1
1,8,0,9,mixedType,1
6,2,0,8,mixedType,1
11,4,0,15,mixedType,2
5,3,0,8,mixedType,1
5,5,0,10,mixedType,1
6,3,0,9,mixedType,1
5,1,0,6,mixedType,0
5,2,0,7,mixedType,0
6,1,0,7,mixedType,0
8,1,0,9,mixedType,1
9,2,0,11,mixedType,1
7,3,0,10,mixedType,1
4,6,0,10,mixedType,1
5,1,0,6,mixedType,0
4,4,0,8,mixedType,1
6,2,0,8,mixedType,1
6,3,0,9,mixedType,1
4,4,0,8,mixedType,1
3,7,0,10,mixedType,1
10,3,0,13,mixedType,1
7,3,0,10,mixedType,1
5,1,0,6,mixedType,0
9,1,0,10,mixedType,1
6,2,0,8,mixedType,1
5,3,0,8,mixedType,1
7,3,0,10,mixedType,1
6,4,0,10,mixedType,1
5,4,0,9,mixedType,1
8,2,0,10,mixedType,1
7,1,0,8,mixedType,1
4,4,0,8,mixedType,1
15,1,0,16,mixedType,2
5,4,0,9,mixedType,1
6,2,0,8,mixedType,1
14,2,0,16,mixedType,2
8,3,0,11,mixedType,1
6,3,0,9,mixedType,1
3,6,0,9,mixedType,1
2,6,0,8,mixedType,1
9,1,0,10,mixedType,1
8,2,0,10,mixedType,1
5,3,0,8,mixedType,1
4,6,0,10,mixedType,1
6,3,0,9,mixedType,1
5,3,0,8,mixedType,1
14,2,0,16,mixedType,2
7,3,0,10,mixedType,1
3,5,0,8,mixedType,1
3,6,0,9,mixedType,1
7,4,0,11,mixedType,1
6,3,0,9,mixedType,1
5,3,0,8,mixedType,1
8,1,0,9,mixedType,1
4,6,0,10,mixedType,1
7,3,0,10,mixedType,1
6,1,0,7,mixedType,0
1,12,0,13,mixedType,1
6,2,0,8,mixedType,1
6,4,0,10,mixedType,1
14,1,0,15,mixedType,2
5,3,0,8,mixedType,1
5,8,0,13,mixedType,1
3,8,0,11,mixedType,1
8,4,0,12,mixedType,1
4,4,0,8,mixedType,1
4,6,0,10,mixedType,1
14,2,0,16,mixedType,2
7,3,0,10,mixedType,1
6,3,0,9,mixedType,1
5,2,0,7,mixedType,0
5,4,0,9,mixedType,1
7,4,0,11,mixedType,1
7,3,0,10,mixedType,1
6,2,0,8,mixedType,1
1,10,0,11,mixedType,1
6,3,0,9,mixedType,1
8,2,0,10,mixedType,1
7,4,0,11,mixedType,1
10,3,0,13,mixedType,1
5,1,0,6,mixedType,0
8,2,0,10,mixedType,1
3,7,0,10,mixedType,1
2,8,0,10,mixedType,1
5,3,0,8,mixedType,1
1,8,0,9,mixedType,1
7,3,0,10,mixedType,1
13,3,0,16,mixedType,2
9,2,0,11,mixedType,1
8,1,0,9,mixedType,1
2,7,0,9,mixedType,1
7,1,0,8,mixedType,1
5,3,0,8,mixedType,1
8,2,0,10,mixedType,1
7,3,0,10,mixedType,1
6,0,1,7,mixedType,0
4,4,0,8,mixedType,1
5,4,0,9,mixedType,1
8,3,0,11,mixedType,1
8,2,0,10,mixedType,1
6,3,0,9,mixedType,1
8,1,0,9,mixedType,1
6,3,0,9,mixedType,1
14,2,0,16,mixedType,2
11,5,0,16,mixedType,2
7,3,0,10,mixedType,1
8,4,0,12,mixedType,1
4,4,0,8,mixedType,1
4,4,0,8,mixedType,1
5,2,0,7,mixedType,0
2,8,0,10,mixedType,1
1,10,0,11,mixedType,1
7,3,0,10,mixedType,1
7,3,0,10,mixedType,1
7,4,0,11,mixedType,1
3,6,0,9,mixedType,1
6,1,0,7,mixedType,0
6,1,0,7,mixedType,0
9,3,0,12,mixedType,1
9,1,0,10,mixedType,1
5,3,0,8,mixedType,1
8,1,0,9,mixedType,1
13,3,0,16,mixedType,2
4,4,0,8,mixedType,1
11,2,0,13,mixedType,1
11,1,0,12,mixedType,1
3,7,0,10,mixedType,1
6,3,0,9,mixedType,1
7,6,0,13,mixedType,1
9,4,0,13,mixedType,1
4,6,0,10,mixedType,1
7,2,0,9,mixedType,1
8,1,0,9,mixedType,1
5,4,0,9,mixedType,1
6,3,0,9,mixedType,1
14,2,0,16,mixedType,2
6,3,0,9,mixedType,1
8,1,0,9,mixedType,1
5,8,0,13,mixedType,1
3,6,0,9,mixedType,1
6,7,0,13,mixedType,1
7,2,0,9,mixedType,1
14,2,0,16,mixedType,2
6,3,0,9,mixedType,1
7,2,0,9,mixedType,1
6,4,0,10,mixedType,1
7,2,0,9,mixedType,1
4,4,0,8,mixedType,1
8,4,0,12,mixedType,1
6,2,0,8,mixedType,1
4,9,0,13,mixedType,1
6,1,0,7,mixedType,0
7,3,0,10,mixedType,1
3,3,0,6,mixedType,0
12,0,1,13,mixedType,1
7,4,0,11,mixedType,1
5,3,0,8,mixedType,1
3,5,0,8,mixedType,1
6,3,0,9,mixedType,1
6,4,0,10,mixedType,1
4,6,0,10,mixedType,1
10,2,0,12,mixedType,1
13,2,0,15,mixedType,2
5,2,0,7,mixedType,0
4,2,0,6,mixedType,0
2,6,0,8,mixedType,1
5,3,0,8,mixedType,1
6,2,0,8,mixedType,1
11,3,0,14,mixedType,2
12,1,2,15,mixedType,2
3,6,0,9,mixedType,1
9,1,0,10,mixedType,1
6,3,0,9,mixedType,1
5,2,0,7,mixedType,0
5,3,0,8,mixedType,1
6,2,0,8,mixedType,1
2,6,0,8,mixedType,1
6,1,0,7,mixedType,0
9,1,0,10,mixedType,1
6,4,0,10,mixedType,1
5,2,0,7,mixedType,0
6,2,0,8,mixedType,1
6,2,0,8,mixedType,1
12,2,2,16,mixedType,2
5,3,0,8,mixedType,1
5,2,0,7,mixedType,0
8,1,0,9,mixedType,1
5,3,0,8,mixedType,1
6,2,0,8,mixedType,1
12,4,0,16,mixedType,2
6,1,0,7,mixedType,0
7,2,0,9,mixedType,1
4,2,0,6,mixedType,0
7,3,0,10,mixedType,1
12,3,1,16,mixedType,2
5,3,0,8,mixedType,1
6,4,0,10,mixedType,1
6,2,0,8,mixedType,1
7,1,0,8,mixedType,1
7,2,0,9,mixedType,1
7,2,0,9,mixedType,1
8,2,0,10,mixedType,1
12,1,1,14,mixedType,2
2,6,0,8,mixedType,1
9,2,0,11,mixedType,1
5,3,0,8,mixedType,1
7,3,0,10,mixedType,1
8,2,0,10,mixedType,1
5,4,0,9,mixedType,1
9,5,0,14,mixedType,2
4,4,0,8,mixedType,1
10,1,0,11,mixedType,1
8,2,0,10,mixedType,1
7,3,0,10,mixedType,1
8,2,0,10,mixedType,1
8,1,0,9,mixedType,1
7,2,0,9,mixedType,1
9,1,0,10,mixedType,1
6,2,0,8,mixedType,1
6,4,0,10,mixedType,1
8,2,0,10,mixedType,1
3,5,0,8,mixedType,1
8,5,0,13,mixedType,1
7,2,0,9,mixedType,1
5,2,0,7,mixedType,0
12,0,1,13,mixedType,1
4,2,0,6,mixedType,0
10,3,0,13,mixedType,1
7,3,0,10,mixedType,1
8,3,0,11,mixedType,1
1,9,0,10,mixedType,1
14,2,0,16,mixedType,2
7,3,0,10,mixedType,1
8,2,0,10,mixedType,1
6,3,0,9,mixedType,1
2,7,0,9,mixedType,1
6,1,0,7,mixedType,0
4,6,0,10,mixedType,1
5,2,0,7,mixedType,0
8,1,0,9,mixedType,1
7,2,0,9,mixedType,1
8,3,0,11,mixedType,1
11,5,0,16,mixedType,2
8,2,0,10,mixedType,1
6,3,0,9,mixedType,1
5,3,0,8,mixedType,1
9,2,0,11,mixedType,1
7,1,0,8,mixedType,1
6,2,0,8,mixedType,1
8,2,0,10,mixedType,1
6,3,0,9,mixedType,1
1,9,0,10,mixedType,1
2,6,0,8,mixedType,1
14,2,0,16,mixedType,2
4,4,0,8,mixedType,1
6,3,0,9,mixedType,1
7,2,0,9,mixedType,1
4,4,0,8,mixedType,1
6,1,0,7,mixedType,0
5,4,0,9,mixedType,1
11,5,0,16,mixedType,2
0,0,8,8,sameType,0
5,4,0,9,mixedType,1
15,6,0,21,mixedType,2
8,1,0,9,mixedType,1
5,3,0,8,mixedType,1
7,3,0,10,mixedType,1
8,2,0,10,mixedType,1
7,3,0,10,mixedType,1
14,2,0,16,mixedType,2
7,1,0,8,mixedType,1
5,3,0,8,mixedType,1
6,1,0,7,mixedType,0
6,4,0,10,mixedType,1
8,1,0,9,mixedType,1
6,3,0,9,mixedType,1
6,2,0,8,mixedType,1
7,1,0,8,mixedType,1
8,2,0,10,mixedType,1
6,1,0,7,mixedType,0
8,2,0,10,mixedType,1
6,3,0,9,mixedType,1
4,2,0,6,mixedType,0
4,7,0,11,mixedType,1
5,4,0,9,mixedType,1
15,1,0,16,mixedType,2
4,7,0,11,mixedType,1
7,1,0,8,mixedType,1
8,4,0,12,mixedType,1
9,4,0,13,mixedType,1
6,3,0,9,mixedType,1
6,6,0,12,mixedType,1
6,1,0,7,mixedType,0
5,3,0,8,mixedType,1
8,2,0,10,mixedType,1
6,3,0,9,mixedType,1
9,2,0,11,mixedType,1
6,6,3,15,mixedType,2
5,3,0,8,mixedType,1
13,3,0,16,mixedType,2
8,2,0,10,mixedType,1
13,3,0,16,mixedType,2
5,3,0,8,mixedType,1
5,2,0,7,mixedType,0
6,2,0,8,mixedType,1
7,4,0,11,mixedType,1
8,2,0,10,mixedType,1
7,1,0,8,mixedType,1
6,4,0,10,mixedType,1
9,1,0,10,mixedType,1
6,2,0,8,mixedType,1
1,12,0,13,mixedType,1
3,6,0,9,mixedType,1
5,2,0,7,mixedType,0
3,6,0,9,mixedType,1
5,2,0,7,mixedType,0
3,8,0,11,mixedType,1
7,2,0,9,mixedType,1
6,1,0,7,mixedType,0
12,4,0,16,mixedType,2
1,8,0,9,mixedType,1
7,3,0,10,mixedType,1
7,1,0,8,mixedType,1
7,2,0,9,mixedType,1
8,4,0,12,mixedType,1
6,3,0,9,mixedType,1
7,1,0,8,mixedType,1
7,1,0,8,mixedType,1
0,8,3,11,mixedType,1
5,6,0,11,mixedType,1
5,6,0,11,mixedType,1
7,2,0,9,mixedType,1
8,1,0,9,mixedType,1
8,2,0,10,mixedType,1
6,1,0,7,mixedType,0
6,6,0,12,mixedType,1
8,1,0,9,mixedType,1
14,2,0,16,mixedType,2
4,5,0,9,mixedType,1
6,3,0,9,mixedType,1
5,3,0,8,mixedType,1
8,2,0,10,mixedType,1
7,3,0,10,mixedType,1
6,4,0,10,mixedType,1
7,1,0,8,mixedType,1
8,4,0,12,mixedType,1
6,4,0,10,mixedType,1
4,2,0,6,mixedType,0
10,4,0,14,mixedType,2
6,1,0,7,mixedType,0
2,6,0,8,mixedType,1
6,4,0,10,mixedType,1
7,3,0,10,mixedType,1
3,6,0,9,mixedType,1
7,2,0,9,mixedType,1
12,3,0,15,mixedType,2
15,1,0,16,mixedType,2
8,2,0,10,mixedType,1
6,3,0,9,mixedType,1
14,2,0,16,mixedType,2
3,5,0,8,mixedType,1
8,1,0,9,mixedType,1
7,1,0,8,mixedType,1
7,3,0,10,mixedType,1
14,2,0,16,mixedType,2
6,3,0,9,mixedType,1
6,2,0,8,mixedType,1
3,9,0,12,mixedType,1
3,6,0,9,mixedType,1
11,1,0,12,mixedType,1
5,3,0,8,mixedType,1
9,2,0,11,mixedType,1
1,9,0,10,mixedType,1
15,1,0,16,mixedType,2
7,3,0,10,mixedType,1
7,4,0,11,mixedType,1
5,7,0,12,mixedType,1
5,2,0,7,mixedType,0
8,1,0,9,mixedType,1
3,5,0,8,mixedType,1
5,4,0,9,mixedType,1
4,9,0,13,mixedType,1
6,4,0,10,mixedType,1
6,1,0,7,mixedType,0
9,2,0,11,mixedType,1
7,2,0,9,mixedType,1
11,4,1,16,mixedType,2
4,4,0,8,mixedType,1
2,4,0,6,mixedType,0
7,1,0,8,mixedType,1
5,2,0,7,mixedType,0
7,2,0,9,mixedType,1
6,3,0,9,mixedType,1
9,1,0,10,mixedType,1
5,2,0,7,mixedType,0
8,3,0,11,mixedType,1
8,2,0,10,mixedType,1
7,3,0,10,mixedType,1
8,3,0,11,mixedType,1
6,1,0,7,mixedType,0
4,2,0,6,mixedType,0
6,4,0,10,mixedType,1
5,4,0,9,mixedType,1
6,2,0,8,mixedType,1
11,2,0,13,mixedType,1
2,8,0,10,mixedType,1
6,1,0,7,mixedType,0
13,3,0,16,mixedType,2
9,1,0,10,mixedType,1
6,2,0,8,mixedType,1
12,5,0,17,mixedType,2
4,4,0,8,mixedType,1
5,3,0,8,mixedType,1
8,2,0,10,mixedType,1
5,2,0,7,mixedType,0
6,2,0,8,mixedType,1
8,2,0,10,mixedType,1
1,8,0,9,mixedType,1
7,1,0,8,mixedType,1
3,6,0,9,mixedType,1
6,3,0,9,mixedType,1
7,3,0,10,mixedType,1
4,4,0,8,mixedType,1
7,3,0,10,mixedType,1
6,3,0,9,mixedType,1
9,1,0,10,mixedType,1
5,3,0,8,mixedType,1
7,2,0,9,mixedType,1
15,1,0,16,mixedType,2
5,4,0,9,mixedType,1
6,3,0,9,mixedType,1
5,3,0,8,mixedType,1
5,5,0,10,mixedType,1
3,3,0,6,mixedType,0
5,2,0,7,mixedType,0
6,2,0,8,mixedType,1
5,4,0,9,mixedType,1
3,5,0,8,mixedType,1
2,8,0,10,mixedType,1
5,3,0,8,mixedType,1
11,1,0,12,mixedType,1
8,2,0,10,mixedType,1
5,4,0,9,mixedType,1
4,4,0,8,mixedType,1
8,1,0,9,mixedType,1
6,2,0,8,mixedType,1
5,4,0,9,mixedType,1
5,2,0,7,mixedType,0
14,3,2,19,mixedType,2
7,1,0,8,mixedType,1
7,3,0,10,mixedType,1
6,2,0,8,mixedType,1
11,3,0,14,mixedType,2
1,9,0,10,mixedType,1
2,8,0,10,mixedType,1
14,2,0,16,mixedType,2
6,6,0,12,mixedType,1
8,2,0,10,mixedType,1
6,3,0,9,mixedType,1
5,4,0,9,mixedType,1
7,8,1,16,mixedType,2
5,8,3,16,mixedType,2
5,1,0,6,mixedType,0
5,3,0,8,mixedType,1
6,3,0,9,mixedType,1
5,8,0,13,mixedType,1
3,7,0,10,mixedType,1
9,1,0,10,mixedType,1
6,2,0,8,mixedType,1
4,4,0,8,mixedType,1
5,1,0,6,mixedType,0
3,6,0,9,mixedType,1
2,7,0,9,mixedType,1
11,1,0,12,mixedType,1
9,3,0,12,mixedType,1
7,5,0,12,mixedType,1
15,1,0,16,mixedType,2
5,2,0,7,mixedType,0
7,3,0,10,mixedType,1
2,6,0,8,mixedType,1
4,5,0,9,mixedType,1
6,4,0,10,mixedType,1
6,1,0,7,mixedType,0
8,4,0,12,mixedType,1
10,2,0,12,mixedType,1
3,9,0,12,mixedType,1
5,2,0,7,mixedType,0
13,3,0,16,mixedType,2
14,2,0,16,mixedType,2
4,2,0,6,mixedType,0
6,2,0,8,mixedType,1
6,3,0,9,mixedType,1
15,1,0,16,mixedType,2
3,5,0,8,mixedType,1
8,1,0,9,mixedType,1
6,4,0,10,mixedType,1
8,1,0,9,mixedType,1
3,9,0,12,mixedType,1
5,5,0,10,mixedType,1
6,3,0,9,mixedType,1
13,3,0,16,mixedType,2
9,3,0,12,mixedType,1
6,4,0,10,mixedType,1
5,2,0,7,mixedType,0
9,3,0,12,mixedType,1
10,3,0,13,mixedType,1
6,1,0,7,mixedType,0
6,2,0,8,mixedType,1
7,3,0,10,mixedType,1
3,5,0,8,mixedType,1
5,3,0,8,mixedType,1
4,4,0,8,mixedType,1
5,4,0,9,mixedType,1
8,1,0,9,mixedType,1
8,2,0,10,mixedType,1
7,3,0,10,mixedType,1
10,1,0,11,mixedType,1
5,2,0,7,mixedType,0
6,2,0,8,mixedType,1
11,3,0,14,mixedType,2
6,5,0,11,mixedType,1
8,1,0,9,mixedType,1
8,2,0,10,mixedType,1
6,3,0,9,mixedType,1
4,6,0,10,mixedType,1
6,3,0,9,mixedType,1
9,2,0,11,mixedType,1
4,2,0,6,mixedType,0
7,1,0,8,mixedType,1
6,3,0,9,mixedType,1
5,2,0,7,mixedType,0
6,4,0,10,mixedType,1
5,2,0,7,mixedType,0
5,1,0,6,mixedType,0
3,6,0,9,mixedType,1
7,3,0,10,mixedType,1
4,4,0,8,mixedType,1
14,2,0,16,mixedType,2
7,2,0,9,mixedType,1
7,2,0,9,mixedType,1
8,1,0,9,mixedType,1
11,5,0,16,mixedType,2
9,2,0,11,mixedType,1
8,1,0,9,mixedType,1
7,2,0,9,mixedType,1
10,3,0,13,mixedType,1
6,3,0,9,mixedType,1
2,10,0,12,mixedType,1
6,3,0,9,mixedType,1
5,1,0,6,mixedType,0
6,2,0,8,mixedType,1
7,7,0,14,mixedType,2
6,2,0,8,mixedType,1
10,2,0,12,mixedType,1
5,1,0,6,mixedType,0
5,4,0,9,mixedType,1
3,6,0,9,mixedType,1
6,2,0,8,mixedType,1
17,1,1,19,mixedType,2
6,1,0,7,mixedType,0
6,2,0,8,mixedType,1
6,2,0,8,mixedType,1
8,1,0,9,mixedType,1
14,2,0,16,mixedType,2
8,1,0,9,mixedType,1
2,6,0,8,mixedType,1
7,2,0,9,mixedType,1
7,3,0,10,mixedType,1
8,4,0,12,mixedType,1
7,3,0,10,mixedType,1
8,2,0,10,mixedType,1
3,10,0,13,mixedType,1
5,3,0,8,mixedType,1
7,2,0,9,mixedType,1
11,3,0,14,mixedType,2
5,2,0,7,mixedType,0
13,3,0,16,mixedType,2
6,5,0,11,mixedType,1
10,1,0,11,mixedType,1
6,3,0,9,mixedType,1
7,2,0,9,mixedType,1
9,2,0,11,mixedType,1
7,3,0,10,mixedType,1
6,0,1,7,mixedType,0
5,8,0,13,mixedType,1
4,2,0,6,mixedType,0
6,2,0,8,mixedType,1
6,0,1,7,mixedType,0
2,8,0,10,mixedType,1
4,4,0,8,mixedType,1
7,2,0,9,mixedType,1
6,2,0,8,mixedType,1
4,4,0,8,mixedType,1
5,1,0,6,mixedType,0
8,1,0,9,mixedType,1
5,4,0,9,mixedType,1
6,3,0,9,mixedType,1
3,5,0,8,mixedType,1
14,2,0,16,mixedType,2
8,2,0,10,mixedType,1
5,3,0,8,mixedType,1
7,3,0,10,mixedType,1
6,4,0,10,mixedType,1
5,4,0,9,mixedType,1
5,6,0,11,mixedType,1
8,1,0,9,mixedType,1
6,1,0,7,mixedType,0
6,1,0,7,mixedType,0
12,1,0,13,mixedType,1
9,1,0,10,mixedType,1
5,4,0,9,mixedType,1
5,2,0,7,mixedType,0
7,3,0,10,mixedType,1
4,0,3,7,mixedType,0
6,2,0,8,mixedType,1
6,6,0,12,mixedType,1
5,1,0,6,mixedType,0
3,5,0,8,mixedType,1
8,1,0,9,mixedType,1
3,8,0,11,mixedType,1
8,1,0,9,mixedType,1
9,2,0,11,mixedType,1
7,2,0,9,mixedType,1
7,2,0,9,mixedType,1
4,0,3,7,mixedType,0
5,1,0,6,mixedType,0
4,2,0,6,mixedType,0
7,3,0,10,mixedType,1
9,2,0,11,mixedType,1
9,2,0,11,mixedType,1
2,10,0,12,mixedType,1
7,3,0,10,mixedType,1
10,1,0,11,mixedType,1
1,7,0,8,mixedType,1
6,3,0,9,mixedType,1
5,3,0,8,mixedType,1
4,4,0,8,mixedType,1
9,1,0,10,mixedType,1
6,4,0,10,mixedType,1
8,1,0,9,mixedType,1
9,2,0,11,mixedType,1
6,2,0,8,mixedType,1
8,1,0,9,mixedType,1
6,3,0,9,mixedType,1
14,2,0,16,mixedType,2
14,2,0,16,mixedType,2
6,3,0,9,mixedType,1
7,3,0,10,mixedType,1
1,8,0,9,mixedType,1
6,2,0,8,mixedType,1
6,1,0,7,mixedType,0
5,4,0,9,mixedType,1
9,4,0,13,mixedType,1
7,5,2,14,mixedType,2
8,2,0,10,mixedType,1
3,6,0,9,mixedType,1
5,3,0,8,mixedType,1
6,4,0,10,mixedType,1
10,1,0,11,mixedType,1
7,5,0,12,mixedType,1
6,1,0,7,mixedType,0
7,4,0,11,mixedType,1
14,2,0,16,mixedType,2
4,2,0,6,mixedType,0
5,3,0,8,mixedType,1
5,3,0,8,mixedType,1
6,5,0,11,mixedType,1
8,5,0,13,mixedType,1
8,3,0,11,mixedType,1
4,4,0,8,mixedType,1
6,3,0,9,mixedType,1
8,1,0,9,mixedType,1
4,4,0,8,mixedType,1
1,8,0,9,mixedType,1
8,2,0,10,mixedType,1
15,1,0,16,mixedType,2
12,4,0,16,mixedType,2
7,1,0,8,mixedType,1
3,6,0,9,mixedType,1
8,4,0,12,mixedType,1
13,3,0,16,mixedType,2
13,3,0,16,mixedType,2
8,1,0,9,mixedType,1
6,2,0,8,mixedType,1
6,3,0,9,mixedType,1
1,8,0,9,mixedType,1
14,6,1,21,mixedType,2
7,3,0,10,mixedType,1
14,2,0,16,mixedType,2
7,1,0,8,mixedType,1
14,2,0,16,mixedType,2
9,3,0,12,mixedType,1
5,3,0,8,mixedType,1
4,2,0,6,mixedType,0
10,1,0,11,mixedType,1
4,5,0,9,mixedType,1
14,2,0,16,mixedType,2
13,3,0,16,mixedType,2
6,4,0,10,mixedType,1
9,1,0,10,mixedType,1
5,5,0,10,mixedType,1
4,4,0,8,mixedType,1
4,6,0,10,mixedType,1
6,2,0,8,mixedType,1
5,3,0,8,mixedType,1
7,3,0,10,mixedType,1
14,2,0,16,mixedType,2
9,1,0,10,mixedType,1
9,3,0,12,mixedType,1
4,4,0,8,mixedType,1
7,3,0,10,mixedType,1
8,1,0,9,mixedType,1
4,4,0,8,mixedType,1
7,2,0,9,mixedType,1
8,6,1,15,mixedType,2
6,2,0,8,mixedType,1
6,2,0,8,mixedType,1
6,6,0,12,mixedType,1
6,1,0,7,mixedType,0
14,2,0,16,mixedType,2
7,1,0,8,mixedType,1
5,3,0,8,mixedType,1
11,3,0,14,mixedType,2
10,3,0,13,mixedType,1
6,1,0,7,mixedType,0
6,1,0,7,mixedType,0
6,5,0,11,mixedType,1
4,2,0,6,mixedType,0
8,1,0,9,mixedType,1
8,2,0,10,mixedType,1
7,2,0,9,mixedType,1
1,12,0,13,mixedType,1
12,3,1,16,mixedType,2
7,1,0,8,mixedType,1
8,2,0,10,mixedType,1
6,3,0,9,mixedType,1
5,1,0,6,mixedType,0
12,3,0,15,mixedType,2
5,8,0,13,mixedType,1
9,1,0,10,mixedType,1
6,1,0,7,mixedType,0
7,3,0,10,mixedType,1
4,8,0,12,mixedType,1
12,3,0,15,mixedType,2
8,2,0,10,mixedType,1
3,3,0,6,mixedType,0
7,2,0,9,mixedType,1
7,2,0,9,mixedType,1
9,3,0,12,mixedType,1
13,3,0,16,mixedType,2
5,1,0,6,mixedType,0
2,8,0,10,mixedType,1
6,3,0,9,mixedType,1
7,2,0,9,mixedType,1
5,3,0,8,mixedType,1
6,3,0,9,mixedType,1
7,3,0,10,mixedType,1
11,1,0,12,mixedType,1
8,2,0,10,mixedType,1
5,2,0,7,mixedType,0
3,6,0,9,mixedType,1
8,1,0,9,mixedType,1
4,8,0,12,mixedType,1
6,2,0,8,mixedType,1
12,3,0,15,mixedType,2
6,1,0,7,mixedType,0
7,2,0,9,mixedType,1
6,1,0,7,mixedType,0
5,2,0,7,mixedType,0
5,5,0,10,mixedType,1
7,3,0,10,mixedType,1
6,2,0,8,mixedType,1
11,4,1,16,mixedType,2
3,9,0,12,mixedType,1
10,2,0,12,mixedType,1
10,4,0,14,mixedType,2
13,3,0,16,mixedType,2
5,6,0,11,mixedType,1
7,1,0,8,mixedType,1
7,6,0,13,mixedType,1
6,3,0,9,mixedType,1
4,8,0,12,mixedType,1
12,3,0,15,mixedType,2
7,6,1,14,mixedType,2
6,3,0,9,mixedType,1
5,4,0,9,mixedType,1
13,3,0,16,mixedType,2
3,6,0,9,mixedType,1
10,6,0,16,mixedType,2
5,4,0,9,mixedType,1
1,10,0,11,mixedType,1
13,3,0,16,mixedType,2
6,1,0,7,mixedType,0
3,5,0,8,mixedType,1
13,3,0,16,mixedType,2
9,0,2,11,mixedType,1
5,2,0,7,mixedType,0
7,3,0,10,mixedType,1
8,1,0,9,mixedType,1
1,8,0,9,mixedType,1
5,3,0,8,mixedType,1
4,4,0,8,mixedType,1
8,1,0,9,mixedType,1
6,4,0,10,mixedType,1
7,3,0,10,mixedType,1
10,2,0,12,mixedType,1
4,2,0,6,mixedType,0
6,3,0,9,mixedType,1
5,3,0,8,mixedType,1
15,3,2,20,mixedType,2
4,5,0,9,mixedType,1
6,2,0,8,mixedType,1
9,4,0,13,mixedType,1
5,3,0,8,mixedType,1
6,1,0,7,mixedType,0
8,2,0,10,mixedType,1
6,1,0,7,mixedType,0
7,3,0,10,mixedType,1
4,4,0,8,mixedType,1
3,7,0,10,mixedType,1
7,3,0,10,mixedType,1
9,1,0,10,mixedType,1
9,3,0,12,mixedType,1
13,3,0,16,mixedType,2
8,2,0,10,mixedType,1
6,4,0,10,mixedType,1
5,3,0,8,mixedType,1
5,3,0,8,mixedType,1
5,7,0,12,mixedType,1
12,1,0,13,mixedType,1
9,1,0,10,mixedType,1
6,1,0,7,mixedType,0
7,3,0,10,mixedType,1
7,1,0,8,mixedType,1
12,1,0,13,mixedType,1
14,2,0,16,mixedType,2
9,4,0,13,mixedType,1
9,2,0,11,mixedType,1
5,2,0,7,mixedType,0
7,2,0,9,mixedType,1
9,2,0,11,mixedType,1
2,6,0,8,mixedType,1
5,4,0,9,mixedType,1
5,4,0,9,mixedType,1
12,4,0,16,mixedType,2
6,3,0,9,mixedType,1
5,1,0,6,mixedType,0
4,4,0,8,mixedType,1
7,1,0,8,mixedType,1
5,3,0,8,mixedType,1
6,1,0,7,mixedType,0
9,1,0,10,mixedType,1
6,11,0,17,mixedType,2
14,2,0,16,mixedType,2
6,4,0,10,mixedType,1
8,2,0,10,mixedType,1
7,4,0,11,mixedType,1
6,4,0,10,mixedType,1
7,3,0,10,mixedType,1
8,3,0,11,mixedType,1
8,3,0,11,mixedType,1
7,3,0,10,mixedType,1
6,2,0,8,mixedType,1
3,5,0,8,mixedType,1
6,3,0,9,mixedType,1
8,1,0,9,mixedType,1
3,6,0,9,mixedType,1
6,1,0,7,mixedType,0
8,1,0,9,mixedType,1
6,3,0,9,mixedType,1
6,6,0,12,mixedType,1
14,2,0,16,mixedType,2
5,2,0,7,mixedType,0
7,3,0,10,mixedType,1
8,1,0,9,mixedType,1
11,1,0,12,mixedType,1
6,4,0,10,mixedType,1
4,2,0,6,mixedType,0
12,1,0,13,mixedType,1
7,3,0,10,mixedType,1
5,3,0,8,mixedType,1
6,3,0,9,mixedType,1
3,5,0,8,mixedType,1
5,4,0,9,mixedType,1
6,1,0,7,mixedType,0
6,3,0,9,mixedType,1
9,1,0,10,mixedType,1
7,7,0,14,mixedType,2
6,3,0,9,mixedType,1
14,2,0,16,mixedType,2
5,4,0,9,mixedType,1
5,3,0,8,mixedType,1
5,3,0,8,mixedType,1
5,2,0,7,mixedType,0
7,2,0,9,mixedType,1
9,2,0,11,mixedType,1
5,2,0,7,mixedType,0
11,3,0,14,mixedType,2
13,3,0,16,mixedType,2
8,2,0,10,mixedType,1
11,2,0,13,mixedType,1
5,3,0,8,mixedType,1
7,3,0,10,mixedType,1
10,6,0,16,mixedType,2
6,1,0,7,mixedType,0
1,8,0,9,mixedType,1
14,2,0,16,mixedType,2
4,4,0,8,mixedType,1
6,3,0,9,mixedType,1
14,2,0,16,mixedType,2
6,1,0,7,mixedType,0
7,0,1,8,mixedType,1
9,2,0,11,mixedType,1
6,4,0,10,mixedType,1
8,3,0,11,mixedType,1
5,2,0,7,mixedType,0
7,3,0,10,mixedType,1
5,3,0,8,mixedType,1
8,1,0,9,mixedType,1
8,1,0,9,mixedType,1
7,4,0,11,mixedType,1
7,3,0,10,mixedType,1
6,2,0,8,mixedType,1
8,2,0,10,mixedType,1
9,2,0,11,mixedType,1
9,4,0,13,mixedType,1
7,3,0,10,mixedType,1
7,3,0,10,mixedType,1
5,5,0,10,mixedType,1
10,1,0,11,mixedType,1
7,2,0,9,mixedType,1
8,1,0,9,mixedType,1
15,1,0,16,mixedType,2
12,4,0,16,mixedType,2
5,3,0,8,mixedType,1
6,2,0,8,mixedType,1
3,9,0,12,mixedType,1
4,6,0,10,mixedType,1
3,5,0,8,mixedType,1
2,7,0,9,mixedType,1
6,2,0,8,mixedType,1
3,10,0,13,mixedType,1
4,2,0,6,mixedType,0
5,3,0,8,mixedType,1
7,3,0,10,mixedType,1
5,4,0,9,mixedType,1
4,4,0,8,mixedType,1
12,4,0,16,mixedType,2
6,1,0,7,mixedType,0
6,1,0,7,mixedType,0
6,4,0,10,mixedType,1
8,2,0,10,mixedType,1
13,3,0,16,mixedType,2
9,2,0,11,mixedType,1
5,3,0,8,mixedType,1
19,1,0,20,mixedType,2
4,2,0,6,mixedType,0
7,2,0,9,mixedType,1
5,2,0,7,mixedType,0
8,1,0,9,mixedType,1
6,4,0,10,mixedType,1
7,1,0,8,mixedType,1
5,1,0,6,mixedType,0
7,4,0,11,mixedType,1
14,2,0,16,mixedType,2
6,2,0,8,mixedType,1
14,2,0,16,mixedType,2
12,4,0,16,mixedType,2
4,4,0,8,mixedType,1
10,3,2,15,mixedType,2
9,3,0,12,mixedType,1
5,3,0,8,mixedType,1
9,1,0,10,mixedType,1
7,2,0,9,mixedType,1
4,4,0,8,mixedType,1
6,3,0,9,mixedType,1
2,6,0,8,mixedType,1
8,4,0,12,mixedType,1
8,2,0,10,mixedType,1
4,7,0,11,mixedType,1
9,1,0,10,mixedType,1
6,3,0,9,mixedType,1
8,3,0,11,mixedType,1
7,2,0,9,mixedType,1
6,3,0,9,mixedType,1
9,4,0,13,mixedType,1
7,2,0,9,mixedType,1
5,3,0,8,mixedType,1
5,4,0,9,mixedType,1
5,6,0,11,mixedType,1
8,3,0,11,mixedType,1
5,4,0,9,mixedType,1
6,3,0,9,mixedType,1
11,1,0,12,mixedType,1
6,3,0,9,mixedType,1
6,4,0,10,mixedType,1
7,2,0,9,mixedType,1
7,3,0,10,mixedType,1
5,4,0,9,mixedType,1
8,2,0,10,mixedType,1
8,2,0,10,mixedType,1
8,4,0,12,mixedType,1
8,3,0,11,mixedType,1
6,3,0,9,mixedType,1
11,3,0,14,mixedType,2
4,4,0,8,mixedType,1
7,3,0,10,mixedType,1
13,3,0,16,mixedType,2
4,6,0,10,mixedType,1
6,2,0,8,mixedType,1
4,2,0,6,mixedType,0
1,8,0,9,mixedType,1
7,3,0,10,mixedType,1
6,3,0,9,mixedType,1
6,4,0,10,mixedType,1
5,3,0,8,mixedType,1
7,3,0,10,mixedType,1
7,2,0,9,mixedType,1
5,2,0,7,mixedType,0
6,4,0,10,mixedType,1
7,3,0,10,mixedType,1
8,1,0,9,mixedType,1
5,1,0,6,mixedType,0
6,2,0,8,mixedType,1
11,2,0,13,mixedType,1
8,4,0,12,mixedType,1
9,1,0,10,mixedType,1
3,6,0,9,mixedType,1
7,1,0,8,mixedType,1
7,3,0,10,mixedType,1
10,1,0,11,mixedType,1
15,1,0,16,mixedType,2
6,3,0,9,mixedType,1
4,5,0,9,mixedType,1
5,3,0,8,mixedType,1
6,2,0,8,mixedType,1
9,1,0,10,mixedType,1
4,4,0,8,mixedType,1
6,4,0,10,mixedType,1
12,3,0,15,mixedType,2
0,9,1,10,mixedType,1
2,4,0,6,mixedType,0
11,2,0,13,mixedType,1
7,2,0,9,mixedType,1
4,8,0,12,mixedType,1
7,4,0,11,mixedType,1
7,3,0,10,mixedType,1
15,1,0,16,mixedType,2
8,2,0,10,mixedType,1
8,2,0,10,mixedType,1
6,1,0,7,mixedType,0
7,3,0,10,mixedType,1
7,1,0,8,mixedType,1
8,3,0,11,mixedType,1
5,5,0,10,mixedType,1
3,3,0,6,mixedType,0
9,3,0,12,mixedType,1
2,4,0,6,mixedType,0
14,2,0,16,mixedType,2
9,4,1,14,mixedType,2
6,4,0,10,mixedType,1
6,0,2,8,mixedType,1
13,3,0,16,mixedType,2
7,3,0,10,mixedType,1
6,2,0,8,mixedType,1
8,4,0,12,mixedType,1
6,4,0,10,mixedType,1
13,3,0,16,mixedType,2
8,2,0,10,mixedType,1
8,2,0,10,mixedType,1
8,2,0,10,mixedType,1
10,2,0,12,mixedType,1
6,3,0,9,mixedType,1
9,1,0,10,mixedType,1
6,1,0,7,mixedType,0
14,2,0,16,mixedType,2
7,3,0,10,mixedType,1
5,2,0,7,mixedType,0
7,3,0,10,mixedType,1
6,4,0,10,mixedType,1
12,4,0,16,mixedType,2
0,11,1,12,mixedType,1
4,2,0,6,mixedType,0
7,3,0,10,mixedType,1
7,2,0,9,mixedType,1
6,5,0,11,mixedType,1
4,5,0,9,mixedType,1
10,3,0,13,mixedType,1
6,3,0,9,mixedType,1
12,2,1,15,mixedType,2
4,4,0,8,mixedType,1
7,2,0,9,mixedType,1
8,1,0,9,mixedType,1
9,2,0,11,mixedType,1
6,4,0,10,mixedType,1
5,5,0,10,mixedType,1
12,4,0,16,mixedType,2
5,2,0,7,mixedType,0
6,2,0,8,mixedType,1
8,1,0,9,mixedType,1
3,6,0,9,mixedType,1
2,4,0,6,mixedType,0
2,8,0,10,mixedType,1
5,3,0,8,mixedType,1
13,3,0,16,mixedType,2
9,2,0,11,mixedType,1
6,3,0,9,mixedType,1
7,2,0,9,mixedType,1
7,3,0,10,mixedType,1
9,2,0,11,mixedType,1
7,2,0,9,mixedType,1
6,2,0,8,mixedType,1
3,3,0,6,mixedType,0
8,3,0,11,mixedType,1
7,3,0,10,mixedType,1
15,1,0,16,mixedType,2
8,3,0,11,mixedType,1
6,2,0,8,mixedType,1
14,2,0,16,mixedType,2
8,2,0,10,mixedType,1
7,1,0,8,mixedType,1
6,4,0,10,mixedType,1
5,2,0,7,mixedType,0
9,4,0,13,mixedType,1
4,6,0,10,mixedType,1
14,2,0,16,mixedType,2
5,2,0,7,mixedType,0
14,2,0,16,mixedType,2
5,2,0,7,mixedType,0
6,2,0,8,mixedType,1
6,5,0,11,mixedType,1
7,2,0,9,mixedType,1
5,2,0,7,mixedType,0
5,3,0,8,mixedType,1
14,2,0,16,mixedType,2
6,1,0,7,mixedType,0
6,6,0,12,mixedType,1
6,4,0,10,mixedType,1
3,6,0,9,mixedType,1
7,3,0,10,mixedType,1
9,2,0,11,mixedType,1
4,4,4,12,mixedType,1
5,4,0,9,mixedType,1
8,2,0,10,mixedType,1
6,3,0,9,mixedType,1
6,1,0,7,mixedType,0
14,2,0,16,mixedType,2
6,4,0,10,mixedType,1
7,1,0,8,mixedType,1
2,4,0,6,mixedType,0
5,2,0,7,mixedType,0
4,4,0,8,mixedType,1
6,4,0,10,mixedType,1
6,3,0,9,mixedType,1
4,4,0,8,mixedType,1
14,2,0,16,mixedType,2
6,2,0,8,mixedType,1
10,3,0,13,mixedType,1
7,2,0,9,mixedType,1
5,2,0,7,mixedType,0
10,0,2,12,mixedType,1
5,4,0,9,mixedType,1
2,10,0,12,mixedType,1
7,3,0,10,mixedType,1
6,3,0,9,mixedType,1
6,1,0,7,mixedType,0
9,6,1,16,mixedType,2
6,4,0,10,mixedType,1
5,2,0,7,mixedType,0
2,6,0,8,mixedType,1
8,4,0,12,mixedType,1
11,2,0,13,mixedType,1
8,2,0,10,mixedType,1
5,6,0,11,mixedType,1
15,1,0,16,mixedType,2
7,3,0,10,mixedType,1
4,4,0,8,mixedType,1
7,7,0,14,mixedType,2
12,4,0,16,mixedType,2
12,4,0,16,mixedType,2
8,2,0,10,mixedType,1
3,5,0,8,mixedType,1
13,3,0,16,mixedType,2
6,3,0,9,mixedType,1
7,2,0,9,mixedType,1
14,2,0,16,mixedType,2
5,2,0,7,mixedType,0
14,2,0,16,mixedType,2
2,10,0,12,mixedType,1
1,8,0,9,mixedType,1
14,2,0,16,mixedType,2
5,6,0,11,mixedType,1
13,3,0,16,mixedType,2
7,1,0,8,mixedType,1
7,2,0,9,mixedType,1
6,2,0,8,mixedType,1
3,6,0,9,mixedType,1
6,4,0,10,mixedType,1
8,1,0,9,mixedType,1
2,6,0,8,mixedType,1
6,4,0,10,mixedType,1
8,2,0,10,mixedType,1
6,4,0,10,mixedType,1
7,2,0,9,mixedType,1
7,4,0,11,mixedType,1
5,4,0,9,mixedType,1
5,4,0,9,mixedType,1
6,4,0,10,mixedType,1
7,8,0,15,mixedType,2
6,3,0,9,mixedType,1
5,2,0,7,mixedType,0
5,4,0,9,mixedType,1
7,3,0,10,mixedType,1
5,7,0,12,mixedType,1
7,3,0,10,mixedType,1
5,3,0,8,mixedType,1
8,4,0,12,mixedType,1
4,4,0,8,mixedType,1
9,2,0,11,mixedType,1
9,0,1,10,mixedType,1
5,3,0,8,mixedType,1
8,3,0,11,mixedType,1
7,4,0,11,mixedType,1
5,2,0,7,mixedType,0
13,3,0,16,mixedType,2
1,7,0,8,mixedType,1
6,3,0,9,mixedType,1
6,1,0,7,mixedType,0
7,1,0,8,mixedType,1
6,2,0,8,mixedType,1
4,2,0,6,mixedType,0
6,1,0,7,mixedType,0
5,11,0,16,mixedType,2
7,3,0,10,mixedType,1
9,3,0,12,mixedType,1
6,6,0,12,mixedType,1
6,2,0,8,mixedType,1
7,3,0,10,mixedType,1
7,2,0,9,mixedType,1
7,4,0,11,mixedType,1
6,9,0,15,mixedType,2
8,2,0,10,mixedType,1
8,1,0,9,mixedType,1
5,3,0,8,mixedType,1
8,2,0,10,mixedType,1
7,2,0,9,mixedType,1
6,4,0,10,mixedType,1
4,2,0,6,mixedType,0
6,3,0,9,mixedType,1
6,2,0,8,mixedType,1
5,1,0,6,mixedType,0
6,4,0,10,mixedType,1
3,6,0,9,mixedType,1
4,2,0,6,mixedType,0
7,2,0,9,mixedType,1
14,2,0,16,mixedType,2
7,1,0,8,mixedType,1
4,8,0,12,mixedType,1
11,7,0,18,mixedType,2
1,10,0,11,mixedType,1
3,5,0,8,mixedType,1
1,8,0,9,mixedType,1
5,1,0,6,mixedType,0
6,4,0,10,mixedType,1
5,2,0,7,mixedType,0
5,3,0,8,mixedType,1
4,4,0,8,mixedType,1
7,3,0,10,mixedType,1
2,7,0,9,mixedType,1
2,7,0,9,mixedType,1
9,2,0,11,mixedType,1
7,2,0,9,mixedType,1
3,6,0,9,mixedType,1
6,3,0,9,mixedType,1
6,4,0,10,mixedType,1
6,4,0,10,mixedType,1
6,4,0,10,mixedType,1
9,1,0,10,mixedType,1
3,3,0,6,mixedType,0
9,2,0,11,mixedType,1
8,3,0,11,mixedType,1
9,4,0,13,mixedType,1
5,2,0,7,mixedType,0
7,4,0,11,mixedType,1
3,9,0,12,mixedType,1
6,1,0,7,mixedType,0
6,3,0,9,mixedType,1
1,8,0,9,mixedType,1
5,2,0,7,mixedType,0
3,3,0,6,mixedType,0
10,4,0,14,mixedType,2
4,2,0,6,mixedType,0
8,3,0,11,mixedType,1
7,4,0,11,mixedType,1
2,6,0,8,mixedType,1
10,3,0,13,mixedType,1
2,4,0,6,mixedType,0
6,4,0,10,mixedType,1
10,1,0,11,mixedType,1
5,5,0,10,mixedType,1
2,10,0,12,mixedType,1
7,4,0,11,mixedType,1
6,3,0,9,mixedType,1
9,3,0,12,mixedType,1
7,3,0,10,mixedType,1
15,1,0,16,mixedType,2
8,3,0,11,mixedType,1
6,2,0,8,mixedType,1
1,8,0,9,mixedType,1
8,3,0,11,mixedType,1
6,3,0,9,mixedType,1
8,2,0,10,mixedType,1
9,1,0,10,mixedType,1
3,9,0,12,mixedType,1
10,2,0,12,mixedType,1
8,4,0,12,mixedType,1
4,6,0,10,mixedType,1
14,2,0,16,mixedType,2
4,2,0,6,mixedType,0
6,1,0,7,mixedType,0
8,2,0,10,mixedType,1
2,4,0,6,mixedType,0
12,4,0,16,mixedType,2
5,2,0,7,mixedType,0
7,3,0,10,mixedType,1
5,3,0,8,mixedType,1
1,8,0,9,mixedType,1
3,6,0,9,mixedType,1
11,2,0,13,mixedType,1
6,1,0,7,mixedType,0
7,2,0,9,mixedType,1
4,9,0,13,mixedType,1
7,4,0,11,mixedType,1
6,3,0,9,mixedType,1
7,3,0,10,mixedType,1
7,2,0,9,mixedType,1
5,3,0,8,mixedType,1
8,2,0,10,mixedType,1
6,2,0,8,mixedType,1
4,6,0,10,mixedType,1
6,1,0,7,mixedType,0
7,1,0,8,mixedType,1
2,6,0,8,mixedType,1
8,2,0,10,mixedType,1
8,4,0,12,mixedType,1
7,2,0,9,mixedType,1
11,2,0,13,mixedType,1
6,3,0,9,mixedType,1
3,7,0,10,mixedType,1
14,2,0,16,mixedType,2
13,3,0,16,mixedType,2
7,2,0,9,mixedType,1
4,4,0,8,mixedType,1
6,2,0,8,mixedType,1
3,6,0,9,mixedType,1
6,4,0,10,mixedType,1
9,2,0,11,mixedType,1
4,4,0,8,mixedType,1
3,7,0,10,mixedType,1
4,4,0,8,mixedType,1
7,2,0,9,mixedType,1
7,3,0,10,mixedType,1
3,6,0,9,mixedType,1
5,1,0,6,mixedType,0
2,8,0,10,mixedType,1
7,3,0,10,mixedType,1
5,3,0,8,mixedType,1
5,3,0,8,mixedType,1
8,4,0,12,mixedType,1
7,3,0,10,mixedType,1
7,3,0,10,mixedType,1
5,2,0,7,mixedType,0
6,5,0,11,mixedType,1
8,4,0,12,mixedType,1
9,2,0,11,mixedType,1
5,4,0,9,mixedType,1
8,2,0,10,mixedType,1
4,6,0,10,mixedType,1
4,4,0,8,mixedType,1
5,4,0,9,mixedType,1
7,3,0,10,mixedType,1
8,2,0,10,mixedType,1
1,9,0,10,mixedType,1
7,3,0,10,mixedType,1
6,2,0,8,mixedType,1
8,1,0,9,mixedType,1
14,2,0,16,mixedType,2
9,1,0,10,mixedType,1
10,2,0,12,mixedType,1
6,2,0,8,mixedType,1
5,2,0,7,mixedType,0
5,1,0,6,mixedType,0
8,3,0,11,mixedType,1
7,2,0,9,mixedType,1
12,1,0,13,mixedType,1
15,1,0,16,mixedType,2
3,3,0,6,mixedType,0
4,2,0,6,mixedType,0
10,3,0,13,mixedType,1
6,2,0,8,mixedType,1
7,3,0,10,mixedType,1
4,4,0,8,mixedType,1
15,2,0,17,mixedType,2
5,2,0,7,mixedType,0
4,4,0,8,mixedType,1
5,3,0,8,mixedType,1
1,8,0,9,mixedType,1
6,3,0,9,mixedType,1
5,2,0,7,mixedType,0
8,2,0,10,mixedType,1
6,1,0,7,mixedType,0
6,3,0,9,mixedType,1
12,4,0,16,mixedType,2
5,3,0,8,mixedType,1
5,1,0,6,mixedType,0
4,2,0,6,mixedType,0
5,2,0,7,mixedType,0
7,3,0,10,mixedType,1
9,3,0,12,mixedType,1
6,5,0,11,mixedType,1
9,2,0,11,mixedType,1
6,2,0,8,mixedType,1
9,1,0,10,mixedType,1
5,5,0,10,mixedType,1
9,1,0,10,mixedType,1
7,4,0,11,mixedType,1
7,3,0,10,mixedType,1
5,2,0,7,mixedType,0
4,8,0,12,mixedType,1
5,4,0,9,mixedType,1
5,5,0,10,mixedType,1
5,1,0,6,mixedType,0
9,1,0,10,mixedType,1
6,1,0,7,mixedType,0
6,2,0,8,mixedType,1
5,6,0,11,mixedType,1
5,5,0,10,mixedType,1
4,8,0,12,mixedType,1
13,10,0,23,mixedType,2
6,1,0,7,mixedType,0
9,1,0,10,mixedType,1
5,3,0,8,mixedType,1
4,6,0,10,mixedType,1
9,1,0,10,mixedType,1
8,1,0,9,mixedType,1
6,1,0,7,mixedType,0
9,1,0,10,mixedType,1
6,3,0,9,mixedType,1
7,2,0,9,mixedType,1
5,5,0,10,mixedType,1
11,1,0,12,mixedType,1
7,1,0,8,mixedType,1
2,8,0,10,mixedType,1
4,6,0,10,mixedType,1
6,1,0,7,mixedType,0
5,2,0,7,mixedType,0
5,4,0,9,mixedType,1
4,2,0,6,mixedType,0
3,5,0,8,mixedType,1
10,2,0,12,mixedType,1
3,6,0,9,mixedType,1
5,5,0,10,mixedType,1
8,1,0,9,mixedType,1
13,3,0,16,mixedType,2
7,2,0,9,mixedType,1
7,3,0,10,mixedType,1
6,4,0,10,mixedType,1
4,4,0,8,mixedType,1
9,2,0,11,mixedType,1
7,2,0,9,mixedType,1
8,1,0,9,mixedType,1
8,2,0,10,mixedType,1
8,5,0,13,mixedType,1
7,1,0,8,mixedType,1
6,3,0,9,mixedType,1
14,2,0,16,mixedType,2
5,2,0,7,mixedType,0
6,3,0,9,mixedType,1
3,6,0,9,mixedType,1
8,4,0,12,mixedType,1
7,2,0,9,mixedType,1
8,2,0,10,mixedType,1
1,8,0,9,mixedType,1
10,2,0,12,mixedType,1
4,6,0,10,mixedType,1
6,3,0,9,mixedType,1
2,7,0,9,mixedType,1
7,4,0,11,mixedType,1
7,3,0,10,mixedType,1
5,3,0,8,mixedType,1
6,3,0,9,mixedType,1
4,5,0,9,mixedType,1
8,2,0,10,mixedType,1
6,1,0,7,mixedType,0
8,2,0,10,mixedType,1
7,4,0,11,mixedType,1
5,3,0,8,mixedType,1
5,2,0,7,mixedType,0
6,2,0,8,mixedType,1
14,2,0,16,mixedType,2
3,3,0,6,mixedType,0
4,2,0,6,mixedType,0
8,2,0,10,mixedType,1
4,5,0,9,mixedType,1
4,2,0,6,mixedType,0
14,2,0,16,mixedType,2
4,4,0,8,mixedType,1
6,2,0,8,mixedType,1
8,3,0,11,mixedType,1
4,6,0,10,mixedType,1
6,3,0,9,mixedType,1
1,9,0,10,mixedType,1
7,6,1,14,mixedType,2
4,4,0,8,mixedType,1
5,4,0,9,mixedType,1
10,1,0,11,mixedType,1
6,3,0,9,mixedType,1
7,2,0,9,mixedType,1
12,4,0,16,mixedType,2
7,1,0,8,mixedType,1
10,1,0,11,mixedType,1
13,3,0,16,mixedType,2
5,2,0,7,mixedType,0
10,2,0,12,mixedType,1
13,3,0,16,mixedType,2
4,2,0,6,mixedType,0
9,3,0,12,mixedType,1
6,3,0,9,mixedType,1
10,1,0,11,mixedType,1
10,6,0,16,mixedType,2
5,3,0,8,mixedType,1
8,3,0,11,mixedType,1
14,2,0,16,mixedType,2
14,2,0,16,mixedType,2
13,3,0,16,mixedType,2
8,6,1,15,mixedType,2
6,4,0,10,mixedType,1
5,5,0,10,mixedType,1
5,1,0,6,mixedType,0
9,4,2,15,mixedType,2
6,2,0,8,mixedType,1
4,4,0,8,mixedType,1
10,3,0,13,mixedType,1
3,7,0,10,mixedType,1
8,1,0,9,mixedType,1
6,3,0,9,mixedType,1
7,2,0,9,mixedType,1
6,6,0,12,mixedType,1
13,3,0,16,mixedType,2
5,2,0,7,mixedType,0
8,4,0,12,mixedType,1
15,1,0,16,mixedType,2
6,4,0,10,mixedType,1
4,4,0,8,mixedType,1
8,2,0,10,mixedType,1
4,5,0,9,mixedType,1
4,4,0,8,mixedType,1
8,1,0,9,mixedType,1
6,3,0,9,mixedType,1
9,4,0,13,mixedType,1
2,10,0,12,mixedType,1
6,2,0,8,mixedType,1
9,1,0,10,mixedType,1
8,1,0,9,mixedType,1
4,6,0,10,mixedType,1
7,4,0,11,mixedType,1
13,3,0,16,mixedType,2
9,1,0,10,mixedType,1
4,6,0,10,mixedType,1
12,3,0,15,mixedType,2
4,4,0,8,mixedType,1
7,3,0,10,mixedType,1
7,1,0,8,mixedType,1
9,3,0,12,mixedType,1
12,1,0,13,mixedType,1
6,0,9,15,mixedType,2
7,3,0,10,mixedType,1
7,3,0,10,mixedType,1
8,1,0,9,mixedType,1
1,7,0,8,mixedType,1
15,1,0,16,mixedType,2
4,4,0,8,mixedType,1
5,3,0,8,mixedType,1
9,2,0,11,mixedType,1
5,2,0,7,mixedType,0
6,2,0,8,mixedType,1
5,3,0,8,mixedType,1
9,2,0,11,mixedType,1
3,8,0,11,mixedType,1
7,3,0,10,mixedType,1
12,4,0,16,mixedType,2
3,5,0,8,mixedType,1
4,4,0,8,mixedType,1
6,6,0,12,mixedType,1
6,3,0,9,mixedType,1
2,8,0,10,mixedType,1
4,4,0,8,mixedType,1
9,3,0,12,mixedType,1
5,2,0,7,mixedType,0
10,3,0,13,mixedType,1
8,4,0,12,mixedType,1
6,2,0,8,mixedType,1
5,1,0,6,mixedType,0
13,3,0,16,mixedType,2
5,0,0,5,sameType,0
7,2,0,9,mixedType,1
12,3,1,16,mixedType,2
5,2,0,7,mixedType,0
6,4,0,10,mixedType,1
3,5,0,8,mixedType,1
5,3,0,8,mixedType,1
9,3,0,12,mixedType,1
6,2,0,8,mixedType,1
5,2,0,7,mixedType,0
4,4,0,8,mixedType,1
3,6,0,9,mixedType,1
1,9,0,10,mixedType,1
8,1,0,9,mixedType,1
2,4,0,6,mixedType,0
14,2,0,16,mixedType,2
7,2,0,9,mixedType,1
4,2,0,6,mixedType,0
7,3,0,10,mixedType,1
11,2,0,13,mixedType,1
8,1,0,9,mixedType,1
6,7,0,13,mixedType,1
5,3,0,8,mixedType,1
0,4,0,4,sameType,0
2,11,0,13,mixedType,1
7,1,0,8,mixedType,1
15,1,0,16,mixedType,2
6,3,0,9,mixedType,1
1,9,0,10,mixedType,1
5,7,0,12,mixedType,1
7,1,0,8,mixedType,1
5,2,0,7,mixedType,0
9,1,0,10,mixedType,1
7,3,0,10,mixedType,1
8,1,0,9,mixedType,1
5,1,0,6,mixedType,0
3,7,0,10,mixedType,1
4,4,0,8,mixedType,1
7,3,0,10,mixedType,1
7,3,0,10,mixedType,1
6,2,0,8,mixedType,1
7,3,0,10,mixedType,1
8,4,0,12,mixedType,1
5,2,0,7,mixedType,0
14,3,0,17,mixedType,2
7,2,0,9,mixedType,1
5,1,0,6,mixedType,0
2,6,0,8,mixedType,1
6,1,0,7,mixedType,0
4,4,0,8,mixedType,1
5,4,0,9,mixedType,1
9,2,0,11,mixedType,1
6,3,0,9,mixedType,1
6,3,0,9,mixedType,1
15,1,0,16,mixedType,2
6,1,0,7,mixedType,0
6,3,0,9,mixedType,1
7,2,0,9,mixedType,1
4,4,0,8,mixedType,1
11,1,0,12,mixedType,1
8,1,0,9,mixedType,1
13,3,0,16,mixedType,2
6,6,0,12,mixedType,1
3,3,0,6,mixedType,0
3,6,0,9,mixedType,1
11,3,0,14,mixedType,2
8,1,0,9,mixedType,1
5,2,0,7,mixedType,0
12,3,0,15,mixedType,2
7,4,0,11,mixedType,1
6,4,0,10,mixedType,1
11,2,0,13,mixedType,1
6,4,0,10,mixedType,1
3,3,0,6,mixedType,0
6,2,0,8,mixedType,1
4,0,3,7,mixedType,0
2,6,0,8,mixedType,1
7,3,0,10,mixedType,1
7,3,0,10,mixedType,1
6,3,0,9,mixedType,1
4,2,0,6,mixedType,0
6,3,0,9,mixedType,1
15,1,0,16,mixedType,2
7,8,0,15,mixedType,2
11,2,0,13,mixedType,1
8,3,0,11,mixedType,1
5,3,0,8,mixedType,1
6,6,0,12,mixedType,1
4,6,0,10,mixedType,1
6,1,0,7,mixedType,0
5,1,0,6,mixedType,0
7,3,0,10,mixedType,1
7,3,0,10,mixedType,1
5,2,0,7,mixedType,0
9,3,0,12,mixedType,1
2,6,0,8,mixedType,1
1,8,0,9,mixedType,1
6,2,0,8,mixedType,1
10,2,0,12,mixedType,1
8,5,0,13,mixedType,1
14,2,0,16,mixedType,2
7,1,0,8,mixedType,1
4,6,0,10,mixedType,1
3,6,0,9,mixedType,1
6,3,0,9,mixedType,1
8,2,0,10,mixedType,1
9,4,0,13,mixedType,1
6,3,0,9,mixedType,1
15,1,0,16,mixedType,2
14,2,0,16,mixedType,2
8,2,0,10,mixedType,1
6,3,0,9,mixedType,1
0,7,1,8,mixedType,1
7,3,0,10,mixedType,1
9,1,0,10,mixedType,1
8,2,0,10,mixedType,1
9,2,0,11,mixedType,1
9,2,0,11,mixedType,1
11,4,0,15,mixedType,2
8,1,0,9,mixedType,1
18,2,0,20,mixedType,2
7,3,0,10,mixedType,1
9,2,0,11,mixedType,1
4,6,0,10,mixedType,1
3,8,0,11,mixedType,1
5,3,0,8,mixedType,1
15,1,0,16,mixedType,2
7,3,0,10,mixedType,1
7,1,0,8,mixedType,1
13,3,0,16,mixedType,2
7,3,0,10,mixedType,1
4,5,0,9,mixedType,1
6,2,0,8,mixedType,1
9,1,0,10,mixedType,1
6,4,0,10,mixedType,1
2,6,0,8,mixedType,1
5,3,0,8,mixedType,1
14,2,0,16,mixedType,2
6,1,0,7,mixedType,0
4,2,0,6,mixedType,0
5,2,0,7,mixedType,0
7,3,0,10,mixedType,1
7,2,0,9,mixedType,1
5,1,0,6,mixedType,0
4,4,0,8,mixedType,1
7,3,0,10,mixedType,1
8,2,0,10,mixedType,1
5,8,0,13,mixedType,1
12,3,0,15,mixedType,2
4,5,0,9,mixedType,1
8,1,0,9,mixedType,1
7,2,0,9,mixedType,1
2,8,0,10,mixedType,1
5,2,0,7,mixedType,0
4,4,0,8,mixedType,1
4,6,0,10,mixedType,1
5,2,0,7,mixedType,0
7,1,0,8,mixedType,1
9,1,0,10,mixedType,1
7,3,0,10,mixedType,1
3,6,0,9,mixedType,1
10,3,0,13,mixedType,1
5,7,0,12,mixedType,1
3,7,0,10,mixedType,1
10,2,0,12,mixedType,1
5,3,0,8,mixedType,1
8,0,1,9,mixedType,1
10,0,2,12,mixedType,1
5,3,0,8,mixedType,1
11,5,0,16,mixedType,2
14,2,0,16,mixedType,2
5,1,0,6,mixedType,0
5,2,0,7,mixedType,0
4,2,0,6,mixedType,0
1,11,0,12,mixedType,1
7,1,0,8,mixedType,1
3,8,0,11,mixedType,1
2,8,0,10,mixedType,1
6,1,0,7,mixedType,0
5,1,0,6,mixedType,0
19,4,0,23,mixedType,2
5,5,0,10,mixedType,1
6,6,0,12,mixedType,1
9,1,0,10,mixedType,1
5,5,0,10,mixedType,1
14,2,0,16,mixedType,2
7,3,0,10,mixedType,1
9,1,0,10,mixedType,1
6,3,0,9,mixedType,1
16,1,1,18,mixedType,2
7,3,0,10,mixedType,1
8,3,0,11,mixedType,1
5,3,0,8,mixedType,1
7,2,0,9,mixedType,1
11,5,0,16,mixedType,2
6,3,0,9,mixedType,1
5,2,0,7,mixedType,0
14,2,0,16,mixedType,2
5,4,0,9,mixedType,1
9,4,0,13,mixedType,1
8,3,0,11,mixedType,1
8,2,0,10,mixedType,1
9,3,0,12,mixedType,1
8,5,0,13,mixedType,1
3,3,0,6,mixedType,0
7,3,0,10,mixedType,1
4,4,0,8,mixedType,1
8,2,0,10,mixedType,1
11,2,0,13,mixedType,1
11,2,0,13,mixedType,1
6,3,0,9,mixedType,1
14,2,0,16,mixedType,2
8,1,0,9,mixedType,1
6,1,0,7,mixedType,0
5,2,0,7,mixedType,0
8,4,0,12,mixedType,1
8,2,0,10,mixedType,1
5,7,0,12,mixedType,1
5,2,0,7,mixedType,0
7,3,0,10,mixedType,1
4,4,0,8,mixedType,1
4,2,0,6,mixedType,0
6,4,0,10,mixedType,1
9,1,0,10,mixedType,1
5,3,0,8,mixedType,1
5,3,0,8,mixedType,1
8,2,0,10,mixedType,1
2,6,0,8,mixedType,1
16,4,0,20,mixedType,2
6,2,0,8,mixedType,1
8,2,0,10,mixedType,1
7,2,0,9,mixedType,1
5,4,0,9,mixedType,1
7,4,0,11,mixedType,1
10,3,1,14,mixedType,2
1,10,0,11,mixedType,1
7,2,0,9,mixedType,1
6,2,0,8,mixedType,1
6,3,0,9,mixedType,1
10,4,0,14,mixedType,2
8,5,0,13,mixedType,1
6,2,0,8,mixedType,1
8,2,0,10,mixedType,1
1,8,0,9,mixedType,1
6,1,0,7,mixedType,0
11,2,2,15,mixedType,2
6,2,0,8,mixedType,1
11,1,0,12,mixedType,1
6,2,0,8,mixedType,1
8,1,0,9,mixedType,1
4,2,0,6,mixedType,0
7,3,0,10,mixedType,1
9,1,0,10,mixedType,1
5,2,0,7,mixedType,0
1,8,0,9,mixedType,1
1,8,0,9,mixedType,1
6,4,0,10,mixedType,1
7,3,0,10,mixedType,1
5,4,0,9,mixedType,1
7,3,0,10,mixedType,1
14,2,0,16,mixedType,2
5,4,0,9,mixedType,1
8,1,0,9,mixedType,1
14,2,0,16,mixedType,2
4,8,0,12,mixedType,1
14,2,0,16,mixedType,2
5,2,0,7,mixedType,0
6,3,0,9,mixedType,1
7,3,0,10,mixedType,1
12,4,0,16,mixedType,2
4,6,0,10,mixedType,1
12,4,0,16,mixedType,2
7,3,0,10,mixedType,1
9,1,0,10,mixedType,1
8,4,0,12,mixedType,1
4,2,0,6,mixedType,0
5,4,0,9,mixedType,1
7,4,0,11,mixedType,1
3,3,0,6,mixedType,0
8,1,0,9,mixedType,1
4,2,0,6,mixedType,0
1,7,0,8,mixedType,1
6,3,0,9,mixedType,1
7,2,0,9,mixedType,1
13,3,0,16,mixedType,2
4,8,0,12,mixedType,1
8,1,0,9,mixedType,1
5,1,0,6,mixedType,0
9,1,0,10,mixedType,1
6,3,0,9,mixedType,1
9,3,0,12,mixedType,1
7,2,0,9,mixedType,1
5,1,0,6,mixedType,0
7,2,0,9,mixedType,1
6,3,0,9,mixedType,1
4,6,0,10,mixedType,1
2,8,0,10,mixedType,1
6,4,0,10,mixedType,1
6,3,0,9,mixedType,1
12,3,0,15,mixedType,2
7,2,0,9,mixedType,1
6,3,0,9,mixedType,1
5,2,0,7,mixedType,0
5,1,0,6,mixedType,0
6,1,0,7,mixedType,0
4,6,0,10,mixedType,1
7,2,0,9,mixedType,1
4,2,0,6,mixedType,0
6,4,0,10,mixedType,1
2,8,0,10,mixedType,1
5,2,0,7,mixedType,0
8,1,0,9,mixedType,1
9,4,0,13,mixedType,1
6,3,0,9,mixedType,1
2,7,0,9,mixedType,1
13,3,0,16,mixedType,2
7,2,0,9,mixedType,1
14,2,0,16,mixedType,2
4,2,0,6,mixedType,0
11,0,1,12,mixedType,1
5,3,0,8,mixedType,1
5,3,0,8,mixedType,1
6,4,0,10,mixedType,1
5,4,0,9,mixedType,1
13,3,0,16,mixedType,2
6,3,0,9,mixedType,1
4,2,0,6,mixedType,0
6,3,0,9,mixedType,1
11,3,0,14,mixedType,2
6,3,0,9,mixedType,1
11,3,0,14,mixedType,2
2,8,0,10,mixedType,1
6,6,0,12,mixedType,1
7,6,0,13,mixedType,1
5,4,0,9,mixedType,1
4,4,0,8,mixedType,1
5,4,0,9,mixedType,1
3,7,0,10,mixedType,1
12,0,1,13,mixedType,1
7,3,0,10,mixedType,1
8,1,0,9,mixedType,1
2,9,0,11,mixedType,1
13,3,0,16,mixedType,2
8,2,0,10,mixedType,1
5,7,0,12,mixedType,1
8,1,0,9,mixedType,1
5,5,0,10,mixedType,1
6,3,0,9,mixedType,1
7,3,0,10,mixedType,1
12,1,0,13,mixedType,1
5,1,0,6,mixedType,0
15,1,0,16,mixedType,2
7,2,0,9,mixedType,1
7,1,0,8,mixedType,1
7,1,0,8,mixedType,1
15,1,0,16,mixedType,2
7,3,0,10,mixedType,1
6,2,0,8,mixedType,1
6,4,0,10,mixedType,1
9,1,0,10,mixedType,1
6,2,0,8,mixedType,1
7,4,0,11,mixedType,1
9,2,0,11,mixedType,1
6,4,0,10,mixedType,1
3,5,0,8,mixedType,1
7,2,0,9,mixedType,1
7,3,0,10,mixedType,1
6,3,0,9,mixedType,1
6,4,0,10,mixedType,1
7,3,0,10,mixedType,1
4,6,0,10,mixedType,1
6,4,0,10,mixedType,1
20,9,1,30,mixedType,2
8,9,1,18,mixedType,2
6,4,0,10,mixedType,1
6,4,0,10,mixedType,1
6,4,0,10,mixedType,1
4,6,0,10,mixedType,1
7,3,0,10,mixedType,1
7,4,0,11,mixedType,1
3,5,0,8,mixedType,1
10,1,0,11,mixedType,1
6,1,0,7,mixedType,0
8,3,0,11,mixedType,1
14,2,0,16,mixedType,2
7,1,0,8,mixedType,1
7,3,0,10,mixedType,1
5,3,0,8,mixedType,1
13,3,0,16,mixedType,2
8,1,0,9,mixedType,1
7,1,0,8,mixedType,1
6,3,0,9,mixedType,1
7,3,0,10,mixedType,1
13,3,0,16,mixedType,2
0,6,2,8,mixedType,1
13,4,0,17,mixedType,2
8,2,0,10,mixedType,1
7,2,0,9,mixedType,1
5,5,0,10,mixedType,1
3,5,0,8,mixedType,1
7,1,0,8,mixedType,1
5,2,0,7,mixedType,0
3,6,0,9,mixedType,1
6,2,0,8,mixedType,1
6,3,0,9,mixedType,1
7,3,0,10,mixedType,1
6,3,0,9,mixedType,1
5,4,0,9,mixedType,1
8,4,0,12,mixedType,1
7,4,0,11,mixedType,1
11,5,0,16,mixedType,2
15,1,0,16,mixedType,2
11,2,0,13,mixedType,1
5,2,0,7,mixedType,0
10,3,0,13,mixedType,1
6,4,0,10,mixedType,1
5,2,0,7,mixedType,0
6,3,0,9,mixedType,1
2,8,0,10,mixedType,1
4,2,0,6,mixedType,0
4,2,0,6,mixedType,0
6,3,0,9,mixedType,1
6,2,0,8,mixedType,1
9,3,0,12,mixedType,1
6,4,0,10,mixedType,1
6,2,0,8,mixedType,1
6,3,0,9,mixedType,1
7,3,0,10,mixedType,1
14,2,0,16,mixedType,2
5,4,0,9,mixedType,1
10,1,0,11,mixedType,1
5,2,0,7,mixedType,0
7,3,0,10,mixedType,1
11,3,0,14,mixedType,2
6,2,0,8,mixedType,1
9,3,0,12,mixedType,1
14,1,1,16,mixedType,2
4,2,0,6,mixedType,0
4,6,0,10,mixedType,1
2,6,0,8,mixedType,1
4,4,0,8,mixedType,1
5,2,0,7,mixedType,0
6,3,0,9,mixedType,1
1,12,1,14,mixedType,2
7,1,0,8,mixedType,1
4,2,0,6,mixedType,0
14,2,0,16,mixedType,2
7,2,0,9,mixedType,1
5,7,0,12,mixedType,1
6,3,0,9,mixedType,1
5,3,0,8,mixedType,1
6,1,0,7,mixedType,0
2,6,0,8,mixedType,1
11,2,0,13,mixedType,1
14,2,0,16,mixedType,2
7,6,2,15,mixedType,2
5,2,0,7,mixedType,0
8,1,0,9,mixedType,1
5,2,0,7,mixedType,0
7,4,0,11,mixedType,1
5,2,0,7,mixedType,0
5,2,0,7,mixedType,0
6,4,0,10,mixedType,1
6,2,0,8,mixedType,1
6,1,0,7,mixedType,0
6,2,0,8,mixedType,1
11,2,0,13,mixedType,1
10,6,0,16,mixedType,2
6,3,0,9,mixedType,1
7,1,0,8,mixedType,1
6,4,0,10,mixedType,1
6,1,0,7,mixedType,0
6,3,0,9,mixedType,1
6,4,0,10,mixedType,1
7,3,0,10,mixedType,1
4,4,0,8,mixedType,1
6,4,0,10,mixedType,1
5,3,0,8,mixedType,1
6,2,0,8,mixedType,1
8,1,0,9,mixedType,1
7,1,0,8,mixedType,1
2,8,0,10,mixedType,1
6,6,0,12,mixedType,1
6,1,0,7,mixedType,0
13,3,0,16,mixedType,2
6,2,0,8,mixedType,1
15,1,0,16,mixedType,2
3,5,0,8,mixedType,1
8,1,0,9,mixedType,1
8,1,0,9,mixedType,1
7,4,0,11,mixedType,1
4,4,0,8,mixedType,1
7,2,0,9,mixedType,1
10,2,0,12,mixedType,1
10,2,0,12,mixedType,1
9,2,0,11,mixedType,1
4,2,0,6,mixedType,0
9,2,0,11,mixedType,1
7,1,0,8,mixedType,1
19,1,0,20,mixedType,2
7,3,0,10,mixedType,1
2,10,0,12,mixedType,1
9,1,0,10,mixedType,1
4,7,0,11,mixedType,1
13,3,0,16,mixedType,2
8,2,0,10,mixedType,1
5,1,0,6,mixedType,0
9,1,0,10,mixedType,1
6,4,0,10,mixedType,1
7,2,0,9,mixedType,1
9,2,0,11,mixedType,1
5,4,0,9,mixedType,1
6,3,0,9,mixedType,1
6,4,0,10,mixedType,1
8,2,0,10,mixedType,1
6,7,0,13,mixedType,1
8,0,1,9,mixedType,1
8,1,0,9,mixedType,1
6,4,0,10,mixedType,1
5,3,0,8,mixedType,1
7,3,0,10,mixedType,1
5,4,0,9,mixedType,1
0,11,1,12,mixedType,1
4,4,0,8,mixedType,1
4,2,0,6,mixedType,0
15,1,0,16,mixedType,2
9,2,0,11,mixedType,1
5,3,0,8,mixedType,1
3,8,0,11,mixedType,1
6,1,0,7,mixedType,0
2,4,0,6,mixedType,0
6,2,0,8,mixedType,1
8,2,0,10,mixedType,1
4,6,0,10,mixedType,1
11,3,0,14,mixedType,2
5,1,0,6,mixedType,0
8,1,0,9,mixedType,1
6,4,0,10,mixedType,1
5,1,0,6,mixedType,0
5,3,0,8,mixedType,1
6,3,0,9,mixedType,1
9,2,0,11,mixedType,1
3,6,0,9,mixedType,1
4,4,0,8,mixedType,1
7,3,0,10,mixedType,1
8,2,0,10,mixedType,1
12,4,0,16,mixedType,2
5,2,0,7,mixedType,0
4,4,0,8,mixedType,1
6,3,0,9,mixedType,1
8,1,0,9,mixedType,1
3,6,0,9,mixedType,1
9,2,0,11,mixedType,1
5,3,0,8,mixedType,1
5,3,0,8,mixedType,1
7,3,0,10,mixedType,1
6,4,0,10,mixedType,1
7,3,0,10,mixedType,1
8,1,0,9,mixedType,1
10,3,0,13,mixedType,1
14,2,0,16,mixedType,2
5,2,0,7,mixedType,0
12,3,0,15,mixedType,2
15,1,0,16,mixedType,2
2,4,0,6,mixedType,0
6,3,0,9,mixedType,1
4,2,0,6,mixedType,0
7,1,0,8,mixedType,1
5,3,0,8,mixedType,1
5,1,0,6,mixedType,0
6,4,0,10,mixedType,1
3,3,0,6,mixedType,0
7,3,0,10,mixedType,1
6,2,0,8,mixedType,1
7,2,0,9,mixedType,1
4,6,0,10,mixedType,1
9,1,0,10,mixedType,1
6,3,0,9,mixedType,1
2,6,0,8,mixedType,1
7,4,0,11,mixedType,1
9,3,0,12,mixedType,1
4,4,0,8,mixedType,1
4,4,0,8,mixedType,1
7,2,0,9,mixedType,1
8,1,0,9,mixedType,1
5,4,0,9,mixedType,1
7,3,0,10,mixedType,1
12,2,1,15,mixedType,2
13,3,0,16,mixedType,2
4,6,0,10,mixedType,1
6,3,0,9,mixedType,1
7,3,0,10,mixedType,1
5,6,0,11,mixedType,1
7,4,0,11,mixedType,1
7,3,0,10,mixedType,1
7,1,0,8,mixedType,1
6,1,0,7,mixedType,0
5,4,0,9,mixedType,1
4,6,0,10,mixedType,1
7,4,0,11,mixedType,1
1,7,0,8,mixedType,1
6,3,0,9,mixedType,1
7,3,0,10,mixedType,1
8,1,0,9,mixedType,1
10,1,0,11,mixedType,1
6,3,0,9,mixedType,1
6,1,0,7,mixedType,0
7,3,0,10,mixedType,1
11,1,0,12,mixedType,1
12,3,0,15,mixedType,2
6,2,0,8,mixedType,1
7,2,0,9,mixedType,1
7,1,0,8,mixedType,1
8,3,0,11,mixedType,1
12,4,0,16,mixedType,2
6,2,0,8,mixedType,1
7,1,0,8,mixedType,1
4,2,0,6,mixedType,0
15,3,0,18,mixedType,2
11,2,1,14,mixedType,2
8,2,0,10,mixedType,1
5,4,0,9,mixedType,1
6,4,0,10,mixedType,1
8,2,0,10,mixedType,1
6,3,0,9,mixedType,1
4,2,0,6,mixedType,0
2,10,0,12,mixedType,1
2,7,0,9,mixedType,1
5,5,0,10,mixedType,1
14,2,0,16,mixedType,2
8,3,0,11,mixedType,1
5,3,0,8,mixedType,1
6,6,0,12,mixedType,1
6,2,0,8,mixedType,1
12,1,0,13,mixedType,1
4,4,0,8,mixedType,1
3,3,0,6,mixedType,0
10,2,2,14,mixedType,2
8,3,0,11,mixedType,1
13,6,0,19,mixedType,2
13,3,0,16,mixedType,2
6,1,0,7,mixedType,0
6,1,0,7,mixedType,0
6,3,0,9,mixedType,1
7,1,0,8,mixedType,1
4,8,0,12,mixedType,1
8,2,0,10,mixedType,1
6,2,0,8,mixedType,1
6,3,0,9,mixedType,1
11,2,0,13,mixedType,1
7,2,0,9,mixedType,1
7,3,0,10,mixedType,1
7,1,0,8,mixedType,1
9,1,0,10,mixedType,1
3,6,0,9,mixedType,1
14,2,0,16,mixedType,2
6,1,0,7,mixedType,0
9,3,0,12,mixedType,1
11,5,0,16,mixedType,2
5,5,0,10,mixedType,1
14,2,0,16,mixedType,2
6,4,0,10,mixedType,1
7,1,0,8,mixedType,1
5,2,0,7,mixedType,0
6,3,0,9,mixedType,1
5,2,0,7,mixedType,0
8,2,0,10,mixedType,1
6,3,0,9,mixedType,1
8,1,0,9,mixedType,1
5,3,0,8,mixedType,1
7,2,0,9,mixedType,1
7,2,0,9,mixedType,1
7,3,0,10,mixedType,1
4,2,0,6,mixedType,0
4,6,0,10,mixedType,1
2,4,0,6,mixedType,0
5,4,0,9,mixedType,1
7,3,0,10,mixedType,1
3,8,0,11,mixedType,1
7,2,0,9,mixedType,1
10,3,0,13,mixedType,1
6,3,0,9,mixedType,1
13,3,0,16,mixedType,2
7,6,0,13,mixedType,1
9,1,0,10,mixedType,1
10,3,0,13,mixedType,1
8,2,0,10,mixedType,1
15,1,0,16,mixedType,2
6,4,0,10,mixedType,1
5,2,0,7,mixedType,0
4,4,0,8,mixedType,1
4,4,0,8,mixedType,1
6,2,0,8,mixedType,1
3,5,0,8,mixedType,1
5,2,0,7,mixedType,0
6,2,0,8,mixedType,1
5,1,0,6,mixedType,0
3,5,0,8,mixedType,1
4,4,0,8,mixedType,1
5,2,0,7,mixedType,0
11,3,0,14,mixedType,2
5,3,0,8,mixedType,1
6,1,0,7,mixedType,0
6,3,0,9,mixedType,1
3,6,0,9,mixedType,1
6,9,2,17,mixedType,2
5,2,0,7,mixedType,0
14,2,0,16,mixedType,2
6,8,1,15,mixedType,2
4,4,0,8,mixedType,1
13,3,0,16,mixedType,2
8,4,0,12,mixedType,1
4,4,0,8,mixedType,1
7,2,0,9,mixedType,1
2,8,0,10,mixedType,1
2,6,0,8,mixedType,1
7,2,0,9,mixedType,1
6,3,0,9,mixedType,1
6,4,0,10,mixedType,1
5,1,0,6,mixedType,0
12,4,0,16,mixedType,2
4,6,0,10,mixedType,1
5,5,0,10,mixedType,1
6,1,0,7,mixedType,0
7,3,0,10,mixedType,1
6,3,0,9,mixedType,1
5,1,0,6,mixedType,0
14,2,0,16,mixedType,2
10,0,1,11,mixedType,1
3,5,0,8,mixedType,1
9,3,0,12,mixedType,1
2,10,0,12,mixedType,1
8,2,0,10,mixedType,1
8,2,0,10,mixedType,1
3,3,0,6,mixedType,0
6,2,0,8,mixedType,1
7,1,0,8,mixedType,1
2,6,0,8,mixedType,1
10,1,0,11,mixedType,1
6,4,0,10,mixedType,1
6,3,0,9,mixedType,1
7,4,0,11,mixedType,1
2,6,0,8,mixedType,1
14,2,0,16,mixedType,2
6,2,0,8,mixedType,1
2,8,0,10,mixedType,1
4,2,0,6,mixedType,0
6,4,0,10,mixedType,1
9,0,1,10,mixedType,1
8,5,0,13,mixedType,1
10,1,0,11,mixedType,1
5,4,0,9,mixedType,1
2,6,0,8,mixedType,1
6,1,0,7,mixedType,0
8,2,0,10,mixedType,1
6,4,0,10,mixedType,1
6,5,0,11,mixedType,1
5,3,0,8,mixedType,1
8,1,0,9,mixedType,1
10,3,0,13,mixedType,1
7,2,0,9,mixedType,1
8,1,0,9,mixedType,1
6,2,0,8,mixedType,1
4,2,0,6,mixedType,0
5,4,0,9,mixedType,1
3,5,0,8,mixedType,1
5,3,0,8,mixedType,1
7,3,0,10,mixedType,1
6,2,0,8,mixedType,1
6,3,0,9,mixedType,1
7,3,0,10,mixedType,1
11,3,0,14,mixedType,2
8,2,0,10,mixedType,1
7,2,0,9,mixedType,1
6,3,0,9,mixedType,1
5,2,0,7,mixedType,0
6,3,0,9,mixedType,1
13,3,0,16,mixedType,2
5,8,0,13,mixedType,1
7,1,0,8,mixedType,1
7,1,0,8,mixedType,1
5,2,0,7,mixedType,0
7,3,0,10,mixedType,1
8,2,0,10,mixedType,1
6,3,0,9,mixedType,1
7,2,0,9,mixedType,1
6,3,0,9,mixedType,1
4,2,0,6,mixedType,0
6,1,0,7,mixedType,0
6,1,0,7,mixedType,0
10,3,0,13,mixedType,1
9,4,0,13,mixedType,1
5,8,0,13,mixedType,1
7,3,0,10,mixedType,1
11,2,0,13,mixedType,1
4,2,0,6,mixedType,0
6,1,0,7,mixedType,0
6,3,0,9,mixedType,1
9,2,0,11,mixedType,1
15,1,1,17,mixedType,2
1,8,0,9,mixedType,1
8,2,0,10,mixedType,1
5,2,0,7,mixedType,0
5,6,0,11,mixedType,1
9,2,0,11,mixedType,1
5,5,0,10,mixedType,1
8,2,0,10,mixedType,1
7,3,0,10,mixedType,1
2,7,0,9,mixedType,1
6,3,0,9,mixedType,1
7,3,0,10,mixedType,1
7,2,0,9,mixedType,1
7,4,0,11,mixedType,1
6,4,0,10,mixedType,1
7,2,0,9,mixedType,1
4,2,0,6,mixedType,0
5,3,0,8,mixedType,1
7,4,0,11,mixedType,1
8,6,1,15,mixedType,2
7,5,0,12,mixedType,1
5,3,0,8,mixedType,1
5,3,0,8,mixedType,1
10,2,0,12,mixedType,1
6,4,0,10,mixedType,1
5,3,0,8,mixedType,1
9,2,0,11,mixedType,1
3,3,0,6,mixedType,0
6,3,0,9,mixedType,1
6,6,0,12,mixedType,1
14,2,0,16,mixedType,2
11,3,0,14,mixedType,2
10,2,0,12,mixedType,1
4,2,0,6,mixedType,0
6,4,0,10,mixedType,1
6,3,0,9,mixedType,1
6,1,0,7,mixedType,0
8,2,0,10,mixedType,1
3,6,0,9,mixedType,1
9,4,0,13,mixedType,1
5,2,0,7,mixedType,0
7,4,0,11,mixedType,1
4,2,0,6,mixedType,0
5,4,0,9,mixedType,1
4,4,0,8,mixedType,1
1,8,0,9,mixedType,1
5,4,0,9,mixedType,1
6,1,0,7,mixedType,0
14,2,0,16,mixedType,2
8,1,0,9,mixedType,1
6,2,0,8,mixedType,1
11,5,0,16,mixedType,2
6,7,0,13,mixedType,1
8,3,0,11,mixedType,1
5,2,0,7,mixedType,0
7,1,0,8,mixedType,1
6,2,0,8,mixedType,1
7,2,0,9,mixedType,1
3,5,0,8,mixedType,1
10,2,0,12,mixedType,1
8,1,0,9,mixedType,1
5,3,0,8,mixedType,1
6,4,0,10,mixedType,1
4,4,0,8,mixedType,1
8,1,0,9,mixedType,1
6,2,0,8,mixedType,1
6,3,0,9,mixedType,1
5,4,0,9,mixedType,1
6,1,0,7,mixedType,0
8,3,0,11,mixedType,1
6,2,0,8,mixedType,1
7,2,0,9,mixedType,1
6,3,0,9,mixedType,1
12,4,0,16,mixedType,2
5,2,0,7,mixedType,0
13,3,0,16,mixedType,2
10,2,0,12,mixedType,1
6,1,0,7,mixedType,0
13,3,0,16,mixedType,2
6,4,0,10,mixedType,1
8,2,0,10,mixedType,1
9,2,0,11,mixedType,1
2,4,0,6,mixedType,0
6,1,0,7,mixedType,0
4,2,0,6,mixedType,0
3,6,0,9,mixedType,1
5,3,0,8,mixedType,1
7,3,0,10,mixedType,1
11,2,0,13,mixedType,1
3,3,0,6,mixedType,0
15,1,0,16,mixedType,2
6,3,0,9,mixedType,1
6,1,0,7,mixedType,0
8,2,0,10,mixedType,1
6,3,0,9,mixedType,1
8,1,0,9,mixedType,1
2,6,0,8,mixedType,1
12,1,0,13,mixedType,1
6,2,0,8,mixedType,1
6,1,0,7,mixedType,0
6,4,0,10,mixedType,1
6,4,0,10,mixedType,1
4,6,0,10,mixedType,1
3,6,0,9,mixedType,1
6,1,0,7,mixedType,0
12,3,0,15,mixedType,2
2,4,0,6,mixedType,0
9,1,0,10,mixedType,1
11,3,0,14,mixedType,2
7,2,0,9,mixedType,1
7,6,0,13,mixedType,1
13,3,0,16,mixedType,2
8,1,0,9,mixedType,1
11,1,0,12,mixedType,1
6,4,0,10,mixedType,1
7,3,0,10,mixedType,1
4,6,0,10,mixedType,1
7,1,0,8,mixedType,1
5,3,0,8,mixedType,1
8,2,0,10,mixedType,1
3,3,0,6,mixedType,0
4,4,0,8,mixedType,1
5,2,0,7,mixedType,0
6,3,0,9,mixedType,1
3,7,0,10,mixedType,1
8,2,0,10,mixedType,1
2,6,0,8,mixedType,1
7,2,0,9,mixedType,1
6,3,0,9,mixedType,1
5,3,0,8,mixedType,1
8,2,0,10,mixedType,1
5,4,0,9,mixedType,1
3,3,0,6,mixedType,0
8,1,0,9,mixedType,1
7,2,0,9,mixedType,1
5,3,0,8,mixedType,1
5,5,0,10,mixedType,1
7,3,0,10,mixedType,1
5,5,0,10,mixedType,1
4,2,0,6,mixedType,0
6,2,0,8,mixedType,1
9,2,0,11,mixedType,1
4,5,0,9,mixedType,1
4,2,0,6,mixedType,0
7,2,0,9,mixedType,1
4,2,0,6,mixedType,0
6,3,0,9,mixedType,1
7,3,0,10,mixedType,1
6,3,0,9,mixedType,1
7,1,0,8,mixedType,1
3,8,0,11,mixedType,1
6,3,0,9,mixedType,1
5,3,0,8,mixedType,1
5,2,0,7,mixedType,0
14,2,0,16,mixedType,2
6,7,0,13,mixedType,1
6,6,0,12,mixedType,1
7,3,0,10,mixedType,1
6,4,0,10,mixedType,1
8,1,0,9,mixedType,1
5,2,0,7,mixedType,0
7,1,0,8,mixedType,1
6,2,0,8,mixedType,1
2,4,0,6,mixedType,0
8,2,0,10,mixedType,1
13,3,0,16,mixedType,2
8,2,0,10,mixedType,1
4,2,0,6,mixedType,0
3,6,0,9,mixedType,1
1,8,0,9,mixedType,1
2,8,0,10,mixedType,1
7,3,0,10,mixedType,1
6,6,0,12,mixedType,1
5,6,0,11,mixedType,1
14,2,0,16,mixedType,2
7,2,0,9,mixedType,1
6,4,0,10,mixedType,1
2,6,0,8,mixedType,1
6,1,0,7,mixedType,0
6,4,0,10,mixedType,1
5,3,0,8,mixedType,1
4,2,0,6,mixedType,0
3,5,0,8,mixedType,1
3,9,0,12,mixedType,1
5,4,0,9,mixedType,1
7,1,0,8,mixedType,1
12,4,0,16,mixedType,2
4,2,0,6,mixedType,0
6,3,0,9,mixedType,1
6,4,0,10,mixedType,1
4,4,0,8,mixedType,1
7,4,0,11,mixedType,1
6,1,0,7,mixedType,0
7,2,0,9,mixedType,1
14,2,0,16,mixedType,2
5,3,0,8,mixedType,1
9,4,0,13,mixedType,1
6,2,0,8,mixedType,1
6,3,0,9,mixedType,1
15,1,0,16,mixedType,2
8,5,0,13,mixedType,1
15,1,0,16,mixedType,2
1,7,0,8,mixedType,1
3,6,0,9,mixedType,1
6,3,0,9,mixedType,1
8,6,1,15,mixedType,2
9,3,0,12,mixedType,1
4,5,0,9,mixedType,1
5,3,0,8,mixedType,1
2,7,0,9,mixedType,1
9,4,0,13,mixedType,1
4,6,0,10,mixedType,1
4,4,0,8,mixedType,1
2,4,0,6,mixedType,0
9,3,0,12,mixedType,1
2,6,0,8,mixedType,1
1,10,0,11,mixedType,1
6,3,0,9,mixedType,1
5,4,0,9,mixedType,1
8,2,0,10,mixedType,1
4,8,3,15,mixedType,2
11,3,0,14,mixedType,2
5,2,0,7,mixedType,0
8,2,0,10,mixedType,1
4,6,0,10,mixedType,1
6,1,0,7,mixedType,0
6,3,0,9,mixedType,1
8,1,0,9,mixedType,1
8,2,0,10,mixedType,1
8,1,0,9,mixedType,1
6,0,1,7,mixedType,0
5,3,0,8,mixedType,1
16,1,1,18,mixedType,2
7,2,0,9,mixedType,1
6,4,0,10,mixedType,1
8,2,0,10,mixedType,1
4,4,0,8,mixedType,1
8,1,0,9,mixedType,1
2,6,0,8,mixedType,1
6,2,0,8,mixedType,1
6,1,0,7,mixedType,0
6,1,0,7,mixedType,0
5,3,0,8,mixedType,1
2,8,0,10,mixedType,1
7,3,0,10,mixedType,1
7,0,1,8,mixedType,1
9,1,0,10,mixedType,1
5,3,0,8,mixedType,1
10,2,0,12,mixedType,1
15,1,0,16,mixedType,2
5,3,0,8,mixedType,1
11,3,0,14,mixedType,2
5,3,0,8,mixedType,1
6,4,0,10,mixedType,1
4,6,0,10,mixedType,1
7,3,0,10,mixedType,1
8,4,0,12,mixedType,1
14,2,0,16,mixedType,2
9,4,0,13,mixedType,1
12,3,0,15,mixedType,2
8,2,0,10,mixedType,1
7,2,0,9,mixedType,1
13,3,0,16,mixedType,2
18,12,0,30,mixedType,2
8,1,0,9,mixedType,1
4,4,0,8,mixedType,1
2,4,0,6,mixedType,0
5,2,0,7,mixedType,0
2,11,0,13,mixedType,1
2,6,0,8,mixedType,1
6,3,0,9,mixedType,1
5,2,0,7,mixedType,0
8,3,0,11,mixedType,1
12,4,0,16,mixedType,2
13,3,0,16,mixedType,2
5,5,0,10,mixedType,1
5,3,0,8,mixedType,1
4,6,0,10,mixedType,1
7,3,0,10,mixedType,1
10,3,0,13,mixedType,1
1,11,0,12,mixedType,1
6,1,0,7,mixedType,0
5,1,0,6,mixedType,0
7,3,0,10,mixedType,1
5,8,0,13,mixedType,1
6,3,0,9,mixedType,1
10,6,0,16,mixedType,2
8,3,0,11,mixedType,1
5,2,0,7,mixedType,0
5,2,0,7,mixedType,0
8,2,0,10,mixedType,1
7,3,0,10,mixedType,1
7,8,2,17,mixedType,2
2,6,0,8,mixedType,1
4,2,0,6,mixedType,0
6,1,0,7,mixedType,0
6,2,0,8,mixedType,1
6,2,0,8,mixedType,1
11,3,0,14,mixedType,2
8,2,0,10,mixedType,1
12,1,0,13,mixedType,1
17,3,2,22,mixedType,2
9,2,0,11,mixedType,1
2,8,0,10,mixedType,1
5,4,0,9,mixedType,1
5,8,0,13,mixedType,1
9,1,0,10,mixedType,1
9,2,0,11,mixedType,1
6,3,0,9,mixedType,1
4,8,0,12,mixedType,1
5,3,0,8,mixedType,1
9,4,0,13,mixedType,1
5,4,0,9,mixedType,1
5,2,0,7,mixedType,0
6,2,0,8,mixedType,1
14,2,0,16,mixedType,2
5,2,0,7,mixedType,0
7,2,0,9,mixedType,1
10,1,0,11,mixedType,1
7,3,0,10,mixedType,1
7,3,0,10,mixedType,1
6,1,0,7,mixedType,0
14,2,0,16,mixedType,2
7,1,0,8,mixedType,1
7,3,0,10,mixedType,1
7,1,0,8,mixedType,1
5,5,0,10,mixedType,1
8,2,0,10,mixedType,1
7,4,0,11,mixedType,1
4,5,0,9,mixedType,1
7,2,0,9,mixedType,1
5,1,0,6,mixedType,0
6,4,0,10,mixedType,1
9,1,0,10,mixedType,1
4,4,0,8,mixedType,1
3,7,0,10,mixedType,1
6,2,0,8,mixedType,1
7,1,0,8,mixedType,1
4,4,0,8,mixedType,1
4,7,0,11,mixedType,1
5,4,0,9,mixedType,1
14,2,0,16,mixedType,2
7,2,0,9,mixedType,1
6,1,0,7,mixedType,0
5,1,0,6,mixedType,0
6,3,0,9,mixedType,1
4,4,0,8,mixedType,1
9,4,0,13,mixedType,1
8,2,0,10,mixedType,1
6,1,0,7,mixedType,0
7,2,0,9,mixedType,1
5,1,0,6,mixedType,0
7,2,0,9,mixedType,1
5,4,0,9,mixedType,1
11,2,0,13,mixedType,1
13,3,0,16,mixedType,2
5,2,0,7,mixedType,0
7,2,0,9,mixedType,1
10,6,1,17,mixedType,2
6,2,0,8,mixedType,1
8,6,1,15,mixedType,2
14,2,0,16,mixedType,2
4,4,0,8,mixedType,1
7,3,0,10,mixedType,1
7,3,0,10,mixedType,1
6,2,0,8,mixedType,1
13,3,0,16,mixedType,2
6,4,0,10,mixedType,1
8,1,0,9,mixedType,1
9,1,0,10,mixedType,1
5,2,0,7,mixedType,0
9,2,0,11,mixedType,1
6,2,0,8,mixedType,1
8,2,0,10,mixedType,1
5,8,1,14,mixedType,2
6,6,0,12,mixedType,1
5,3,0,8,mixedType,1
6,3,0,9,mixedType,1
8,4,0,12,mixedType,1
7,2,0,9,mixedType,1
4,2,0,6,mixedType,0
3,5,0,8,mixedType,1
9,3,0,12,mixedType,1
2,6,0,8,mixedType,1
1,8,0,9,mixedType,1
8,1,0,9,mixedType,1
7,3,0,10,mixedType,1
4,2,0,6,mixedType,0
9,2,0,11,mixedType,1
6,4,0,10,mixedType,1
2,8,0,10,mixedType,1
15,1,0,16,mixedType,2
4,2,0,6,mixedType,0
10,1,0,11,mixedType,1
6,6,0,12,mixedType,1
10,3,0,13,mixedType,1
8,0,1,9,mixedType,1
3,6,0,9,mixedType,1
6,1,0,7,mixedType,0
6,0,0,6,sameType,0
2,8,0,10,mixedType,1
7,2,0,9,mixedType,1
8,4,0,12,mixedType,1
3,5,0,8,mixedType,1
15,1,0,16,mixedType,2
1,8,0,9,mixedType,1
2,6,0,8,mixedType,1
5,4,0,9,mixedType,1
7,3,0,10,mixedType,1
7,4,0,11,mixedType,1
4,4,0,8,mixedType,1
5,3,0,8,mixedType,1
6,3,0,9,mixedType,1
5,4,0,9,mixedType,1
6,1,0,7,mixedType,0
6,2,0,8,mixedType,1
6,2,0,8,mixedType,1
6,3,0,9,mixedType,1
8,1,0,9,mixedType,1
5,4,0,9,mixedType,1
9,1,0,10,mixedType,1
4,4,0,8,mixedType,1
5,3,0,8,mixedType,1
6,1,0,7,mixedType,0
8,2,0,10,mixedType,1
6,1,0,7,mixedType,0
7,4,0,11,mixedType,1
6,3,0,9,mixedType,1
9,3,0,12,mixedType,1
5,3,0,8,mixedType,1
4,2,0,6,mixedType,0
7,4,0,11,mixedType,1
6,3,0,9,mixedType,1
4,4,0,8,mixedType,1
9,5,0,14,mixedType,2
6,4,0,10,mixedType,1
4,2,0,6,mixedType,0
7,2,0,9,mixedType,1
5,4,0,9,mixedType,1
6,1,0,7,mixedType,0
2,4,0,6,mixedType,0
5,3,0,8,mixedType,1
4,4,0,8,mixedType,1
8,3,0,11,mixedType,1
15,1,0,16,mixedType,2
5,3,0,8,mixedType,1
8,4,0,12,mixedType,1
7,2,0,9,mixedType,1
7,3,0,10,mixedType,1
3,3,0,6,mixedType,0
7,2,0,9,mixedType,1
6,4,0,10,mixedType,1
8,1,0,9,mixedType,1
10,2,0,12,mixedType,1
6,1,0,7,mixedType,0
5,2,0,7,mixedType,0
5,3,0,8,mixedType,1
3,5,0,8,mixedType,1
15,1,0,16,mixedType,2
5,3,0,8,mixedType,1
5,2,0,7,mixedType,0
7,3,0,10,mixedType,1
10,3,0,13,mixedType,1
6,3,0,9,mixedType,1
7,3,0,10,mixedType,1
5,5,0,10,mixedType,1
7,3,0,10,mixedType,1
3,3,0,6,mixedType,0
9,3,0,12,mixedType,1
6,4,0,10,mixedType,1
12,4,0,16,mixedType,2
5,4,0,9,mixedType,1
6,3,0,9,mixedType,1
15,1,0,16,mixedType,2
2,4,0,6,mixedType,0
6,1,0,7,mixedType,0
7,3,0,10,mixedType,1
6,3,0,9,mixedType,1
6,3,0,9,mixedType,1
11,5,0,16,mixedType,2
7,2,0,9,mixedType,1
6,2,0,8,mixedType,1
6,2,0,8,mixedType,1
2,8,0,10,mixedType,1
4,5,0,9,mixedType,1
5,4,0,9,mixedType,1
7,2,0,9,mixedType,1
7,2,0,9,mixedType,1
3,3,0,6,mixedType,0
14,2,0,16,mixedType,2
3,5,0,8,mixedType,1
5,3,0,8,mixedType,1
3,3,0,6,mixedType,0
7,1,0,8,mixedType,1
5,2,0,7,mixedType,0
8,1,0,9,mixedType,1
5,3,0,8,mixedType,1
2,6,0,8,mixedType,1
4,2,0,6,mixedType,0
4,5,0,9,mixedType,1
5,4,0,9,mixedType,1
7,3,0,10,mixedType,1
6,3,0,9,mixedType,1
7,2,0,9,mixedType,1
14,2,0,16,mixedType,2
3,3,0,6,mixedType,0
5,3,0,8,mixedType,1
5,3,0,8,mixedType,1
4,4,0,8,mixedType,1
8,1,0,9,mixedType,1
14,2,0,16,mixedType,2
14,2,0,16,mixedType,2
6,1,0,7,mixedType,0
7,2,0,9,mixedType,1
8,2,0,10,mixedType,1
8,1,0,9,mixedType,1
11,1,0,12,mixedType,1
7,2,0,9,mixedType,1
7,2,0,9,mixedType,1
4,5,0,9,mixedType,1
8,4,0,12,mixedType,1
4,2,0,6,mixedType,0
6,2,0,8,mixedType,1
2,4,0,6,mixedType,0
3,8,0,11,mixedType,1
6,2,0,8,mixedType,1
9,2,0,11,mixedType,1
8,2,0,10,mixedType,1
4,5,0,9,mixedType,1
9,1,0,10,mixedType,1
5,2,0,7,mixedType,0
1,7,0,8,mixedType,1
1,8,0,9,mixedType,1
1,7,0,8,mixedType,1
7,4,0,11,mixedType,1
6,4,0,10,mixedType,1
6,4,0,10,mixedType,1
5,2,0,7,mixedType,0
5,3,0,8,mixedType,1
5,3,0,8,mixedType,1
8,1,0,9,mixedType,1
1,5,0,6,mixedType,0
7,2,0,9,mixedType,1
5,3,0,8,mixedType,1
7,3,0,10,mixedType,1
6,3,0,9,mixedType,1
2,8,0,10,mixedType,1
7,3,0,10,mixedType,1
5,3,0,8,mixedType,1
8,2,0,10,mixedType,1
6,3,0,9,mixedType,1
6,3,0,9,mixedType,1
6,2,0,8,mixedType,1
4,2,0,6,mixedType,0
15,1,0,16,mixedType,2
8,3,0,11,mixedType,1
6,4,0,10,mixedType,1
5,2,0,7,mixedType,0
6,4,0,10,mixedType,1
13,3,0,16,mixedType,2
4,4,0,8,mixedType,1
6,1,0,7,mixedType,0
9,1,0,10,mixedType,1
9,1,0,10,mixedType,1
4,6,0,10,mixedType,1
10,1,0,11,mixedType,1
8,1,0,9,mixedType,1
5,2,0,7,mixedType,0
7,2,0,9,mixedType,1
6,3,0,9,mixedType,1
5,1,0,6,mixedType,0
2,4,0,6,mixedType,0
4,5,0,9,mixedType,1
2,8,0,10,mixedType,1
7,5,0,12,mixedType,1
10,2,0,12,mixedType,1
6,4,0,10,mixedType,1
11,3,0,14,mixedType,2
4,4,0,8,mixedType,1
8,1,0,9,mixedType,1
9,1,0,10,mixedType,1
1,8,0,9,mixedType,1
4,5,0,9,mixedType,1
14,2,0,16,mixedType,2
8,3,0,11,mixedType,1
12,4,0,16,mixedType,2
7,3,0,10,mixedType,1
6,1,0,7,mixedType,0
7,2,0,9,mixedType,1
6,1,0,7,mixedType,0
5,1,0,6,mixedType,0
7,2,0,9,mixedType,1
5,1,0,6,mixedType,0
6,1,0,7,mixedType,0
6,3,0,9,mixedType,1
6,3,0,9,mixedType,1
6,1,0,7,mixedType,0
10,1,0,11,mixedType,1
4,7,0,11,mixedType,1
6,3,0,9,mixedType,1
7,3,0,10,mixedType,1
4,6,0,10,mixedType,1
2,10,0,12,mixedType,1
10,3,0,13,mixedType,1
9,2,0,11,mixedType,1
5,8,0,13,mixedType,1
14,2,0,16,mixedType,2
5,2,0,7,mixedType,0
7,4,0,11,mixedType,1
11,3,0,14,mixedType,2
8,2,0,10,mixedType,1
6,1,0,7,mixedType,0
12,4,0,16,mixedType,2
1,8,0,9,mixedType,1
8,2,0,10,mixedType,1
6,1,0,7,mixedType,0
4,4,0,8,mixedType,1
3,6,0,9,mixedType,1
7,1,0,8,mixedType,1
3,6,0,9,mixedType,1
14,2,0,16,mixedType,2
2,7,0,9,mixedType,1
7,3,0,10,mixedType,1
9,1,0,10,mixedType,1
8,2,0,10,mixedType,1
13,3,0,16,mixedType,2
9,0,1,10,mixedType,1
6,4,0,10,mixedType,1
14,2,0,16,mixedType,2
3,13,1,17,mixedType,2
3,7,0,10,mixedType,1
4,6,0,10,mixedType,1
13,3,0,16,mixedType,2
3,6,0,9,mixedType,1
5,2,0,7,mixedType,0
13,3,0,16,mixedType,2
8,4,0,12,mixedType,1
6,1,0,7,mixedType,0
5,5,0,10,mixedType,1
6,3,0,9,mixedType,1
9,1,0,10,mixedType,1
5,1,0,6,mixedType,0
8,4,0,12,mixedType,1
15,1,0,16,mixedType,2
7,4,0,11,mixedType,1
7,1,0,8,mixedType,1
5,3,0,8,mixedType,1
4,4,0,8,mixedType,1
3,6,0,9,mixedType,1
8,1,0,9,mixedType,1
5,2,0,7,mixedType,0
13,3,0,16,mixedType,2
9,1,0,10,mixedType,1
1,9,0,10,mixedType,1
4,4,0,8,mixedType,1
8,1,0,9,mixedType,1
6,4,0,10,mixedType,1
8,1,0,9,mixedType,1
6,3,0,9,mixedType,1
13,3,0,16,mixedType,2
9,3,0,12,mixedType,1
15,1,0,16,mixedType,2
5,8,0,13,mixedType,1
7,2,0,9,mixedType,1
4,2,0,6,mixedType,0
9,2,0,11,mixedType,1
3,5,0,8,mixedType,1
6,2,0,8,mixedType,1
4,2,0,6,mixedType,0
8,1,0,9,mixedType,1
5,8,0,13,mixedType,1
5,3,0,8,mixedType,1
7,3,0,10,mixedType,1
5,3,0,8,mixedType,1
8,3,0,11,mixedType,1
6,3,0,9,mixedType,1
3,5,0,8,mixedType,1
6,3,0,9,mixedType,1
9,1,0,10,mixedType,1
8,2,0,10,mixedType,1
6,3,0,9,mixedType,1
6,4,0,10,mixedType,1
4,2,0,6,mixedType,0
5,1,0,6,mixedType,0
1,8,0,9,mixedType,1
7,3,0,10,mixedType,1
3,7,0,10,mixedType,1
8,2,0,10,mixedType,1
8,4,0,12,mixedType,1
6,4,0,10,mixedType,1
1,5,0,6,mixedType,0
2,8,0,10,mixedType,1
5,3,0,8,mixedType,1
5,2,0,7,mixedType,0
3,6,0,9,mixedType,1
4,4,0,8,mixedType,1
7,2,0,9,mixedType,1
6,3,0,9,mixedType,1
2,6,0,8,mixedType,1
6,4,0,10,mixedType,1
8,2,0,10,mixedType,1
8,1,0,9,mixedType,1
12,3,0,15,mixedType,2
6,3,0,9,mixedType,1
5,4,0,9,mixedType,1
8,2,0,10,mixedType,1
8,1,0,9,mixedType,1
8,2,0,10,mixedType,1
2,4,0,6,mixedType,0
6,3,0,9,mixedType,1
6,4,0,10,mixedType,1
6,3,0,9,mixedType,1
6,3,0,9,mixedType,1
3,6,0,9,mixedType,1
7,3,0,10,mixedType,1
12,3,0,15,mixedType,2
6,1,0,7,mixedType,0
6,1,0,7,mixedType,0
4,6,0,10,mixedType,1
3,8,0,11,mixedType,1
4,5,0,9,mixedType,1
3,6,0,9,mixedType,1
6,5,0,11,mixedType,1
3,6,0,9,mixedType,1
5,2,0,7,mixedType,0
9,3,0,12,mixedType,1
5,4,0,9,mixedType,1
9,1,0,10,mixedType,1
4,4,0,8,mixedType,1
9,2,0,11,mixedType,1
5,2,0,7,mixedType,0
3,8,0,11,mixedType,1
7,3,0,10,mixedType,1
4,5,0,9,mixedType,1
10,2,0,12,mixedType,1
8,2,0,10,mixedType,1
6,2,0,8,mixedType,1
8,2,0,10,mixedType,1
6,4,0,10,mixedType,1
7,4,0,11,mixedType,1
4,6,0,10,mixedType,1
7,3,0,10,mixedType,1
9,1,0,10,mixedType,1
8,4,0,12,mixedType,1
4,6,0,10,mixedType,1
5,3,0,8,mixedType,1
9,1,0,10,mixedType,1
4,7,0,11,mixedType,1
8,1,0,9,mixedType,1
5,4,0,9,mixedType,1
13,3,0,16,mixedType,2
4,4,0,8,mixedType,1
7,3,0,10,mixedType,1
4,7,0,11,mixedType,1
6,1,0,7,mixedType,0
9,1,0,10,mixedType,1
2,8,0,10,mixedType,1
5,1,0,6,mixedType,0
7,3,0,10,mixedType,1
2,10,0,12,mixedType,1
5,1,0,6,mixedType,0
9,2,0,11,mixedType,1
4,4,0,8,mixedType,1
5,4,0,9,mixedType,1
15,1,0,16,mixedType,2
4,4,0,8,mixedType,1
6,2,0,8,mixedType,1
2,6,0,8,mixedType,1
7,3,0,10,mixedType,1
12,3,0,15,mixedType,2
12,3,1,16,mixedType,2
9,3,0,12,mixedType,1
5,2,0,7,mixedType,0
7,0,0,7,sameType,0
14,2,0,16,mixedType,2
7,1,0,8,mixedType,1
9,4,0,13,mixedType,1
1,9,0,10,mixedType,1
6,1,0,7,mixedType,0
6,5,0,11,mixedType,1
6,7,0,13,mixedType,1
4,6,0,10,mixedType,1
6,3,0,9,mixedType,1
8,1,0,9,mixedType,1
4,9,0,13,mixedType,1
3,3,0,6,mixedType,0
7,2,0,9,mixedType,1
1,8,0,9,mixedType,1
1,8,0,9,mixedType,1
7,3,0,10,mixedType,1
1,9,0,10,mixedType,1
7,3,0,10,mixedType,1
8,1,0,9,mixedType,1
3,7,0,10,mixedType,1
9,2,0,11,mixedType,1
8,3,0,11,mixedType,1
6,2,0,8,mixedType,1
4,2,0,6,mixedType,0
10,3,0,13,mixedType,1
6,1,0,7,mixedType,0
20,1,1,22,mixedType,2
5,1,0,6,mixedType,0
6,1,0,7,mixedType,0
2,4,0,6,mixedType,0
12,3,0,15,mixedType,2
8,2,0,10,mixedType,1
6,2,0,8,mixedType,1
4,4,0,8,mixedType,1
6,3,0,9,mixedType,1
7,3,0,10,mixedType,1
4,2,0,6,mixedType,0
14,2,0,16,mixedType,2
6,1,0,7,mixedType,0
6,2,0,8,mixedType,1
7,3,0,10,mixedType,1
9,2,0,11,mixedType,1
7,2,0,9,mixedType,1
8,4,0,12,mixedType,1
6,7,0,13,mixedType,1
5,2,0,7,mixedType,0
6,3,0,9,mixedType,1
9,3,0,12,mixedType,1
6,1,0,7,mixedType,0
7,3,0,10,mixedType,1
5,3,0,8,mixedType,1
10,3,0,13,mixedType,1
4,8,0,12,mixedType,1
9,2,0,11,mixedType,1
14,2,0,16,mixedType,2
8,1,0,9,mixedType,1
7,2,0,9,mixedType,1
5,4,0,9,mixedType,1
8,3,0,11,mixedType,1
9,3,0,12,mixedType,1
7,4,0,11,mixedType,1
13,2,0,15,mixedType,2
5,3,0,8,mixedType,1
4,4,0,8,mixedType,1
14,2,0,16,mixedType,2
4,6,0,10,mixedType,1
6,2,0,8,mixedType,1
16,1,0,17,mixedType,2
5,1,0,6,mixedType,0
5,5,0,10,mixedType,1
6,1,0,7,mixedType,0
4,2,0,6,mixedType,0
13,3,0,16,mixedType,2
8,5,0,13,mixedType,1
6,2,0,8,mixedType,1
4,4,0,8,mixedType,1
4,2,0,6,mixedType,0
4,6,0,10,mixedType,1
6,3,0,9,mixedType,1
14,2,0,16,mixedType,2
5,4,0,9,mixedType,1
5,3,0,8,mixedType,1
8,2,0,10,mixedType,1
7,3,0,10,mixedType,1
7,1,0,8,mixedType,1
7,3,0,10,mixedType,1
6,3,0,9,mixedType,1
9,1,0,10,mixedType,1
11,3,0,14,mixedType,2
14,2,0,16,mixedType,2
6,3,0,9,mixedType,1
8,1,0,9,mixedType,1
5,3,0,8,mixedType,1
6,3,0,9,mixedType,1
6,4,0,10,mixedType,1
6,3,0,9,mixedType,1
6,3,0,9,mixedType,1
6,2,0,8,mixedType,1
12,4,0,16,mixedType,2
5,3,0,8,mixedType,1
2,9,0,11,mixedType,1
9,1,0,10,mixedType,1
7,3,0,10,mixedType,1
4,6,0,10,mixedType,1
6,3,0,9,mixedType,1
6,3,0,9,mixedType,1
11,2,0,13,mixedType,1
9,3,0,12,mixedType,1
10,2,0,12,mixedType,1
6,1,0,7,mixedType,0
3,3,0,6,mixedType,0
10,3,0,13,mixedType,1
4,4,0,8,mixedType,1
15,1,0,16,mixedType,2
9,0,1,10,mixedType,1
1,7,0,8,mixedType,1
5,3,0,8,mixedType,1
8,1,0,9,mixedType,1
4,4,0,8,mixedType,1
13,3,0,16,mixedType,2
5,2,0,7,mixedType,0
5,2,0,7,mixedType,0
5,3,0,8,mixedType,1
5,2,0,7,mixedType,0
5,3,0,8,mixedType,1
3,6,0,9,mixedType,1
12,4,0,16,mixedType,2
14,2,0,16,mixedType,2
3,6,0,9,mixedType,1
13,3,0,16,mixedType,2
5,3,0,8,mixedType,1
7,3,0,10,mixedType,1
14,2,0,16,mixedType,2
7,1,0,8,mixedType,1
7,1,0,8,mixedType,1
5,2,0,7,mixedType,0
6,1,0,7,mixedType,0
1,9,0,10,mixedType,1
4,2,0,6,mixedType,0
5,5,0,10,mixedType,1
9,2,0,11,mixedType,1
2,6,0,8,mixedType,1
10,3,0,13,mixedType,1
13,3,0,16,mixedType,2
6,2,0,8,mixedType,1
9,1,0,10,mixedType,1
4,4,0,8,mixedType,1
6,1,0,7,mixedType,0
8,2,0,10,mixedType,1
13,3,0,16,mixedType,2
9,6,1,16,mixedType,2
6,4,0,10,mixedType,1
4,5,0,9,mixedType,1
6,3,0,9,mixedType,1
6,4,0,10,mixedType,1
5,2,0,7,mixedType,0
14,2,0,16,mixedType,2
14,2,0,16,mixedType,2
14,2,0,16,mixedType,2
6,3,0,9,mixedType,1
5,4,0,9,mixedType,1
8,4,0,12,mixedType,1
14,2,0,16,mixedType,2
5,3,0,8,mixedType,1
14,2,0,16,mixedType,2
7,2,0,9,mixedType,1
8,4,0,12,mixedType,1
5,3,0,8,mixedType,1
6,1,0,7,mixedType,0
6,4,0,10,mixedType,1
5,2,0,7,mixedType,0
9,2,0,11,mixedType,1
6,1,0,7,mixedType,0
9,2,0,11,mixedType,1
7,3,0,10,mixedType,1
8,4,0,12,mixedType,1
2,4,0,6,mixedType,0
8,2,0,10,mixedType,1
18,1,1,20,mixedType,2
9,1,0,10,mixedType,1
10,3,0,13,mixedType,1
6,3,0,9,mixedType,1
9,2,0,11,mixedType,1
4,2,0,6,mixedType,0
8,2,0,10,mixedType,1
4,7,0,11,mixedType,1
9,2,0,11,mixedType,1
5,3,0,8,mixedType,1
5,3,0,8,mixedType,1
7,3,0,10,mixedType,1
14,1,0,15,mixedType,2
6,3,0,9,mixedType,1
5,3,0,8,mixedType,1
6,4,0,10,mixedType,1
9,2,0,11,mixedType,1
8,4,0,12,mixedType,1
13,3,0,16,mixedType,2
11,3,0,14,mixedType,2
8,4,0,12,mixedType,1
8,1,0,9,mixedType,1
8,3,0,11,mixedType,1
6,3,0,9,mixedType,1
7,2,0,9,mixedType,1
1,8,0,9,mixedType,1
8,3,0,11,mixedType,1
7,1,0,8,mixedType,1
14,2,0,16,mixedType,2
5,4,0,9,mixedType,1
12,3,0,15,mixedType,2
4,8,0,12,mixedType,1
2,4,0,6,mixedType,0
5,2,0,7,mixedType,0
9,4,0,13,mixedType,1
3,6,0,9,mixedType,1
7,3,0,10,mixedType,1
6,2,0,8,mixedType,1
6,3,0,9,mixedType,1
9,2,0,11,mixedType,1
9,2,0,11,mixedType,1
6,2,0,8,mixedType,1
7,2,0,9,mixedType,1
5,1,0,6,mixedType,0
7,2,0,9,mixedType,1
1,8,0,9,mixedType,1
3,3,0,6,mixedType,0
10,2,0,12,mixedType,1
7,3,0,10,mixedType,1
8,1,0,9,mixedType,1
6,5,0,11,mixedType,1
5,1,0,6,mixedType,0
5,3,0,8,mixedType,1
1,8,0,9,mixedType,1
5,4,0,9,mixedType,1
10,2,0,12,mixedType,1
6,2,0,8,mixedType,1
4,6,0,10,mixedType,1
6,1,0,7,mixedType,0
6,3,0,9,mixedType,1
7,1,0,8,mixedType,1
8,2,0,10,mixedType,1
5,2,0,7,mixedType,0
7,3,0,10,mixedType,1
10,1,0,11,mixedType,1
9,1,0,10,mixedType,1
5,2,0,7,mixedType,0
7,1,0,8,mixedType,1
4,6,0,10,mixedType,1
6,3,0,9,mixedType,1
5,5,0,10,mixedType,1
2,8,0,10,mixedType,1
7,3,0,10,mixedType,1
8,2,0,10,mixedType,1
0,9,0,9,sameType,1
4,4,0,8,mixedType,1
14,2,0,16,mixedType,2
6,2,0,8,mixedType,1
1,8,0,9,mixedType,1
10,2,0,12,mixedType,1
6,3,0,9,mixedType,1
6,7,0,13,mixedType,1
5,4,0,9,mixedType,1
1,11,0,12,mixedType,1
7,3,0,10,mixedType,1
6,1,0,7,mixedType,0
7,4,0,11,mixedType,1
2,10,0,12,mixedType,1
9,2,0,11,mixedType,1
10,6,0,16,mixedType,2
8,4,0,12,mixedType,1
8,2,0,10,mixedType,1
10,2,0,12,mixedType,1
13,3,0,16,mixedType,2
3,6,0,9,mixedType,1
7,3,0,10,mixedType,1
5,4,0,9,mixedType,1
5,3,0,8,mixedType,1
5,1,0,6,mixedType,0
6,3,0,9,mixedType,1
8,2,0,10,mixedType,1
8,3,0,11,mixedType,1
6,4,0,10,mixedType,1
11,8,0,19,mixedType,2
5,2,0,7,mixedType,0
6,3,0,9,mixedType,1
8,2,0,10,mixedType,1
5,8,0,13,mixedType,1
2,6,0,8,mixedType,1
12,3,0,15,mixedType,2
8,1,0,9,mixedType,1
9,0,1,10,mixedType,1
7,3,0,10,mixedType,1
9,1,0,10,mixedType,1
6,1,0,7,mixedType,0
9,2,0,11,mixedType,1
7,3,0,10,mixedType,1
8,2,0,10,mixedType,1
8,3,0,11,mixedType,1
3,8,0,11,mixedType,1
12,3,0,15,mixedType,2
13,3,0,16,mixedType,2
8,1,0,9,mixedType,1
10,2,0,12,mixedType,1
8,1,0,9,mixedType,1
5,2,0,7,mixedType,0
6,1,0,7,mixedType,0
12,4,0,16,mixedType,2
4,8,0,12,mixedType,1
6,4,0,10,mixedType,1
9,4,0,13,mixedType,1
7,1,0,8,mixedType,1
2,6,0,8,mixedType,1
4,4,0,8,mixedType,1
1,8,0,9,mixedType,1
8,2,0,10,mixedType,1
7,2,0,9,mixedType,1
6,2,0,8,mixedType,1
8,3,0,11,mixedType,1
7,2,0,9,mixedType,1
4,4,0,8,mixedType,1
8,2,0,10,mixedType,1
6,4,0,10,mixedType,1
11,4,0,15,mixedType,2
5,4,0,9,mixedType,1
6,4,0,10,mixedType,1
6,3,0,9,mixedType,1
3,6,0,9,mixedType,1
14,2,0,16,mixedType,2
8,1,0,9,mixedType,1
9,4,0,13,mixedType,1
6,4,0,10,mixedType,1
2,8,0,10,mixedType,1
6,3,0,9,mixedType,1
4,6,0,10,mixedType,1
7,3,0,10,mixedType,1
4,6,0,10,mixedType,1
2,10,0,12,mixedType,1
2,6,0,8,mixedType,1
9,2,0,11,mixedType,1
7,0,2,9,mixedType,1
6,1,0,7,mixedType,0
3,7,0,10,mixedType,1
6,1,0,7,mixedType,0
5,2,0,7,mixedType,0
7,3,0,10,mixedType,1
10,1,0,11,mixedType,1
9,1,0,10,mixedType,1
9,1,0,10,mixedType,1
11,5,0,16,mixedType,2
7,4,0,11,mixedType,1
8,1,0,9,mixedType,1
7,3,0,10,mixedType,1
4,4,0,8,mixedType,1
6,3,0,9,mixedType,1
1,7,0,8,mixedType,1
3,5,0,8,mixedType,1
9,4,0,13,mixedType,1
9,1,0,10,mixedType,1
5,4,0,9,mixedType,1
6,3,0,9,mixedType,1
7,2,0,9,mixedType,1
6,4,0,10,mixedType,1
7,3,0,10,mixedType,1
7,4,0,11,mixedType,1
5,6,0,11,mixedType,1
7,3,0,10,mixedType,1
6,4,0,10,mixedType,1
6,1,0,7,mixedType,0
4,2,0,6,mixedType,0
1,8,0,9,mixedType,1
8,4,0,12,mixedType,1
8,2,0,10,mixedType,1
11,3,0,14,mixedType,2
5,1,0,6,mixedType,0
2,6,0,8,mixedType,1
7,3,0,10,mixedType,1
6,3,0,9,mixedType,1
5,4,0,9,mixedType,1
8,5,0,13,mixedType,1
3,6,0,9,mixedType,1
7,2,0,9,mixedType,1
6,3,0,9,mixedType,1
12,3,0,15,mixedType,2
4,4,0,8,mixedType,1
9,1,0,10,mixedType,1
7,1,0,8,mixedType,1
7,1,0,8,mixedType,1
8,1,0,9,mixedType,1
7,3,0,10,mixedType,1
8,3,0,11,mixedType,1
1,8,0,9,mixedType,1
5,3,0,8,mixedType,1
3,5,0,8,mixedType,1
9,1,0,10,mixedType,1
9,2,0,11,mixedType,1
7,3,0,10,mixedType,1
14,2,0,16,mixedType,2
2,8,0,10,mixedType,1
3,7,0,10,mixedType,1
2,4,0,6,mixedType,0
4,4,0,8,mixedType,1
8,2,0,10,mixedType,1
1,8,0,9,mixedType,1
9,1,0,10,mixedType,1
3,3,0,6,mixedType,0
7,3,0,10,mixedType,1
4,9,0,13,mixedType,1
6,4,0,10,mixedType,1
3,6,0,9,mixedType,1
11,3,0,14,mixedType,2
5,3,0,8,mixedType,1
7,1,0,8,mixedType,1
5,2,0,7,mixedType,0
7,2,0,9,mixedType,1
7,1,0,8,mixedType,1
8,2,0,10,mixedType,1
9,4,3,16,mixedType,2
11,3,0,14,mixedType,2
1,10,0,11,mixedType,1
2,7,0,9,mixedType,1
11,3,0,14,mixedType,2
10,4,0,14,mixedType,2
9,3,0,12,mixedType,1
4,4,0,8,mixedType,1
5,1,0,6,mixedType,0
4,2,0,6,mixedType,0
2,6,0,8,mixedType,1
8,1,0,9,mixedType,1
6,1,0,7,mixedType,0
4,4,0,8,mixedType,1
5,2,0,7,mixedType,0
7,3,0,10,mixedType,1
5,5,0,10,mixedType,1
6,3,0,9,mixedType,1
7,3,0,10,mixedType,1
8,1,0,9,mixedType,1
10,4,1,15,mixedType,2
8,1,0,9,mixedType,1
9,1,0,10,mixedType,1
13,3,0,16,mixedType,2
6,3,0,9,mixedType,1
14,2,0,16,mixedType,2
8,1,0,9,mixedType,1
5,2,0,7,mixedType,0
6,4,0,10,mixedType,1
5,4,0,9,mixedType,1
4,2,0,6,mixedType,0
9,1,0,10,mixedType,1
14,2,0,16,mixedType,2
6,3,0,9,mixedType,1
8,4,0,12,mixedType,1
1,8,0,9,mixedType,1
8,3,0,11,mixedType,1
5,4,0,9,mixedType,1
3,7,0,10,mixedType,1
5,2,0,7,mixedType,0
3,3,0,6,mixedType,0
14,2,0,16,mixedType,2
6,2,0,8,mixedType,1
13,4,1,18,mixedType,2
8,3,0,11,mixedType,1
5,3,0,8,mixedType,1
7,2,0,9,mixedType,1
6,1,0,7,mixedType,0
7,3,0,10,mixedType,1
10,4,0,14,mixedType,2
7,3,0,10,mixedType,1
6,2,0,8,mixedType,1
4,2,0,6,mixedType,0
5,6,0,11,mixedType,1
4,4,0,8,mixedType,1
15,1,0,16,mixedType,2
7,3,0,10,mixedType,1
7,2,0,9,mixedType,1
10,4,0,14,mixedType,2
7,1,0,8,mixedType,1
10,4,0,14,mixedType,2
6,1,0,7,mixedType,0
1,10,0,11,mixedType,1
8,1,0,9,mixedType,1
6,3,0,9,mixedType,1
6,2,0,8,mixedType,1
8,1,0,9,mixedType,1
6,3,0,9,mixedType,1
7,2,0,9,mixedType,1
2,4,0,6,mixedType,0
7,1,0,8,mixedType,1
5,2,0,7,mixedType,0
5,5,0,10,mixedType,1
9,3,0,12,mixedType,1
10,2,0,12,mixedType,1
7,3,0,10,mixedType,1
2,7,0,9,mixedType,1
8,1,0,9,mixedType,1
8,8,3,19,mixedType,2
5,1,0,6,mixedType,0
3,10,0,13,mixedType,1
6,3,0,9,mixedType,1
5,2,0,7,mixedType,0
5,1,0,6,mixedType,0
12,4,0,16,mixedType,2
6,3,0,9,mixedType,1
1,8,0,9,mixedType,1
1,8,0,9,mixedType,1
7,2,0,9,mixedType,1
9,5,0,14,mixedType,2
9,2,0,11,mixedType,1
15,1,0,16,mixedType,2
1,7,0,8,mixedType,1
2,10,0,12,mixedType,1
4,6,0,10,mixedType,1
6,4,0,10,mixedType,1
6,3,0,9,mixedType,1
1,7,0,8,mixedType,1
13,3,0,16,mixedType,2
8,2,0,10,mixedType,1
6,2,0,8,mixedType,1
6,2,0,8,mixedType,1
9,3,0,12,mixedType,1
9,1,0,10,mixedType,1
6,1,0,7,mixedType,0
4,5,0,9,mixedType,1
9,1,0,10,mixedType,1
8,2,0,10,mixedType,1
10,2,0,12,mixedType,1
5,2,0,7,mixedType,0
4,2,0,6,mixedType,0
7,1,0,8,mixedType,1
9,3,0,12,mixedType,1
14,2,0,16,mixedType,2
6,1,0,7,mixedType,0
6,2,0,8,mixedType,1
5,4,0,9,mixedType,1
6,5,0,11,mixedType,1
7,2,0,9,mixedType,1
6,4,0,10,mixedType,1
6,3,0,9,mixedType,1
4,9,0,13,mixedType,1
4,4,0,8,mixedType,1
6,3,0,9,mixedType,1
9,1,0,10,mixedType,1
11,5,0,16,mixedType,2
9,1,0,10,mixedType,1
4,4,0,8,mixedType,1
2,8,0,10,mixedType,1
9,1,0,10,mixedType,1
9,3,0,12,mixedType,1
8,3,0,11,mixedType,1
6,4,0,10,mixedType,1
8,1,0,9,mixedType,1
10,6,0,16,mixedType,2
5,3,0,8,mixedType,1
6,1,0,7,mixedType,0
10,5,0,15,mixedType,2
5,3,0,8,mixedType,1
6,2,0,8,mixedType,1
5,2,0,7,mixedType,0
6,3,0,9,mixedType,1
14,2,0,16,mixedType,2
6,7,0,13,mixedType,1
4,2,0,6,mixedType,0
8,2,0,10,mixedType,1
5,1,0,6,mixedType,0
8,1,0,9,mixedType,1
6,2,0,8,mixedType,1
5,4,0,9,mixedType,1
8,3,0,11,mixedType,1
10,2,0,12,mixedType,1
5,3,0,8,mixedType,1
11,1,0,12,mixedType,1
7,1,0,8,mixedType,1
5,2,0,7,mixedType,0
11,1,0,12,mixedType,1
4,6,0,10,mixedType,1
13,3,0,16,mixedType,2
7,3,0,10,mixedType,1
5,3,0,8,mixedType,1
6,1,0,7,mixedType,0
7,6,0,13,mixedType,1
10,1,0,11,mixedType,1
6,2,0,8,mixedType,1
5,2,0,7,mixedType,0
6,2,0,8,mixedType,1
9,1,0,10,mixedType,1
7,3,0,10,mixedType,1
7,2,0,9,mixedType,1
13,3,0,16,mixedType,2
10,1,0,11,mixedType,1
3,5,0,8,mixedType,1
7,3,0,10,mixedType,1
4,4,0,8,mixedType,1
1,7,0,8,mixedType,1
5,4,0,9,mixedType,1
9,1,0,10,mixedType,1
15,1,0,16,mixedType,2
4,2,0,6,mixedType,0
7,3,0,10,mixedType,1
8,3,0,11,mixedType,1
4,6,0,10,mixedType,1
8,4,0,12,mixedType,1
8,2,0,10,mixedType,1
6,4,0,10,mixedType,1
9,1,0,10,mixedType,1
9,7,0,16,mixedType,2
6,1,0,7,mixedType,0
6,1,0,7,mixedType,0
5,3,0,8,mixedType,1
6,3,0,9,mixedType,1
13,3,0,16,mixedType,2
3,7,0,10,mixedType,1
7,3,0,10,mixedType,1
5,2,0,7,mixedType,0
5,3,0,8,mixedType,1
3,6,0,9,mixedType,1
8,2,0,10,mixedType,1
5,1,0,6,mixedType,0
6,2,0,8,mixedType,1
9,2,0,11,mixedType,1
12,4,0,16,mixedType,2
4,2,0,6,mixedType,0
5,4,0,9,mixedType,1
13,3,0,16,mixedType,2
5,6,0,11,mixedType,1
10,1,0,11,mixedType,1
5,6,0,11,mixedType,1
3,3,0,6,mixedType,0
0,6,2,8,mixedType,1
5,2,0,7,mixedType,0
6,3,0,9,mixedType,1
6,1,0,7,mixedType,0
13,3,0,16,mixedType,2
5,3,0,8,mixedType,1
8,1,0,9,mixedType,1
1,8,0,9,mixedType,1
1,7,0,8,mixedType,1
3,6,0,9,mixedType,1
3,6,0,9,mixedType,1
10,2,0,12,mixedType,1
8,2,0,10,mixedType,1
6,1,0,7,mixedType,0
3,8,0,11,mixedType,1
9,3,0,12,mixedType,1
5,4,0,9,mixedType,1
3,5,0,8,mixedType,1
5,2,0,7,mixedType,0
4,2,0,6,mixedType,0
3,8,0,11,mixedType,1
5,2,0,7,mixedType,0
13,3,0,16,mixedType,2
5,5,0,10,mixedType,1
5,3,0,8,mixedType,1
7,2,0,9,mixedType,1
10,2,0,12,mixedType,1
8,3,0,11,mixedType,1
13,3,1,17,mixedType,2
5,2,0,7,mixedType,0
6,3,0,9,mixedType,1
8,3,0,11,mixedType,1
7,3,0,10,mixedType,1
2,10,0,12,mixedType,1
11,2,0,13,mixedType,1
6,4,0,10,mixedType,1
2,11,0,13,mixedType,1
3,7,0,10,mixedType,1
4,4,0,8,mixedType,1
7,1,0,8,mixedType,1
10,1,0,11,mixedType,1
5,2,0,7,mixedType,0
7,3,0,10,mixedType,1
3,3,0,6,mixedType,0
7,3,0,10,mixedType,1
9,1,0,10,mixedType,1
11,5,0,16,mixedType,2
6,1,0,7,mixedType,0
4,2,0,6,mixedType,0
14,2,0,16,mixedType,2
7,6,0,13,mixedType,1
8,1,0,9,mixedType,1
7,3,0,10,mixedType,1
5,2,0,7,mixedType,0
7,3,0,10,mixedType,1
4,2,0,6,mixedType,0
2,8,0,10,mixedType,1
5,4,0,9,mixedType,1
9,3,0,12,mixedType,1
7,3,0,10,mixedType,1
5,3,0,8,mixedType,1
15,1,0,16,mixedType,2
5,3,0,8,mixedType,1
10,5,0,15,mixedType,2
7,3,0,10,mixedType,1
6,3,0,9,mixedType,1
3,5,0,8,mixedType,1
2,8,0,10,mixedType,1
7,1,0,8,mixedType,1
6,3,0,9,mixedType,1
10,1,0,11,mixedType,1
7,3,0,10,mixedType,1
9,9,0,18,mixedType,2
5,1,0,6,mixedType,0
5,2,0,7,mixedType,0
7,2,0,9,mixedType,1
6,1,0,7,mixedType,0
5,6,0,11,mixedType,1
6,1,0,7,mixedType,0
6,4,0,10,mixedType,1
9,1,0,10,mixedType,1
6,2,0,8,mixedType,1
2,4,0,6,mixedType,0
7,2,0,9,mixedType,1
7,3,0,10,mixedType,1
8,2,0,10,mixedType,1
10,1,0,11,mixedType,1
6,1,0,7,mixedType,0
15,1,0,16,mixedType,2
5,3,0,8,mixedType,1
7,1,0,8,mixedType,1
2,8,0,10,mixedType,1
6,3,0,9,mixedType,1
14,2,0,16,mixedType,2
1,10,0,11,mixedType,1
6,4,0,10,mixedType,1
7,3,0,10,mixedType,1
14,2,0,16,mixedType,2
10,1,0,11,mixedType,1
7,2,0,9,mixedType,1
3,6,0,9,mixedType,1
6,2,0,8,mixedType,1
5,1,0,6,mixedType,0
13,3,0,16,mixedType,2
6,4,0,10,mixedType,1
4,7,0,11,mixedType,1
7,3,0,10,mixedType,1
7,6,0,13,mixedType,1
6,10,0,16,mixedType,2
2,6,0,8,mixedType,1
8,2,0,10,mixedType,1
7,2,0,9,mixedType,1
3,6,0,9,mixedType,1
0,6,1,7,mixedType,0
6,3,0,9,mixedType,1
6,3,0,9,mixedType,1
5,2,0,7,mixedType,0
4,4,0,8,mixedType,1
6,3,0,9,mixedType,1
5,2,0,7,mixedType,0
8,2,0,10,mixedType,1
9,3,0,12,mixedType,1
2,8,0,10,mixedType,1
1,8,0,9,mixedType,1
7,2,0,9,mixedType,1
5,3,0,8,mixedType,1
5,2,0,7,mixedType,0
13,3,0,16,mixedType,2
5,3,0,8,mixedType,1
7,2,0,9,mixedType,1
9,2,0,11,mixedType,1
6,2,0,8,mixedType,1
9,2,0,11,mixedType,1
7,3,0,10,mixedType,1
6,3,0,9,mixedType,1
4,4,0,8,mixedType,1
5,4,0,9,mixedType,1
5,4,0,9,mixedType,1
8,1,0,9,mixedType,1
10,1,0,11,mixedType,1
13,3,0,16,mixedType,2
15,1,0,16,mixedType,2
8,3,0,11,mixedType,1
9,1,0,10,mixedType,1
4,2,0,6,mixedType,0
6,3,0,9,mixedType,1
8,1,0,9,mixedType,1
8,4,0,12,mixedType,1
8,4,0,12,mixedType,1
7,1,0,8,mixedType,1
5,3,0,8,mixedType,1
6,2,0,8,mixedType,1
12,4,0,16,mixedType,2
5,3,0,8,mixedType,1
5,2,0,7,mixedType,0
8,3,0,11,mixedType,1
9,3,0,12,mixedType,1
8,1,0,9,mixedType,1
5,5,0,10,mixedType,1
15,1,0,16,mixedType,2
8,4,0,12,mixedType,1
6,2,0,8,mixedType,1
8,2,0,10,mixedType,1
11,3,0,14,mixedType,2
5,6,0,11,mixedType,1
7,1,0,8,mixedType,1
11,0,1,12,mixedType,1
4,2,0,6,mixedType,0
8,2,0,10,mixedType,1
5,2,0,7,mixedType,0
15,1,0,16,mixedType,2
5,3,0,8,mixedType,1
10,3,0,13,mixedType,1
8,2,0,10,mixedType,1
6,1,0,7,mixedType,0
6,3,0,9,mixedType,1
7,2,0,9,mixedType,1
5,4,0,9,mixedType,1
4,2,0,6,mixedType,0
15,1,0,16,mixedType,2
7,2,0,9,mixedType,1
7,3,0,10,mixedType,1
6,3,0,9,mixedType,1
4,4,0,8,mixedType,1
7,2,0,9,mixedType,1
6,2,0,8,mixedType,1
8,4,0,12,mixedType,1
18,1,1,20,mixedType,2
12,1,0,13,mixedType,1
6,4,0,10,mixedType,1
7,3,0,10,mixedType,1
9,3,0,12,mixedType,1
5,3,0,8,mixedType,1
8,2,0,10,mixedType,1
14,2,0,16,mixedType,2
12,4,1,17,mixedType,2
6,1,0,7,mixedType,0
5,4,0,9,mixedType,1
1,8,0,9,mixedType,1
6,1,0,7,mixedType,0
7,2,0,9,mixedType,1
7,0,2,9,mixedType,1
5,2,0,7,mixedType,0
12,4,0,16,mixedType,2
7,3,0,10,mixedType,1
4,4,0,8,mixedType,1
7,2,0,9,mixedType,1
15,1,0,16,mixedType,2
5,1,0,6,mixedType,0
4,4,0,8,mixedType,1
8,4,0,12,mixedType,1
11,1,0,12,mixedType,1
7,2,0,9,mixedType,1
9,2,0,11,mixedType,1
4,4,0,8,mixedType,1
7,2,0,9,mixedType,1
7,2,0,9,mixedType,1
11,1,0,12,mixedType,1
4,6,0,10,mixedType,1
16,2,2,20,mixedType,2
7,2,0,9,mixedType,1
2,4,0,6,mixedType,0
4,5,0,9,mixedType,1
6,1,0,7,mixedType,0
10,2,0,12,mixedType,1
7,4,0,11,mixedType,1
6,4,0,10,mixedType,1
6,2,0,8,mixedType,1
14,2,0,16,mixedType,2
1,5,0,6,mixedType,0
7,3,0,10,mixedType,1
7,2,0,9,mixedType,1
8,2,0,10,mixedType,1
7,3,0,10,mixedType,1
5,2,0,7,mixedType,0
6,1,0,7,mixedType,0
8,2,0,10,mixedType,1
6,2,0,8,mixedType,1
7,3,0,10,mixedType,1
8,1,0,9,mixedType,1
7,3,0,10,mixedType,1
7,1,0,8,mixedType,1
5,3,0,8,mixedType,1
6,1,0,7,mixedType,0
3,7,0,10,mixedType,1
8,2,0,10,mixedType,1
9,2,0,11,mixedType,1
5,4,0,9,mixedType,1
1,9,0,10,mixedType,1
1,10,0,11,mixedType,1
8,1,0,9,mixedType,1
5,2,0,7,mixedType,0
5,2,0,7,mixedType,0
5,3,0,8,mixedType,1
1,7,0,8,mixedType,1
9,3,0,12,mixedType,1
7,3,0,10,mixedType,1
13,3,0,16,mixedType,2
5,3,0,8,mixedType,1
6,4,0,10,mixedType,1
7,3,0,10,mixedType,1
6,3,0,9,mixedType,1
7,3,0,10,mixedType,1
6,1,0,7,mixedType,0
6,3,0,9,mixedType,1
8,2,0,10,mixedType,1
5,3,0,8,mixedType,1
8,1,0,9,mixedType,1
6,4,0,10,mixedType,1
6,3,0,9,mixedType,1
8,2,0,10,mixedType,1
5,4,0,9,mixedType,1
8,1,0,9,mixedType,1
9,2,0,11,mixedType,1
6,3,0,9,mixedType,1
8,2,0,10,mixedType,1
9,1,0,10,mixedType,1
6,4,0,10,mixedType,1
6,2,0,8,mixedType,1
5,1,0,6,mixedType,0
1,8,0,9,mixedType,1
6,2,0,8,mixedType,1
6,3,0,9,mixedType,1
2,4,0,6,mixedType,0
6,3,0,9,mixedType,1
7,3,0,10,mixedType,1
6,5,0,11,mixedType,1
6,3,0,9,mixedType,1
5,3,0,8,mixedType,1
7,1,0,8,mixedType,1
1,7,0,8,mixedType,1
2,6,0,8,mixedType,1
7,3,0,10,mixedType,1
5,1,0,6,mixedType,0
4,5,0,9,mixedType,1
6,3,0,9,mixedType,1
2,6,0,8,mixedType,1
2,6,0,8,mixedType,1
6,3,0,9,mixedType,1
2,4,0,6,mixedType,0
11,1,0,12,mixedType,1
8,1,0,9,mixedType,1
6,4,0,10,mixedType,1
6,6,0,12,mixedType,1
7,4,0,11,mixedType,1
8,3,0,11,mixedType,1
14,2,0,16,mixedType,2
1,7,0,8,mixedType,1
5,3,0,8,mixedType,1
5,3,0,8,mixedType,1
7,2,0,9,mixedType,1
7,4,0,11,mixedType,1
7,3,0,10,mixedType,1
7,3,0,10,mixedType,1
6,1,0,7,mixedType,0
6,2,0,8,mixedType,1
12,3,0,15,mixedType,2
5,6,0,11,mixedType,1
7,3,0,10,mixedType,1
5,7,0,12,mixedType,1
6,2,0,8,mixedType,1
6,3,0,9,mixedType,1
7,4,0,11,mixedType,1
4,8,0,12,mixedType,1
13,3,0,16,mixedType,2
5,3,0,8,mixedType,1
1,7,0,8,mixedType,1
7,2,0,9,mixedType,1
4,4,0,8,mixedType,1
6,3,0,9,mixedType,1
9,1,0,10,mixedType,1
9,2,0,11,mixedType,1
5,3,0,8,mixedType,1
15,1,0,16,mixedType,2
5,3,0,8,mixedType,1
8,1,0,9,mixedType,1
9,4,1,14,mixedType,2
9,0,1,10,mixedType,1
7,3,0,10,mixedType,1
15,1,0,16,mixedType,2
8,3,0,11,mixedType,1
7,1,0,8,mixedType,1
2,7,0,9,mixedType,1
5,4,0,9,mixedType,1
6,2,0,8,mixedType,1
3,10,0,13,mixedType,1
3,3,0,6,mixedType,0
4,4,0,8,mixedType,1
15,1,0,16,mixedType,2
7,1,0,8,mixedType,1
1,11,0,12,mixedType,1
8,5,0,13,mixedType,1
5,3,0,8,mixedType,1
6,0,1,7,mixedType,0
9,2,0,11,mixedType,1
9,1,0,10,mixedType,1
8,1,0,9,mixedType,1
5,4,0,9,mixedType,1
1,7,0,8,mixedType,1
11,7,0,18,mixedType,2
5,3,0,8,mixedType,1
7,3,0,10,mixedType,1
9,3,0,12,mixedType,1
3,6,0,9,mixedType,1
10,3,0,13,mixedType,1
12,4,0,16,mixedType,2
5,1,0,6,mixedType,0
8,2,0,10,mixedType,1
6,2,0,8,mixedType,1
5,5,0,10,mixedType,1
4,2,0,6,mixedType,0
6,4,0,10,mixedType,1
7,3,0,10,mixedType,1
5,3,0,8,mixedType,1
9,2,0,11,mixedType,1
3,7,0,10,mixedType,1
6,1,0,7,mixedType,0
4,4,0,8,mixedType,1
13,3,0,16,mixedType,2
8,6,0,14,mixedType,2
7,2,0,9,mixedType,1
8,3,0,11,mixedType,1
9,2,0,11,mixedType,1
6,3,0,9,mixedType,1
14,2,0,16,mixedType,2
10,6,0,16,mixedType,2
8,2,0,10,mixedType,1
8,1,0,9,mixedType,1
6,4,0,10,mixedType,1
8,1,0,9,mixedType,1
7,2,0,9,mixedType,1
4,4,0,8,mixedType,1
6,2,0,8,mixedType,1
5,4,0,9,mixedType,1
9,1,0,10,mixedType,1
4,4,0,8,mixedType,1
7,4,0,11,mixedType,1
6,2,0,8,mixedType,1
5,3,0,8,mixedType,1
6,4,0,10,mixedType,1
14,2,0,16,mixedType,2
7,1,0,8,mixedType,1
6,4,0,10,mixedType,1
5,3,0,8,mixedType,1
5,4,0,9,mixedType,1
8,1,0,9,mixedType,1
4,4,0,8,mixedType,1
12,4,0,16,mixedType,2
5,3,0,8,mixedType,1
14,2,0,16,mixedType,2
5,4,0,9,mixedType,1
4,4,0,8,mixedType,1
6,2,0,8,mixedType,1
9,1,0,10,mixedType,1
4,6,0,10,mixedType,1
5,2,0,7,mixedType,0
9,4,0,13,mixedType,1
5,1,0,6,mixedType,0
2,8,0,10,mixedType,1
2,6,0,8,mixedType,1
6,2,0,8,mixedType,1
3,7,0,10,mixedType,1
7,3,0,10,mixedType,1
4,4,0,8,mixedType,1
5,5,0,10,mixedType,1
5,4,0,9,mixedType,1
9,1,0,10,mixedType,1
7,3,0,10,mixedType,1
14,2,0,16,mixedType,2
8,1,0,9,mixedType,1
7,2,0,9,mixedType,1
6,3,0,9,mixedType,1
2,11,0,13,mixedType,1
8,2,0,10,mixedType,1
9,1,0,10,mixedType,1
5,3,0,8,mixedType,1
2,9,0,11,mixedType,1
14,2,0,16,mixedType,2
8,3,0,11,mixedType,1
3,3,0,6,mixedType,0
6,1,0,7,mixedType,0
7,3,0,10,mixedType,1
5,1,0,6,mixedType,0
8,4,0,12,mixedType,1
2,4,0,6,mixedType,0
5,2,0,7,mixedType,0
7,3,0,10,mixedType,1
6,1,0,7,mixedType,0
4,8,0,12,mixedType,1
5,1,0,6,mixedType,0
7,3,0,10,mixedType,1
9,3,0,12,mixedType,1
9,2,0,11,mixedType,1
9,1,0,10,mixedType,1
8,2,0,10,mixedType,1
3,6,0,9,mixedType,1
4,2,0,6,mixedType,0
5,3,0,8,mixedType,1
6,1,0,7,mixedType,0
5,2,0,7,mixedType,0
7,3,0,10,mixedType,1
15,1,0,16,mixedType,2
1,7,0,8,mixedType,1
5,4,0,9,mixedType,1
7,3,0,10,mixedType,1
7,2,0,9,mixedType,1
5,3,0,8,mixedType,1
5,6,0,11,mixedType,1
4,4,0,8,mixedType,1
7,4,0,11,mixedType,1
6,2,0,8,mixedType,1
7,3,0,10,mixedType,1
11,3,0,14,mixedType,2
5,3,0,8,mixedType,1
4,2,0,6,mixedType,0
8,1,0,9,mixedType,1
5,1,0,6,mixedType,0
6,1,0,7,mixedType,0
13,3,0,16,mixedType,2
8,1,0,9,mixedType,1
14,2,0,16,mixedType,2
5,6,0,11,mixedType,1
7,4,0,11,mixedType,1
15,1,0,16,mixedType,2
5,1,0,6,mixedType,0
4,2,0,6,mixedType,0
6,2,0,8,mixedType,1
6,2,0,8,mixedType,1
8,3,0,11,mixedType,1
7,1,0,8,mixedType,1
5,5,0,10,mixedType,1
5,1,0,6,mixedType,0
5,2,0,7,mixedType,0
4,4,0,8,mixedType,1
7,1,0,8,mixedType,1
4,4,0,8,mixedType,1
4,4,0,8,mixedType,1
5,3,0,8,mixedType,1
7,2,0,9,mixedType,1
5,3,0,8,mixedType,1
9,1,0,10,mixedType,1
10,2,0,12,mixedType,1
1,6,0,7,mixedType,0
6,3,0,9,mixedType,1
7,1,0,8,mixedType,1
9,1,0,10,mixedType,1
14,2,0,16,mixedType,2
5,4,0,9,mixedType,1
10,3,0,13,mixedType,1
7,3,0,10,mixedType,1
6,1,0,7,mixedType,0
6,7,1,14,mixedType,2
11,3,0,14,mixedType,2
6,2,0,8,mixedType,1
10,4,0,14,mixedType,2
8,1,0,9,mixedType,1
8,2,0,10,mixedType,1
4,6,0,10,mixedType,1
9,2,0,11,mixedType,1
9,3,0,12,mixedType,1
8,2,0,10,mixedType,1
4,2,0,6,mixedType,0
1,8,0,9,mixedType,1
7,3,0,10,mixedType,1
5,3,0,8,mixedType,1
7,3,0,10,mixedType,1
6,2,0,8,mixedType,1
10,1,0,11,mixedType,1
1,7,0,8,mixedType,1
6,4,0,10,mixedType,1
4,7,0,11,mixedType,1
14,2,0,16,mixedType,2
5,6,0,11,mixedType,1
1,8,0,9,mixedType,1
4,7,0,11,mixedType,1
15,1,0,16,mixedType,2
4,4,0,8,mixedType,1
15,1,0,16,mixedType,2
11,5,0,16,mixedType,2
7,4,0,11,mixedType,1
14,2,0,16,mixedType,2
8,2,0,10,mixedType,1
6,2,0,8,mixedType,1
2,6,0,8,mixedType,1
6,3,0,9,mixedType,1
6,1,0,7,mixedType,0
6,2,0,8,mixedType,1
9,1,0,10,mixedType,1
5,2,0,7,mixedType,0
7,3,0,10,mixedType,1
11,1,0,12,mixedType,1
4,4,0,8,mixedType,1
8,2,0,10,mixedType,1
5,2,0,7,mixedType,0
7,2,0,9,mixedType,1
12,3,0,15,mixedType,2
6,4,0,10,mixedType,1
4,5,0,9,mixedType,1
6,3,0,9,mixedType,1
8,2,0,10,mixedType,1
6,3,0,9,mixedType,1
7,2,0,9,mixedType,1
14,2,0,16,mixedType,2
2,6,0,8,mixedType,1
5,2,0,7,mixedType,0
5,0,1,6,mixedType,0
3,3,0,6,mixedType,0
8,2,0,10,mixedType,1
6,4,0,10,mixedType,1
6,3,0,9,mixedType,1
8,3,0,11,mixedType,1
12,0,1,13,mixedType,1
4,4,0,8,mixedType,1
7,3,0,10,mixedType,1
13,3,0,16,mixedType,2
3,7,0,10,mixedType,1
6,3,0,9,mixedType,1
6,1,0,7,mixedType,0
8,1,0,9,mixedType,1
5,1,0,6,mixedType,0
6,1,0,7,mixedType,0
6,1,0,7,mixedType,0
5,6,0,11,mixedType,1
2,4,0,6,mixedType,0
13,3,0,16,mixedType,2
5,2,0,7,mixedType,0
11,1,0,12,mixedType,1
4,2,0,6,mixedType,0
10,1,0,11,mixedType,1
6,4,0,10,mixedType,1
7,4,0,11,mixedType,1
2,6,0,8,mixedType,1
8,2,0,10,mixedType,1
5,1,0,6,mixedType,0
7,1,0,8,mixedType,1
2,6,0,8,mixedType,1
7,3,0,10,mixedType,1
8,2,0,10,mixedType,1
1,8,0,9,mixedType,1
5,3,0,8,mixedType,1
6,2,0,8,mixedType,1
4,6,0,10,mixedType,1
8,1,0,9,mixedType,1
9,3,0,12,mixedType,1
9,2,0,11,mixedType,1
6,3,0,9,mixedType,1
5,1,0,6,mixedType,0
8,2,0,10,mixedType,1
6,1,0,7,mixedType,0
2,6,0,8,mixedType,1
10,3,0,13,mixedType,1
6,1,0,7,mixedType,0
6,2,0,8,mixedType,1
2,7,0,9,mixedType,1
7,3,0,10,mixedType,1
14,2,0,16,mixedType,2
6,5,0,11,mixedType,1
12,3,0,15,mixedType,2
6,3,0,9,mixedType,1
5,3,0,8,mixedType,1
1,7,0,8,mixedType,1
6,2,0,8,mixedType,1
9,2,0,11,mixedType,1
1,7,0,8,mixedType,1
6,3,0,9,mixedType,1
9,4,0,13,mixedType,1
6,4,0,10,mixedType,1
9,2,0,11,mixedType,1
5,3,0,8,mixedType,1
6,2,0,8,mixedType,1
5,3,0,8,mixedType,1
12,3,0,15,mixedType,2
7,2,0,9,mixedType,1
6,3,0,9,mixedType,1
8,4,0,12,mixedType,1
11,3,0,14,mixedType,2
2,4,0,6,mixedType,0
8,2,0,10,mixedType,1
2,8,0,10,mixedType,1
10,2,0,12,mixedType,1
9,4,0,13,mixedType,1
8,1,0,9,mixedType,1
4,2,0,6,mixedType,0
6,0,1,7,mixedType,0
9,1,0,10,mixedType,1
10,3,0,13,mixedType,1
15,1,0,16,mixedType,2
3,3,0,6,mixedType,0
5,4,0,9,mixedType,1
9,2,0,11,mixedType,1
9,5,0,14,mixedType,2
8,1,0,9,mixedType,1
6,1,0,7,mixedType,0
9,1,0,10,mixedType,1
5,2,0,7,mixedType,0
5,4,0,9,mixedType,1
6,2,0,8,mixedType,1
6,3,0,9,mixedType,1
2,6,0,8,mixedType,1
5,3,0,8,mixedType,1
7,3,0,10,mixedType,1
14,2,0,16,mixedType,2
6,3,0,9,mixedType,1
6,2,0,8,mixedType,1
7,3,0,10,mixedType,1
9,2,0,11,mixedType,1
3,3,0,6,mixedType,0
8,1,0,9,mixedType,1
5,3,0,8,mixedType,1
4,6,0,10,mixedType,1
5,2,0,7,mixedType,0
7,3,0,10,mixedType,1
3,10,0,13,mixedType,1
6,2,0,8,mixedType,1
6,1,0,7,mixedType,0
9,2,0,11,mixedType,1
2,8,0,10,mixedType,1
6,1,0,7,mixedType,0
5,2,0,7,mixedType,0
8,2,0,10,mixedType,1
7,3,0,10,mixedType,1
5,4,0,9,mixedType,1
7,4,0,11,mixedType,1
6,1,0,7,mixedType,0
11,3,0,14,mixedType,2
6,4,0,10,mixedType,1
14,2,0,16,mixedType,2
10,3,0,13,mixedType,1
4,4,0,8,mixedType,1
7,3,0,10,mixedType,1
2,7,0,9,mixedType,1
1,7,0,8,mixedType,1
6,3,0,9,mixedType,1
6,1,0,7,mixedType,0
5,4,0,9,mixedType,1
7,3,0,10,mixedType,1
9,2,0,11,mixedType,1
5,1,0,6,mixedType,0
1,9,0,10,mixedType,1
6,3,0,9,mixedType,1
6,1,0,7,mixedType,0
4,0,2,6,mixedType,0
8,1,0,9,mixedType,1
9,3,0,12,mixedType,1
7,3,0,10,mixedType,1
13,3,0,16,mixedType,2
8,3,0,11,mixedType,1
2,6,0,8,mixedType,1
2,6,0,8,mixedType,1
7,3,0,10,mixedType,1
3,6,0,9,mixedType,1
4,2,0,6,mixedType,0
5,6,0,11,mixedType,1
6,6,0,12,mixedType,1
7,3,0,10,mixedType,1
7,4,0,11,mixedType,1
7,3,0,10,mixedType,1
11,5,0,16,mixedType,2
9,2,0,11,mixedType,1
1,8,0,9,mixedType,1
3,8,0,11,mixedType,1
3,3,0,6,mixedType,0
8,2,0,10,mixedType,1
10,1,0,11,mixedType,1
15,1,0,16,mixedType,2
9,1,0,10,mixedType,1
5,4,0,9,mixedType,1
4,9,0,13,mixedType,1
7,2,0,9,mixedType,1
6,2,0,8,mixedType,1
6,4,0,10,mixedType,1
6,4,0,10,mixedType,1
5,4,0,9,mixedType,1
2,8,0,10,mixedType,1
7,5,0,12,mixedType,1
9,2,0,11,mixedType,1
2,7,0,9,mixedType,1
2,4,0,6,mixedType,0
2,8,0,10,mixedType,1
9,2,0,11,mixedType,1
6,1,0,7,mixedType,0
11,1,0,12,mixedType,1
17,1,1,19,mixedType,2
2,6,0,8,mixedType,1
8,2,0,10,mixedType,1
1,8,0,9,mixedType,1
6,4,0,10,mixedType,1
12,4,0,16,mixedType,2
4,4,0,8,mixedType,1
7,3,0,10,mixedType,1
8,1,0,9,mixedType,1
15,5,0,20,mixedType,2
6,4,0,10,mixedType,1
5,3,0,8,mixedType,1
7,6,1,14,mixedType,2
6,3,0,9,mixedType,1
8,2,0,10,mixedType,1
4,2,0,6,mixedType,0
8,2,0,10,mixedType,1
6,4,0,10,mixedType,1
5,2,0,7,mixedType,0
5,4,0,9,mixedType,1
2,6,0,8,mixedType,1
7,3,0,10,mixedType,1
2,6,0,8,mixedType,1
7,4,0,11,mixedType,1
5,3,0,8,mixedType,1
5,2,0,7,mixedType,0
5,3,0,8,mixedType,1
9,3,0,12,mixedType,1
2,8,0,10,mixedType,1
7,2,0,9,mixedType,1
7,3,0,10,mixedType,1
8,1,0,9,mixedType,1
6,3,0,9,mixedType,1
5,2,0,7,mixedType,0
7,2,0,9,mixedType,1
4,2,0,6,mixedType,0
6,4,0,10,mixedType,1
5,2,0,7,mixedType,0
9,1,0,10,mixedType,1
9,3,0,12,mixedType,1
6,3,0,9,mixedType,1
5,5,0,10,mixedType,1
7,2,0,9,mixedType,1
7,3,0,10,mixedType,1
11,5,0,16,mixedType,2
6,1,0,7,mixedType,0
5,4,0,9,mixedType,1
2,4,0,6,mixedType,0
6,3,0,9,mixedType,1
13,3,0,16,mixedType,2
10,1,0,11,mixedType,1
6,1,0,7,mixedType,0
8,2,0,10,mixedType,1
9,2,0,11,mixedType,1
5,4,0,9,mixedType,1
2,8,0,10,mixedType,1
6,2,0,8,mixedType,1
5,2,0,7,mixedType,0
3,3,0,6,mixedType,0
7,2,0,9,mixedType,1
5,3,0,8,mixedType,1
6,1,0,7,mixedType,0
3,9,0,12,mixedType,1
7,2,0,9,mixedType,1
1,8,0,9,mixedType,1
7,2,0,9,mixedType,1
8,4,0,12,mixedType,1
7,2,0,9,mixedType,1
5,3,0,8,mixedType,1
4,4,0,8,mixedType,1
5,2,0,7,mixedType,0
8,1,0,9,mixedType,1
6,3,0,9,mixedType,1
8,2,0,10,mixedType,1
9,2,0,11,mixedType,1
14,2,0,16,mixedType,2
10,1,0,11,mixedType,1
14,2,0,16,mixedType,2
3,10,0,13,mixedType,1
5,6,0,11,mixedType,1
2,6,0,8,mixedType,1
3,3,0,6,mixedType,0
5,1,0,6,mixedType,0
7,5,0,12,mixedType,1
4,6,0,10,mixedType,1
5,3,0,8,mixedType,1
5,8,0,13,mixedType,1
1,11,0,12,mixedType,1
4,6,0,10,mixedType,1
6,6,0,12,mixedType,1
6,4,0,10,mixedType,1
5,7,0,12,mixedType,1
6,4,0,10,mixedType,1
14,2,0,16,mixedType,2
6,2,0,8,mixedType,1
5,4,0,9,mixedType,1
8,1,0,9,mixedType,1
4,4,0,8,mixedType,1
5,2,0,7,mixedType,0
7,2,0,9,mixedType,1
5,2,0,7,mixedType,0
7,2,0,9,mixedType,1
6,3,0,9,mixedType,1
9,1,0,10,mixedType,1
7,3,0,10,mixedType,1
6,3,0,9,mixedType,1
6,1,0,7,mixedType,0
6,3,0,9,mixedType,1
5,3,0,8,mixedType,1
7,6,0,13,mixedType,1
8,3,0,11,mixedType,1
6,3,0,9,mixedType,1
14,2,0,16,mixedType,2
7,4,0,11,mixedType,1
8,1,0,9,mixedType,1
5,2,0,7,mixedType,0
8,1,0,9,mixedType,1
4,6,0,10,mixedType,1
14,2,0,16,mixedType,2
6,4,0,10,mixedType,1
14,2,0,16,mixedType,2
1,8,0,9,mixedType,1
4,2,0,6,mixedType,0
5,3,0,8,mixedType,1
8,4,0,12,mixedType,1
6,1,0,7,mixedType,0
7,3,0,10,mixedType,1
6,2,0,8,mixedType,1
12,4,0,16,mixedType,2
8,6,0,14,mixedType,2
5,3,0,8,mixedType,1
5,6,0,11,mixedType,1
6,6,0,12,mixedType,1
5,3,0,8,mixedType,1
8,2,0,10,mixedType,1
6,2,0,8,mixedType,1
4,7,0,11,mixedType,1
7,3,0,10,mixedType,1
8,0,1,9,mixedType,1
7,4,0,11,mixedType,1
3,6,0,9,mixedType,1
1,11,0,12,mixedType,1
6,4,0,10,mixedType,1
2,8,0,10,mixedType,1
3,6,0,9,mixedType,1
10,2,0,12,mixedType,1
6,4,0,10,mixedType,1
13,3,0,16,mixedType,2
4,2,0,6,mixedType,0
8,3,0,11,mixedType,1
7,5,3,15,mixedType,2
8,1,0,9,mixedType,1
9,1,0,10,mixedType,1
11,3,0,14,mixedType,2
2,7,0,9,mixedType,1
8,1,0,9,mixedType,1
11,3,0,14,mixedType,2
12,3,0,15,mixedType,2
5,3,0,8,mixedType,1
6,4,0,10,mixedType,1
3,7,0,10,mixedType,1
0,6,0,6,sameType,0
8,3,0,11,mixedType,1
6,6,0,12,mixedType,1
5,4,0,9,mixedType,1
5,2,0,7,mixedType,0
3,6,0,9,mixedType,1
6,2,0,8,mixedType,1
10,2,2,14,mixedType,2
5,4,0,9,mixedType,1
5,3,0,8,mixedType,1
7,2,0,9,mixedType,1
1,7,0,8,mixedType,1
5,2,0,7,mixedType,0
11,3,0,14,mixedType,2
1,7,0,8,mixedType,1
1,5,0,6,mixedType,0
15,1,0,16,mixedType,2
6,2,0,8,mixedType,1
4,5,0,9,mixedType,1
1,8,0,9,mixedType,1
11,1,0,12,mixedType,1
7,3,0,10,mixedType,1
9,3,3,15,mixedType,2
4,6,0,10,mixedType,1
8,1,0,9,mixedType,1
5,1,0,6,mixedType,0
6,5,0,11,mixedType,1
9,1,0,10,mixedType,1
6,2,0,8,mixedType,1
5,2,0,7,mixedType,0
5,4,0,9,mixedType,1
6,11,0,17,mixedType,2
15,1,0,16,mixedType,2
12,4,0,16,mixedType,2
6,2,0,8,mixedType,1
11,0,1,12,mixedType,1
10,2,0,12,mixedType,1
12,4,0,16,mixedType,2
7,3,0,10,mixedType,1
5,5,0,10,mixedType,1
3,6,0,9,mixedType,1
4,4,0,8,mixedType,1
9,2,0,11,mixedType,1
9,2,1,12,mixedType,1
8,1,0,9,mixedType,1
5,2,0,7,mixedType,0
6,4,0,10,mixedType,1
19,1,1,21,mixedType,2
15,1,0,16,mixedType,2
12,3,0,15,mixedType,2
4,4,0,8,mixedType,1
7,2,0,9,mixedType,1
6,2,0,8,mixedType,1
8,3,0,11,mixedType,1
6,1,0,7,mixedType,0
6,4,0,10,mixedType,1
15,1,0,16,mixedType,2
5,2,0,7,mixedType,0
5,2,0,7,mixedType,0
6,4,0,10,mixedType,1
11,3,0,14,mixedType,2
6,2,0,8,mixedType,1
15,1,0,16,mixedType,2
5,3,0,8,mixedType,1
5,3,0,8,mixedType,1
8,2,0,10,mixedType,1
6,3,0,9,mixedType,1
4,4,0,8,mixedType,1
11,5,0,16,mixedType,2
6,2,0,8,mixedType,1
7,6,0,13,mixedType,1
4,4,0,8,mixedType,1
4,9,0,13,mixedType,1
5,3,0,8,mixedType,1
1,9,0,10,mixedType,1
7,3,0,10,mixedType,1
5,2,0,7,mixedType,0
1,8,0,9,mixedType,1
3,7,0,10,mixedType,1
6,1,0,7,mixedType,0
15,1,0,16,mixedType,2
1,8,0,9,mixedType,1
5,5,0,10,mixedType,1
10,1,0,11,mixedType,1
9,3,0,12,mixedType,1
6,4,0,10,mixedType,1
5,3,0,8,mixedType,1
8,2,0,10,mixedType,1
5,4,0,9,mixedType,1
8,1,0,9,mixedType,1
8,2,0,10,mixedType,1
6,3,0,9,mixedType,1
6,2,0,8,mixedType,1
7,3,0,10,mixedType,1
5,10,2,17,mixedType,2
4,2,0,6,mixedType,0
13,3,0,16,mixedType,2
6,1,0,7,mixedType,0
6,1,0,7,mixedType,0
7,2,0,9,mixedType,1
8,1,0,9,mixedType,1
3,9,0,12,mixedType,1
8,3,0,11,mixedType,1
10,4,0,14,mixedType,2
6,3,0,9,mixedType,1
7,4,0,11,mixedType,1
13,3,0,16,mixedType,2
8,2,0,10,mixedType,1
13,3,0,16,mixedType,2
13,3,0,16,mixedType,2
8,1,0,9,mixedType,1
4,6,0,10,mixedType,1
10,0,1,11,mixedType,1
6,1,0,7,mixedType,0
6,3,0,9,mixedType,1
6,2,0,8,mixedType,1
6,2,0,8,mixedType,1
12,4,0,16,mixedType,2
7,3,0,10,mixedType,1
4,5,0,9,mixedType,1
5,3,0,8,mixedType,1
5,2,0,7,mixedType,0
8,2,0,10,mixedType,1
7,2,0,9,mixedType,1
13,3,0,16,mixedType,2
6,4,0,10,mixedType,1
7,2,0,9,mixedType,1
6,3,0,9,mixedType,1
4,2,0,6,mixedType,0
8,1,0,9,mixedType,1
8,2,0,10,mixedType,1
4,2,0,6,mixedType,0
10,3,0,13,mixedType,1
8,1,0,9,mixedType,1
14,2,0,16,mixedType,2
6,3,0,9,mixedType,1
7,2,0,9,mixedType,1
5,3,0,8,mixedType,1
6,3,0,9,mixedType,1
6,1,0,7,mixedType,0
6,4,0,10,mixedType,1
6,4,0,10,mixedType,1
5,2,0,7,mixedType,0
7,3,0,10,mixedType,1
4,2,0,6,mixedType,0
1,7,0,8,mixedType,1
6,3,0,9,mixedType,1
9,2,0,11,mixedType,1
15,1,1,17,mixedType,2
2,9,0,11,mixedType,1
7,3,0,10,mixedType,1
5,3,0,8,mixedType,1
7,3,0,10,mixedType,1
5,2,0,7,mixedType,0
7,6,0,13,mixedType,1
4,4,0,8,mixedType,1
8,3,0,11,mixedType,1
6,3,0,9,mixedType,1
6,3,0,9,mixedType,1
6,1,0,7,mixedType,0
2,6,0,8,mixedType,1
5,2,0,7,mixedType,0
8,2,0,10,mixedType,1
1,8,0,9,mixedType,1
6,2,0,8,mixedType,1
3,3,0,6,mixedType,0
5,2,0,7,mixedType,0
7,5,0,12,mixedType,1
2,6,0,8,mixedType,1
6,3,0,9,mixedType,1
12,4,0,16,mixedType,2
7,3,0,10,mixedType,1
7,3,0,10,mixedType,1
6,4,0,10,mixedType,1
5,3,0,8,mixedType,1
5,2,0,7,mixedType,0
7,1,0,8,mixedType,1
13,3,0,16,mixedType,2
6,4,0,10,mixedType,1
5,3,0,8,mixedType,1
1,8,0,9,mixedType,1
8,4,0,12,mixedType,1
5,1,0,6,mixedType,0
4,2,0,6,mixedType,0
5,3,0,8,mixedType,1
4,4,0,8,mixedType,1
7,3,0,10,mixedType,1
6,2,0,8,mixedType,1
6,4,0,10,mixedType,1
6,1,0,7,mixedType,0
7,3,0,10,mixedType,1
7,3,0,10,mixedType,1
6,2,0,8,mixedType,1
6,1,0,7,mixedType,0
5,3,0,8,mixedType,1
7,1,0,8,mixedType,1
13,3,0,16,mixedType,2
6,4,0,10,mixedType,1
6,2,0,8,mixedType,1
8,2,0,10,mixedType,1
6,4,0,10,mixedType,1
8,2,0,10,mixedType,1
4,8,0,12,mixedType,1
2,9,0,11,mixedType,1
6,4,0,10,mixedType,1
4,8,0,12,mixedType,1
9,1,0,10,mixedType,1
8,4,0,12,mixedType,1
5,8,0,13,mixedType,1
4,6,0,10,mixedType,1
13,3,0,16,mixedType,2
11,3,0,14,mixedType,2
6,1,0,7,mixedType,0
7,3,0,10,mixedType,1
5,3,0,8,mixedType,1
5,4,0,9,mixedType,1
6,2,0,8,mixedType,1
8,1,0,9,mixedType,1
4,4,0,8,mixedType,1
4,5,0,9,mixedType,1
5,4,0,9,mixedType,1
8,1,0,9,mixedType,1
14,2,0,16,mixedType,2
13,3,0,16,mixedType,2
11,3,0,14,mixedType,2
6,3,0,9,mixedType,1
15,1,0,16,mixedType,2
6,1,0,7,mixedType,0
11,4,0,15,mixedType,2
7,3,0,10,mixedType,1
12,4,0,16,mixedType,2
7,3,0,10,mixedType,1
12,1,1,14,mixedType,2
7,3,0,10,mixedType,1
6,4,0,10,mixedType,1
10,1,0,11,mixedType,1
4,2,0,6,mixedType,0
5,6,0,11,mixedType,1
11,4,0,15,mixedType,2
6,1,0,7,mixedType,0
7,3,0,10,mixedType,1
8,1,0,9,mixedType,1
9,4,0,13,mixedType,1
7,2,0,9,mixedType,1
7,2,0,9,mixedType,1
7,3,0,10,mixedType,1
6,3,0,9,mixedType,1
7,6,0,13,mixedType,1
6,2,0,8,mixedType,1
6,6,0,12,mixedType,1
7,3,0,10,mixedType,1
13,3,0,16,mixedType,2
10,0,1,11,mixedType,1
8,1,0,9,mixedType,1
5,6,0,11,mixedType,1
3,6,0,9,mixedType,1
6,1,0,7,mixedType,0
4,2,0,6,mixedType,0
6,4,0,10,mixedType,1
4,4,0,8,mixedType,1
6,3,0,9,mixedType,1
7,3,0,10,mixedType,1
7,2,0,9,mixedType,1
6,6,0,12,mixedType,1
7,3,0,10,mixedType,1
6,2,0,8,mixedType,1
8,1,0,9,mixedType,1
5,10,0,15,mixedType,2
6,1,0,7,mixedType,0
4,6,0,10,mixedType,1
4,7,0,11,mixedType,1
11,3,0,14,mixedType,2
4,2,0,6,mixedType,0
12,4,1,17,mixedType,2
6,4,0,10,mixedType,1
1,12,0,13,mixedType,1
8,2,0,10,mixedType,1
10,2,0,12,mixedType,1
8,2,0,10,mixedType,1
4,4,0,8,mixedType,1
8,2,0,10,mixedType,1
5,8,0,13,mixedType,1
7,3,0,10,mixedType,1
7,3,0,10,mixedType,1
6,2,0,8,mixedType,1
7,3,0,10,mixedType,1
6,3,0,9,mixedType,1
6,3,0,9,mixedType,1
9,3,0,12,mixedType,1
8,3,0,11,mixedType,1
1,9,0,10,mixedType,1
10,2,0,12,mixedType,1
12,4,0,16,mixedType,2
8,3,0,11,mixedType,1
1,8,0,9,mixedType,1
3,8,0,11,mixedType,1
8,1,0,9,mixedType,1
4,8,0,12,mixedType,1
7,3,0,10,mixedType,1
4,2,0,6,mixedType,0
8,1,0,9,mixedType,1
6,3,0,9,mixedType,1
10,2,0,12,mixedType,1
6,3,0,9,mixedType,1
6,2,0,8,mixedType,1
2,11,0,13,mixedType,1
1,7,0,8,mixedType,1
6,3,0,9,mixedType,1
3,5,0,8,mixedType,1
6,4,0,10,mixedType,1
6,3,0,9,mixedType,1
9,2,0,11,mixedType,1
7,4,0,11,mixedType,1
7,2,0,9,mixedType,1
6,4,0,10,mixedType,1
5,3,0,8,mixedType,1
5,4,0,9,mixedType,1
7,4,0,11,mixedType,1
7,2,0,9,mixedType,1
8,2,0,10,mixedType,1
7,4,0,11,mixedType,1
5,3,0,8,mixedType,1
4,4,0,8,mixedType,1
11,5,0,16,mixedType,2
7,3,0,10,mixedType,1
4,4,0,8,mixedType,1
2,10,0,12,mixedType,1
14,2,0,16,mixedType,2
9,1,0,10,mixedType,1
7,1,0,8,mixedType,1
7,3,0,10,mixedType,1
5,4,0,9,mixedType,1
12,0,1,13,mixedType,1
6,3,0,9,mixedType,1
5,4,0,9,mixedType,1
6,3,0,9,mixedType,1
15,1,0,16,mixedType,2
10,1,0,11,mixedType,1
1,8,0,9,mixedType,1
1,8,0,9,mixedType,1
9,2,0,11,mixedType,1
5,5,0,10,mixedType,1
4,2,0,6,mixedType,0
5,2,0,7,mixedType,0
6,2,0,8,mixedType,1
7,3,0,10,mixedType,1
2,6,0,8,mixedType,1
3,3,0,6,mixedType,0
5,3,0,8,mixedType,1
10,2,0,12,mixedType,1
1,8,0,9,mixedType,1
4,2,0,6,mixedType,0
5,1,0,6,mixedType,0
5,3,0,8,mixedType,1
4,6,0,10,mixedType,1
3,3,0,6,mixedType,0
2,6,0,8,mixedType,1
7,2,0,9,mixedType,1
7,7,3,17,mixedType,2
7,2,0,9,mixedType,1
6,4,0,10,mixedType,1
8,1,0,9,mixedType,1
9,2,0,11,mixedType,1
6,3,0,9,mixedType,1
5,2,0,7,mixedType,0
6,6,0,12,mixedType,1
14,2,0,16,mixedType,2
6,3,0,9,mixedType,1
5,3,0,8,mixedType,1
6,3,0,9,mixedType,1
6,3,0,9,mixedType,1
8,6,1,15,mixedType,2
6,7,0,13,mixedType,1
7,1,0,8,mixedType,1
5,7,0,12,mixedType,1
6,6,0,12,mixedType,1
11,3,0,14,mixedType,2
1,7,0,8,mixedType,1
2,6,0,8,mixedType,1
7,1,0,8,mixedType,1
12,4,0,16,mixedType,2
15,1,0,16,mixedType,2
14,2,0,16,mixedType,2
6,3,0,9,mixedType,1
4,6,0,10,mixedType,1
5,4,0,9,mixedType,1
8,2,0,10,mixedType,1
11,5,0,16,mixedType,2
6,4,0,10,mixedType,1
10,4,0,14,mixedType,2
7,1,0,8,mixedType,1
6,1,0,7,mixedType,0
6,3,0,9,mixedType,1
11,5,0,16,mixedType,2
7,1,0,8,mixedType,1
3,5,0,8,mixedType,1
6,2,0,8,mixedType,1
9,1,0,10,mixedType,1
14,2,0,16,mixedType,2
4,2,0,6,mixedType,0
1,5,0,6,mixedType,0
7,2,0,9,mixedType,1
9,2,0,11,mixedType,1
15,1,0,16,mixedType,2
4,8,0,12,mixedType,1
5,3,0,8,mixedType,1
12,4,0,16,mixedType,2
0,6,1,7,mixedType,0
11,2,0,13,mixedType,1
7,3,0,10,mixedType,1
5,1,0,6,mixedType,0
14,2,0,16,mixedType,2
7,2,0,9,mixedType,1
11,3,0,14,mixedType,2
9,4,0,13,mixedType,1
7,3,0,10,mixedType,1
8,3,0,11,mixedType,1
5,2,0,7,mixedType,0
14,2,0,16,mixedType,2
5,4,0,9,mixedType,1
7,4,0,11,mixedType,1
6,1,0,7,mixedType,0
15,1,0,16,mixedType,2
6,3,0,9,mixedType,1
1,9,0,10,mixedType,1
6,4,0,10,mixedType,1
6,1,0,7,mixedType,0
6,3,0,9,mixedType,1
7,3,0,10,mixedType,1
2,4,0,6,mixedType,0
15,1,0,16,mixedType,2
0,6,0,6,sameType,0
14,2,0,16,mixedType,2
4,8,0,12,mixedType,1
6,4,0,10,mixedType,1
5,2,0,7,mixedType,0
11,1,0,12,mixedType,1
14,2,0,16,mixedType,2
9,1,0,10,mixedType,1
7,2,0,9,mixedType,1
3,7,0,10,mixedType,1
8,2,0,10,mixedType,1
4,4,0,8,mixedType,1
5,3,0,8,mixedType,1
8,1,0,9,mixedType,1
2,4,0,6,mixedType,0
7,3,0,10,mixedType,1
9,2,0,11,mixedType,1
2,6,0,8,mixedType,1
6,3,0,9,mixedType,1
4,4,0,8,mixedType,1
11,2,0,13,mixedType,1
13,2,0,15,mixedType,2
8,1,0,9,mixedType,1
7,3,0,10,mixedType,1
8,4,0,12,mixedType,1
11,5,0,16,mixedType,2
3,5,0,8,mixedType,1
8,1,0,9,mixedType,1
6,4,0,10,mixedType,1
7,3,0,10,mixedType,1
6,1,0,7,mixedType,0
8,2,0,10,mixedType,1
5,2,0,7,mixedType,0
6,4,0,10,mixedType,1
7,2,0,9,mixedType,1
7,3,0,10,mixedType,1
6,4,0,10,mixedType,1
6,4,0,10,mixedType,1
9,1,0,10,mixedType,1
2,6,0,8,mixedType,1
6,2,0,8,mixedType,1
12,0,1,13,mixedType,1
12,1,0,13,mixedType,1
8,6,0,14,mixedType,2
11,2,0,13,mixedType,1
0,7,1,8,mixedType,1
12,3,0,15,mixedType,2
9,1,0,10,mixedType,1
5,6,0,11,mixedType,1
7,3,0,10,mixedType,1
8,2,0,10,mixedType,1
4,6,0,10,mixedType,1
6,4,0,10,mixedType,1
4,2,0,6,mixedType,0
5,3,0,8,mixedType,1
6,3,0,9,mixedType,1
3,3,0,6,mixedType,0
6,1,0,7,mixedType,0
6,4,0,10,mixedType,1
6,2,0,8,mixedType,1
5,1,0,6,mixedType,0
14,2,0,16,mixedType,2
7,2,0,9,mixedType,1
6,0,4,10,mixedType,1
11,0,1,12,mixedType,1
8,1,0,9,mixedType,1
5,2,0,7,mixedType,0
12,4,0,16,mixedType,2
5,4,0,9,mixedType,1
12,4,0,16,mixedType,2
6,3,0,9,mixedType,1
5,3,0,8,mixedType,1
13,3,0,16,mixedType,2
5,4,0,9,mixedType,1
11,3,1,15,mixedType,2
10,2,0,12,mixedType,1
12,0,1,13,mixedType,1
12,4,0,16,mixedType,2
8,2,0,10,mixedType,1
7,2,0,9,mixedType,1
3,6,0,9,mixedType,1
6,2,0,8,mixedType,1
6,2,0,8,mixedType,1
8,2,0,10,mixedType,1
6,4,0,10,mixedType,1
2,8,0,10,mixedType,1
5,2,0,7,mixedType,0
7,3,0,10,mixedType,1
7,2,0,9,mixedType,1
7,4,0,11,mixedType,1
7,3,0,10,mixedType,1
7,1,0,8,mixedType,1
11,5,0,16,mixedType,2
5,3,0,8,mixedType,1
4,6,0,10,mixedType,1
5,3,0,8,mixedType,1
7,3,0,10,mixedType,1
8,3,0,11,mixedType,1
15,1,0,16,mixedType,2
8,3,0,11,mixedType,1
5,1,0,6,mixedType,0
6,2,0,8,mixedType,1
6,1,0,7,mixedType,0
8,3,0,11,mixedType,1
13,3,0,16,mixedType,2
4,6,0,10,mixedType,1
8,2,0,10,mixedType,1
7,4,0,11,mixedType,1
3,9,0,12,mixedType,1
8,1,0,9,mixedType,1
8,2,0,10,mixedType,1
6,2,0,8,mixedType,1
6,1,0,7,mixedType,0
5,4,0,9,mixedType,1
6,1,0,7,mixedType,0
5,3,0,8,mixedType,1
6,6,0,12,mixedType,1
7,3,0,10,mixedType,1
5,4,0,9,mixedType,1
6,3,0,9,mixedType,1
7,1,0,8,mixedType,1
5,3,0,8,mixedType,1
5,2,0,7,mixedType,0
6,3,0,9,mixedType,1
9,2,0,11,mixedType,1
8,1,0,9,mixedType,1
1,7,0,8,mixedType,1
6,2,0,8,mixedType,1
12,3,0,15,mixedType,2
11,3,0,14,mixedType,2
6,1,0,7,mixedType,0
3,3,0,6,mixedType,0
1,8,0,9,mixedType,1
2,6,0,8,mixedType,1
9,2,0,11,mixedType,1
5,4,0,9,mixedType,1
12,4,0,16,mixedType,2
5,4,0,9,mixedType,1
4,2,0,6,mixedType,0
8,3,0,11,mixedType,1
5,1,0,6,mixedType,0
6,4,0,10,mixedType,1
7,4,0,11,mixedType,1
3,7,0,10,mixedType,1
4,4,0,8,mixedType,1
9,2,0,11,mixedType,1
3,6,0,9,mixedType,1
5,4,0,9,mixedType,1
5,8,0,13,mixedType,1
6,2,0,8,mixedType,1
6,3,0,9,mixedType,1
7,3,0,10,mixedType,1
1,8,0,9,mixedType,1
11,4,3,18,mixedType,2
6,3,0,9,mixedType,1
7,4,0,11,mixedType,1
6,1,0,7,mixedType,0
6,4,0,10,mixedType,1
7,3,0,10,mixedType,1
6,1,0,7,mixedType,0
14,2,0,16,mixedType,2
7,2,0,9,mixedType,1
5,2,0,7,mixedType,0
8,1,0,9,mixedType,1
6,4,0,10,mixedType,1
9,3,0,12,mixedType,1
4,4,0,8,mixedType,1
3,6,0,9,mixedType,1
7,3,0,10,mixedType,1
9,4,0,13,mixedType,1
5,3,0,8,mixedType,1
11,3,0,14,mixedType,2
3,6,0,9,mixedType,1
4,4,0,8,mixedType,1
9,2,0,11,mixedType,1
11,2,0,13,mixedType,1
4,8,0,12,mixedType,1
7,3,0,10,mixedType,1
8,3,0,11,mixedType,1
8,2,0,10,mixedType,1
5,4,0,9,mixedType,1
4,2,0,6,mixedType,0
4,2,0,6,mixedType,0
9,1,0,10,mixedType,1
3,3,0,6,mixedType,0
6,3,0,9,mixedType,1
5,4,0,9,mixedType,1
5,2,0,7,mixedType,0
14,2,0,16,mixedType,2
5,2,0,7,mixedType,0
5,6,0,11,mixedType,1
5,2,0,7,mixedType,0
7,2,0,9,mixedType,1
6,3,0,9,mixedType,1
4,6,0,10,mixedType,1
14,2,0,16,mixedType,2
8,1,0,9,mixedType,1
7,3,0,10,mixedType,1
8,2,0,10,mixedType,1
7,2,0,9,mixedType,1
5,4,0,9,mixedType,1
5,2,0,7,mixedType,0
8,6,2,16,mixedType,2
4,4,0,8,mixedType,1
1,8,0,9,mixedType,1
9,1,0,10,mixedType,1
7,3,0,10,mixedType,1
14,2,0,16,mixedType,2
6,2,0,8,mixedType,1
9,3,0,12,mixedType,1
8,1,0,9,mixedType,1
9,1,0,10,mixedType,1
8,3,0,11,mixedType,1
6,3,0,9,mixedType,1
6,4,0,10,mixedType,1
5,9,0,14,mixedType,2
15,2,0,17,mixedType,2
0,8,1,9,mixedType,1
9,1,0,10,mixedType,1
1,9,0,10,mixedType,1
11,3,1,15,mixedType,2
15,1,0,16,mixedType,2
5,4,0,9,mixedType,1
12,3,0,15,mixedType,2
10,3,0,13,mixedType,1
6,2,0,8,mixedType,1
7,3,0,10,mixedType,1
6,3,0,9,mixedType,1
6,1,0,7,mixedType,0
6,3,0,9,mixedType,1
8,1,0,9,mixedType,1
3,5,0,8,mixedType,1
7,3,0,10,mixedType,1
8,2,0,10,mixedType,1
5,4,0,9,mixedType,1
13,3,0,16,mixedType,2
8,2,0,10,mixedType,1
14,2,0,16,mixedType,2
7,2,0,9,mixedType,1
10,1,0,11,mixedType,1
4,9,0,13,mixedType,1
5,4,0,9,mixedType,1
6,4,0,10,mixedType,1
6,1,0,7,mixedType,0
1,8,0,9,mixedType,1
2,8,0,10,mixedType,1
3,7,0,10,mixedType,1
6,4,0,10,mixedType,1
4,4,0,8,mixedType,1
6,4,0,10,mixedType,1
8,2,0,10,mixedType,1
8,2,0,10,mixedType,1
14,2,0,16,mixedType,2
6,3,0,9,mixedType,1
6,1,0,7,mixedType,0
8,4,0,12,mixedType,1
14,2,0,16,mixedType,2
6,4,0,10,mixedType,1
5,2,0,7,mixedType,0
6,4,0,10,mixedType,1
6,4,0,10,mixedType,1
2,8,0,10,mixedType,1
4,4,0,8,mixedType,1
6,1,0,7,mixedType,0
3,3,0,6,mixedType,0
8,1,0,9,mixedType,1
7,3,0,10,mixedType,1
14,2,0,16,mixedType,2
2,8,0,10,mixedType,1
6,4,0,10,mixedType,1
9,1,0,10,mixedType,1
7,3,0,10,mixedType,1
7,3,0,10,mixedType,1
6,3,0,9,mixedType,1
5,2,0,7,mixedType,0
7,2,0,9,mixedType,1
14,2,0,16,mixedType,2
1,8,0,9,mixedType,1
8,2,0,10,mixedType,1
2,8,0,10,mixedType,1
2,4,0,6,mixedType,0
13,3,0,16,mixedType,2
12,4,0,16,mixedType,2
5,3,0,8,mixedType,1
5,4,0,9,mixedType,1
8,1,0,9,mixedType,1
7,2,0,9,mixedType,1
6,2,0,8,mixedType,1
5,6,0,11,mixedType,1
11,3,0,14,mixedType,2
2,6,0,8,mixedType,1
6,1,0,7,mixedType,0
6,2,0,8,mixedType,1
6,2,0,8,mixedType,1
6,4,0,10,mixedType,1
8,2,0,10,mixedType,1
6,6,0,12,mixedType,1
8,2,0,10,mixedType,1
10,0,1,11,mixedType,1
6,1,0,7,mixedType,0
6,3,0,9,mixedType,1
8,3,0,11,mixedType,1
5,4,0,9,mixedType,1
8,1,0,9,mixedType,1
10,1,0,11,mixedType,1
15,1,0,16,mixedType,2
11,1,0,12,mixedType,1
2,4,0,6,mixedType,0
7,3,0,10,mixedType,1
6,1,0,7,mixedType,0
9,2,0,11,mixedType,1
4,6,0,10,mixedType,1
6,4,0,10,mixedType,1
3,8,0,11,mixedType,1
5,3,0,8,mixedType,1
8,3,0,11,mixedType,1
5,4,0,9,mixedType,1
9,4,0,13,mixedType,1
6,1,0,7,mixedType,0
7,3,0,10,mixedType,1
6,4,0,10,mixedType,1
4,4,0,8,mixedType,1
11,2,0,13,mixedType,1
7,1,0,8,mixedType,1
5,1,0,6,mixedType,0
8,2,0,10,mixedType,1
7,3,0,10,mixedType,1
5,3,0,8,mixedType,1
6,4,0,10,mixedType,1
6,1,0,7,mixedType,0
5,4,0,9,mixedType,1
7,2,0,9,mixedType,1
8,2,0,10,mixedType,1
7,3,0,10,mixedType,1
5,4,0,9,mixedType,1
7,3,0,10,mixedType,1
8,2,0,10,mixedType,1
11,1,0,12,mixedType,1
5,1,0,6,mixedType,0
5,3,0,8,mixedType,1
2,6,0,8,mixedType,1
6,2,0,8,mixedType,1
10,4,0,14,mixedType,2
7,2,0,9,mixedType,1
7,2,0,9,mixedType,1
8,1,0,9,mixedType,1
2,6,0,8,mixedType,1
3,6,0,9,mixedType,1
9,1,0,10,mixedType,1
6,3,0,9,mixedType,1
7,3,0,10,mixedType,1
7,3,0,10,mixedType,1
6,4,0,10,mixedType,1
4,4,0,8,mixedType,1
2,4,0,6,mixedType,0
4,2,0,6,mixedType,0
11,5,0,16,mixedType,2
6,4,0,10,mixedType,1
8,2,0,10,mixedType,1
8,2,0,10,mixedType,1
1,8,0,9,mixedType,1
4,2,0,6,mixedType,0
5,4,0,9,mixedType,1
12,2,1,15,mixedType,2
2,4,0,6,mixedType,0
6,4,0,10,mixedType,1
4,5,0,9,mixedType,1
14,2,0,16,mixedType,2
6,1,0,7,mixedType,0
1,8,0,9,mixedType,1
6,3,0,9,mixedType,1
1,9,0,10,mixedType,1
5,2,0,7,mixedType,0
13,3,0,16,mixedType,2
6,3,0,9,mixedType,1
5,1,0,6,mixedType,0
14,2,0,16,mixedType,2
6,5,0,11,mixedType,1
9,1,0,10,mixedType,1
7,1,0,8,mixedType,1
15,1,0,16,mixedType,2
7,3,0,10,mixedType,1
9,1,0,10,mixedType,1
6,3,0,9,mixedType,1
6,4,0,10,mixedType,1
7,6,0,13,mixedType,1
4,2,0,6,mixedType,0
6,3,0,9,mixedType,1
13,3,0,16,mixedType,2
6,4,0,10,mixedType,1
1,8,0,9,mixedType,1
7,2,0,9,mixedType,1
4,4,0,8,mixedType,1
7,3,0,10,mixedType,1
5,3,0,8,mixedType,1
4,8,0,12,mixedType,1
11,1,0,12,mixedType,1
7,1,0,8,mixedType,1
5,2,0,7,mixedType,0
11,5,0,16,mixedType,2
4,6,0,10,mixedType,1
7,3,0,10,mixedType,1
5,2,0,7,mixedType,0
7,3,0,10,mixedType,1
4,4,0,8,mixedType,1
14,2,0,16,mixedType,2
4,2,0,6,mixedType,0
9,1,0,10,mixedType,1
9,3,0,12,mixedType,1
7,2,0,9,mixedType,1
9,1,0,10,mixedType,1
2,8,0,10,mixedType,1
4,4,0,8,mixedType,1
7,2,0,9,mixedType,1
7,2,0,9,mixedType,1
5,4,0,9,mixedType,1
6,3,0,9,mixedType,1
3,5,0,8,mixedType,1
7,6,0,13,mixedType,1
15,1,0,16,mixedType,2
6,3,0,9,mixedType,1
9,4,1,14,mixedType,2
9,2,0,11,mixedType,1
2,8,0,10,mixedType,1
1,8,0,9,mixedType,1
7,4,0,11,mixedType,1
5,5,0,10,mixedType,1
8,2,0,10,mixedType,1
5,2,0,7,mixedType,0
6,3,0,9,mixedType,1
6,4,0,10,mixedType,1
2,4,0,6,mixedType,0
7,1,0,8,mixedType,1
11,1,0,12,mixedType,1
12,3,0,15,mixedType,2
11,3,0,14,mixedType,2
9,3,0,12,mixedType,1
5,3,0,8,mixedType,1
14,2,0,16,mixedType,2
7,3,0,10,mixedType,1
9,1,0,10,mixedType,1
5,2,0,7,mixedType,0
15,1,0,16,mixedType,2
5,2,0,7,mixedType,0
6,3,0,9,mixedType,1
6,4,0,10,mixedType,1
2,9,0,11,mixedType,1
6,1,0,7,mixedType,0
2,10,0,12,mixedType,1
8,2,0,10,mixedType,1
11,1,0,12,mixedType,1
7,3,0,10,mixedType,1
4,8,0,12,mixedType,1
7,3,0,10,mixedType,1
9,2,0,11,mixedType,1
6,3,0,9,mixedType,1
7,1,0,8,mixedType,1
5,1,0,6,mixedType,0
8,2,0,10,mixedType,1
2,4,0,6,mixedType,0
5,5,0,10,mixedType,1
5,3,0,8,mixedType,1
8,3,0,11,mixedType,1
2,6,0,8,mixedType,1
7,2,0,9,mixedType,1
5,2,0,7,mixedType,0
8,1,0,9,mixedType,1
6,3,0,9,mixedType,1
6,3,0,9,mixedType,1
3,5,0,8,mixedType,1
14,2,0,16,mixedType,2
5,5,0,10,mixedType,1
1,7,0,8,mixedType,1
7,2,0,9,mixedType,1
7,2,0,9,mixedType,1
10,3,0,13,mixedType,1
5,1,0,6,mixedType,0
8,2,0,10,mixedType,1
12,4,0,16,mixedType,2
6,3,0,9,mixedType,1
4,5,0,9,mixedType,1
5,4,0,9,mixedType,1
7,3,0,10,mixedType,1
4,4,0,8,mixedType,1
4,4,0,8,mixedType,1
14,2,0,16,mixedType,2
3,5,0,8,mixedType,1
7,2,0,9,mixedType,1
15,1,0,16,mixedType,2
5,1,0,6,mixedType,0
6,2,0,8,mixedType,1
6,1,0,7,mixedType,0
5,3,0,8,mixedType,1
6,2,0,8,mixedType,1
15,1,0,16,mixedType,2
6,2,0,8,mixedType,1
6,2,0,8,mixedType,1
9,1,0,10,mixedType,1
6,2,0,8,mixedType,1
7,1,0,8,mixedType,1
5,1,0,6,mixedType,0
6,2,0,8,mixedType,1
7,4,0,11,mixedType,1
6,3,0,9,mixedType,1
10,1,0,11,mixedType,1
8,2,0,10,mixedType,1
5,3,0,8,mixedType,1
7,2,0,9,mixedType,1
5,2,0,7,mixedType,0
10,2,0,12,mixedType,1
3,8,0,11,mixedType,1
7,3,0,10,mixedType,1
6,2,0,8,mixedType,1
5,3,0,8,mixedType,1
5,3,0,8,mixedType,1
8,2,0,10,mixedType,1
6,4,0,10,mixedType,1
6,4,0,10,mixedType,1
7,2,0,9,mixedType,1
6,3,0,9,mixedType,1
6,4,0,10,mixedType,1
3,6,0,9,mixedType,1
6,0,1,7,mixedType,0
6,4,0,10,mixedType,1
6,3,0,9,mixedType,1
1,9,0,10,mixedType,1
5,4,0,9,mixedType,1
13,3,0,16,mixedType,2
14,2,0,16,mixedType,2
7,3,0,10,mixedType,1
13,3,0,16,mixedType,2
5,2,0,7,mixedType,0
6,3,0,9,mixedType,1
9,3,0,12,mixedType,1
6,4,0,10,mixedType,1
5,3,0,8,mixedType,1
6,1,0,7,mixedType,0
6,3,0,9,mixedType,1
1,12,0,13,mixedType,1
5,2,0,7,mixedType,0
2,7,0,9,mixedType,1
4,4,0,8,mixedType,1
12,3,0,15,mixedType,2
15,1,0,16,mixedType,2
4,2,0,6,mixedType,0
11,1,0,12,mixedType,1
7,3,0,10,mixedType,1
13,3,0,16,mixedType,2
6,3,0,9,mixedType,1
6,3,0,9,mixedType,1
8,1,0,9,mixedType,1
6,1,0,7,mixedType,0
5,2,0,7,mixedType,0
5,3,0,8,mixedType,1
6,2,0,8,mixedType,1
6,3,0,9,mixedType,1
4,2,0,6,mixedType,0
3,6,0,9,mixedType,1
5,4,0,9,mixedType,1
6,5,0,11,mixedType,1
9,4,0,13,mixedType,1
2,4,0,6,mixedType,0
6,6,0,12,mixedType,1
7,3,0,10,mixedType,1
6,3,0,9,mixedType,1
9,1,0,10,mixedType,1
3,6,0,9,mixedType,1
9,2,0,11,mixedType,1
8,2,0,10,mixedType,1
9,1,0,10,mixedType,1
1,8,0,9,mixedType,1
6,1,0,7,mixedType,0
1,9,0,10,mixedType,1
5,2,0,7,mixedType,0
5,3,0,8,mixedType,1
5,4,0,9,mixedType,1
7,3,0,10,mixedType,1
8,3,0,11,mixedType,1
6,3,0,9,mixedType,1
3,7,0,10,mixedType,1
11,1,0,12,mixedType,1
7,1,0,8,mixedType,1
6,2,0,8,mixedType,1
7,1,0,8,mixedType,1
6,2,0,8,mixedType,1
7,3,0,10,mixedType,1
6,3,0,9,mixedType,1
5,3,0,8,mixedType,1
4,8,0,12,mixedType,1
3,5,0,8,mixedType,1
7,2,0,9,mixedType,1
12,1,0,13,mixedType,1
8,3,0,11,mixedType,1
7,3,0,10,mixedType,1
8,1,0,9,mixedType,1
3,5,0,8,mixedType,1
8,1,0,9,mixedType,1
8,1,0,9,mixedType,1
9,1,0,10,mixedType,1
6,3,0,9,mixedType,1
13,3,0,16,mixedType,2
6,4,0,10,mixedType,1
6,1,0,7,mixedType,0
7,3,0,10,mixedType,1
7,3,0,10,mixedType,1
7,3,0,10,mixedType,1
5,3,0,8,mixedType,1
6,6,0,12,mixedType,1
3,6,0,9,mixedType,1
6,2,0,8,mixedType,1
7,2,0,9,mixedType,1
7,3,0,10,mixedType,1
5,3,0,8,mixedType,1
8,1,0,9,mixedType,1
6,1,0,7,mixedType,0
6,2,0,8,mixedType,1
7,3,0,10,mixedType,1
2,7,0,9,mixedType,1
5,5,0,10,mixedType,1
2,8,0,10,mixedType,1
5,3,0,8,mixedType,1
11,3,0,14,mixedType,2
5,2,0,7,mixedType,0
8,8,0,16,mixedType,2
5,2,0,7,mixedType,0
1,7,0,8,mixedType,1
6,3,0,9,mixedType,1
4,6,0,10,mixedType,1
2,4,0,6,mixedType,0
5,3,0,8,mixedType,1
6,1,0,7,mixedType,0
6,3,0,9,mixedType,1
7,2,0,9,mixedType,1
6,4,0,10,mixedType,1
9,3,0,12,mixedType,1
4,2,0,6,mixedType,0
5,6,0,11,mixedType,1
9,1,0,10,mixedType,1
7,2,0,9,mixedType,1
9,2,0,11,mixedType,1
6,4,0,10,mixedType,1
6,2,0,8,mixedType,1
2,4,0,6,mixedType,0
6,3,0,9,mixedType,1
5,5,0,10,mixedType,1
8,3,0,11,mixedType,1
5,5,0,10,mixedType,1
8,2,0,10,mixedType,1
2,4,0,6,mixedType,0
5,13,0,18,mixedType,2
8,1,0,9,mixedType,1
9,2,0,11,mixedType,1
2,6,0,8,mixedType,1
2,8,0,10,mixedType,1
5,2,0,7,mixedType,0
5,3,0,8,mixedType,1
8,6,0,14,mixedType,2
10,3,0,13,mixedType,1
6,2,0,8,mixedType,1
10,3,0,13,mixedType,1
5,2,0,7,mixedType,0
7,2,0,9,mixedType,1
7,3,0,10,mixedType,1
6,3,0,9,mixedType,1
14,2,0,16,mixedType,2
6,2,0,8,mixedType,1
4,6,0,10,mixedType,1
4,5,0,9,mixedType,1
6,4,0,10,mixedType,1
5,4,0,9,mixedType,1
8,1,0,9,mixedType,1
8,1,0,9,mixedType,1
4,2,0,6,mixedType,0
6,3,0,9,mixedType,1
6,2,0,8,mixedType,1
6,3,0,9,mixedType,1
14,2,0,16,mixedType,2
12,8,0,20,mixedType,2
6,4,0,10,mixedType,1
4,2,0,6,mixedType,0
6,4,0,10,mixedType,1
3,8,0,11,mixedType,1
2,8,0,10,mixedType,1
4,6,0,10,mixedType,1
4,7,0,11,mixedType,1
8,4,0,12,mixedType,1
8,2,0,10,mixedType,1
7,2,0,9,mixedType,1
7,3,0,10,mixedType,1
9,1,0,10,mixedType,1
6,4,0,10,mixedType,1
3,6,0,9,mixedType,1
6,2,0,8,mixedType,1
8,1,0,9,mixedType,1
4,4,0,8,mixedType,1
8,2,0,10,mixedType,1
7,1,0,8,mixedType,1
5,2,0,7,mixedType,0
3,7,0,10,mixedType,1
5,6,0,11,mixedType,1
7,1,0,8,mixedType,1
1,8,0,9,mixedType,1
15,1,0,16,mixedType,2
6,3,0,9,mixedType,1
7,2,0,9,mixedType,1
5,1,0,6,mixedType,0
6,4,0,10,mixedType,1
6,8,0,14,mixedType,2
6,3,0,9,mixedType,1
6,2,0,8,mixedType,1
14,2,0,16,mixedType,2
2,4,0,6,mixedType,0
6,1,0,7,mixedType,0
3,3,0,6,mixedType,0
8,2,0,10,mixedType,1
7,3,0,10,mixedType,1
14,2,0,16,mixedType,2
13,3,0,16,mixedType,2
5,3,0,8,mixedType,1
5,6,0,11,mixedType,1
14,2,0,16,mixedType,2
10,2,0,12,mixedType,1
7,2,0,9,mixedType,1
5,1,0,6,mixedType,0
9,1,0,10,mixedType,1
8,4,2,14,mixedType,2
13,5,2,20,mixedType,2
5,1,0,6,mixedType,0
7,3,0,10,mixedType,1
6,3,0,9,mixedType,1
9,3,0,12,mixedType,1
6,3,0,9,mixedType,1
8,2,0,10,mixedType,1
15,1,0,16,mixedType,2
5,2,0,7,mixedType,0
1,8,0,9,mixedType,1
4,4,0,8,mixedType,1
9,2,0,11,mixedType,1
5,1,0,6,mixedType,0
6,3,0,9,mixedType,1
7,3,0,10,mixedType,1
7,3,0,10,mixedType,1
6,2,0,8,mixedType,1
2,8,0,10,mixedType,1
5,3,0,8,mixedType,1
7,2,0,9,mixedType,1
6,3,0,9,mixedType,1
1,11,0,12,mixedType,1
5,4,0,9,mixedType,1
10,2,0,12,mixedType,1
6,3,0,9,mixedType,1
6,2,0,8,mixedType,1
5,3,0,8,mixedType,1
9,4,0,13,mixedType,1
4,2,0,6,mixedType,0
6,3,0,9,mixedType,1
7,2,0,9,mixedType,1
7,1,0,8,mixedType,1
7,1,0,8,mixedType,1
5,1,0,6,mixedType,0
4,6,0,10,mixedType,1
3,3,0,6,mixedType,0
6,2,0,8,mixedType,1
6,1,0,7,mixedType,0
5,3,0,8,mixedType,1
6,2,0,8,mixedType,1
9,3,0,12,mixedType,1
5,4,0,9,mixedType,1
4,2,0,6,mixedType,0
8,1,0,9,mixedType,1
15,1,0,16,mixedType,2
13,3,0,16,mixedType,2
5,3,0,8,mixedType,1
9,4,0,13,mixedType,1
7,3,0,10,mixedType,1
11,3,0,14,mixedType,2
5,2,0,7,mixedType,0
4,4,0,8,mixedType,1
7,7,0,14,mixedType,2
7,3,0,10,mixedType,1
4,6,0,10,mixedType,1
9,4,0,13,mixedType,1
5,1,0,6,mixedType,0
6,1,0,7,mixedType,0
7,3,0,10,mixedType,1
13,3,0,16,mixedType,2
6,2,0,8,mixedType,1
6,1,0,7,mixedType,0
6,3,0,9,mixedType,1
9,1,0,10,mixedType,1
7,3,0,10,mixedType,1
8,2,0,10,mixedType,1
7,2,0,9,mixedType,1
12,3,0,15,mixedType,2
5,3,0,8,mixedType,1
7,4,0,11,mixedType,1
12,4,0,16,mixedType,2
13,3,0,16,mixedType,2
12,3,0,15,mixedType,2
7,3,0,10,mixedType,1
5,6,0,11,mixedType,1
3,3,0,6,mixedType,0
6,1,0,7,mixedType,0
6,3,0,9,mixedType,1
7,3,0,10,mixedType,1
6,4,0,10,mixedType,1
6,3,0,9,mixedType,1
8,2,0,10,mixedType,1
6,5,0,11,mixedType,1
5,3,0,8,mixedType,1
8,2,0,10,mixedType,1
12,4,0,16,mixedType,2
8,1,0,9,mixedType,1
6,3,0,9,mixedType,1
7,3,0,10,mixedType,1
9,2,0,11,mixedType,1
13,3,0,16,mixedType,2
9,4,0,13,mixedType,1
6,4,0,10,mixedType,1
7,2,0,9,mixedType,1
5,2,0,7,mixedType,0
9,3,0,12,mixedType,1
5,3,0,8,mixedType,1
11,3,0,14,mixedType,2
6,3,0,9,mixedType,1
7,2,0,9,mixedType,1
7,2,0,9,mixedType,1
7,3,0,10,mixedType,1
9,1,0,10,mixedType,1
5,2,0,7,mixedType,0
14,2,0,16,mixedType,2
1,10,0,11,mixedType,1
17,4,0,21,mixedType,2
6,3,0,9,mixedType,1
7,3,0,10,mixedType,1
2,8,0,10,mixedType,1
8,2,0,10,mixedType,1
6,4,0,10,mixedType,1
6,4,0,10,mixedType,1
9,4,0,13,mixedType,1
12,3,0,15,mixedType,2
5,4,0,9,mixedType,1
8,3,0,11,mixedType,1
3,8,0,11,mixedType,1
1,7,0,8,mixedType,1
5,3,0,8,mixedType,1
9,1,0,10,mixedType,1
6,2,0,8,mixedType,1
11,4,0,15,mixedType,2
6,4,0,10,mixedType,1
10,1,0,11,mixedType,1
10,2,0,12,mixedType,1
5,4,0,9,mixedType,1
6,3,0,9,mixedType,1
6,3,0,9,mixedType,1
4,2,0,6,mixedType,0
15,1,0,16,mixedType,2
4,6,0,10,mixedType,1
11,4,0,15,mixedType,2
8,2,0,10,mixedType,1
5,1,0,6,mixedType,0
1,7,0,8,mixedType,1
1,7,0,8,mixedType,1
4,6,0,10,mixedType,1
7,2,0,9,mixedType,1
6,1,0,7,mixedType,0
6,2,0,8,mixedType,1
5,2,0,7,mixedType,0
1,9,0,10,mixedType,1
5,3,0,8,mixedType,1
4,4,0,8,mixedType,1
7,2,0,9,mixedType,1
1,8,0,9,mixedType,1
5,4,0,9,mixedType,1
1,8,0,9,mixedType,1
5,3,0,8,mixedType,1
9,1,0,10,mixedType,1
4,8,0,12,mixedType,1
8,2,0,10,mixedType,1
6,3,0,9,mixedType,1
11,2,0,13,mixedType,1
6,4,0,10,mixedType,1
13,3,0,16,mixedType,2
4,2,0,6,mixedType,0
7,2,0,9,mixedType,1
7,3,0,10,mixedType,1
5,3,0,8,mixedType,1
4,6,0,10,mixedType,1
9,1,0,10,mixedType,1
11,1,0,12,mixedType,1
4,4,0,8,mixedType,1
5,3,0,8,mixedType,1
7,2,0,9,mixedType,1
6,3,0,9,mixedType,1
5,2,0,7,mixedType,0
8,3,0,11,mixedType,1
6,3,0,9,mixedType,1
3,5,0,8,mixedType,1
5,4,0,9,mixedType,1
11,1,0,12,mixedType,1
7,7,0,14,mixedType,2
14,2,0,16,mixedType,2
9,3,0,12,mixedType,1
8,2,0,10,mixedType,1
8,2,0,10,mixedType,1
5,4,0,9,mixedType,1
1,9,0,10,mixedType,1
5,3,0,8,mixedType,1
7,3,0,10,mixedType,1
3,5,0,8,mixedType,1
5,8,0,13,mixedType,1
8,2,0,10,mixedType,1
7,2,0,9,mixedType,1
6,2,0,8,mixedType,1
8,1,0,9,mixedType,1
7,2,0,9,mixedType,1
2,4,0,6,mixedType,0
9,2,0,11,mixedType,1
5,4,0,9,mixedType,1
12,4,0,16,mixedType,2
13,3,0,16,mixedType,2
6,2,0,8,mixedType,1
8,2,0,10,mixedType,1
4,8,0,12,mixedType,1
4,6,0,10,mixedType,1
3,5,0,8,mixedType,1
6,3,0,9,mixedType,1
2,8,0,10,mixedType,1
2,6,0,8,mixedType,1
7,3,0,10,mixedType,1
6,1,0,7,mixedType,0
1,7,0,8,mixedType,1
6,1,0,7,mixedType,0
9,2,0,11,mixedType,1
3,6,0,9,mixedType,1
5,2,0,7,mixedType,0
11,3,0,14,mixedType,2
8,2,0,10,mixedType,1
8,4,0,12,mixedType,1
7,2,0,9,mixedType,1
2,4,0,6,mixedType,0
6,0,1,7,mixedType,0
7,1,0,8,mixedType,1
8,4,0,12,mixedType,1
13,3,0,16,mixedType,2
6,3,0,9,mixedType,1
4,4,0,8,mixedType,1
8,1,0,9,mixedType,1
13,3,0,16,mixedType,2
7,2,0,9,mixedType,1
4,4,0,8,mixedType,1
6,2,0,8,mixedType,1
11,2,0,13,mixedType,1
9,1,0,10,mixedType,1
6,1,0,7,mixedType,0
1,10,0,11,mixedType,1
7,2,0,9,mixedType,1
6,1,0,7,mixedType,0
6,2,0,8,mixedType,1
6,1,0,7,mixedType,0
2,6,0,8,mixedType,1
13,3,0,16,mixedType,2
2,7,0,9,mixedType,1
8,2,0,10,mixedType,1
5,2,0,7,mixedType,0
5,4,0,9,mixedType,1
6,1,0,7,mixedType,0
8,2,0,10,mixedType,1
7,2,0,9,mixedType,1
8,2,0,10,mixedType,1
6,2,0,8,mixedType,1
5,2,0,7,mixedType,0
7,4,0,11,mixedType,1
7,3,0,10,mixedType,1
6,2,0,8,mixedType,1
5,4,0,9,mixedType,1
5,3,0,8,mixedType,1
9,3,0,12,mixedType,1
5,3,0,8,mixedType,1
4,8,0,12,mixedType,1
8,1,0,9,mixedType,1
4,2,0,6,mixedType,0
6,1,0,7,mixedType,0
7,1,0,8,mixedType,1
4,2,0,6,mixedType,0
7,3,0,10,mixedType,1
7,3,0,10,mixedType,1
11,1,0,12,mixedType,1
4,6,0,10,mixedType,1
6,3,0,9,mixedType,1
1,11,0,12,mixedType,1
4,2,0,6,mixedType,0
9,3,0,12,mixedType,1
6,6,0,12,mixedType,1
5,1,0,6,mixedType,0
13,3,0,16,mixedType,2
2,6,0,8,mixedType,1
14,2,0,16,mixedType,2
6,2,0,8,mixedType,1
5,3,0,8,mixedType,1
12,3,0,15,mixedType,2
5,2,0,7,mixedType,0
4,4,0,8,mixedType,1
1,9,0,10,mixedType,1
8,1,0,9,mixedType,1
12,1,0,13,mixedType,1
15,1,0,16,mixedType,2
8,3,0,11,mixedType,1
6,3,0,9,mixedType,1
7,3,0,10,mixedType,1
6,1,0,7,mixedType,0
8,5,0,13,mixedType,1
3,6,0,9,mixedType,1
5,2,0,7,mixedType,0
1,7,0,8,mixedType,1
5,2,0,7,mixedType,0
5,2,0,7,mixedType,0
5,3,0,8,mixedType,1
6,3,0,9,mixedType,1
8,2,0,10,mixedType,1
9,3,0,12,mixedType,1
6,2,0,8,mixedType,1
7,3,0,10,mixedType,1
3,10,0,13,mixedType,1
6,1,0,7,mixedType,0
5,5,0,10,mixedType,1
13,3,0,16,mixedType,2
9,2,0,11,mixedType,1
6,3,0,9,mixedType,1
4,4,0,8,mixedType,1
9,4,0,13,mixedType,1
12,4,0,16,mixedType,2
8,3,0,11,mixedType,1
6,3,0,9,mixedType,1
5,2,0,7,mixedType,0
9,3,0,12,mixedType,1
6,1,0,7,mixedType,0
5,2,0,7,mixedType,0
6,1,0,7,mixedType,0
6,2,0,8,mixedType,1
5,3,0,8,mixedType,1
7,2,0,9,mixedType,1
6,0,1,7,mixedType,0
4,4,0,8,mixedType,1
4,2,0,6,mixedType,0
3,6,0,9,mixedType,1
7,3,0,10,mixedType,1
9,6,0,15,mixedType,2
4,4,0,8,mixedType,1
5,6,0,11,mixedType,1
7,3,0,10,mixedType,1
6,4,0,10,mixedType,1
8,1,0,9,mixedType,1
8,3,0,11,mixedType,1
2,9,0,11,mixedType,1
10,3,0,13,mixedType,1
12,4,0,16,mixedType,2
2,4,0,6,mixedType,0
3,7,0,10,mixedType,1
5,4,0,9,mixedType,1
6,1,0,7,mixedType,0
9,4,0,13,mixedType,1
6,1,0,7,mixedType,0
4,2,0,6,mixedType,0
12,4,0,16,mixedType,2
9,1,0,10,mixedType,1
2,10,0,12,mixedType,1
3,7,0,10,mixedType,1
7,2,0,9,mixedType,1
13,3,0,16,mixedType,2
8,1,0,9,mixedType,1
6,3,0,9,mixedType,1
5,4,0,9,mixedType,1
6,2,0,8,mixedType,1
9,2,0,11,mixedType,1
11,3,0,14,mixedType,2
7,2,0,9,mixedType,1
6,1,0,7,mixedType,0
7,2,0,9,mixedType,1
5,2,0,7,mixedType,0
6,3,0,9,mixedType,1
6,3,0,9,mixedType,1
12,4,0,16,mixedType,2
4,2,0,6,mixedType,0
1,8,0,9,mixedType,1
14,2,0,16,mixedType,2
7,3,0,10,mixedType,1
6,4,0,10,mixedType,1
4,4,0,8,mixedType,1
6,2,0,8,mixedType,1
7,1,0,8,mixedType,1
15,1,0,16,mixedType,2
7,3,0,10,mixedType,1
14,2,0,16,mixedType,2
7,2,0,9,mixedType,1
5,4,0,9,mixedType,1
5,4,0,9,mixedType,1
8,1,0,9,mixedType,1
14,2,0,16,mixedType,2
6,4,0,10,mixedType,1
8,1,0,9,mixedType,1
7,2,0,9,mixedType,1
7,3,0,10,mixedType,1
1,8,0,9,mixedType,1
5,4,0,9,mixedType,1
7,3,0,10,mixedType,1
6,4,0,10,mixedType,1
3,5,0,8,mixedType,1
8,1,0,9,mixedType,1
7,3,0,10,mixedType,1
4,2,0,6,mixedType,0
7,1,0,8,mixedType,1
7,2,0,9,mixedType,1
7,2,0,9,mixedType,1
5,2,0,7,mixedType,0
5,3,0,8,mixedType,1
4,2,0,6,mixedType,0
13,2,0,15,mixedType,2
6,4,0,10,mixedType,1
10,7,3,20,mixedType,2
2,8,0,10,mixedType,1
3,8,0,11,mixedType,1
9,2,0,11,mixedType,1
1,7,0,8,mixedType,1
12,4,0,16,mixedType,2
7,3,0,10,mixedType,1
12,4,0,16,mixedType,2
1,8,0,9,mixedType,1
6,1,0,7,mixedType,0
7,3,0,10,mixedType,1
4,6,0,10,mixedType,1
6,1,0,7,mixedType,0
8,1,0,9,mixedType,1
7,3,0,10,mixedType,1
13,2,1,16,mixedType,2
7,3,0,10,mixedType,1
5,3,0,8,mixedType,1
5,4,0,9,mixedType,1
10,2,0,12,mixedType,1
5,1,0,6,mixedType,0
3,2,0,5,mixedType,0
5,6,0,11,mixedType,1
5,4,0,9,mixedType,1
13,3,0,16,mixedType,2
4,4,0,8,mixedType,1
6,3,0,9,mixedType,1
8,1,0,9,mixedType,1
11,5,0,16,mixedType,2
5,4,0,9,mixedType,1
7,2,0,9,mixedType,1
8,0,1,9,mixedType,1
7,3,0,10,mixedType,1
5,3,0,8,mixedType,1
7,3,0,10,mixedType,1
6,3,0,9,mixedType,1
10,6,1,17,mixedType,2
8,2,0,10,mixedType,1
6,3,0,9,mixedType,1
9,1,0,10,mixedType,1
3,7,0,10,mixedType,1
13,3,0,16,mixedType,2
5,3,0,8,mixedType,1
6,3,0,9,mixedType,1
15,1,0,16,mixedType,2
14,2,0,16,mixedType,2
9,4,0,13,mixedType,1
8,1,0,9,mixedType,1
6,3,0,9,mixedType,1
3,7,0,10,mixedType,1
8,4,0,12,mixedType,1
5,4,0,9,mixedType,1
8,0,1,9,mixedType,1
5,2,0,7,mixedType,0
3,6,0,9,mixedType,1
8,3,0,11,mixedType,1
7,3,0,10,mixedType,1
4,2,0,6,mixedType,0
6,6,0,12,mixedType,1
14,2,0,16,mixedType,2
5,2,0,7,mixedType,0
2,6,0,8,mixedType,1
6,2,0,8,mixedType,1
8,1,0,9,mixedType,1
8,1,0,9,mixedType,1
6,3,0,9,mixedType,1
12,4,0,16,mixedType,2
7,1,0,8,mixedType,1
6,2,0,8,mixedType,1
5,3,0,8,mixedType,1
6,3,0,9,mixedType,1
10,2,0,12,mixedType,1
14,2,0,16,mixedType,2
2,6,0,8,mixedType,1
5,2,0,7,mixedType,0
6,1,0,7,mixedType,0
3,3,0,6,mixedType,0
4,5,0,9,mixedType,1
6,1,0,7,mixedType,0
4,2,0,6,mixedType,0
7,3,0,10,mixedType,1
2,7,0,9,mixedType,1
4,2,0,6,mixedType,0
7,3,0,10,mixedType,1
6,4,0,10,mixedType,1
10,3,0,13,mixedType,1
9,1,0,10,mixedType,1
5,3,0,8,mixedType,1
4,2,0,6,mixedType,0
8,2,0,10,mixedType,1
10,2,0,12,mixedType,1
4,2,0,6,mixedType,0
2,10,0,12,mixedType,1
5,3,0,8,mixedType,1
4,8,0,12,mixedType,1
5,4,0,9,mixedType,1
6,3,0,9,mixedType,1
4,4,0,8,mixedType,1
8,2,0,10,mixedType,1
7,3,0,10,mixedType,1
9,3,0,12,mixedType,1
7,2,0,9,mixedType,1
5,3,0,8,mixedType,1
6,4,0,10,mixedType,1
7,4,0,11,mixedType,1
6,2,0,8,mixedType,1
14,2,0,16,mixedType,2
6,2,0,8,mixedType,1
6,2,0,8,mixedType,1
6,2,0,8,mixedType,1
8,1,0,9,mixedType,1
1,11,0,12,mixedType,1
5,1,0,6,mixedType,0
9,2,0,11,mixedType,1
6,2,0,8,mixedType,1
8,3,0,11,mixedType,1
5,3,0,8,mixedType,1
13,3,0,16,mixedType,2
3,3,0,6,mixedType,0
14,2,0,16,mixedType,2
7,2,0,9,mixedType,1
6,2,0,8,mixedType,1
8,3,0,11,mixedType,1
6,3,0,9,mixedType,1
5,4,0,9,mixedType,1
5,2,0,7,mixedType,0
7,2,0,9,mixedType,1
4,4,0,8,mixedType,1
13,3,0,16,mixedType,2
7,2,0,9,mixedType,1
8,2,0,10,mixedType,1
8,4,0,12,mixedType,1
4,4,0,8,mixedType,1
3,9,0,12,mixedType,1
5,2,0,7,mixedType,0
5,2,0,7,mixedType,0
5,6,0,11,mixedType,1
6,4,0,10,mixedType,1
8,2,0,10,mixedType,1
5,6,0,11,mixedType,1
9,1,0,10,mixedType,1
7,3,0,10,mixedType,1
6,3,0,9,mixedType,1
5,3,0,8,mixedType,1
7,1,0,8,mixedType,1
8,2,0,10,mixedType,1
11,2,0,13,mixedType,1
5,4,0,9,mixedType,1
8,2,0,10,mixedType,1
1,8,0,9,mixedType,1
1,7,0,8,mixedType,1
4,4,0,8,mixedType,1
4,4,0,8,mixedType,1
1,8,0,9,mixedType,1
7,3,0,10,mixedType,1
6,2,0,8,mixedType,1
11,5,0,16,mixedType,2
6,3,0,9,mixedType,1
1,8,0,9,mixedType,1
9,1,0,10,mixedType,1
15,1,0,16,mixedType,2
5,4,0,9,mixedType,1
12,11,0,23,mixedType,2
7,3,0,10,mixedType,1
5,5,0,10,mixedType,1
8,3,0,11,mixedType,1
1,8,0,9,mixedType,1
2,6,0,8,mixedType,1
8,1,0,9,mixedType,1
5,3,0,8,mixedType,1
2,8,0,10,mixedType,1
10,1,0,11,mixedType,1
11,3,0,14,mixedType,2
5,3,0,8,mixedType,1
17,3,0,20,mixedType,2
8,2,0,10,mixedType,1
6,2,0,8,mixedType,1
3,6,0,9,mixedType,1
5,2,0,7,mixedType,0
9,1,0,10,mixedType,1
10,3,0,13,mixedType,1
6,3,0,9,mixedType,1
6,2,0,8,mixedType,1
16,6,0,22,mixedType,2
2,6,0,8,mixedType,1
4,4,0,8,mixedType,1
4,2,0,6,mixedType,0
4,4,0,8,mixedType,1
6,3,0,9,mixedType,1
1,8,0,9,mixedType,1
7,2,0,9,mixedType,1
6,2,0,8,mixedType,1
13,3,0,16,mixedType,2
7,3,0,10,mixedType,1
8,6,0,14,mixedType,2
11,3,0,14,mixedType,2
7,3,0,10,mixedType,1
6,3,0,9,mixedType,1
8,2,0,10,mixedType,1
4,6,0,10,mixedType,1
12,1,0,13,mixedType,1
4,6,0,10,mixedType,1
6,3,0,9,mixedType,1
6,3,0,9,mixedType,1
3,6,0,9,mixedType,1
6,3,0,9,mixedType,1
5,2,0,7,mixedType,0
7,6,0,13,mixedType,1
5,3,0,8,mixedType,1
6,2,0,8,mixedType,1
17,3,0,20,mixedType,2
8,4,0,12,mixedType,1
13,3,0,16,mixedType,2
3,3,0,6,mixedType,0
8,1,0,9,mixedType,1
7,6,0,13,mixedType,1
4,5,0,9,mixedType,1
4,6,0,10,mixedType,1
11,1,0,12,mixedType,1
5,2,0,7,mixedType,0
5,2,0,7,mixedType,0
1,8,0,9,mixedType,1
9,2,0,11,mixedType,1
6,2,0,8,mixedType,1
1,8,0,9,mixedType,1
5,3,0,8,mixedType,1
10,1,0,11,mixedType,1
5,3,0,8,mixedType,1
6,3,0,9,mixedType,1
9,1,0,10,mixedType,1
7,1,0,8,mixedType,1
11,3,0,14,mixedType,2
8,2,0,10,mixedType,1
8,1,0,9,mixedType,1
4,6,0,10,mixedType,1
3,9,0,12,mixedType,1
6,3,0,9,mixedType,1
6,2,0,8,mixedType,1
3,8,0,11,mixedType,1
3,6,0,9,mixedType,1
5,1,0,6,mixedType,0
8,1,0,9,mixedType,1
8,4,0,12,mixedType,1
9,2,0,11,mixedType,1
4,2,0,6,mixedType,0
7,3,0,10,mixedType,1
9,1,0,10,mixedType,1
5,4,0,9,mixedType,1
7,3,0,10,mixedType,1
8,2,0,10,mixedType,1
6,3,0,9,mixedType,1
7,4,0,11,mixedType,1
13,2,0,15,mixedType,2
2,7,0,9,mixedType,1
12,4,0,16,mixedType,2
10,4,0,14,mixedType,2
1,10,0,11,mixedType,1
2,4,0,6,mixedType,0
0,6,1,7,mixedType,0
10,1,0,11,mixedType,1
1,8,0,9,mixedType,1
3,6,0,9,mixedType,1
7,3,0,10,mixedType,1
6,2,0,8,mixedType,1
7,2,0,9,mixedType,1
6,4,0,10,mixedType,1
6,4,0,10,mixedType,1
2,4,0,6,mixedType,0
4,4,0,8,mixedType,1
9,1,0,10,mixedType,1
2,8,0,10,mixedType,1
8,1,0,9,mixedType,1
5,3,0,8,mixedType,1
7,2,0,9,mixedType,1
8,2,0,10,mixedType,1
10,3,0,13,mixedType,1
9,1,0,10,mixedType,1
10,2,0,12,mixedType,1
7,3,0,10,mixedType,1
4,4,0,8,mixedType,1
9,2,0,11,mixedType,1
8,2,0,10,mixedType,1
8,3,0,11,mixedType,1
2,7,0,9,mixedType,1
8,1,0,9,mixedType,1
1,8,0,9,mixedType,1
4,4,0,8,mixedType,1
8,2,0,10,mixedType,1
3,7,0,10,mixedType,1
13,3,0,16,mixedType,2
8,1,0,9,mixedType,1
4,4,0,8,mixedType,1
4,2,0,6,mixedType,0
8,1,0,9,mixedType,1
6,3,0,9,mixedType,1
5,2,0,7,mixedType,0
4,8,0,12,mixedType,1
5,2,0,7,mixedType,0
9,1,0,10,mixedType,1
6,1,0,7,mixedType,0
6,3,0,9,mixedType,1
5,3,0,8,mixedType,1
12,2,2,16,mixedType,2
3,5,0,8,mixedType,1
8,1,0,9,mixedType,1
13,3,0,16,mixedType,2
4,2,0,6,mixedType,0
6,1,0,7,mixedType,0
4,11,1,16,mixedType,2
3,6,0,9,mixedType,1
7,2,0,9,mixedType,1
5,3,0,8,mixedType,1
2,6,0,8,mixedType,1
7,4,0,11,mixedType,1
4,2,0,6,mixedType,0
6,3,0,9,mixedType,1
5,7,0,12,mixedType,1
4,6,0,10,mixedType,1
14,2,0,16,mixedType,2
11,5,0,16,mixedType,2
11,3,0,14,mixedType,2
6,3,0,9,mixedType,1
11,3,0,14,mixedType,2
9,1,0,10,mixedType,1
4,4,0,8,mixedType,1
4,2,0,6,mixedType,0
7,2,0,9,mixedType,1
6,3,0,9,mixedType,1
5,5,0,10,mixedType,1
5,3,0,8,mixedType,1
13,3,0,16,mixedType,2
1,9,0,10,mixedType,1
3,6,0,9,mixedType,1
6,2,0,8,mixedType,1
8,2,0,10,mixedType,1
5,4,0,9,mixedType,1
1,8,0,9,mixedType,1
7,3,0,10,mixedType,1
11,9,1,21,mixedType,2
13,3,0,16,mixedType,2
7,4,0,11,mixedType,1
4,4,0,8,mixedType,1
9,1,0,10,mixedType,1
2,9,0,11,mixedType,1
6,3,0,9,mixedType,1
10,3,0,13,mixedType,1
4,2,0,6,mixedType,0
5,1,0,6,mixedType,0
5,3,0,8,mixedType,1
4,7,0,11,mixedType,1
6,3,0,9,mixedType,1
2,4,0,6,mixedType,0
7,2,0,9,mixedType,1
14,2,0,16,mixedType,2
10,1,0,11,mixedType,1
8,2,0,10,mixedType,1
2,8,0,10,mixedType,1
2,4,0,6,mixedType,0
3,6,0,9,mixedType,1
7,3,0,10,mixedType,1
1,9,0,10,mixedType,1
8,1,0,9,mixedType,1
2,8,0,10,mixedType,1
12,4,0,16,mixedType,2
8,3,0,11,mixedType,1
2,4,0,6,mixedType,0
1,8,0,9,mixedType,1
6,4,0,10,mixedType,1
5,1,0,6,mixedType,0
7,2,0,9,mixedType,1
7,3,0,10,mixedType,1
5,3,0,8,mixedType,1
9,2,0,11,mixedType,1
9,2,0,11,mixedType,1
3,7,0,10,mixedType,1
9,4,0,13,mixedType,1
7,2,0,9,mixedType,1
8,2,0,10,mixedType,1
3,3,0,6,mixedType,0
6,6,0,12,mixedType,1
7,4,0,11,mixedType,1
13,3,0,16,mixedType,2
6,3,0,9,mixedType,1
5,5,0,10,mixedType,1
8,1,0,9,mixedType,1
7,3,0,10,mixedType,1
7,3,0,10,mixedType,1
8,1,0,9,mixedType,1
6,3,0,9,mixedType,1
9,3,0,12,mixedType,1
2,4,0,6,mixedType,0
7,2,0,9,mixedType,1
5,3,0,8,mixedType,1
7,4,0,11,mixedType,1
5,2,0,7,mixedType,0
5,4,0,9,mixedType,1
11,2,0,13,mixedType,1
7,2,0,9,mixedType,1
5,2,0,7,mixedType,0
8,2,0,10,mixedType,1
7,2,0,9,mixedType,1
1,9,0,10,mixedType,1
5,4,0,9,mixedType,1
9,2,0,11,mixedType,1
12,3,0,15,mixedType,2
8,4,0,12,mixedType,1
4,6,0,10,mixedType,1
1,10,0,11,mixedType,1
7,2,0,9,mixedType,1
5,4,0,9,mixedType,1
4,9,0,13,mixedType,1
6,4,0,10,mixedType,1
5,6,0,11,mixedType,1
6,2,0,8,mixedType,1
3,8,0,11,mixedType,1
4,6,0,10,mixedType,1
5,4,0,9,mixedType,1
5,3,0,8,mixedType,1
6,3,0,9,mixedType,1
6,4,0,10,mixedType,1
11,1,0,12,mixedType,1
5,2,0,7,mixedType,0
6,2,0,8,mixedType,1
9,1,0,10,mixedType,1
5,5,0,10,mixedType,1
7,3,0,10,mixedType,1
7,3,0,10,mixedType,1
4,4,0,8,mixedType,1
7,2,0,9,mixedType,1
5,3,0,8,mixedType,1
7,1,0,8,mixedType,1
1,8,0,9,mixedType,1
7,1,0,8,mixedType,1
5,4,0,9,mixedType,1
8,4,0,12,mixedType,1
6,4,0,10,mixedType,1
4,6,0,10,mixedType,1
5,3,0,8,mixedType,1
4,4,0,8,mixedType,1
7,2,0,9,mixedType,1
2,10,0,12,mixedType,1
11,5,0,16,mixedType,2
2,6,0,8,mixedType,1
5,6,0,11,mixedType,1
7,3,0,10,mixedType,1
6,1,0,7,mixedType,0
8,2,0,10,mixedType,1
10,3,0,13,mixedType,1
15,1,0,16,mixedType,2
9,3,0,12,mixedType,1
9,7,3,19,mixedType,2
3,7,0,10,mixedType,1
4,2,0,6,mixedType,0
6,4,0,10,mixedType,1
7,1,0,8,mixedType,1
5,2,0,7,mixedType,0
8,3,0,11,mixedType,1
7,1,0,8,mixedType,1
6,3,0,9,mixedType,1
12,1,0,13,mixedType,1
8,2,0,10,mixedType,1
6,2,0,8,mixedType,1
1,10,0,11,mixedType,1
6,2,0,8,mixedType,1
6,3,0,9,mixedType,1
13,3,0,16,mixedType,2
6,3,0,9,mixedType,1
9,2,0,11,mixedType,1
9,2,0,11,mixedType,1
5,4,0,9,mixedType,1
3,6,0,9,mixedType,1
6,3,0,9,mixedType,1
2,9,0,11,mixedType,1
8,2,0,10,mixedType,1
3,3,0,6,mixedType,0
3,6,0,9,mixedType,1
6,1,0,7,mixedType,0
5,2,0,7,mixedType,0
5,3,0,8,mixedType,1
7,4,0,11,mixedType,1
7,1,0,8,mixedType,1
3,6,0,9,mixedType,1
2,6,0,8,mixedType,1
15,1,0,16,mixedType,2
6,3,0,9,mixedType,1
7,3,0,10,mixedType,1
7,3,0,10,mixedType,1
14,2,0,16,mixedType,2
7,4,0,11,mixedType,1
6,6,0,12,mixedType,1
8,2,0,10,mixedType,1
11,1,0,12,mixedType,1
5,1,0,6,mixedType,0
12,4,0,16,mixedType,2
5,3,0,8,mixedType,1
5,4,0,9,mixedType,1
6,3,0,9,mixedType,1
10,2,3,15,mixedType,2
9,1,0,10,mixedType,1
6,4,0,10,mixedType,1
8,1,0,9,mixedType,1
3,5,0,8,mixedType,1
6,4,0,10,mixedType,1
14,2,0,16,mixedType,2
4,4,0,8,mixedType,1
12,4,0,16,mixedType,2
7,3,0,10,mixedType,1
4,4,0,8,mixedType,1
14,2,0,16,mixedType,2
4,8,0,12,mixedType,1
11,3,0,14,mixedType,2
6,3,0,9,mixedType,1
3,3,0,6,mixedType,0
7,1,0,8,mixedType,1
8,2,0,10,mixedType,1
8,2,0,10,mixedType,1
7,3,0,10,mixedType,1
7,2,0,9,mixedType,1
6,4,0,10,mixedType,1
7,3,0,10,mixedType,1
7,2,0,9,mixedType,1
7,2,0,9,mixedType,1
7,1,0,8,mixedType,1
4,4,0,8,mixedType,1
7,1,0,8,mixedType,1
3,6,0,9,mixedType,1
6,3,0,9,mixedType,1
5,5,0,10,mixedType,1
12,1,1,14,mixedType,2
7,1,0,8,mixedType,1
4,8,0,12,mixedType,1
6,4,0,10,mixedType,1
1,10,0,11,mixedType,1
7,3,0,10,mixedType,1
6,3,0,9,mixedType,1
7,3,0,10,mixedType,1
5,1,0,6,mixedType,0
4,6,0,10,mixedType,1
8,1,0,9,mixedType,1
11,5,0,16,mixedType,2
7,1,0,8,mixedType,1
2,10,0,12,mixedType,1
8,1,0,9,mixedType,1
8,1,0,9,mixedType,1
6,1,0,7,mixedType,0
14,2,0,16,mixedType,2
4,2,0,6,mixedType,0
5,3,0,8,mixedType,1
6,4,0,10,mixedType,1
8,1,0,9,mixedType,1
6,2,0,8,mixedType,1
8,2,0,10,mixedType,1
5,2,0,7,mixedType,0
1,5,0,6,mixedType,0
4,2,0,6,mixedType,0
9,3,0,12,mixedType,1
8,2,0,10,mixedType,1
7,3,0,10,mixedType,1
7,1,0,8,mixedType,1
7,3,0,10,mixedType,1
2,8,0,10,mixedType,1
6,1,0,7,mixedType,0
8,4,0,12,mixedType,1
1,9,0,10,mixedType,1
5,4,0,9,mixedType,1
8,1,0,9,mixedType,1
8,2,0,10,mixedType,1
6,3,0,9,mixedType,1
6,3,0,9,mixedType,1
3,3,0,6,mixedType,0
5,3,0,8,mixedType,1
7,3,0,10,mixedType,1
6,3,0,9,mixedType,1
4,2,0,6,mixedType,0
8,2,0,10,mixedType,1
3,3,0,6,mixedType,0
6,4,0,10,mixedType,1
5,1,0,6,mixedType,0
4,2,0,6,mixedType,0
12,4,0,16,mixedType,2
5,3,0,8,mixedType,1
5,3,0,8,mixedType,1
12,1,0,13,mixedType,1
6,2,0,8,mixedType,1
11,1,0,12,mixedType,1
5,2,0,7,mixedType,0
9,2,0,11,mixedType,1
8,2,0,10,mixedType,1
2,7,0,9,mixedType,1
7,3,0,10,mixedType,1
4,8,0,12,mixedType,1
4,6,0,10,mixedType,1
13,3,0,16,mixedType,2
7,1,0,8,mixedType,1
6,4,0,10,mixedType,1
7,3,0,10,mixedType,1
8,1,0,9,mixedType,1
5,3,0,8,mixedType,1
6,1,0,7,mixedType,0
4,6,0,10,mixedType,1
6,1,0,7,mixedType,0
6,4,0,10,mixedType,1
7,2,0,9,mixedType,1
7,3,0,10,mixedType,1
7,4,0,11,mixedType,1
6,2,0,8,mixedType,1
7,3,0,10,mixedType,1
3,9,0,12,mixedType,1
5,3,0,8,mixedType,1
4,2,0,6,mixedType,0
9,1,0,10,mixedType,1
14,2,0,16,mixedType,2
6,3,0,9,mixedType,1
5,3,0,8,mixedType,1
7,3,0,10,mixedType,1
7,5,0,12,mixedType,1
7,3,0,10,mixedType,1
4,4,0,8,mixedType,1
4,4,0,8,mixedType,1
5,3,0,8,mixedType,1
5,9,2,16,mixedType,2
12,3,0,15,mixedType,2
5,3,0,8,mixedType,1
14,2,0,16,mixedType,2
8,2,0,10,mixedType,1
9,1,0,10,mixedType,1
5,4,0,9,mixedType,1
4,2,0,6,mixedType,0
7,1,0,8,mixedType,1
5,4,0,9,mixedType,1
5,2,0,7,mixedType,0
7,3,0,10,mixedType,1
8,1,0,9,mixedType,1
2,6,0,8,mixedType,1
6,3,0,9,mixedType,1
12,4,0,16,mixedType,2
8,1,0,9,mixedType,1
6,2,0,8,mixedType,1
9,3,0,12,mixedType,1
5,2,0,7,mixedType,0
8,2,0,10,mixedType,1
5,3,0,8,mixedType,1
6,4,0,10,mixedType,1
14,2,0,16,mixedType,2
14,2,0,16,mixedType,2
9,3,0,12,mixedType,1
7,3,0,10,mixedType,1
7,3,0,10,mixedType,1
6,1,0,7,mixedType,0
1,8,0,9,mixedType,1
7,3,0,10,mixedType,1
11,1,0,12,mixedType,1
5,4,0,9,mixedType,1
7,3,0,10,mixedType,1
12,4,0,16,mixedType,2
7,2,0,9,mixedType,1
5,2,0,7,mixedType,0
1,11,0,12,mixedType,1
3,7,0,10,mixedType,1
8,1,0,9,mixedType,1
6,1,0,7,mixedType,0
8,1,0,9,mixedType,1
7,3,0,10,mixedType,1
6,2,0,8,mixedType,1
7,2,0,9,mixedType,1
12,4,0,16,mixedType,2
6,1,0,7,mixedType,0
3,6,0,9,mixedType,1
8,1,0,9,mixedType,1
5,2,0,7,mixedType,0
7,1,0,8,mixedType,1
2,6,0,8,mixedType,1
3,7,0,10,mixedType,1
6,1,0,7,mixedType,0
6,1,0,7,mixedType,0
8,1,0,9,mixedType,1
4,2,0,6,mixedType,0
11,3,0,14,mixedType,2
7,2,0,9,mixedType,1
8,1,0,9,mixedType,1
13,4,2,19,mixedType,2
14,2,0,16,mixedType,2
5,3,0,8,mixedType,1
7,3,0,10,mixedType,1
5,4,0,9,mixedType,1
8,2,0,10,mixedType,1
6,3,0,9,mixedType,1
2,8,0,10,mixedType,1
9,1,0,10,mixedType,1
7,2,0,9,mixedType,1
4,2,0,6,mixedType,0
12,3,0,15,mixedType,2
5,3,0,8,mixedType,1
7,2,0,9,mixedType,1
5,1,0,6,mixedType,0
6,3,0,9,mixedType,1
7,3,0,10,mixedType,1
7,4,0,11,mixedType,1
5,3,0,8,mixedType,1
6,3,0,9,mixedType,1
9,1,0,10,mixedType,1
4,4,0,8,mixedType,1
5,3,0,8,mixedType,1
4,4,0,8,mixedType,1
6,5,0,11,mixedType,1
8,1,0,9,mixedType,1
5,1,0,6,mixedType,0
4,2,0,6,mixedType,0
8,2,0,10,mixedType,1
6,2,0,8,mixedType,1
6,2,0,8,mixedType,1
8,1,0,9,mixedType,1
5,6,0,11,mixedType,1
6,4,0,10,mixedType,1
2,8,0,10,mixedType,1
12,1,0,13,mixedType,1
8,2,0,10,mixedType,1
4,4,0,8,mixedType,1
8,2,0,10,mixedType,1
7,3,0,10,mixedType,1
4,4,0,8,mixedType,1
14,2,0,16,mixedType,2
12,4,0,16,mixedType,2
14,1,1,16,mixedType,2
14,2,0,16,mixedType,2
4,4,1,9,mixedType,1
4,4,0,8,mixedType,1
8,1,0,9,mixedType,1
8,2,0,10,mixedType,1
8,2,0,10,mixedType,1
7,3,0,10,mixedType,1
5,4,0,9,mixedType,1
6,3,0,9,mixedType,1
13,3,0,16,mixedType,2
4,2,0,6,mixedType,0
5,3,0,8,mixedType,1
7,1,0,8,mixedType,1
5,4,0,9,mixedType,1
6,2,0,8,mixedType,1
7,3,0,10,mixedType,1
4,2,0,6,mixedType,0
9,1,0,10,mixedType,1
6,2,0,8,mixedType,1
8,4,0,12,mixedType,1
4,4,0,8,mixedType,1
7,2,0,9,mixedType,1
9,1,0,10,mixedType,1
10,8,0,18,mixedType,2
14,2,0,16,mixedType,2
7,3,0,10,mixedType,1
7,3,0,10,mixedType,1
7,3,0,10,mixedType,1
7,4,0,11,mixedType,1
6,3,0,9,mixedType,1
17,3,0,20,mixedType,2
1,8,0,9,mixedType,1
4,5,0,9,mixedType,1
8,5,1,14,mixedType,2
5,2,0,7,mixedType,0
6,3,0,9,mixedType,1
4,2,0,6,mixedType,0
7,3,0,10,mixedType,1
4,4,0,8,mixedType,1
6,3,0,9,mixedType,1
9,1,0,10,mixedType,1
8,3,0,11,mixedType,1
5,4,0,9,mixedType,1
6,4,0,10,mixedType,1
9,1,0,10,mixedType,1
6,4,0,10,mixedType,1
11,1,0,12,mixedType,1
6,3,0,9,mixedType,1
3,7,0,10,mixedType,1
6,3,0,9,mixedType,1
6,2,0,8,mixedType,1
7,2,0,9,mixedType,1
8,1,0,9,mixedType,1
7,1,0,8,mixedType,1
2,10,0,12,mixedType,1
8,2,0,10,mixedType,1
6,1,0,7,mixedType,0
5,1,0,6,mixedType,0
7,2,0,9,mixedType,1
6,3,0,9,mixedType,1
8,0,1,9,mixedType,1
7,2,0,9,mixedType,1
12,3,0,15,mixedType,2
14,2,0,16,mixedType,2
14,2,0,16,mixedType,2
6,3,0,9,mixedType,1
7,1,0,8,mixedType,1
6,1,0,7,mixedType,0
13,3,0,16,mixedType,2
9,1,0,10,mixedType,1
5,2,0,7,mixedType,0
5,1,0,6,mixedType,0
6,2,0,8,mixedType,1
9,1,0,10,mixedType,1
2,6,0,8,mixedType,1
6,1,0,7,mixedType,0
8,4,0,12,mixedType,1
5,4,0,9,mixedType,1
9,4,0,13,mixedType,1
7,3,0,10,mixedType,1
10,2,0,12,mixedType,1
7,3,0,10,mixedType,1
4,2,0,6,mixedType,0
12,4,0,16,mixedType,2
7,3,0,10,mixedType,1
4,4,0,8,mixedType,1
3,6,0,9,mixedType,1
10,0,1,11,mixedType,1
6,3,0,9,mixedType,1
6,1,0,7,mixedType,0
9,3,2,14,mixedType,2
8,3,0,11,mixedType,1
1,7,0,8,mixedType,1
7,1,0,8,mixedType,1
4,4,0,8,mixedType,1
5,5,0,10,mixedType,1
14,2,0,16,mixedType,2
2,7,0,9,mixedType,1
4,5,0,9,mixedType,1
4,5,0,9,mixedType,1
13,3,0,16,mixedType,2
18,1,1,20,mixedType,2
7,1,0,8,mixedType,1
8,1,0,9,mixedType,1
7,2,0,9,mixedType,1
8,1,0,9,mixedType,1
9,2,0,11,mixedType,1
1,7,0,8,mixedType,1
7,3,0,10,mixedType,1
6,3,0,9,mixedType,1
6,1,0,7,mixedType,0
4,2,0,6,mixedType,0
5,2,0,7,mixedType,0
2,7,0,9,mixedType,1
15,1,0,16,mixedType,2
4,2,0,6,mixedType,0
7,1,0,8,mixedType,1
6,3,0,9,mixedType,1
5,4,0,9,mixedType,1
4,4,0,8,mixedType,1
4,2,0,6,mixedType,0
4,5,0,9,mixedType,1
5,3,0,8,mixedType,1
8,1,0,9,mixedType,1
4,4,0,8,mixedType,1
7,1,0,8,mixedType,1
4,7,0,11,mixedType,1
5,3,0,8,mixedType,1
6,0,1,7,mixedType,0
7,2,0,9,mixedType,1
4,6,0,10,mixedType,1
7,2,0,9,mixedType,1
11,3,0,14,mixedType,2
7,4,0,11,mixedType,1
5,1,0,6,mixedType,0
2,6,0,8,mixedType,1
8,1,0,9,mixedType,1
6,2,0,8,mixedType,1
1,8,0,9,mixedType,1
15,7,0,22,mixedType,2
15,1,0,16,mixedType,2
5,3,0,8,mixedType,1
14,2,0,16,mixedType,2
2,8,0,10,mixedType,1
6,3,0,9,mixedType,1
8,4,0,12,mixedType,1
8,2,0,10,mixedType,1
6,3,0,9,mixedType,1
14,2,0,16,mixedType,2
5,2,0,7,mixedType,0
10,2,0,12,mixedType,1
8,2,0,10,mixedType,1
6,4,0,10,mixedType,1
5,2,0,7,mixedType,0
14,2,0,16,mixedType,2
14,2,0,16,mixedType,2
7,5,0,12,mixedType,1
14,2,0,16,mixedType,2
4,2,0,6,mixedType,0
7,2,0,9,mixedType,1
6,2,0,8,mixedType,1
4,6,0,10,mixedType,1
7,3,0,10,mixedType,1
11,4,0,15,mixedType,2
8,2,0,10,mixedType,1
6,1,0,7,mixedType,0
8,2,0,10,mixedType,1
3,10,0,13,mixedType,1
4,2,0,6,mixedType,0
14,1,0,15,mixedType,2
1,8,0,9,mixedType,1
7,2,0,9,mixedType,1
6,1,0,7,mixedType,0
7,1,0,8,mixedType,1
8,2,0,10,mixedType,1
4,6,0,10,mixedType,1
10,6,0,16,mixedType,2
5,4,0,9,mixedType,1
4,2,0,6,mixedType,0
7,3,0,10,mixedType,1
5,7,0,12,mixedType,1
7,2,0,9,mixedType,1
15,1,0,16,mixedType,2
8,1,0,9,mixedType,1
8,4,0,12,mixedType,1
5,0,0,5,sameType,0
8,2,0,10,mixedType,1
7,2,0,9,mixedType,1
8,1,0,9,mixedType,1
1,9,0,10,mixedType,1
5,3,0,8,mixedType,1
6,1,0,7,mixedType,0
9,2,0,11,mixedType,1
7,2,0,9,mixedType,1
11,2,0,13,mixedType,1
5,4,0,9,mixedType,1
8,1,0,9,mixedType,1
5,2,0,7,mixedType,0
8,1,0,9,mixedType,1
4,6,0,10,mixedType,1
7,3,0,10,mixedType,1
6,4,0,10,mixedType,1
12,4,0,16,mixedType,2
10,2,0,12,mixedType,1
8,2,0,10,mixedType,1
5,8,0,13,mixedType,1
6,2,0,8,mixedType,1
6,3,0,9,mixedType,1
6,1,0,7,mixedType,0
1,9,0,10,mixedType,1
10,5,1,16,mixedType,2
7,4,0,11,mixedType,1
6,4,0,10,mixedType,1
6,4,0,10,mixedType,1
18,1,0,19,mixedType,2
5,3,0,8,mixedType,1
1,10,0,11,mixedType,1
8,4,0,12,mixedType,1
12,4,0,16,mixedType,2
8,1,0,9,mixedType,1
4,4,0,8,mixedType,1
7,2,0,9,mixedType,1
14,2,0,16,mixedType,2
14,2,0,16,mixedType,2
6,2,0,8,mixedType,1
7,6,0,13,mixedType,1
6,1,0,7,mixedType,0
7,1,0,8,mixedType,1
6,2,0,8,mixedType,1
2,8,0,10,mixedType,1
5,3,0,8,mixedType,1
8,2,0,10,mixedType,1
2,4,0,6,mixedType,0
8,2,0,10,mixedType,1
15,3,1,19,mixedType,2
5,7,0,12,mixedType,1
4,4,0,8,mixedType,1
6,3,0,9,mixedType,1
14,2,0,16,mixedType,2
5,3,0,8,mixedType,1
14,2,0,16,mixedType,2
8,1,0,9,mixedType,1
8,1,0,9,mixedType,1
7,2,0,9,mixedType,1
13,3,0,16,mixedType,2
6,2,0,8,mixedType,1
6,3,0,9,mixedType,1
15,1,0,16,mixedType,2
3,6,0,9,mixedType,1
6,2,0,8,mixedType,1
7,3,0,10,mixedType,1
6,3,0,9,mixedType,1
5,6,0,11,mixedType,1
9,1,0,10,mixedType,1
12,4,0,16,mixedType,2
9,4,0,13,mixedType,1
1,7,0,8,mixedType,1
15,1,0,16,mixedType,2
5,2,0,7,mixedType,0
6,3,0,9,mixedType,1
15,8,0,23,mixedType,2
6,2,0,8,mixedType,1
8,3,0,11,mixedType,1
8,2,0,10,mixedType,1
5,2,0,7,mixedType,0
9,2,0,11,mixedType,1
1,5,0,6,mixedType,0
10,3,0,13,mixedType,1
12,4,0,16,mixedType,2
6,2,0,8,mixedType,1
9,2,0,11,mixedType,1
10,3,1,14,mixedType,2
6,1,0,7,mixedType,0
6,6,0,12,mixedType,1
4,4,0,8,mixedType,1
9,1,0,10,mixedType,1
7,3,0,10,mixedType,1
5,3,0,8,mixedType,1
8,2,0,10,mixedType,1
5,3,0,8,mixedType,1
4,0,1,5,mixedType,0
5,2,0,7,mixedType,0
5,4,0,9,mixedType,1
1,8,0,9,mixedType,1
8,1,0,9,mixedType,1
6,3,0,9,mixedType,1
8,2,0,10,mixedType,1
7,3,0,10,mixedType,1
5,4,0,9,mixedType,1
2,8,0,10,mixedType,1
8,3,0,11,mixedType,1
5,4,0,9,mixedType,1
15,1,0,16,mixedType,2
6,1,0,7,mixedType,0
12,2,1,15,mixedType,2
9,2,0,11,mixedType,1
8,1,0,9,mixedType,1
5,4,0,9,mixedType,1
6,3,0,9,mixedType,1
13,3,0,16,mixedType,2
5,5,0,10,mixedType,1
6,2,0,8,mixedType,1
7,2,0,9,mixedType,1
7,2,0,9,mixedType,1
7,1,0,8,mixedType,1
5,3,0,8,mixedType,1
9,1,0,10,mixedType,1
9,3,0,12,mixedType,1
9,1,0,10,mixedType,1
13,3,0,16,mixedType,2
10,1,0,11,mixedType,1
5,3,0,8,mixedType,1
7,2,0,9,mixedType,1
15,1,0,16,mixedType,2
6,1,0,7,mixedType,0
3,6,0,9,mixedType,1
7,2,0,9,mixedType,1
3,3,0,6,mixedType,0
4,4,0,8,mixedType,1
8,3,0,11,mixedType,1
6,1,0,7,mixedType,0
8,1,0,9,mixedType,1
4,5,0,9,mixedType,1
8,1,0,9,mixedType,1
8,1,0,9,mixedType,1
3,3,0,6,mixedType,0
6,3,0,9,mixedType,1
4,2,0,6,mixedType,0
2,6,0,8,mixedType,1
7,1,0,8,mixedType,1
4,5,0,9,mixedType,1
6,2,0,8,mixedType,1
6,1,0,7,mixedType,0
7,8,0,15,mixedType,2
5,4,0,9,mixedType,1
7,2,0,9,mixedType,1
6,4,0,10,mixedType,1
13,3,0,16,mixedType,2
7,5,0,12,mixedType,1
8,4,0,12,mixedType,1
14,2,0,16,mixedType,2
8,3,0,11,mixedType,1
6,1,0,7,mixedType,0
2,7,0,9,mixedType,1
8,3,0,11,mixedType,1
5,4,0,9,mixedType,1
14,2,0,16,mixedType,2
7,3,0,10,mixedType,1
14,2,0,16,mixedType,2
5,3,0,8,mixedType,1
6,3,0,9,mixedType,1
7,3,0,10,mixedType,1
10,1,0,11,mixedType,1
7,1,0,8,mixedType,1
4,4,0,8,mixedType,1
7,2,0,9,mixedType,1
15,2,0,17,mixedType,2
12,4,0,16,mixedType,2
3,6,0,9,mixedType,1
11,1,0,12,mixedType,1
7,1,0,8,mixedType,1
4,2,0,6,mixedType,0
7,2,0,9,mixedType,1
15,1,0,16,mixedType,2
1,8,0,9,mixedType,1
6,1,0,7,mixedType,0
5,5,0,10,mixedType,1
8,2,0,10,mixedType,1
7,1,0,8,mixedType,1
3,6,0,9,mixedType,1
12,4,0,16,mixedType,2
2,8,0,10,mixedType,1
4,6,0,10,mixedType,1
6,2,0,8,mixedType,1
5,7,0,12,mixedType,1
3,6,0,9,mixedType,1
4,4,0,8,mixedType,1
6,4,0,10,mixedType,1
8,2,0,10,mixedType,1
2,8,0,10,mixedType,1
4,4,0,8,mixedType,1
9,1,0,10,mixedType,1
7,3,0,10,mixedType,1
7,2,0,9,mixedType,1
8,2,0,10,mixedType,1
6,3,0,9,mixedType,1
8,2,0,10,mixedType,1
9,2,0,11,mixedType,1
7,2,0,9,mixedType,1
4,2,0,6,mixedType,0
7,3,0,10,mixedType,1
14,2,0,16,mixedType,2
7,3,0,10,mixedType,1
6,3,0,9,mixedType,1
5,2,0,7,mixedType,0
14,2,0,16,mixedType,2
4,5,0,9,mixedType,1
4,4,0,8,mixedType,1
14,2,0,16,mixedType,2
9,2,0,11,mixedType,1
14,2,0,16,mixedType,2
12,4,0,16,mixedType,2
5,2,0,7,mixedType,0
6,4,0,10,mixedType,1
12,1,0,13,mixedType,1
10,3,0,13,mixedType,1
8,1,0,9,mixedType,1
6,3,0,9,mixedType,1
5,2,0,7,mixedType,0
6,2,0,8,mixedType,1
7,3,0,10,mixedType,1
10,2,0,12,mixedType,1
6,1,0,7,mixedType,0
9,3,0,12,mixedType,1
9,3,0,12,mixedType,1
4,5,0,9,mixedType,1
5,3,0,8,mixedType,1
9,1,0,10,mixedType,1
3,8,0,11,mixedType,1
11,3,0,14,mixedType,2
7,3,0,10,mixedType,1
4,2,0,6,mixedType,0
10,2,0,12,mixedType,1
8,3,0,11,mixedType,1
4,2,0,6,mixedType,0
5,6,0,11,mixedType,1
7,3,0,10,mixedType,1
1,9,0,10,mixedType,1
4,4,0,8,mixedType,1
9,3,0,12,mixedType,1
9,2,0,11,mixedType,1
11,2,0,13,mixedType,1
6,4,0,10,mixedType,1
15,1,0,16,mixedType,2
13,3,0,16,mixedType,2
6,3,0,9,mixedType,1
7,3,0,10,mixedType,1
8,1,0,9,mixedType,1
1,7,0,8,mixedType,1
8,1,0,9,mixedType,1
6,5,0,11,mixedType,1
7,3,0,10,mixedType,1
9,2,0,11,mixedType,1
3,3,0,6,mixedType,0
2,7,0,9,mixedType,1
2,8,0,10,mixedType,1
8,1,0,9,mixedType,1
16,2,1,19,mixedType,2
4,6,0,10,mixedType,1
6,3,0,9,mixedType,1
6,3,0,9,mixedType,1
7,3,0,10,mixedType,1
7,3,0,10,mixedType,1
3,5,0,8,mixedType,1
7,2,0,9,mixedType,1
9,1,0,10,mixedType,1
9,2,0,11,mixedType,1
8,1,0,9,mixedType,1
3,6,0,9,mixedType,1
15,1,0,16,mixedType,2
6,2,0,8,mixedType,1
6,2,0,8,mixedType,1
10,3,0,13,mixedType,1
7,2,0,9,mixedType,1
14,2,0,16,mixedType,2
8,3,0,11,mixedType,1
1,9,0,10,mixedType,1
8,1,0,9,mixedType,1
7,3,0,10,mixedType,1
15,1,0,16,mixedType,2
6,2,0,8,mixedType,1
5,4,0,9,mixedType,1
5,5,0,10,mixedType,1
9,2,0,11,mixedType,1
5,3,0,8,mixedType,1
10,2,0,12,mixedType,1
6,3,0,9,mixedType,1
8,2,0,10,mixedType,1
5,3,0,8,mixedType,1
8,1,0,9,mixedType,1
8,1,0,9,mixedType,1
5,2,0,7,mixedType,0
9,2,0,11,mixedType,1
4,2,0,6,mixedType,0
8,1,0,9,mixedType,1
9,1,0,10,mixedType,1
8,3,0,11,mixedType,1
6,7,0,13,mixedType,1
6,1,0,7,mixedType,0
8,1,0,9,mixedType,1
8,4,0,12,mixedType,1
8,1,0,9,mixedType,1
5,2,0,7,mixedType,0
7,4,0,11,mixedType,1
9,3,0,12,mixedType,1
5,6,0,11,mixedType,1
5,2,0,7,mixedType,0
5,2,0,7,mixedType,0
7,3,0,10,mixedType,1
5,3,0,8,mixedType,1
8,1,0,9,mixedType,1
7,3,0,10,mixedType,1
15,1,0,16,mixedType,2
7,3,0,10,mixedType,1
15,1,0,16,mixedType,2
5,8,0,13,mixedType,1
8,1,0,9,mixedType,1
3,5,0,8,mixedType,1
13,3,0,16,mixedType,2
7,4,0,11,mixedType,1
7,2,0,9,mixedType,1
8,1,0,9,mixedType,1
7,3,0,10,mixedType,1
14,2,0,16,mixedType,2
7,2,0,9,mixedType,1
4,4,0,8,mixedType,1
6,3,0,9,mixedType,1
8,4,0,12,mixedType,1
7,3,0,10,mixedType,1
9,1,0,10,mixedType,1
9,0,1,10,mixedType,1
8,0,2,10,mixedType,1
8,2,0,10,mixedType,1
3,6,0,9,mixedType,1
5,1,0,6,mixedType,0
15,4,0,19,mixedType,2
6,1,0,7,mixedType,0
6,4,0,10,mixedType,1
7,4,0,11,mixedType,1
9,2,0,11,mixedType,1
7,3,0,10,mixedType,1
7,1,0,8,mixedType,1
5,3,0,8,mixedType,1
7,2,0,9,mixedType,1
8,1,0,9,mixedType,1
5,2,0,7,mixedType,0
8,4,0,12,mixedType,1
6,4,0,10,mixedType,1
7,1,0,8,mixedType,1
4,2,0,6,mixedType,0
5,2,0,7,mixedType,0
4,4,0,8,mixedType,1
6,3,0,9,mixedType,1
6,5,0,11,mixedType,1
10,2,2,14,mixedType,2
5,6,0,11,mixedType,1
5,3,0,8,mixedType,1
13,2,1,16,mixedType,2
7,2,0,9,mixedType,1
4,2,0,6,mixedType,0
8,1,0,9,mixedType,1
9,1,0,10,mixedType,1
12,4,0,16,mixedType,2
6,3,0,9,mixedType,1
7,3,0,10,mixedType,1
8,1,0,9,mixedType,1
5,2,0,7,mixedType,0
6,3,0,9,mixedType,1
7,1,0,8,mixedType,1
8,1,0,9,mixedType,1
9,1,0,10,mixedType,1
3,3,0,6,mixedType,0
11,2,0,13,mixedType,1
7,2,0,9,mixedType,1
9,4,0,13,mixedType,1
9,3,0,12,mixedType,1
6,4,0,10,mixedType,1
14,2,0,16,mixedType,2
8,1,0,9,mixedType,1
4,4,0,8,mixedType,1
7,2,0,9,mixedType,1
1,8,0,9,mixedType,1
9,3,0,12,mixedType,1
5,6,0,11,mixedType,1
6,1,0,7,mixedType,0
7,3,0,10,mixedType,1
7,3,0,10,mixedType,1
6,2,0,8,mixedType,1
5,3,0,8,mixedType,1
3,9,0,12,mixedType,1
1,8,0,9,mixedType,1
6,8,0,14,mixedType,2
6,3,0,9,mixedType,1
14,2,0,16,mixedType,2
2,6,0,8,mixedType,1
13,3,0,16,mixedType,2
6,3,0,9,mixedType,1
7,4,0,11,mixedType,1
5,2,0,7,mixedType,0
8,1,0,9,mixedType,1
9,2,0,11,mixedType,1
3,6,0,9,mixedType,1
3,6,0,9,mixedType,1
7,1,0,8,mixedType,1
14,2,0,16,mixedType,2
11,3,0,14,mixedType,2
4,5,0,9,mixedType,1
4,9,0,13,mixedType,1
3,6,0,9,mixedType,1
6,1,0,7,mixedType,0
7,2,0,9,mixedType,1
9,1,0,10,mixedType,1
7,2,0,9,mixedType,1
1,10,0,11,mixedType,1
6,2,0,8,mixedType,1
10,1,0,11,mixedType,1
6,1,0,7,mixedType,0
7,3,0,10,mixedType,1
3,6,0,9,mixedType,1
6,3,0,9,mixedType,1
14,2,0,16,mixedType,2
10,4,2,16,mixedType,2
4,4,0,8,mixedType,1
13,3,0,16,mixedType,2
6,0,1,7,mixedType,0
7,3,0,10,mixedType,1
4,5,0,9,mixedType,1
13,3,0,16,mixedType,2
6,3,0,9,mixedType,1
2,9,0,11,mixedType,1
9,1,0,10,mixedType,1
8,3,0,11,mixedType,1
4,2,0,6,mixedType,0
5,2,0,7,mixedType,0
5,1,0,6,mixedType,0
1,8,0,9,mixedType,1
9,1,0,10,mixedType,1
11,5,0,16,mixedType,2
15,1,0,16,mixedType,2
4,5,0,9,mixedType,1
7,1,0,8,mixedType,1
8,3,0,11,mixedType,1
5,4,0,9,mixedType,1
4,2,0,6,mixedType,0
6,2,0,8,mixedType,1
6,3,0,9,mixedType,1
8,3,0,11,mixedType,1
7,2,0,9,mixedType,1
5,4,0,9,mixedType,1
6,2,0,8,mixedType,1
7,6,0,13,mixedType,1
13,2,0,15,mixedType,2
3,3,0,6,mixedType,0
6,2,0,8,mixedType,1
4,2,0,6,mixedType,0
1,10,0,11,mixedType,1
7,3,0,10,mixedType,1
7,2,0,9,mixedType,1
5,13,0,18,mixedType,2
5,6,0,11,mixedType,1
9,1,0,10,mixedType,1
8,4,0,12,mixedType,1
5,2,0,7,mixedType,0
7,2,0,9,mixedType,1
12,4,0,16,mixedType,2
6,3,0,9,mixedType,1
7,3,0,10,mixedType,1
4,6,0,10,mixedType,1
4,4,0,8,mixedType,1
3,8,0,11,mixedType,1
4,6,0,10,mixedType,1
8,2,0,10,mixedType,1
8,3,0,11,mixedType,1
6,2,0,8,mixedType,1
5,6,0,11,mixedType,1
5,3,0,8,mixedType,1
6,4,0,10,mixedType,1
8,5,0,13,mixedType,1
5,2,0,7,mixedType,0
3,3,0,6,mixedType,0
3,6,0,9,mixedType,1
14,2,0,16,mixedType,2
6,2,0,8,mixedType,1
3,6,0,9,mixedType,1
9,3,0,12,mixedType,1
14,2,0,16,mixedType,2
8,1,0,9,mixedType,1
8,1,0,9,mixedType,1
1,8,0,9,mixedType,1
5,6,0,11,mixedType,1
8,2,0,10,mixedType,1
2,6,0,8,mixedType,1
8,3,0,11,mixedType,1
11,4,0,15,mixedType,2
6,4,0,10,mixedType,1
14,2,0,16,mixedType,2
14,2,0,16,mixedType,2
9,4,0,13,mixedType,1
6,4,0,10,mixedType,1
5,3,0,8,mixedType,1
5,1,0,6,mixedType,0
5,7,0,12,mixedType,1
6,1,0,7,mixedType,0
5,3,0,8,mixedType,1
8,1,0,9,mixedType,1
7,2,0,9,mixedType,1
12,4,0,16,mixedType,2
3,6,0,9,mixedType,1
9,2,0,11,mixedType,1
11,3,0,14,mixedType,2
6,4,0,10,mixedType,1
6,2,6,14,mixedType,2
5,4,0,9,mixedType,1
6,3,0,9,mixedType,1
8,2,0,10,mixedType,1
6,4,0,10,mixedType,1
9,1,0,10,mixedType,1
8,1,0,9,mixedType,1
6,3,0,9,mixedType,1
4,6,0,10,mixedType,1
5,1,0,6,mixedType,0
8,4,0,12,mixedType,1
12,3,0,15,mixedType,2
8,4,0,12,mixedType,1
4,4,0,8,mixedType,1
1,9,0,10,mixedType,1
3,6,0,9,mixedType,1
6,3,0,9,mixedType,1
1,8,0,9,mixedType,1
1,8,0,9,mixedType,1
6,3,0,9,mixedType,1
5,3,0,8,mixedType,1
8,1,0,9,mixedType,1
10,2,0,12,mixedType,1
5,5,0,10,mixedType,1
6,2,0,8,mixedType,1
5,2,0,7,mixedType,0
7,1,0,8,mixedType,1
9,1,0,10,mixedType,1
7,3,0,10,mixedType,1
7,2,0,9,mixedType,1
5,4,0,9,mixedType,1
7,2,0,9,mixedType,1
3,6,0,9,mixedType,1
6,4,0,10,mixedType,1
6,3,0,9,mixedType,1
7,3,0,10,mixedType,1
5,3,0,8,mixedType,1
4,9,0,13,mixedType,1
10,2,0,12,mixedType,1
4,4,0,8,mixedType,1
3,5,0,8,mixedType,1
15,0,1,16,mixedType,2
7,3,0,10,mixedType,1
2,7,0,9,mixedType,1
3,6,0,9,mixedType,1
6,3,0,9,mixedType,1
3,9,0,12,mixedType,1
6,2,0,8,mixedType,1
13,3,0,16,mixedType,2
6,3,0,9,mixedType,1
1,9,0,10,mixedType,1
13,3,0,16,mixedType,2
3,7,0,10,mixedType,1
7,2,0,9,mixedType,1
2,7,0,9,mixedType,1
5,2,0,7,mixedType,0
3,6,0,9,mixedType,1
5,1,0,6,mixedType,0
2,4,0,6,mixedType,0
9,1,0,10,mixedType,1
6,2,0,8,mixedType,1
6,2,0,8,mixedType,1
12,4,0,16,mixedType,2
10,1,0,11,mixedType,1
11,5,0,16,mixedType,2
8,2,0,10,mixedType,1
8,2,0,10,mixedType,1
7,3,0,10,mixedType,1
14,2,0,16,mixedType,2
6,3,0,9,mixedType,1
11,0,1,12,mixedType,1
5,2,0,7,mixedType,0
6,2,0,8,mixedType,1
5,2,0,7,mixedType,0
4,4,0,8,mixedType,1
6,3,0,9,mixedType,1
5,3,0,8,mixedType,1
8,5,0,13,mixedType,1
11,3,0,14,mixedType,2
6,1,0,7,mixedType,0
6,3,0,9,mixedType,1
4,2,0,6,mixedType,0
13,3,0,16,mixedType,2
6,2,0,8,mixedType,1
5,3,0,8,mixedType,1
9,2,0,11,mixedType,1
5,2,0,7,mixedType,0
5,2,0,7,mixedType,0
5,2,0,7,mixedType,0
8,2,0,10,mixedType,1
6,1,0,7,mixedType,0
6,1,0,7,mixedType,0
8,1,0,9,mixedType,1
9,1,0,10,mixedType,1
4,2,0,6,mixedType,0
8,1,0,9,mixedType,1
7,2,0,9,mixedType,1
4,0,0,4,sameType,0
9,3,0,12,mixedType,1
6,3,0,9,mixedType,1
3,3,0,6,mixedType,0
4,6,0,10,mixedType,1
5,5,0,10,mixedType,1
6,4,0,10,mixedType,1
8,1,0,9,mixedType,1
6,3,0,9,mixedType,1
9,0,3,12,mixedType,1
14,2,0,16,mixedType,2
3,6,0,9,mixedType,1
7,2,0,9,mixedType,1
8,2,0,10,mixedType,1
4,2,0,6,mixedType,0
12,4,0,16,mixedType,2
9,4,0,13,mixedType,1
14,2,0,16,mixedType,2
9,4,0,13,mixedType,1
9,1,0,10,mixedType,1
1,10,0,11,mixedType,1
5,2,0,7,mixedType,0
7,2,0,9,mixedType,1
8,2,0,10,mixedType,1
5,2,0,7,mixedType,0
15,1,0,16,mixedType,2
7,1,0,8,mixedType,1
1,8,0,9,mixedType,1
5,3,0,8,mixedType,1
9,1,0,10,mixedType,1
5,1,0,6,mixedType,0
11,5,0,16,mixedType,2
2,6,0,8,mixedType,1
6,2,0,8,mixedType,1
5,2,0,7,mixedType,0
6,4,0,10,mixedType,1
7,1,0,8,mixedType,1
8,2,0,10,mixedType,1
3,6,0,9,mixedType,1
10,1,0,11,mixedType,1
5,3,0,8,mixedType,1
8,1,0,9,mixedType,1
6,3,0,9,mixedType,1
8,4,0,12,mixedType,1
4,2,0,6,mixedType,0
13,3,0,16,mixedType,2
6,3,0,9,mixedType,1
9,2,0,11,mixedType,1
5,8,0,13,mixedType,1
7,1,0,8,mixedType,1
10,3,0,13,mixedType,1
7,2,0,9,mixedType,1
7,3,0,10,mixedType,1
9,1,0,10,mixedType,1
5,1,0,6,mixedType,0
5,4,0,9,mixedType,1
6,1,0,7,mixedType,0
7,4,0,11,mixedType,1
4,2,0,6,mixedType,0
6,4,0,10,mixedType,1
5,2,0,7,mixedType,0
12,3,0,15,mixedType,2
9,2,0,11,mixedType,1
12,4,0,16,mixedType,2
9,4,0,13,mixedType,1
4,4,0,8,mixedType,1
6,2,0,8,mixedType,1
2,6,0,8,mixedType,1
13,3,0,16,mixedType,2
6,6,0,12,mixedType,1
2,8,0,10,mixedType,1
5,3,0,8,mixedType,1
7,2,0,9,mixedType,1
6,1,0,7,mixedType,0
7,3,0,10,mixedType,1
4,2,0,6,mixedType,0
14,2,0,16,mixedType,2
7,4,0,11,mixedType,1
6,3,0,9,mixedType,1
5,6,0,11,mixedType,1
4,5,0,9,mixedType,1
7,3,0,10,mixedType,1
6,2,0,8,mixedType,1
2,7,0,9,mixedType,1
5,2,0,7,mixedType,0
12,4,0,16,mixedType,2
8,2,0,10,mixedType,1
6,4,0,10,mixedType,1
3,3,0,6,mixedType,0
4,9,1,14,mixedType,2
8,2,0,10,mixedType,1
5,4,0,9,mixedType,1
8,2,0,10,mixedType,1
7,1,0,8,mixedType,1
1,8,0,9,mixedType,1
7,2,0,9,mixedType,1
7,3,0,10,mixedType,1
5,2,0,7,mixedType,0
7,4,0,11,mixedType,1
8,2,0,10,mixedType,1
8,4,0,12,mixedType,1
7,3,0,10,mixedType,1
3,7,0,10,mixedType,1
2,6,0,8,mixedType,1
5,3,0,8,mixedType,1
12,3,0,15,mixedType,2
3,9,0,12,mixedType,1
6,1,0,7,mixedType,0
8,2,0,10,mixedType,1
12,4,0,16,mixedType,2
3,6,0,9,mixedType,1
11,5,0,16,mixedType,2
13,3,0,16,mixedType,2
6,3,0,9,mixedType,1
2,6,0,8,mixedType,1
9,2,0,11,mixedType,1
5,3,0,8,mixedType,1
12,4,0,16,mixedType,2
9,2,0,11,mixedType,1
9,1,0,10,mixedType,1
6,4,0,10,mixedType,1
6,3,0,9,mixedType,1
6,3,0,9,mixedType,1
5,3,0,8,mixedType,1
7,1,0,8,mixedType,1
5,7,0,12,mixedType,1
8,4,0,12,mixedType,1
6,3,0,9,mixedType,1
4,2,0,6,mixedType,0
1,8,0,9,mixedType,1
7,3,0,10,mixedType,1
6,3,0,9,mixedType,1
5,3,0,8,mixedType,1
5,4,0,9,mixedType,1
6,1,0,7,mixedType,0
4,6,0,10,mixedType,1
6,3,0,9,mixedType,1
7,1,0,8,mixedType,1
6,1,0,7,mixedType,0
10,2,0,12,mixedType,1
8,1,0,9,mixedType,1
7,2,0,9,mixedType,1
8,1,0,9,mixedType,1
7,3,0,10,mixedType,1
3,6,0,9,mixedType,1
7,3,0,10,mixedType,1
6,1,0,7,mixedType,0
5,4,0,9,mixedType,1
7,4,0,11,mixedType,1
5,2,0,7,mixedType,0
8,2,0,10,mixedType,1
6,1,0,7,mixedType,0
8,2,0,10,mixedType,1
7,2,0,9,mixedType,1
6,1,0,7,mixedType,0
4,2,0,6,mixedType,0
11,1,0,12,mixedType,1
6,3,0,9,mixedType,1
12,1,0,13,mixedType,1
6,4,0,10,mixedType,1
9,3,0,12,mixedType,1
8,2,0,10,mixedType,1
8,2,0,10,mixedType,1
8,1,0,9,mixedType,1
6,1,0,7,mixedType,0
5,1,0,6,mixedType,0
5,2,0,7,mixedType,0
6,3,0,9,mixedType,1
1,7,0,8,mixedType,1
5,2,0,7,mixedType,0
4,6,0,10,mixedType,1
1,8,0,9,mixedType,1
13,3,0,16,mixedType,2
12,4,0,16,mixedType,2
7,1,0,8,mixedType,1
8,2,0,10,mixedType,1
6,3,0,9,mixedType,1
6,2,0,8,mixedType,1
10,2,0,12,mixedType,1
14,2,0,16,mixedType,2
6,3,0,9,mixedType,1
5,2,0,7,mixedType,0
4,4,0,8,mixedType,1
8,1,0,9,mixedType,1
4,2,0,6,mixedType,0
2,8,0,10,mixedType,1
8,4,0,12,mixedType,1
1,8,0,9,mixedType,1
5,3,0,8,mixedType,1
4,4,0,8,mixedType,1
8,2,0,10,mixedType,1
14,2,0,16,mixedType,2
6,1,0,7,mixedType,0
2,9,0,11,mixedType,1
15,1,0,16,mixedType,2
14,2,0,16,mixedType,2
6,1,0,7,mixedType,0
9,2,0,11,mixedType,1
8,2,0,10,mixedType,1
7,4,0,11,mixedType,1
6,2,0,8,mixedType,1
5,2,0,7,mixedType,0
9,1,0,10,mixedType,1
6,1,0,7,mixedType,0
7,2,0,9,mixedType,1
6,3,0,9,mixedType,1
7,2,0,9,mixedType,1
0,7,0,7,sameType,1
5,3,0,8,mixedType,1
5,4,0,9,mixedType,1
9,2,0,11,mixedType,1
5,1,0,6,mixedType,0
6,5,0,11,mixedType,1
8,4,0,12,mixedType,1
6,3,0,9,mixedType,1
1,11,0,12,mixedType,1
13,3,0,16,mixedType,2
14,2,0,16,mixedType,2
7,6,0,13,mixedType,1
5,3,0,8,mixedType,1
6,2,0,8,mixedType,1
7,3,0,10,mixedType,1
11,3,0,14,mixedType,2
7,3,0,10,mixedType,1
6,3,0,9,mixedType,1
7,1,0,8,mixedType,1
7,2,0,9,mixedType,1
1,7,0,8,mixedType,1
8,1,0,9,mixedType,1
2,6,0,8,mixedType,1
6,2,0,8,mixedType,1
6,4,0,10,mixedType,1
8,2,0,10,mixedType,1
7,2,0,9,mixedType,1
7,3,0,10,mixedType,1
4,2,0,6,mixedType,0
5,4,0,9,mixedType,1
4,4,0,8,mixedType,1
2,6,0,8,mixedType,1
6,1,0,7,mixedType,0
2,6,0,8,mixedType,1
7,2,0,9,mixedType,1
6,4,0,10,mixedType,1
7,3,0,10,mixedType,1
9,4,0,13,mixedType,1
8,1,0,9,mixedType,1
7,5,0,12,mixedType,1
7,7,0,14,mixedType,2
1,9,0,10,mixedType,1
14,2,0,16,mixedType,2
10,3,0,13,mixedType,1
7,2,0,9,mixedType,1
6,2,0,8,mixedType,1
5,4,0,9,mixedType,1
9,4,0,13,mixedType,1
3,6,0,9,mixedType,1
3,6,0,9,mixedType,1
7,5,0,12,mixedType,1
7,3,0,10,mixedType,1
7,1,0,8,mixedType,1
12,4,0,16,mixedType,2
4,4,0,8,mixedType,1
1,8,0,9,mixedType,1
8,3,0,11,mixedType,1
7,3,0,10,mixedType,1
4,6,0,10,mixedType,1
14,2,0,16,mixedType,2
4,2,0,6,mixedType,0
5,3,0,8,mixedType,1
4,6,0,10,mixedType,1
7,4,0,11,mixedType,1
6,1,0,7,mixedType,0
6,3,0,9,mixedType,1
6,3,0,9,mixedType,1
5,5,0,10,mixedType,1
7,2,0,9,mixedType,1
2,6,0,8,mixedType,1
7,1,0,8,mixedType,1
14,2,0,16,mixedType,2
5,1,0,6,mixedType,0
8,1,0,9,mixedType,1
7,2,0,9,mixedType,1
6,2,0,8,mixedType,1
9,1,0,10,mixedType,1
5,5,0,10,mixedType,1
7,1,0,8,mixedType,1
6,3,0,9,mixedType,1
6,3,0,9,mixedType,1
9,4,0,13,mixedType,1
7,1,0,8,mixedType,1
15,1,0,16,mixedType,2
7,3,0,10,mixedType,1
1,9,0,10,mixedType,1
7,4,0,11,mixedType,1
7,3,0,10,mixedType,1
5,2,0,7,mixedType,0
8,1,0,9,mixedType,1
2,8,0,10,mixedType,1
6,3,0,9,mixedType,1
3,5,0,8,mixedType,1
14,2,0,16,mixedType,2
6,4,0,10,mixedType,1
4,4,0,8,mixedType,1
7,3,0,10,mixedType,1
5,1,0,6,mixedType,0
5,1,0,6,mixedType,0
5,3,0,8,mixedType,1
3,3,0,6,mixedType,0
5,6,0,11,mixedType,1
11,5,0,16,mixedType,2
7,2,0,9,mixedType,1
8,1,0,9,mixedType,1
7,3,0,10,mixedType,1
7,5,0,12,mixedType,1
3,6,0,9,mixedType,1
7,2,0,9,mixedType,1
8,1,0,9,mixedType,1
4,2,0,6,mixedType,0
8,1,0,9,mixedType,1
5,4,0,9,mixedType,1
6,2,0,8,mixedType,1
5,5,0,10,mixedType,1
7,2,0,9,mixedType,1
5,3,0,8,mixedType,1
4,2,0,6,mixedType,0
6,1,0,7,mixedType,0
7,4,0,11,mixedType,1
5,1,0,6,mixedType,0
14,2,0,16,mixedType,2
14,2,0,16,mixedType,2
9,3,0,12,mixedType,1
7,3,0,10,mixedType,1
2,6,0,8,mixedType,1
8,2,0,10,mixedType,1
6,2,0,8,mixedType,1
14,2,0,16,mixedType,2
7,8,1,16,mixedType,2
7,2,0,9,mixedType,1
10,1,0,11,mixedType,1
6,3,0,9,mixedType,1
4,2,0,6,mixedType,0
14,2,0,16,mixedType,2
5,2,0,7,mixedType,0
7,3,0,10,mixedType,1
6,3,0,9,mixedType,1
3,7,0,10,mixedType,1
6,2,0,8,mixedType,1
7,6,0,13,mixedType,1
5,1,0,6,mixedType,0
15,1,0,16,mixedType,2
6,4,0,10,mixedType,1
6,3,0,9,mixedType,1
6,3,0,9,mixedType,1
6,1,0,7,mixedType,0
1,8,0,9,mixedType,1
3,6,0,9,mixedType,1
13,3,0,16,mixedType,2
1,8,0,9,mixedType,1
7,4,0,11,mixedType,1
7,3,0,10,mixedType,1
9,0,1,10,mixedType,1
9,1,0,10,mixedType,1
2,4,0,6,mixedType,0
7,3,0,10,mixedType,1
6,1,0,7,mixedType,0
5,4,0,9,mixedType,1
5,2,0,7,mixedType,0
1,5,0,6,mixedType,0
7,3,0,10,mixedType,1
4,4,0,8,mixedType,1
7,4,0,11,mixedType,1
7,3,0,10,mixedType,1
6,1,0,7,mixedType,0
7,3,0,10,mixedType,1
2,6,0,8,mixedType,1
10,6,0,16,mixedType,2
2,6,0,8,mixedType,1
7,3,0,10,mixedType,1
6,4,0,10,mixedType,1
5,3,0,8,mixedType,1
6,4,0,10,mixedType,1
6,3,0,9,mixedType,1
5,5,0,10,mixedType,1
10,2,0,12,mixedType,1
6,4,0,10,mixedType,1
5,1,0,6,mixedType,0
4,2,0,6,mixedType,0
5,3,0,8,mixedType,1
5,6,0,11,mixedType,1
6,1,0,7,mixedType,0
8,2,0,10,mixedType,1
6,2,0,8,mixedType,1
6,1,0,7,mixedType,0
5,4,0,9,mixedType,1
5,4,0,9,mixedType,1
8,4,0,12,mixedType,1
4,5,0,9,mixedType,1
7,1,0,8,mixedType,1
10,3,0,13,mixedType,1
2,6,0,8,mixedType,1
3,5,0,8,mixedType,1
6,3,0,9,mixedType,1
5,1,0,6,mixedType,0
11,1,0,12,mixedType,1
3,6,0,9,mixedType,1
9,1,0,10,mixedType,1
5,3,0,8,mixedType,1
7,3,0,10,mixedType,1
4,6,0,10,mixedType,1
5,4,0,9,mixedType,1
8,2,0,10,mixedType,1
6,3,0,9,mixedType,1
7,3,0,10,mixedType,1
14,2,0,16,mixedType,2
6,1,0,7,mixedType,0
8,5,0,13,mixedType,1
12,3,0,15,mixedType,2
7,3,0,10,mixedType,1
9,1,0,10,mixedType,1
5,3,0,8,mixedType,1
6,6,0,12,mixedType,1
5,2,0,7,mixedType,0
6,1,0,7,mixedType,0
5,3,0,8,mixedType,1
7,2,0,9,mixedType,1
6,4,0,10,mixedType,1
5,3,0,8,mixedType,1
7,2,0,9,mixedType,1
4,2,0,6,mixedType,0
6,12,0,18,mixedType,2
2,6,0,8,mixedType,1
5,3,0,8,mixedType,1
6,2,0,8,mixedType,1
7,2,0,9,mixedType,1
0,7,1,8,mixedType,1
2,6,0,8,mixedType,1
6,2,0,8,mixedType,1
1,8,0,9,mixedType,1
6,4,0,10,mixedType,1
8,1,0,9,mixedType,1
15,1,0,16,mixedType,2
4,6,0,10,mixedType,1
8,2,1,11,mixedType,1
3,6,0,9,mixedType,1
4,5,0,9,mixedType,1
7,3,0,10,mixedType,1
9,1,0,10,mixedType,1
11,1,0,12,mixedType,1
6,7,0,13,mixedType,1
6,4,0,10,mixedType,1
6,2,0,8,mixedType,1
3,7,0,10,mixedType,1
9,2,0,11,mixedType,1
2,10,0,12,mixedType,1
6,3,0,9,mixedType,1
12,3,0,15,mixedType,2
8,2,0,10,mixedType,1
6,4,0,10,mixedType,1
7,2,0,9,mixedType,1
12,3,0,15,mixedType,2
6,4,0,10,mixedType,1
8,2,0,10,mixedType,1
1,8,0,9,mixedType,1
6,1,0,7,mixedType,0
14,2,0,16,mixedType,2
12,3,0,15,mixedType,2
8,2,0,10,mixedType,1
6,2,0,8,mixedType,1
7,2,0,9,mixedType,1
8,1,0,9,mixedType,1
7,3,0,10,mixedType,1
6,6,0,12,mixedType,1
6,3,0,9,mixedType,1
5,4,0,9,mixedType,1
7,3,0,10,mixedType,1
7,2,0,9,mixedType,1
5,2,0,7,mixedType,0
6,1,0,7,mixedType,0
10,2,0,12,mixedType,1
1,8,0,9,mixedType,1
7,1,0,8,mixedType,1
6,6,0,12,mixedType,1
1,7,0,8,mixedType,1
7,1,0,8,mixedType,1
9,3,0,12,mixedType,1
6,4,0,10,mixedType,1
3,6,0,9,mixedType,1
7,3,0,10,mixedType,1
2,4,0,6,mixedType,0
10,1,0,11,mixedType,1
9,3,0,12,mixedType,1
8,1,0,9,mixedType,1
4,2,0,6,mixedType,0
6,3,0,9,mixedType,1
15,1,0,16,mixedType,2
11,3,0,14,mixedType,2
6,3,0,9,mixedType,1
9,1,0,10,mixedType,1
5,5,0,10,mixedType,1
4,2,0,6,mixedType,0
4,4,0,8,mixedType,1
5,4,0,9,mixedType,1
5,6,0,11,mixedType,1
13,3,0,16,mixedType,2
6,6,0,12,mixedType,1
7,2,0,9,mixedType,1
3,5,0,8,mixedType,1
6,2,0,8,mixedType,1
7,3,0,10,mixedType,1
12,3,0,15,mixedType,2
12,4,0,16,mixedType,2
2,6,0,8,mixedType,1
11,2,0,13,mixedType,1
13,3,0,16,mixedType,2
7,1,0,8,mixedType,1
7,3,0,10,mixedType,1
7,5,0,12,mixedType,1
5,3,0,8,mixedType,1
6,4,0,10,mixedType,1
7,2,0,9,mixedType,1
5,3,0,8,mixedType,1
7,3,0,10,mixedType,1
2,6,0,8,mixedType,1
7,6,0,13,mixedType,1
13,3,0,16,mixedType,2
7,3,0,10,mixedType,1
8,2,0,10,mixedType,1
8,1,0,9,mixedType,1
9,2,0,11,mixedType,1
13,2,0,15,mixedType,2
6,1,0,7,mixedType,0
4,2,0,6,mixedType,0
10,1,0,11,mixedType,1
6,3,0,9,mixedType,1
8,2,0,10,mixedType,1
7,4,0,11,mixedType,1
12,4,0,16,mixedType,2
7,2,0,9,mixedType,1
8,2,0,10,mixedType,1
4,2,0,6,mixedType,0
8,2,0,10,mixedType,1
8,0,1,9,mixedType,1
8,4,0,12,mixedType,1
6,4,0,10,mixedType,1
7,4,0,11,mixedType,1
6,1,0,7,mixedType,0
6,3,0,9,mixedType,1
5,1,0,6,mixedType,0
9,1,0,10,mixedType,1
6,3,0,9,mixedType,1
6,3,0,9,mixedType,1
7,3,0,10,mixedType,1
15,1,0,16,mixedType,2
8,2,0,10,mixedType,1
1,7,0,8,mixedType,1
5,3,0,8,mixedType,1
5,3,0,8,mixedType,1
5,2,0,7,mixedType,0
9,2,0,11,mixedType,1
4,6,0,10,mixedType,1
6,6,0,12,mixedType,1
14,2,0,16,mixedType,2
5,4,0,9,mixedType,1
9,1,0,10,mixedType,1
3,6,0,9,mixedType,1
0,8,1,9,mixedType,1
4,4,0,8,mixedType,1
8,3,0,11,mixedType,1
2,7,0,9,mixedType,1
6,3,0,9,mixedType,1
6,2,0,8,mixedType,1
7,1,0,8,mixedType,1
5,4,0,9,mixedType,1
7,3,0,10,mixedType,1
4,4,0,8,mixedType,1
9,1,0,10,mixedType,1
8,3,0,11,mixedType,1
6,3,0,9,mixedType,1
2,7,0,9,mixedType,1
7,3,0,10,mixedType,1
15,1,0,16,mixedType,2
6,1,0,7,mixedType,0
9,3,0,12,mixedType,1
1,9,0,10,mixedType,1
15,1,0,16,mixedType,2
1,7,0,8,mixedType,1
5,4,0,9,mixedType,1
5,3,0,8,mixedType,1
7,2,0,9,mixedType,1
7,2,0,9,mixedType,1
7,1,0,8,mixedType,1
9,1,0,10,mixedType,1
5,1,0,6,mixedType,0
11,3,0,14,mixedType,2
4,4,0,8,mixedType,1
7,2,0,9,mixedType,1
8,1,0,9,mixedType,1
9,3,0,12,mixedType,1
6,4,0,10,mixedType,1
6,3,0,9,mixedType,1
10,0,1,11,mixedType,1
6,1,0,7,mixedType,0
15,1,0,16,mixedType,2
13,3,0,16,mixedType,2
7,3,0,10,mixedType,1
6,2,0,8,mixedType,1
9,2,0,11,mixedType,1
6,1,0,7,mixedType,0
6,4,0,10,mixedType,1
12,2,1,15,mixedType,2
7,3,0,10,mixedType,1
8,2,0,10,mixedType,1
12,3,0,15,mixedType,2
8,3,0,11,mixedType,1
2,7,0,9,mixedType,1
8,2,0,10,mixedType,1
4,6,0,10,mixedType,1
6,3,0,9,mixedType,1
6,1,0,7,mixedType,0
13,3,0,16,mixedType,2
5,2,0,7,mixedType,0
5,4,0,9,mixedType,1
6,2,0,8,mixedType,1
5,1,0,6,mixedType,0
1,7,0,8,mixedType,1
6,3,0,9,mixedType,1
7,3,0,10,mixedType,1
9,4,0,13,mixedType,1
5,1,0,6,mixedType,0
5,3,0,8,mixedType,1
7,3,0,10,mixedType,1
5,4,0,9,mixedType,1
5,3,0,8,mixedType,1
5,3,0,8,mixedType,1
7,2,0,9,mixedType,1
14,2,0,16,mixedType,2
5,2,0,7,mixedType,0
8,1,0,9,mixedType,1
7,3,0,10,mixedType,1
5,4,0,9,mixedType,1
6,2,0,8,mixedType,1
8,1,0,9,mixedType,1
2,6,0,8,mixedType,1
5,2,0,7,mixedType,0
8,2,0,10,mixedType,1
6,2,0,8,mixedType,1
5,5,0,10,mixedType,1
7,3,0,10,mixedType,1
8,2,0,10,mixedType,1
6,3,0,9,mixedType,1
6,3,0,9,mixedType,1
8,4,0,12,mixedType,1
7,3,0,10,mixedType,1
6,2,0,8,mixedType,1
8,1,0,9,mixedType,1
10,1,0,11,mixedType,1
7,1,0,8,mixedType,1
4,4,0,8,mixedType,1
6,4,0,10,mixedType,1
8,2,0,10,mixedType,1
8,2,0,10,mixedType,1
7,2,0,9,mixedType,1
8,2,0,10,mixedType,1
7,1,0,8,mixedType,1
5,4,0,9,mixedType,1
5,7,0,12,mixedType,1
8,1,0,9,mixedType,1
4,4,0,8,mixedType,1
8,2,0,10,mixedType,1
5,1,0,6,mixedType,0
7,3,0,10,mixedType,1
7,1,0,8,mixedType,1
8,3,0,11,mixedType,1
10,3,0,13,mixedType,1
2,7,0,9,mixedType,1
7,2,0,9,mixedType,1
5,2,0,7,mixedType,0
7,3,0,10,mixedType,1
5,3,0,8,mixedType,1
10,6,0,16,mixedType,2
6,3,0,9,mixedType,1
6,2,0,8,mixedType,1
14,3,1,18,mixedType,2
9,3,0,12,mixedType,1
2,6,0,8,mixedType,1
5,2,0,7,mixedType,0
9,1,0,10,mixedType,1
10,3,0,13,mixedType,1
3,6,0,9,mixedType,1
10,6,0,16,mixedType,2
5,4,0,9,mixedType,1
9,2,0,11,mixedType,1
9,3,0,12,mixedType,1
7,2,0,9,mixedType,1
7,3,0,10,mixedType,1
8,2,0,10,mixedType,1
7,2,0,9,mixedType,1
5,4,0,9,mixedType,1
2,6,0,8,mixedType,1
9,3,0,12,mixedType,1
7,4,0,11,mixedType,1
6,4,0,10,mixedType,1
2,4,0,6,mixedType,0
4,2,0,6,mixedType,0
2,7,0,9,mixedType,1
6,3,0,9,mixedType,1
12,4,0,16,mixedType,2
5,3,0,8,mixedType,1
12,4,0,16,mixedType,2
6,3,0,9,mixedType,1
6,2,0,8,mixedType,1
4,4,0,8,mixedType,1
8,2,0,10,mixedType,1
7,1,0,8,mixedType,1
9,2,0,11,mixedType,1
5,3,0,8,mixedType,1
1,10,0,11,mixedType,1
9,2,0,11,mixedType,1
8,3,0,11,mixedType,1
9,1,0,10,mixedType,1
5,1,0,6,mixedType,0
5,4,0,9,mixedType,1
3,9,0,12,mixedType,1
6,3,0,9,mixedType,1
8,1,0,9,mixedType,1
6,2,0,8,mixedType,1
6,1,0,7,mixedType,0
4,5,0,9,mixedType,1
8,2,0,10,mixedType,1
1,8,0,9,mixedType,1
8,2,0,10,mixedType,1
4,2,0,6,mixedType,0
1,8,0,9,mixedType,1
15,1,0,16,mixedType,2
7,3,0,10,mixedType,1
4,6,0,10,mixedType,1
6,3,0,9,mixedType,1
7,3,0,10,mixedType,1
6,10,0,16,mixedType,2
7,3,0,10,mixedType,1
4,2,0,6,mixedType,0
4,2,0,6,mixedType,0
0,7,2,9,mixedType,1
7,3,0,10,mixedType,1
6,1,0,7,mixedType,0
7,1,0,8,mixedType,1
7,2,0,9,mixedType,1
1,8,0,9,mixedType,1
7,4,0,11,mixedType,1
4,4,0,8,mixedType,1
9,0,1,10,mixedType,1
12,3,0,15,mixedType,2
12,4,0,16,mixedType,2
5,7,0,12,mixedType,1
6,4,0,10,mixedType,1
6,3,0,9,mixedType,1
5,3,0,8,mixedType,1
4,4,0,8,mixedType,1
8,1,0,9,mixedType,1
5,2,0,7,mixedType,0
7,3,0,10,mixedType,1
7,3,0,10,mixedType,1
7,3,0,10,mixedType,1
5,2,0,7,mixedType,0
6,2,0,8,mixedType,1
3,5,0,8,mixedType,1
7,3,0,10,mixedType,1
11,3,0,14,mixedType,2
5,3,0,8,mixedType,1
2,4,0,6,mixedType,0
3,5,0,8,mixedType,1
6,6,0,12,mixedType,1
6,3,0,9,mixedType,1
7,3,0,10,mixedType,1
7,2,0,9,mixedType,1
5,4,0,9,mixedType,1
10,1,0,11,mixedType,1
6,2,0,8,mixedType,1
10,1,0,11,mixedType,1
4,2,0,6,mixedType,0
14,2,0,16,mixedType,2
6,2,0,8,mixedType,1
6,1,0,7,mixedType,0
7,2,0,9,mixedType,1
3,8,0,11,mixedType,1
4,2,0,6,mixedType,0
6,4,0,10,mixedType,1
2,7,0,9,mixedType,1
6,3,0,9,mixedType,1
9,2,1,12,mixedType,1
15,1,0,16,mixedType,2
5,4,0,9,mixedType,1
1,6,0,7,mixedType,0
6,7,0,13,mixedType,1
7,4,0,11,mixedType,1
3,8,0,11,mixedType,1
7,4,0,11,mixedType,1
5,4,0,9,mixedType,1
5,6,0,11,mixedType,1
5,1,0,6,mixedType,0
8,1,0,9,mixedType,1
8,2,0,10,mixedType,1
7,1,0,8,mixedType,1
2,7,0,9,mixedType,1
5,2,0,7,mixedType,0
4,2,0,6,mixedType,0
5,3,0,8,mixedType,1
7,2,0,9,mixedType,1
14,2,0,16,mixedType,2
8,2,0,10,mixedType,1
12,1,0,13,mixedType,1
12,4,0,16,mixedType,2
11,3,0,14,mixedType,2
5,2,0,7,mixedType,0
3,7,0,10,mixedType,1
6,3,0,9,mixedType,1
14,3,4,21,mixedType,2
5,3,0,8,mixedType,1
7,5,0,12,mixedType,1
3,7,0,10,mixedType,1
8,1,0,9,mixedType,1
7,3,0,10,mixedType,1
1,5,0,6,mixedType,0
1,8,0,9,mixedType,1
7,3,0,10,mixedType,1
5,5,0,10,mixedType,1
13,3,0,16,mixedType,2
2,8,0,10,mixedType,1
14,2,0,16,mixedType,2
6,7,0,13,mixedType,1
6,1,0,7,mixedType,0
5,3,0,8,mixedType,1
14,2,0,16,mixedType,2
4,4,0,8,mixedType,1
4,4,0,8,mixedType,1
6,1,0,7,mixedType,0
6,4,0,10,mixedType,1
7,2,0,9,mixedType,1
8,1,0,9,mixedType,1
9,1,0,10,mixedType,1
8,3,0,11,mixedType,1
7,2,0,9,mixedType,1
4,2,0,6,mixedType,0
8,4,0,12,mixedType,1
5,1,0,6,mixedType,0
8,3,0,11,mixedType,1
7,3,0,10,mixedType,1
4,4,0,8,mixedType,1
6,4,0,10,mixedType,1
6,3,0,9,mixedType,1
8,2,0,10,mixedType,1
8,2,0,10,mixedType,1
5,4,0,9,mixedType,1
6,1,0,7,mixedType,0
14,2,0,16,mixedType,2
6,2,0,8,mixedType,1
6,3,0,9,mixedType,1
8,2,0,10,mixedType,1
8,2,0,10,mixedType,1
12,3,0,15,mixedType,2
4,2,0,6,mixedType,0
7,1,0,8,mixedType,1
4,2,0,6,mixedType,0
3,5,0,8,mixedType,1
4,6,0,10,mixedType,1
15,1,0,16,mixedType,2
3,6,0,9,mixedType,1
7,2,0,9,mixedType,1
5,4,0,9,mixedType,1
8,2,0,10,mixedType,1
2,7,0,9,mixedType,1
4,2,0,6,mixedType,0
4,4,0,8,mixedType,1
5,3,0,8,mixedType,1
5,4,0,9,mixedType,1
6,2,0,8,mixedType,1
6,4,0,10,mixedType,1
6,4,0,10,mixedType,1
7,2,0,9,mixedType,1
7,1,0,8,mixedType,1
8,1,0,9,mixedType,1
6,3,0,9,mixedType,1
5,3,0,8,mixedType,1
7,3,0,10,mixedType,1
7,3,0,10,mixedType,1
10,2,0,12,mixedType,1
7,3,0,10,mixedType,1
8,2,0,10,mixedType,1
6,1,0,7,mixedType,0
7,3,0,10,mixedType,1
8,2,0,10,mixedType,1
4,6,0,10,mixedType,1
5,6,0,11,mixedType,1
3,10,0,13,mixedType,1
5,2,0,7,mixedType,0
4,6,0,10,mixedType,1
6,4,0,10,mixedType,1
8,1,0,9,mixedType,1
5,4,0,9,mixedType,1
7,2,0,9,mixedType,1
7,4,0,11,mixedType,1
8,2,0,10,mixedType,1
3,6,0,9,mixedType,1
5,8,0,13,mixedType,1
2,6,0,8,mixedType,1
12,4,0,16,mixedType,2
7,2,0,9,mixedType,1
12,1,1,14,mixedType,2
8,4,0,12,mixedType,1
5,3,0,8,mixedType,1
7,3,0,10,mixedType,1
7,4,0,11,mixedType,1
7,2,0,9,mixedType,1
5,2,0,7,mixedType,0
4,5,0,9,mixedType,1
7,2,0,9,mixedType,1
8,3,0,11,mixedType,1
2,5,0,7,mixedType,0
12,4,0,16,mixedType,2
6,3,0,9,mixedType,1
8,5,0,13,mixedType,1
7,3,0,10,mixedType,1
14,2,0,16,mixedType,2
9,1,0,10,mixedType,1
6,3,0,9,mixedType,1
2,6,0,8,mixedType,1
7,5,0,12,mixedType,1
5,3,0,8,mixedType,1
7,1,0,8,mixedType,1
7,1,0,8,mixedType,1
11,5,0,16,mixedType,2
10,2,0,12,mixedType,1
5,3,0,8,mixedType,1
7,4,0,11,mixedType,1
6,3,0,9,mixedType,1
3,6,0,9,mixedType,1
3,6,0,9,mixedType,1
7,3,0,10,mixedType,1
7,3,0,10,mixedType,1
15,1,0,16,mixedType,2
6,3,0,9,mixedType,1
7,3,0,10,mixedType,1
2,6,0,8,mixedType,1
5,3,0,8,mixedType,1
12,4,0,16,mixedType,2
6,10,1,17,mixedType,2
7,3,0,10,mixedType,1
6,3,0,9,mixedType,1
8,1,0,9,mixedType,1
8,9,0,17,mixedType,2
3,5,0,8,mixedType,1
7,4,0,11,mixedType,1
1,8,0,9,mixedType,1
5,4,0,9,mixedType,1
15,1,0,16,mixedType,2
7,5,0,12,mixedType,1
7,1,0,8,mixedType,1
7,4,0,11,mixedType,1
6,6,0,12,mixedType,1
5,3,0,8,mixedType,1
8,4,0,12,mixedType,1
8,1,0,9,mixedType,1
10,2,0,12,mixedType,1
7,3,0,10,mixedType,1
5,4,0,9,mixedType,1
2,4,0,6,mixedType,0
9,2,0,11,mixedType,1
6,3,0,9,mixedType,1
15,1,0,16,mixedType,2
1,10,0,11,mixedType,1
8,3,0,11,mixedType,1
8,2,0,10,mixedType,1
5,4,0,9,mixedType,1
9,1,0,10,mixedType,1
5,2,0,7,mixedType,0
2,6,0,8,mixedType,1
7,3,0,10,mixedType,1
7,4,0,11,mixedType,1
5,3,0,8,mixedType,1
6,1,0,7,mixedType,0
5,1,0,6,mixedType,0
7,3,0,10,mixedType,1
8,1,0,9,mixedType,1
6,4,0,10,mixedType,1
9,0,2,11,mixedType,1
2,6,0,8,mixedType,1
6,2,0,8,mixedType,1
10,1,0,11,mixedType,1
6,1,0,7,mixedType,0
6,4,0,10,mixedType,1
3,5,0,8,mixedType,1
8,4,0,12,mixedType,1
4,4,0,8,mixedType,1
6,6,0,12,mixedType,1
7,2,0,9,mixedType,1
5,3,0,8,mixedType,1
4,4,0,8,mixedType,1
7,3,0,10,mixedType,1
4,4,0,8,mixedType,1
7,3,0,10,mixedType,1
12,1,1,14,mixedType,2
1,7,0,8,mixedType,1
9,2,0,11,mixedType,1
13,3,0,16,mixedType,2
6,1,0,7,mixedType,0
10,1,0,11,mixedType,1
5,3,0,8,mixedType,1
6,1,0,7,mixedType,0
10,2,0,12,mixedType,1
8,1,0,9,mixedType,1
3,6,0,9,mixedType,1
6,3,0,9,mixedType,1
10,1,0,11,mixedType,1
8,2,0,10,mixedType,1
2,7,0,9,mixedType,1
7,2,0,9,mixedType,1
10,3,1,14,mixedType,2
4,4,0,8,mixedType,1
16,2,0,18,mixedType,2
2,6,0,8,mixedType,1
6,3,0,9,mixedType,1
13,3,0,16,mixedType,2
5,4,0,9,mixedType,1
10,3,0,13,mixedType,1
5,1,0,6,mixedType,0
8,3,0,11,mixedType,1
14,2,0,16,mixedType,2
8,2,0,10,mixedType,1
0,9,0,9,sameType,1
3,6,0,9,mixedType,1
7,3,0,10,mixedType,1
8,1,0,9,mixedType,1
5,3,0,8,mixedType,1
7,4,0,11,mixedType,1
14,2,0,16,mixedType,2
5,1,0,6,mixedType,0
2,6,0,8,mixedType,1
7,3,0,10,mixedType,1
2,8,0,10,mixedType,1
3,6,0,9,mixedType,1
3,8,0,11,mixedType,1
11,5,0,16,mixedType,2
6,1,0,7,mixedType,0
6,4,0,10,mixedType,1
3,6,0,9,mixedType,1
11,1,0,12,mixedType,1
8,3,0,11,mixedType,1
4,2,0,6,mixedType,0
8,2,0,10,mixedType,1
7,2,0,9,mixedType,1
5,2,0,7,mixedType,0
9,3,0,12,mixedType,1
8,4,0,12,mixedType,1
9,2,0,11,mixedType,1
4,2,0,6,mixedType,0
8,1,0,9,mixedType,1
10,1,0,11,mixedType,1
6,4,0,10,mixedType,1
8,3,0,11,mixedType,1
10,1,0,11,mixedType,1
10,1,0,11,mixedType,1
12,3,0,15,mixedType,2
9,1,0,10,mixedType,1
8,3,0,11,mixedType,1
6,3,0,9,mixedType,1
5,1,0,6,mixedType,0
10,0,1,11,mixedType,1
6,1,0,7,mixedType,0
6,3,0,9,mixedType,1
3,3,0,6,mixedType,0
12,4,0,16,mixedType,2
5,2,0,7,mixedType,0
10,2,0,12,mixedType,1
6,1,0,7,mixedType,0
12,4,0,16,mixedType,2
8,2,0,10,mixedType,1
8,4,0,12,mixedType,1
5,3,0,8,mixedType,1
6,3,0,9,mixedType,1
9,1,0,10,mixedType,1
9,4,0,13,mixedType,1
8,2,0,10,mixedType,1
7,3,0,10,mixedType,1
3,5,0,8,mixedType,1
1,8,0,9,mixedType,1
1,11,0,12,mixedType,1
8,3,0,11,mixedType,1
15,1,0,16,mixedType,2
4,4,0,8,mixedType,1
6,4,0,10,mixedType,1
4,6,0,10,mixedType,1
2,6,0,8,mixedType,1
13,3,0,16,mixedType,2
3,5,0,8,mixedType,1
11,1,0,12,mixedType,1
5,3,0,8,mixedType,1
6,2,0,8,mixedType,1
8,2,0,10,mixedType,1
8,4,0,12,mixedType,1
12,3,0,15,mixedType,2
10,1,0,11,mixedType,1
5,4,0,9,mixedType,1
5,3,0,8,mixedType,1
1,9,0,10,mixedType,1
9,3,0,12,mixedType,1
5,7,0,12,mixedType,1
12,3,0,15,mixedType,2
8,1,0,9,mixedType,1
12,4,0,16,mixedType,2
8,3,0,11,mixedType,1
7,3,0,10,mixedType,1
6,3,0,9,mixedType,1
4,2,0,6,mixedType,0
9,2,0,11,mixedType,1
6,3,0,9,mixedType,1
8,2,0,10,mixedType,1
6,2,0,8,mixedType,1
7,2,0,9,mixedType,1
4,4,0,8,mixedType,1
5,3,0,8,mixedType,1
9,2,0,11,mixedType,1
4,4,0,8,mixedType,1
6,2,0,8,mixedType,1
6,4,0,10,mixedType,1
8,2,0,10,mixedType,1
7,2,0,9,mixedType,1
7,1,0,8,mixedType,1
6,3,0,9,mixedType,1
6,2,0,8,mixedType,1
4,2,0,6,mixedType,0
5,8,0,13,mixedType,1
3,6,0,9,mixedType,1
6,3,0,9,mixedType,1
7,6,0,13,mixedType,1
5,4,0,9,mixedType,1
14,2,0,16,mixedType,2
7,3,0,10,mixedType,1
6,4,0,10,mixedType,1
6,1,0,7,mixedType,0
4,2,0,6,mixedType,0
6,3,0,9,mixedType,1
14,2,0,16,mixedType,2
8,3,0,11,mixedType,1
4,2,0,6,mixedType,0
3,8,0,11,mixedType,1
11,5,0,16,mixedType,2
8,2,0,10,mixedType,1
7,2,0,9,mixedType,1
6,1,0,7,mixedType,0
5,2,0,7,mixedType,0
5,4,0,9,mixedType,1
1,8,0,9,mixedType,1
10,2,0,12,mixedType,1
5,1,0,6,mixedType,0
13,3,0,16,mixedType,2
5,3,0,8,mixedType,1
7,3,0,10,mixedType,1
9,1,0,10,mixedType,1
2,6,0,8,mixedType,1
5,3,0,8,mixedType,1
12,3,0,15,mixedType,2
8,3,0,11,mixedType,1
7,3,0,10,mixedType,1
6,6,0,12,mixedType,1
7,2,0,9,mixedType,1
1,8,0,9,mixedType,1
7,3,0,10,mixedType,1
13,3,0,16,mixedType,2
6,4,0,10,mixedType,1
5,4,0,9,mixedType,1
5,3,0,8,mixedType,1
5,4,0,9,mixedType,1
2,4,0,6,mixedType,0
14,2,0,16,mixedType,2
6,6,0,12,mixedType,1
4,4,0,8,mixedType,1
2,4,0,6,mixedType,0
7,3,0,10,mixedType,1
6,2,0,8,mixedType,1
12,4,0,16,mixedType,2
4,2,0,6,mixedType,0
4,4,0,8,mixedType,1
14,2,0,16,mixedType,2
4,4,0,8,mixedType,1
9,3,0,12,mixedType,1
9,2,0,11,mixedType,1
5,1,0,6,mixedType,0
8,1,0,9,mixedType,1
1,7,0,8,mixedType,1
6,1,0,7,mixedType,0
1,8,0,9,mixedType,1
15,1,0,16,mixedType,2
4,5,0,9,mixedType,1
6,3,0,9,mixedType,1
8,3,0,11,mixedType,1
8,3,0,11,mixedType,1
2,4,0,6,mixedType,0
2,6,0,8,mixedType,1
15,1,0,16,mixedType,2
6,1,0,7,mixedType,0
4,2,0,6,mixedType,0
6,2,0,8,mixedType,1
2,6,0,8,mixedType,1
6,4,0,10,mixedType,1
3,5,0,8,mixedType,1
7,3,0,10,mixedType,1
4,4,0,8,mixedType,1
6,3,0,9,mixedType,1
6,1,0,7,mixedType,0
8,2,0,10,mixedType,1
7,2,0,9,mixedType,1
5,1,0,6,mixedType,0
4,9,0,13,mixedType,1
7,2,0,9,mixedType,1
12,4,0,16,mixedType,2
6,2,0,8,mixedType,1
8,1,0,9,mixedType,1
7,3,0,10,mixedType,1
6,6,0,12,mixedType,1
2,6,0,8,mixedType,1
6,2,0,8,mixedType,1
6,3,0,9,mixedType,1
5,5,0,10,mixedType,1
5,5,0,10,mixedType,1
6,3,0,9,mixedType,1
5,4,0,9,mixedType,1
2,6,0,8,mixedType,1
7,3,0,10,mixedType,1
3,6,0,9,mixedType,1
6,4,0,10,mixedType,1
6,1,0,7,mixedType,0
5,1,0,6,mixedType,0
4,2,0,6,mixedType,0
5,4,0,9,mixedType,1
8,1,0,9,mixedType,1
6,2,0,8,mixedType,1
5,2,0,7,mixedType,0
7,3,0,10,mixedType,1
13,3,0,16,mixedType,2
8,2,0,10,mixedType,1
1,8,0,9,mixedType,1
4,6,0,10,mixedType,1
9,1,0,10,mixedType,1
12,4,0,16,mixedType,2
2,6,0,8,mixedType,1
8,3,0,11,mixedType,1
6,2,0,8,mixedType,1
1,8,0,9,mixedType,1
6,2,0,8,mixedType,1
12,3,0,15,mixedType,2
6,3,0,9,mixedType,1
6,3,0,9,mixedType,1
8,2,0,10,mixedType,1
11,3,0,14,mixedType,2
9,2,0,11,mixedType,1
6,2,0,8,mixedType,1
6,3,0,9,mixedType,1
14,2,0,16,mixedType,2
0,9,2,11,mixedType,1
6,2,0,8,mixedType,1
3,6,0,9,mixedType,1
7,3,0,10,mixedType,1
7,4,0,11,mixedType,1
5,1,0,6,mixedType,0
6,3,0,9,mixedType,1
6,3,0,9,mixedType,1
4,2,0,6,mixedType,0
8,5,0,13,mixedType,1
2,8,0,10,mixedType,1
15,1,0,16,mixedType,2
6,2,0,8,mixedType,1
6,4,0,10,mixedType,1
14,2,0,16,mixedType,2
7,3,0,10,mixedType,1
6,3,0,9,mixedType,1
7,2,0,9,mixedType,1
7,2,0,9,mixedType,1
5,2,0,7,mixedType,0
6,3,0,9,mixedType,1
5,4,0,9,mixedType,1
5,3,0,8,mixedType,1
7,1,0,8,mixedType,1
6,3,0,9,mixedType,1
10,0,1,11,mixedType,1
8,1,0,9,mixedType,1
6,3,0,9,mixedType,1
6,1,0,7,mixedType,0
4,4,0,8,mixedType,1
4,4,0,8,mixedType,1
9,3,0,12,mixedType,1
4,2,0,6,mixedType,0
4,4,0,8,mixedType,1
5,2,0,7,mixedType,0
6,1,0,7,mixedType,0
8,4,0,12,mixedType,1
4,2,0,6,mixedType,0
6,4,0,10,mixedType,1
5,3,0,8,mixedType,1
0,8,1,9,mixedType,1
8,1,0,9,mixedType,1
4,4,0,8,mixedType,1
5,2,0,7,mixedType,0
4,4,0,8,mixedType,1
7,3,0,10,mixedType,1
7,3,0,10,mixedType,1
14,2,0,16,mixedType,2
7,3,0,10,mixedType,1
14,1,0,15,mixedType,2
7,4,0,11,mixedType,1
6,2,0,8,mixedType,1
5,2,0,7,mixedType,0
6,3,0,9,mixedType,1
4,6,0,10,mixedType,1
12,3,0,15,mixedType,2
4,2,0,6,mixedType,0
8,3,0,11,mixedType,1
9,1,0,10,mixedType,1
6,4,0,10,mixedType,1
1,12,0,13,mixedType,1
9,2,0,11,mixedType,1
15,1,0,16,mixedType,2
5,4,0,9,mixedType,1
10,2,0,12,mixedType,1
9,1,0,10,mixedType,1
8,2,0,10,mixedType,1
3,7,0,10,mixedType,1
7,2,0,9,mixedType,1
8,10,0,18,mixedType,2
4,4,0,8,mixedType,1
8,2,0,10,mixedType,1
8,4,0,12,mixedType,1
4,2,0,6,mixedType,0
11,3,0,14,mixedType,2
17,1,0,18,mixedType,2
8,2,0,10,mixedType,1
1,8,0,9,mixedType,1
5,1,0,6,mixedType,0
8,2,0,10,mixedType,1
7,2,0,9,mixedType,1
5,4,0,9,mixedType,1
7,6,0,13,mixedType,1
4,6,0,10,mixedType,1
10,4,0,14,mixedType,2
4,5,0,9,mixedType,1
3,3,0,6,mixedType,0
6,4,0,10,mixedType,1
7,1,0,8,mixedType,1
6,4,0,10,mixedType,1
4,5,0,9,mixedType,1
5,1,0,6,mixedType,0
12,11,0,23,mixedType,2
9,3,0,12,mixedType,1
7,2,0,9,mixedType,1
5,2,0,7,mixedType,0
1,10,0,11,mixedType,1
6,6,0,12,mixedType,1
7,3,0,10,mixedType,1
12,4,0,16,mixedType,2
7,3,0,10,mixedType,1
2,6,0,8,mixedType,1
5,1,0,6,mixedType,0
6,3,0,9,mixedType,1
6,6,0,12,mixedType,1
12,4,0,16,mixedType,2
6,1,0,7,mixedType,0
3,6,0,9,mixedType,1
9,1,0,10,mixedType,1
6,1,0,7,mixedType,0
6,1,0,7,mixedType,0
4,2,0,6,mixedType,0
7,2,0,9,mixedType,1
9,1,0,10,mixedType,1
4,2,0,6,mixedType,0
6,2,0,8,mixedType,1
6,4,0,10,mixedType,1
9,1,0,10,mixedType,1
5,1,0,6,mixedType,0
13,3,0,16,mixedType,2
1,7,0,8,mixedType,1
5,2,0,7,mixedType,0
6,3,0,9,mixedType,1
6,3,0,9,mixedType,1
14,2,0,16,mixedType,2
6,1,0,7,mixedType,0
6,4,0,10,mixedType,1
7,3,0,10,mixedType,1
6,2,0,8,mixedType,1
10,2,0,12,mixedType,1
4,2,0,6,mixedType,0
6,3,0,9,mixedType,1
8,1,0,9,mixedType,1
9,2,0,11,mixedType,1
7,3,0,10,mixedType,1
2,10,0,12,mixedType,1
10,2,0,12,mixedType,1
2,4,0,6,mixedType,0
4,6,0,10,mixedType,1
6,2,0,8,mixedType,1
8,1,0,9,mixedType,1
6,6,0,12,mixedType,1
1,8,0,9,mixedType,1
4,4,0,8,mixedType,1
5,3,0,8,mixedType,1
1,7,0,8,mixedType,1
5,3,0,8,mixedType,1
9,1,0,10,mixedType,1
5,2,0,7,mixedType,0
7,2,0,9,mixedType,1
9,2,0,11,mixedType,1
15,1,0,16,mixedType,2
7,3,0,10,mixedType,1
3,6,0,9,mixedType,1
2,8,0,10,mixedType,1
7,2,0,9,mixedType,1
4,2,0,6,mixedType,0
3,6,0,9,mixedType,1
6,3,0,9,mixedType,1
7,3,0,10,mixedType,1
7,3,0,10,mixedType,1
6,4,0,10,mixedType,1
1,9,0,10,mixedType,1
6,3,0,9,mixedType,1
1,7,0,8,mixedType,1
6,3,0,9,mixedType,1
5,2,0,7,mixedType,0
5,2,0,7,mixedType,0
3,5,0,8,mixedType,1
10,3,0,13,mixedType,1
7,2,0,9,mixedType,1
5,3,0,8,mixedType,1
1,8,0,9,mixedType,1
3,6,0,9,mixedType,1
8,3,0,11,mixedType,1
6,2,0,8,mixedType,1
6,2,0,8,mixedType,1
4,2,0,6,mixedType,0
5,4,0,9,mixedType,1
5,4,0,9,mixedType,1
6,4,0,10,mixedType,1
10,6,0,16,mixedType,2
5,1,0,6,mixedType,0
6,4,0,10,mixedType,1
8,1,0,9,mixedType,1
6,2,0,8,mixedType,1
8,1,0,9,mixedType,1
7,3,0,10,mixedType,1
7,3,0,10,mixedType,1
2,8,0,10,mixedType,1
2,6,0,8,mixedType,1
14,2,0,16,mixedType,2
13,3,0,16,mixedType,2
9,1,0,10,mixedType,1
11,5,0,16,mixedType,2
5,4,0,9,mixedType,1
11,3,0,14,mixedType,2
15,1,0,16,mixedType,2
7,3,0,10,mixedType,1
10,6,0,16,mixedType,2
5,2,0,7,mixedType,0
4,2,0,6,mixedType,0
3,8,0,11,mixedType,1
9,1,0,10,mixedType,1
7,3,0,10,mixedType,1
7,3,0,10,mixedType,1
6,2,0,8,mixedType,1
7,5,0,12,mixedType,1
15,1,0,16,mixedType,2
8,3,0,11,mixedType,1
5,2,0,7,mixedType,0
7,2,0,9,mixedType,1
7,3,0,10,mixedType,1
5,4,0,9,mixedType,1
7,2,0,9,mixedType,1
1,8,0,9,mixedType,1
8,1,0,9,mixedType,1
8,1,0,9,mixedType,1
3,6,0,9,mixedType,1
5,2,0,7,mixedType,0
6,3,0,9,mixedType,1
9,1,0,10,mixedType,1
9,1,0,10,mixedType,1
5,5,0,10,mixedType,1
5,4,0,9,mixedType,1
7,2,0,9,mixedType,1
6,3,0,9,mixedType,1
6,2,0,8,mixedType,1
7,1,0,8,mixedType,1
6,4,0,10,mixedType,1
6,3,0,9,mixedType,1
9,1,0,10,mixedType,1
14,2,0,16,mixedType,2
4,2,0,6,mixedType,0
6,2,0,8,mixedType,1
7,1,0,8,mixedType,1
7,2,0,9,mixedType,1
8,4,0,12,mixedType,1
5,2,0,7,mixedType,0
3,6,0,9,mixedType,1
13,2,0,15,mixedType,2
2,6,0,8,mixedType,1
2,7,0,9,mixedType,1
8,2,0,10,mixedType,1
3,5,0,8,mixedType,1
6,4,0,10,mixedType,1
5,2,0,7,mixedType,0
6,3,0,9,mixedType,1
13,3,0,16,mixedType,2
7,3,0,10,mixedType,1
8,4,0,12,mixedType,1
4,6,0,10,mixedType,1
7,1,0,8,mixedType,1
7,3,0,10,mixedType,1
8,2,0,10,mixedType,1
7,3,0,10,mixedType,1
5,2,0,7,mixedType,0
6,1,0,7,mixedType,0
7,0,0,7,sameType,0
6,1,0,7,mixedType,0
15,1,0,16,mixedType,2
6,1,0,7,mixedType,0
11,5,0,16,mixedType,2
6,2,0,8,mixedType,1
8,3,0,11,mixedType,1
8,1,0,9,mixedType,1
10,4,0,14,mixedType,2
7,3,0,10,mixedType,1
4,4,0,8,mixedType,1
13,2,0,15,mixedType,2
3,3,0,6,mixedType,0
5,4,0,9,mixedType,1
7,3,0,10,mixedType,1
12,1,0,13,mixedType,1
9,1,0,10,mixedType,1
6,3,0,9,mixedType,1
5,2,0,7,mixedType,0
1,7,0,8,mixedType,1
6,4,0,10,mixedType,1
6,1,0,7,mixedType,0
5,3,0,8,mixedType,1
5,2,0,7,mixedType,0
3,8,0,11,mixedType,1
9,1,0,10,mixedType,1
1,8,0,9,mixedType,1
6,3,0,9,mixedType,1
4,4,0,8,mixedType,1
5,3,0,8,mixedType,1
9,4,0,13,mixedType,1
6,6,0,12,mixedType,1
14,2,0,16,mixedType,2
12,4,0,16,mixedType,2
5,3,0,8,mixedType,1
5,2,0,7,mixedType,0
7,2,0,9,mixedType,1
8,2,0,10,mixedType,1
7,2,0,9,mixedType,1
6,4,0,10,mixedType,1
7,3,0,10,mixedType,1
7,2,0,9,mixedType,1
8,4,0,12,mixedType,1
8,4,0,12,mixedType,1
6,3,0,9,mixedType,1
13,3,0,16,mixedType,2
7,2,0,9,mixedType,1
7,3,0,10,mixedType,1
5,3,0,8,mixedType,1
4,4,0,8,mixedType,1
5,1,0,6,mixedType,0
5,3,0,8,mixedType,1
7,6,0,13,mixedType,1
7,2,0,9,mixedType,1
2,4,0,6,mixedType,0
6,3,0,9,mixedType,1
7,3,0,10,mixedType,1
8,2,0,10,mixedType,1
6,4,0,10,mixedType,1
5,3,0,8,mixedType,1
9,1,0,10,mixedType,1
7,3,0,10,mixedType,1
2,6,0,8,mixedType,1
11,4,0,15,mixedType,2
11,5,0,16,mixedType,2
7,3,0,10,mixedType,1
1,9,0,10,mixedType,1
4,2,0,6,mixedType,0
5,2,0,7,mixedType,0
13,3,0,16,mixedType,2
6,3,0,9,mixedType,1
10,3,1,14,mixedType,2
9,3,0,12,mixedType,1
12,4,0,16,mixedType,2
5,3,0,8,mixedType,1
11,1,0,12,mixedType,1
8,3,0,11,mixedType,1
6,3,0,9,mixedType,1
15,1,0,16,mixedType,2
9,3,0,12,mixedType,1
5,3,0,8,mixedType,1
11,2,0,13,mixedType,1
5,1,0,6,mixedType,0
9,1,0,10,mixedType,1
2,4,0,6,mixedType,0
7,3,0,10,mixedType,1
5,3,0,8,mixedType,1
7,3,0,10,mixedType,1
8,1,0,9,mixedType,1
2,8,0,10,mixedType,1
6,6,0,12,mixedType,1
10,3,0,13,mixedType,1
8,1,0,9,mixedType,1
6,3,0,9,mixedType,1
15,1,0,16,mixedType,2
7,3,0,10,mixedType,1
1,9,0,10,mixedType,1
4,4,0,8,mixedType,1
8,3,0,11,mixedType,1
8,2,0,10,mixedType,1
6,3,0,9,mixedType,1
6,4,0,10,mixedType,1
6,1,0,7,mixedType,0
9,1,0,10,mixedType,1
6,4,0,10,mixedType,1
4,4,0,8,mixedType,1
6,3,0,9,mixedType,1
7,6,0,13,mixedType,1
5,3,0,8,mixedType,1
5,2,0,7,mixedType,0
15,1,0,16,mixedType,2
2,9,0,11,mixedType,1
3,5,0,8,mixedType,1
7,3,0,10,mixedType,1
8,3,0,11,mixedType,1
8,2,0,10,mixedType,1
6,2,0,8,mixedType,1
2,11,0,13,mixedType,1
5,1,0,6,mixedType,0
4,4,0,8,mixedType,1
6,1,0,7,mixedType,0
7,1,0,8,mixedType,1
6,4,0,10,mixedType,1
8,1,0,9,mixedType,1
10,6,0,16,mixedType,2
2,6,0,8,mixedType,1
6,4,0,10,mixedType,1
13,3,0,16,mixedType,2
5,4,0,9,mixedType,1
4,4,0,8,mixedType,1
15,1,0,16,mixedType,2
4,4,0,8,mixedType,1
8,4,0,12,mixedType,1
8,4,0,12,mixedType,1
2,9,0,11,mixedType,1
2,8,0,10,mixedType,1
7,2,0,9,mixedType,1
5,3,0,8,mixedType,1
6,3,0,9,mixedType,1
3,6,0,9,mixedType,1
13,3,0,16,mixedType,2
8,2,0,10,mixedType,1
10,6,0,16,mixedType,2
8,3,0,11,mixedType,1
15,1,1,17,mixedType,2
6,2,0,8,mixedType,1
9,0,1,10,mixedType,1
7,4,0,11,mixedType,1
6,3,0,9,mixedType,1
5,3,0,8,mixedType,1
8,2,0,10,mixedType,1
7,3,0,10,mixedType,1
7,3,0,10,mixedType,1
8,1,0,9,mixedType,1
1,9,0,10,mixedType,1
7,4,0,11,mixedType,1
5,4,0,9,mixedType,1
3,5,0,8,mixedType,1
5,4,0,9,mixedType,1
1,8,0,9,mixedType,1
4,4,0,8,mixedType,1
8,2,0,10,mixedType,1
6,4,0,10,mixedType,1
9,1,0,10,mixedType,1
3,6,0,9,mixedType,1
6,4,0,10,mixedType,1
8,2,0,10,mixedType,1
5,1,0,6,mixedType,0
1,7,0,8,mixedType,1
5,3,0,8,mixedType,1
3,3,0,6,mixedType,0
9,3,0,12,mixedType,1
3,3,0,6,mixedType,0
1,10,0,11,mixedType,1
7,2,0,9,mixedType,1
7,2,0,9,mixedType,1
13,3,0,16,mixedType,2
3,6,0,9,mixedType,1
7,4,0,11,mixedType,1
5,4,0,9,mixedType,1
7,2,0,9,mixedType,1
5,3,0,8,mixedType,1
11,3,0,14,mixedType,2
11,2,0,13,mixedType,1
6,7,0,13,mixedType,1
4,4,0,8,mixedType,1
7,1,0,8,mixedType,1
6,3,0,9,mixedType,1
6,3,0,9,mixedType,1
6,3,0,9,mixedType,1
8,1,0,9,mixedType,1
6,3,0,9,mixedType,1
5,2,0,7,mixedType,0
5,2,0,7,mixedType,0
4,2,0,6,mixedType,0
5,4,0,9,mixedType,1
4,4,0,8,mixedType,1
6,4,0,10,mixedType,1
12,3,0,15,mixedType,2
3,5,0,8,mixedType,1
5,4,0,9,mixedType,1
6,1,0,7,mixedType,0
4,2,0,6,mixedType,0
5,3,0,8,mixedType,1
14,2,0,16,mixedType,2
5,4,0,9,mixedType,1
3,5,0,8,mixedType,1
8,4,0,12,mixedType,1
2,4,0,6,mixedType,0
6,4,0,10,mixedType,1
8,2,0,10,mixedType,1
6,3,0,9,mixedType,1
7,2,0,9,mixedType,1
8,1,0,9,mixedType,1
4,2,0,6,mixedType,0
11,1,0,12,mixedType,1
11,5,0,16,mixedType,2
3,3,0,6,mixedType,0
1,7,0,8,mixedType,1
7,7,0,14,mixedType,2
6,1,0,7,mixedType,0
6,4,0,10,mixedType,1
6,3,0,9,mixedType,1
4,4,0,8,mixedType,1
5,1,0,6,mixedType,0
6,3,0,9,mixedType,1
9,2,0,11,mixedType,1
1,10,0,11,mixedType,1
9,1,0,10,mixedType,1
6,2,0,8,mixedType,1
5,3,0,8,mixedType,1
4,4,0,8,mixedType,1
6,3,0,9,mixedType,1
6,2,0,8,mixedType,1
6,1,0,7,mixedType,0
6,4,0,10,mixedType,1
6,3,0,9,mixedType,1
3,6,0,9,mixedType,1
3,7,0,10,mixedType,1
4,8,0,12,mixedType,1
7,2,0,9,mixedType,1
6,4,0,10,mixedType,1
6,4,0,10,mixedType,1
7,3,0,10,mixedType,1
8,2,0,10,mixedType,1
6,3,0,9,mixedType,1
8,3,0,11,mixedType,1
8,2,0,10,mixedType,1
9,2,0,11,mixedType,1
2,7,0,9,mixedType,1
4,4,0,8,mixedType,1
7,3,0,10,mixedType,1
8,2,0,10,mixedType,1
5,5,0,10,mixedType,1
6,4,0,10,mixedType,1
11,4,1,16,mixedType,2
7,3,0,10,mixedType,1
5,6,0,11,mixedType,1
8,2,0,10,mixedType,1
8,1,0,9,mixedType,1
5,4,0,9,mixedType,1
8,2,0,10,mixedType,1
14,2,0,16,mixedType,2
6,7,0,13,mixedType,1
5,2,0,7,mixedType,0
7,3,0,10,mixedType,1
3,6,0,9,mixedType,1
8,4,0,12,mixedType,1
6,4,0,10,mixedType,1
4,4,0,8,mixedType,1
6,2,0,8,mixedType,1
7,2,0,9,mixedType,1
7,2,0,9,mixedType,1
8,1,0,9,mixedType,1
5,2,0,7,mixedType,0
4,4,0,8,mixedType,1
7,3,0,10,mixedType,1
5,6,0,11,mixedType,1
5,3,0,8,mixedType,1
11,2,0,13,mixedType,1
7,3,0,10,mixedType,1
8,1,0,9,mixedType,1
5,2,0,7,mixedType,0
1,8,0,9,mixedType,1
6,1,0,7,mixedType,0
14,2,0,16,mixedType,2
5,3,0,8,mixedType,1
14,2,0,16,mixedType,2
6,3,0,9,mixedType,1
1,8,0,9,mixedType,1
13,3,0,16,mixedType,2
3,6,0,9,mixedType,1
7,3,0,10,mixedType,1
7,2,0,9,mixedType,1
5,3,0,8,mixedType,1
6,1,0,7,mixedType,0
9,1,0,10,mixedType,1
12,3,0,15,mixedType,2
5,2,0,7,mixedType,0
5,3,0,8,mixedType,1
7,6,0,13,mixedType,1
7,4,0,11,mixedType,1
5,2,0,7,mixedType,0
9,2,0,11,mixedType,1
13,3,0,16,mixedType,2
7,2,0,9,mixedType,1
10,1,0,11,mixedType,1
9,1,0,10,mixedType,1
6,1,0,7,mixedType,0
14,2,0,16,mixedType,2
6,2,0,8,mixedType,1
14,2,0,16,mixedType,2
7,2,0,9,mixedType,1
6,2,0,8,mixedType,1
7,2,0,9,mixedType,1
6,3,0,9,mixedType,1
4,2,0,6,mixedType,0
7,3,0,10,mixedType,1
13,3,0,16,mixedType,2
9,2,0,11,mixedType,1
6,1,0,7,mixedType,0
7,3,0,10,mixedType,1
7,3,0,10,mixedType,1
12,3,0,15,mixedType,2
1,5,0,6,mixedType,0
10,3,0,13,mixedType,1
5,2,0,7,mixedType,0
15,1,0,16,mixedType,2
5,4,0,9,mixedType,1
14,2,0,16,mixedType,2
3,5,0,8,mixedType,1
5,3,0,8,mixedType,1
7,2,0,9,mixedType,1
7,3,0,10,mixedType,1
2,6,0,8,mixedType,1
9,1,0,10,mixedType,1
8,3,0,11,mixedType,1
6,0,2,8,mixedType,0
6,3,0,9,mixedType,1
6,2,0,8,mixedType,1
6,3,0,9,mixedType,1
4,2,0,6,mixedType,0
8,2,0,10,mixedType,1
5,2,0,7,mixedType,0
13,3,0,16,mixedType,2
6,2,0,8,mixedType,1
8,1,0,9,mixedType,1
5,3,0,8,mixedType,1
2,6,0,8,mixedType,1
9,1,0,10,mixedType,1
6,2,0,8,mixedType,1
5,2,0,7,mixedType,0
8,0,1,9,mixedType,1
6,1,0,7,mixedType,0
6,1,0,7,mixedType,0
8,4,0,12,mixedType,1
11,3,0,14,mixedType,2
6,2,0,8,mixedType,1
7,3,0,10,mixedType,1
7,1,0,8,mixedType,1
7,3,0,10,mixedType,1
3,6,0,9,mixedType,1
8,5,2,15,mixedType,2
6,1,0,7,mixedType,0
11,5,0,16,mixedType,2
7,2,0,9,mixedType,1
6,4,0,10,mixedType,1
6,6,0,12,mixedType,1
14,2,0,16,mixedType,2
6,3,0,9,mixedType,1
10,2,0,12,mixedType,1
6,3,0,9,mixedType,1
6,6,0,12,mixedType,1
5,2,0,7,mixedType,0
5,4,0,9,mixedType,1
6,1,0,7,mixedType,0
14,1,1,16,mixedType,2
6,2,0,8,mixedType,1
5,6,0,11,mixedType,1
13,3,0,16,mixedType,2
5,4,0,9,mixedType,1
5,4,0,9,mixedType,1
10,6,0,16,mixedType,2
10,2,0,12,mixedType,1
4,4,0,8,mixedType,1
15,1,0,16,mixedType,2
3,6,0,9,mixedType,1
4,4,0,8,mixedType,1
3,10,0,13,mixedType,1
5,4,0,9,mixedType,1
4,4,0,8,mixedType,1
2,4,0,6,mixedType,0
8,1,0,9,mixedType,1
3,6,0,9,mixedType,1
8,1,0,9,mixedType,1
6,4,0,10,mixedType,1
6,3,0,9,mixedType,1
7,3,0,10,mixedType,1
6,3,0,9,mixedType,1
6,1,0,7,mixedType,0
5,4,0,9,mixedType,1
8,4,0,12,mixedType,1
5,3,0,8,mixedType,1
6,3,0,9,mixedType,1
8,4,0,12,mixedType,1
7,3,0,10,mixedType,1
5,5,0,10,mixedType,1
3,4,0,7,mixedType,0
6,3,0,9,mixedType,1
6,2,0,8,mixedType,1
13,3,0,16,mixedType,2
9,3,0,12,mixedType,1
5,6,0,11,mixedType,1
4,2,0,6,mixedType,0
7,2,0,9,mixedType,1
5,4,0,9,mixedType,1
7,3,0,10,mixedType,1
6,4,0,10,mixedType,1
9,3,0,12,mixedType,1
6,2,0,8,mixedType,1
6,3,0,9,mixedType,1
6,2,0,8,mixedType,1
5,2,0,7,mixedType,0
7,3,0,10,mixedType,1
5,3,0,8,mixedType,1
4,4,0,8,mixedType,1
6,2,0,8,mixedType,1
8,3,0,11,mixedType,1
1,8,0,9,mixedType,1
5,2,0,7,mixedType,0
1,9,0,10,mixedType,1
6,3,0,9,mixedType,1
6,1,0,7,mixedType,0
4,4,0,8,mixedType,1
7,2,0,9,mixedType,1
7,1,0,8,mixedType,1
6,3,0,9,mixedType,1
8,1,0,9,mixedType,1
12,4,0,16,mixedType,2
6,4,0,10,mixedType,1
14,2,0,16,mixedType,2
2,6,0,8,mixedType,1
8,1,0,9,mixedType,1
13,3,0,16,mixedType,2
4,4,0,8,mixedType,1
6,3,0,9,mixedType,1
7,3,0,10,mixedType,1
9,1,0,10,mixedType,1
6,1,0,7,mixedType,0
9,2,0,11,mixedType,1
8,2,0,10,mixedType,1
8,2,0,10,mixedType,1
1,8,0,9,mixedType,1
7,2,0,9,mixedType,1
7,2,0,9,mixedType,1
8,1,0,9,mixedType,1
5,4,0,9,mixedType,1
4,4,0,8,mixedType,1
7,2,0,9,mixedType,1
7,3,0,10,mixedType,1
6,1,0,7,mixedType,0
3,7,0,10,mixedType,1
5,2,0,7,mixedType,0
7,2,0,9,mixedType,1
7,1,0,8,mixedType,1
6,3,0,9,mixedType,1
8,2,0,10,mixedType,1
6,1,0,7,mixedType,0
8,1,0,9,mixedType,1
5,3,0,8,mixedType,1
1,8,0,9,mixedType,1
6,3,0,9,mixedType,1
4,2,0,6,mixedType,0
4,2,0,6,mixedType,0
7,4,0,11,mixedType,1
1,7,0,8,mixedType,1
5,2,0,7,mixedType,0
6,3,0,9,mixedType,1
6,3,0,9,mixedType,1
2,6,0,8,mixedType,1
9,1,0,10,mixedType,1
9,3,0,12,mixedType,1
6,4,0,10,mixedType,1
4,2,0,6,mixedType,0
3,6,0,9,mixedType,1
15,1,0,16,mixedType,2
4,4,0,8,mixedType,1
12,4,0,16,mixedType,2
15,1,0,16,mixedType,2
13,3,0,16,mixedType,2
6,2,0,8,mixedType,1
5,2,0,7,mixedType,0
2,6,0,8,mixedType,1
13,3,0,16,mixedType,2
3,7,0,10,mixedType,1
6,3,0,9,mixedType,1
8,2,0,10,mixedType,1
6,4,0,10,mixedType,1
1,8,0,9,mixedType,1
6,2,0,8,mixedType,1
11,4,2,17,mixedType,2
7,1,0,8,mixedType,1
6,1,0,7,mixedType,0
1,7,0,8,mixedType,1
3,5,0,8,mixedType,1
7,3,0,10,mixedType,1
4,4,0,8,mixedType,1
2,7,0,9,mixedType,1
13,3,0,16,mixedType,2
15,1,0,16,mixedType,2
4,6,0,10,mixedType,1
7,3,0,10,mixedType,1
6,2,0,8,mixedType,1
1,8,0,9,mixedType,1
6,2,0,8,mixedType,1
13,3,0,16,mixedType,2
4,4,0,8,mixedType,1
5,3,0,8,mixedType,1
7,2,0,9,mixedType,1
1,8,0,9,mixedType,1
6,1,0,7,mixedType,0
8,3,0,11,mixedType,1
11,2,0,13,mixedType,1
7,6,0,13,mixedType,1
6,3,0,9,mixedType,1
11,4,0,15,mixedType,2
6,3,0,9,mixedType,1
6,3,0,9,mixedType,1
4,5,0,9,mixedType,1
6,1,0,7,mixedType,0
7,3,0,10,mixedType,1
6,6,0,12,mixedType,1
5,4,0,9,mixedType,1
2,7,0,9,mixedType,1
5,3,0,8,mixedType,1
4,2,0,6,mixedType,0
6,4,0,10,mixedType,1
6,3,0,9,mixedType,1
7,3,0,10,mixedType,1
8,2,0,10,mixedType,1
6,1,0,7,mixedType,0
11,3,0,14,mixedType,2
5,3,0,8,mixedType,1
6,2,0,8,mixedType,1
13,3,0,16,mixedType,2
6,3,0,9,mixedType,1
7,3,0,10,mixedType,1
7,4,0,11,mixedType,1
7,2,0,9,mixedType,1
8,1,0,9,mixedType,1
15,1,0,16,mixedType,2
6,1,0,7,mixedType,0
5,4,0,9,mixedType,1
5,4,0,9,mixedType,1
8,1,0,9,mixedType,1
6,4,0,10,mixedType,1
11,1,0,12,mixedType,1
7,3,0,10,mixedType,1
11,3,0,14,mixedType,2
2,6,0,8,mixedType,1
6,3,0,9,mixedType,1
7,3,0,10,mixedType,1
9,2,0,11,mixedType,1
4,5,0,9,mixedType,1
7,1,0,8,mixedType,1
8,1,0,9,mixedType,1
9,1,0,10,mixedType,1
7,2,0,9,mixedType,1
7,3,0,10,mixedType,1
5,3,0,8,mixedType,1
6,4,0,10,mixedType,1
13,3,0,16,mixedType,2
2,7,0,9,mixedType,1
5,3,0,8,mixedType,1
8,3,0,11,mixedType,1
9,1,0,10,mixedType,1
7,5,0,12,mixedType,1
7,3,0,10,mixedType,1
9,2,0,11,mixedType,1
11,1,0,12,mixedType,1
6,4,0,10,mixedType,1
10,1,0,11,mixedType,1
9,2,0,11,mixedType,1
7,4,0,11,mixedType,1
5,2,0,7,mixedType,0
6,4,0,10,mixedType,1
11,2,0,13,mixedType,1
8,3,0,11,mixedType,1
9,1,0,10,mixedType,1
4,2,0,6,mixedType,0
4,2,0,6,mixedType,0
6,6,0,12,mixedType,1
8,2,0,10,mixedType,1
1,9,0,10,mixedType,1
3,7,0,10,mixedType,1
4,6,0,10,mixedType,1
14,2,0,16,mixedType,2
12,1,0,13,mixedType,1
5,4,0,9,mixedType,1
4,6,0,10,mixedType,1
4,2,0,6,mixedType,0
5,2,0,7,mixedType,0
8,4,0,12,mixedType,1
7,1,0,8,mixedType,1
7,3,0,10,mixedType,1
7,1,0,8,mixedType,1
3,5,0,8,mixedType,1
8,3,0,11,mixedType,1
9,1,0,10,mixedType,1
6,3,0,9,mixedType,1
7,1,0,8,mixedType,1
4,2,0,6,mixedType,0
5,3,0,8,mixedType,1
6,2,0,8,mixedType,1
12,1,0,13,mixedType,1
7,2,0,9,mixedType,1
5,2,0,7,mixedType,0
15,1,0,16,mixedType,2
6,3,0,9,mixedType,1
4,4,0,8,mixedType,1
14,2,0,16,mixedType,2
3,6,0,9,mixedType,1
4,5,0,9,mixedType,1
13,3,0,16,mixedType,2
8,2,0,10,mixedType,1
7,3,0,10,mixedType,1
6,1,0,7,mixedType,0
7,2,0,9,mixedType,1
7,3,0,10,mixedType,1
7,2,0,9,mixedType,1
9,1,0,10,mixedType,1
1,10,0,11,mixedType,1
4,2,0,6,mixedType,0
11,3,0,14,mixedType,2
7,3,0,10,mixedType,1
8,1,0,9,mixedType,1
15,1,0,16,mixedType,2
7,3,0,10,mixedType,1
5,3,0,8,mixedType,1
4,4,0,8,mixedType,1
9,3,0,12,mixedType,1
7,4,0,11,mixedType,1
4,6,0,10,mixedType,1
5,4,0,9,mixedType,1
7,1,0,8,mixedType,1
8,2,0,10,mixedType,1
7,7,0,14,mixedType,2
6,4,0,10,mixedType,1
1,8,0,9,mixedType,1
1,7,0,8,mixedType,1
6,2,0,8,mixedType,1
6,4,0,10,mixedType,1
10,2,0,12,mixedType,1
5,4,0,9,mixedType,1
7,3,0,10,mixedType,1
8,1,0,9,mixedType,1
13,3,0,16,mixedType,2
5,6,0,11,mixedType,1
10,3,0,13,mixedType,1
6,6,0,12,mixedType,1
15,1,1,17,mixedType,2
6,5,0,11,mixedType,1
9,3,0,12,mixedType,1
10,2,0,12,mixedType,1
4,4,0,8,mixedType,1
2,7,0,9,mixedType,1
15,1,0,16,mixedType,2
4,4,0,8,mixedType,1
7,2,0,9,mixedType,1
2,4,0,6,mixedType,0
6,2,0,8,mixedType,1
7,3,0,10,mixedType,1
6,2,0,8,mixedType,1
6,3,0,9,mixedType,1
6,3,0,9,mixedType,1
3,5,0,8,mixedType,1
5,3,0,8,mixedType,1
6,2,0,8,mixedType,1
8,3,0,11,mixedType,1
9,1,0,10,mixedType,1
5,2,0,7,mixedType,0
13,6,0,19,mixedType,2
5,5,0,10,mixedType,1
6,2,0,8,mixedType,1
7,3,0,10,mixedType,1
6,4,0,10,mixedType,1
6,1,0,7,mixedType,0
6,2,0,8,mixedType,1
9,1,0,10,mixedType,1
7,3,0,10,mixedType,1
6,4,0,10,mixedType,1
7,2,0,9,mixedType,1
2,4,0,6,mixedType,0
5,2,0,7,mixedType,0
8,1,0,9,mixedType,1
9,3,0,12,mixedType,1
7,1,0,8,mixedType,1
10,2,0,12,mixedType,1
5,3,0,8,mixedType,1
4,4,0,8,mixedType,1
10,2,0,12,mixedType,1
12,4,0,16,mixedType,2
10,3,0,13,mixedType,1
8,2,0,10,mixedType,1
6,3,0,9,mixedType,1
5,2,0,7,mixedType,0
4,7,0,11,mixedType,1
1,8,0,9,mixedType,1
7,2,0,9,mixedType,1
5,3,0,8,mixedType,1
7,3,0,10,mixedType,1
8,1,0,9,mixedType,1
6,2,0,8,mixedType,1
6,6,0,12,mixedType,1
6,2,0,8,mixedType,1
11,3,0,14,mixedType,2
6,2,0,8,mixedType,1
1,9,0,10,mixedType,1
9,3,0,12,mixedType,1
3,8,0,11,mixedType,1
6,4,0,10,mixedType,1
8,2,0,10,mixedType,1
8,1,0,9,mixedType,1
8,0,1,9,mixedType,1
6,1,0,7,mixedType,0
14,2,0,16,mixedType,2
1,7,0,8,mixedType,1
8,2,0,10,mixedType,1
1,8,0,9,mixedType,1
6,3,0,9,mixedType,1
6,3,0,9,mixedType,1
8,1,0,9,mixedType,1
10,2,0,12,mixedType,1
7,3,0,10,mixedType,1
8,1,0,9,mixedType,1
5,1,0,6,mixedType,0
5,10,0,15,mixedType,2
2,4,0,6,mixedType,0
7,2,0,9,mixedType,1
6,2,0,8,mixedType,1
5,3,0,8,mixedType,1
4,6,0,10,mixedType,1
8,4,0,12,mixedType,1
7,2,0,9,mixedType,1
15,1,0,16,mixedType,2
6,2,0,8,mixedType,1
15,3,0,18,mixedType,2
15,1,0,16,mixedType,2
4,9,0,13,mixedType,1
5,1,0,6,mixedType,0
7,2,0,9,mixedType,1
4,2,0,6,mixedType,0
7,2,0,9,mixedType,1
7,2,0,9,mixedType,1
5,4,0,9,mixedType,1
5,5,0,10,mixedType,1
7,1,0,8,mixedType,1
15,1,0,16,mixedType,2
7,1,0,8,mixedType,1
7,4,0,11,mixedType,1
7,4,0,11,mixedType,1
5,4,0,9,mixedType,1
3,6,0,9,mixedType,1
6,2,0,8,mixedType,1
9,4,0,13,mixedType,1
6,2,0,8,mixedType,1
7,2,0,9,mixedType,1
8,2,0,10,mixedType,1
6,2,0,8,mixedType,1
4,2,0,6,mixedType,0
6,2,0,8,mixedType,1
6,2,0,8,mixedType,1
14,2,0,16,mixedType,2
7,3,0,10,mixedType,1
5,1,0,6,mixedType,0
6,4,0,10,mixedType,1
5,4,0,9,mixedType,1
7,3,0,10,mixedType,1
9,1,0,10,mixedType,1
6,1,0,7,mixedType,0
4,4,0,8,mixedType,1
14,2,0,16,mixedType,2
3,6,0,9,mixedType,1
2,8,0,10,mixedType,1
4,4,0,8,mixedType,1
9,3,0,12,mixedType,1
11,2,1,14,mixedType,2
6,3,0,9,mixedType,1
3,8,0,11,mixedType,1
5,2,0,7,mixedType,0
5,4,0,9,mixedType,1
12,1,0,13,mixedType,1
9,4,0,13,mixedType,1
11,1,0,12,mixedType,1
13,3,0,16,mixedType,2
6,3,0,9,mixedType,1
5,3,0,8,mixedType,1
8,2,0,10,mixedType,1
6,3,0,9,mixedType,1
3,5,0,8,mixedType,1
7,3,0,10,mixedType,1
8,2,0,10,mixedType,1
8,4,0,12,mixedType,1
12,1,0,13,mixedType,1
5,2,0,7,mixedType,0
6,2,0,8,mixedType,1
6,2,0,8,mixedType,1
8,1,0,9,mixedType,1
8,2,0,10,mixedType,1
4,2,0,6,mixedType,0
6,4,0,10,mixedType,1
4,4,0,8,mixedType,1
12,4,0,16,mixedType,2
14,2,0,16,mixedType,2
6,3,0,9,mixedType,1
6,1,0,7,mixedType,0
4,9,0,13,mixedType,1
6,3,0,9,mixedType,1
5,3,0,8,mixedType,1
12,3,0,15,mixedType,2
2,6,0,8,mixedType,1
15,1,0,16,mixedType,2
3,8,0,11,mixedType,1
9,3,0,12,mixedType,1
1,11,0,12,mixedType,1
15,1,0,16,mixedType,2
4,2,0,6,mixedType,0
10,2,0,12,mixedType,1
10,3,0,13,mixedType,1
6,6,0,12,mixedType,1
7,3,0,10,mixedType,1
7,4,0,11,mixedType,1
6,3,0,9,mixedType,1
6,3,0,9,mixedType,1
6,1,0,7,mixedType,0
7,6,0,13,mixedType,1
6,1,0,7,mixedType,0
5,2,0,7,mixedType,0
5,4,0,9,mixedType,1
7,3,0,10,mixedType,1
10,2,0,12,mixedType,1
15,1,0,16,mixedType,2
8,2,0,10,mixedType,1
4,2,0,6,mixedType,0
7,3,0,10,mixedType,1
4,4,0,8,mixedType,1
11,3,0,14,mixedType,2
4,2,0,6,mixedType,0
5,3,0,8,mixedType,1
5,3,0,8,mixedType,1
5,2,0,7,mixedType,0
7,6,0,13,mixedType,1
10,4,0,14,mixedType,2
5,1,0,6,mixedType,0
6,3,0,9,mixedType,1
7,5,0,12,mixedType,1
4,2,0,6,mixedType,0
5,4,0,9,mixedType,1
5,1,0,6,mixedType,0
5,3,0,8,mixedType,1
6,3,0,9,mixedType,1
5,5,0,10,mixedType,1
6,1,0,7,mixedType,0
14,2,0,16,mixedType,2
8,3,0,11,mixedType,1
8,3,0,11,mixedType,1
3,7,0,10,mixedType,1
6,3,0,9,mixedType,1
4,2,0,6,mixedType,0
6,4,0,10,mixedType,1
3,7,0,10,mixedType,1
5,4,0,9,mixedType,1
5,4,0,9,mixedType,1
6,3,0,9,mixedType,1
7,3,0,10,mixedType,1
5,4,0,9,mixedType,1
14,2,0,16,mixedType,2
8,8,0,16,mixedType,2
7,9,0,16,mixedType,2
16,2,1,19,mixedType,2
1,8,0,9,mixedType,1
10,3,0,13,mixedType,1
3,7,0,10,mixedType,1
1,8,0,9,mixedType,1
8,2,0,10,mixedType,1
7,3,0,10,mixedType,1
10,5,6,21,mixedType,2
13,3,0,16,mixedType,2
7,2,0,9,mixedType,1
4,4,0,8,mixedType,1
10,2,0,12,mixedType,1
2,6,0,8,mixedType,1
6,3,0,9,mixedType,1
7,2,0,9,mixedType,1
6,2,0,8,mixedType,1
8,2,0,10,mixedType,1
10,3,0,13,mixedType,1
13,3,0,16,mixedType,2
5,2,0,7,mixedType,0
8,1,0,9,mixedType,1
13,3,0,16,mixedType,2
7,3,0,10,mixedType,1
8,2,0,10,mixedType,1
8,1,0,9,mixedType,1
4,4,0,8,mixedType,1
9,1,0,10,mixedType,1
8,3,0,11,mixedType,1
5,4,0,9,mixedType,1
9,4,0,13,mixedType,1
20,6,4,30,mixedType,2
6,4,0,10,mixedType,1
12,4,0,16,mixedType,2
6,1,0,7,mixedType,0
6,3,0,9,mixedType,1
5,2,0,7,mixedType,0
11,2,3,16,mixedType,2
6,1,0,7,mixedType,0
5,4,0,9,mixedType,1
1,11,0,12,mixedType,1
7,1,0,8,mixedType,1
4,4,0,8,mixedType,1
6,2,0,8,mixedType,1
7,6,0,13,mixedType,1
6,3,0,9,mixedType,1
5,3,0,8,mixedType,1
8,4,0,12,mixedType,1
5,1,0,6,mixedType,0
11,3,0,14,mixedType,2
4,2,0,6,mixedType,0
8,2,0,10,mixedType,1
5,3,0,8,mixedType,1
1,8,0,9,mixedType,1
6,4,0,10,mixedType,1
5,2,0,7,mixedType,0
4,6,0,10,mixedType,1
6,2,0,8,mixedType,1
8,1,0,9,mixedType,1
6,1,0,7,mixedType,0
4,4,0,8,mixedType,1
4,5,0,9,mixedType,1
4,4,0,8,mixedType,1
4,4,0,8,mixedType,1
8,1,0,9,mixedType,1
6,10,0,16,mixedType,2
5,2,0,7,mixedType,0
6,2,0,8,mixedType,1
7,4,0,11,mixedType,1
6,6,0,12,mixedType,1
6,4,0,10,mixedType,1
6,6,0,12,mixedType,1
3,6,0,9,mixedType,1
3,3,0,6,mixedType,0
6,4,0,10,mixedType,1
4,2,0,6,mixedType,0
4,6,0,10,mixedType,1
7,3,0,10,mixedType,1
8,2,0,10,mixedType,1
8,1,0,9,mixedType,1
6,4,0,10,mixedType,1
6,2,0,8,mixedType,1
10,1,0,11,mixedType,1
15,1,0,16,mixedType,2
8,2,0,10,mixedType,1
1,7,0,8,mixedType,1
5,3,0,8,mixedType,1
3,5,0,8,mixedType,1
8,5,0,13,mixedType,1
9,1,0,10,mixedType,1
7,3,0,10,mixedType,1
5,4,0,9,mixedType,1
6,3,0,9,mixedType,1
8,1,0,9,mixedType,1
6,4,0,10,mixedType,1
4,6,0,10,mixedType,1
5,3,0,8,mixedType,1
6,1,0,7,mixedType,0
6,3,0,9,mixedType,1
4,4,0,8,mixedType,1
4,4,0,8,mixedType,1
7,2,0,9,mixedType,1
9,1,0,10,mixedType,1
12,3,0,15,mixedType,2
7,3,0,10,mixedType,1
6,4,0,10,mixedType,1
5,2,0,7,mixedType,0
6,0,1,7,mixedType,0
5,3,0,8,mixedType,1
4,4,0,8,mixedType,1
6,4,0,10,mixedType,1
7,2,0,9,mixedType,1
6,1,0,7,mixedType,0
5,2,0,7,mixedType,0
9,3,0,12,mixedType,1
5,3,0,8,mixedType,1
12,3,0,15,mixedType,2
8,1,0,9,mixedType,1
6,4,0,10,mixedType,1
6,1,0,7,mixedType,0
5,6,0,11,mixedType,1
7,3,0,10,mixedType,1
7,2,0,9,mixedType,1
12,1,0,13,mixedType,1
4,4,0,8,mixedType,1
8,1,0,9,mixedType,1
8,3,0,11,mixedType,1
9,2,0,11,mixedType,1
5,2,0,7,mixedType,0
14,2,0,16,mixedType,2
12,1,1,14,mixedType,2
1,7,0,8,mixedType,1
12,4,0,16,mixedType,2
11,5,0,16,mixedType,2
5,4,0,9,mixedType,1
10,4,3,17,mixedType,2
11,3,1,15,mixedType,2
4,6,0,10,mixedType,1
7,4,0,11,mixedType,1
11,2,0,13,mixedType,1
7,3,0,10,mixedType,1
9,3,0,12,mixedType,1
5,5,0,10,mixedType,1
8,2,0,10,mixedType,1
14,2,0,16,mixedType,2
8,2,0,10,mixedType,1
6,1,0,7,mixedType,0
5,3,0,8,mixedType,1
9,4,0,13,mixedType,1
6,2,0,8,mixedType,1
8,2,0,10,mixedType,1
8,1,0,9,mixedType,1
4,4,0,8,mixedType,1
6,2,0,8,mixedType,1
6,3,0,9,mixedType,1
14,2,0,16,mixedType,2
6,3,0,9,mixedType,1
6,2,0,8,mixedType,1
5,3,0,8,mixedType,1
8,2,0,10,mixedType,1
3,9,0,12,mixedType,1
6,2,0,8,mixedType,1
8,2,0,10,mixedType,1
5,6,0,11,mixedType,1
1,10,0,11,mixedType,1
8,2,0,10,mixedType,1
7,4,0,11,mixedType,1
5,2,0,7,mixedType,0
9,2,0,11,mixedType,1
5,2,0,7,mixedType,0
6,3,0,9,mixedType,1
10,2,0,12,mixedType,1
7,4,0,11,mixedType,1
12,3,0,15,mixedType,2
10,1,0,11,mixedType,1
15,1,0,16,mixedType,2
7,1,0,8,mixedType,1
15,1,1,17,mixedType,2
5,1,0,6,mixedType,0
7,3,0,10,mixedType,1
4,5,0,9,mixedType,1
14,2,0,16,mixedType,2
5,2,0,7,mixedType,0
8,4,0,12,mixedType,1
6,4,0,10,mixedType,1
7,2,0,9,mixedType,1
6,3,0,9,mixedType,1
9,2,0,11,mixedType,1
8,1,0,9,mixedType,1
11,5,0,16,mixedType,2
1,8,0,9,mixedType,1
3,9,0,12,mixedType,1
9,3,0,12,mixedType,1
8,0,3,11,mixedType,1
5,4,0,9,mixedType,1
8,4,0,12,mixedType,1
5,2,0,7,mixedType,0
6,2,0,8,mixedType,1
7,2,0,9,mixedType,1
5,3,0,8,mixedType,1
6,4,0,10,mixedType,1
6,3,0,9,mixedType,1
6,1,0,7,mixedType,0
7,2,0,9,mixedType,1
12,4,0,16,mixedType,2
13,3,0,16,mixedType,2
5,6,0,11,mixedType,1
15,1,0,16,mixedType,2
7,2,0,9,mixedType,1
5,2,0,7,mixedType,0
13,3,0,16,mixedType,2
7,3,0,10,mixedType,1
7,2,0,9,mixedType,1
5,2,0,7,mixedType,0
6,2,0,8,mixedType,1
3,5,0,8,mixedType,1
11,3,0,14,mixedType,2
2,8,0,10,mixedType,1
9,3,0,12,mixedType,1
15,1,0,16,mixedType,2
9,1,0,10,mixedType,1
15,1,0,16,mixedType,2
4,2,0,6,mixedType,0
9,1,0,10,mixedType,1
1,9,0,10,mixedType,1
13,3,0,16,mixedType,2
5,3,0,8,mixedType,1
5,3,0,8,mixedType,1
6,3,0,9,mixedType,1
13,2,0,15,mixedType,2
3,7,0,10,mixedType,1
5,6,0,11,mixedType,1
12,4,0,16,mixedType,2
6,2,0,8,mixedType,1
5,3,0,8,mixedType,1
6,3,0,9,mixedType,1
10,2,0,12,mixedType,1
8,2,0,10,mixedType,1
7,1,0,8,mixedType,1
8,3,0,11,mixedType,1
13,3,0,16,mixedType,2
15,1,0,16,mixedType,2
5,1,0,6,mixedType,0
7,3,0,10,mixedType,1
6,3,0,9,mixedType,1
7,3,0,10,mixedType,1
8,3,0,11,mixedType,1
12,3,0,15,mixedType,2
6,2,0,8,mixedType,1
2,8,0,10,mixedType,1
3,4,0,7,mixedType,0
8,4,0,12,mixedType,1
6,3,0,9,mixedType,1
6,4,0,10,mixedType,1
15,1,0,16,mixedType,2
8,2,0,10,mixedType,1
6,1,0,7,mixedType,0
11,2,0,13,mixedType,1
4,4,0,8,mixedType,1
7,3,0,10,mixedType,1
6,3,0,9,mixedType,1
8,2,0,10,mixedType,1
6,1,0,7,mixedType,0
7,3,0,10,mixedType,1
9,2,0,11,mixedType,1
1,8,0,9,mixedType,1
3,3,0,6,mixedType,0
8,2,0,10,mixedType,1
5,4,0,9,mixedType,1
3,10,0,13,mixedType,1
5,3,0,8,mixedType,1
2,6,0,8,mixedType,1
3,8,0,11,mixedType,1
6,4,0,10,mixedType,1
9,1,0,10,mixedType,1
8,4,0,12,mixedType,1
7,2,0,9,mixedType,1
5,3,0,8,mixedType,1
8,4,0,12,mixedType,1
19,1,1,21,mixedType,2
2,6,0,8,mixedType,1
1,8,0,9,mixedType,1
14,2,0,16,mixedType,2
1,7,0,8,mixedType,1
4,7,0,11,mixedType,1
6,1,0,7,mixedType,0
6,1,0,7,mixedType,0
5,3,0,8,mixedType,1
14,2,0,16,mixedType,2
7,3,0,10,mixedType,1
7,3,0,10,mixedType,1
8,1,0,9,mixedType,1
9,3,0,12,mixedType,1
6,3,0,9,mixedType,1
6,1,0,7,mixedType,0
6,1,0,7,mixedType,0
7,2,0,9,mixedType,1
6,2,0,8,mixedType,1
5,1,0,6,mixedType,0
7,3,0,10,mixedType,1
5,1,0,6,mixedType,0
6,3,0,9,mixedType,1
6,3,0,9,mixedType,1
15,1,0,16,mixedType,2
7,3,0,10,mixedType,1
7,3,0,10,mixedType,1
14,2,0,16,mixedType,2
7,2,0,9,mixedType,1
6,2,0,8,mixedType,1
6,3,0,9,mixedType,1
6,4,0,10,mixedType,1
5,1,0,6,mixedType,0
2,8,0,10,mixedType,1
8,2,0,10,mixedType,1
6,1,0,7,mixedType,0
1,5,0,6,mixedType,0
7,3,0,10,mixedType,1
6,2,0,8,mixedType,1
5,5,0,10,mixedType,1
1,9,0,10,mixedType,1
11,3,0,14,mixedType,2
8,1,0,9,mixedType,1
5,5,0,10,mixedType,1
4,5,0,9,mixedType,1
6,1,0,7,mixedType,0
14,2,0,16,mixedType,2
3,6,0,9,mixedType,1
4,4,0,8,mixedType,1
8,1,0,9,mixedType,1
1,8,0,9,mixedType,1
14,2,0,16,mixedType,2
8,1,0,9,mixedType,1
4,4,0,8,mixedType,1
4,2,0,6,mixedType,0
6,4,0,10,mixedType,1
9,2,0,11,mixedType,1
8,0,1,9,mixedType,1
4,5,0,9,mixedType,1
6,4,0,10,mixedType,1
7,5,0,12,mixedType,1
14,2,0,16,mixedType,2
4,4,0,8,mixedType,1
4,6,0,10,mixedType,1
6,3,0,9,mixedType,1
12,4,0,16,mixedType,2
5,2,0,7,mixedType,0
5,2,0,7,mixedType,0
8,2,0,10,mixedType,1
11,5,0,16,mixedType,2
7,3,0,10,mixedType,1
7,3,0,10,mixedType,1
4,2,0,6,mixedType,0
6,1,0,7,mixedType,0
8,2,0,10,mixedType,1
14,2,0,16,mixedType,2
12,4,0,16,mixedType,2
15,1,0,16,mixedType,2
7,2,0,9,mixedType,1
11,2,0,13,mixedType,1
5,2,0,7,mixedType,0
5,3,0,8,mixedType,1
2,4,0,6,mixedType,0
15,1,0,16,mixedType,2
5,8,0,13,mixedType,1
7,3,0,10,mixedType,1
3,3,0,6,mixedType,0
7,2,0,9,mixedType,1
7,3,0,10,mixedType,1
6,3,0,9,mixedType,1
5,2,0,7,mixedType,0
10,1,0,11,mixedType,1
1,8,0,9,mixedType,1
8,1,0,9,mixedType,1
12,4,0,16,mixedType,2
5,2,0,7,mixedType,0
7,2,0,9,mixedType,1
10,1,0,11,mixedType,1
5,3,0,8,mixedType,1
9,3,0,12,mixedType,1
4,4,0,8,mixedType,1
6,3,0,9,mixedType,1
3,3,0,6,mixedType,0
9,1,0,10,mixedType,1
12,4,0,16,mixedType,2
9,2,0,11,mixedType,1
7,2,0,9,mixedType,1
7,3,0,10,mixedType,1
5,2,0,7,mixedType,0
9,1,0,10,mixedType,1
5,2,0,7,mixedType,0
10,1,0,11,mixedType,1
9,1,0,10,mixedType,1
12,4,0,16,mixedType,2
5,3,0,8,mixedType,1
7,3,0,10,mixedType,1
6,3,0,9,mixedType,1
14,2,0,16,mixedType,2
7,2,0,9,mixedType,1
5,1,0,6,mixedType,0
8,1,0,9,mixedType,1
4,4,0,8,mixedType,1
8,2,0,10,mixedType,1
5,5,0,10,mixedType,1
7,1,0,8,mixedType,1
5,4,0,9,mixedType,1
9,3,0,12,mixedType,1
8,2,0,10,mixedType,1
12,4,0,16,mixedType,2
6,4,0,10,mixedType,1
4,5,0,9,mixedType,1
2,8,0,10,mixedType,1
4,6,0,10,mixedType,1
8,1,0,9,mixedType,1
7,1,0,8,mixedType,1
6,4,0,10,mixedType,1
9,3,0,12,mixedType,1
7,1,0,8,mixedType,1
6,3,0,9,mixedType,1
11,0,2,13,mixedType,1
8,1,0,9,mixedType,1
7,3,0,10,mixedType,1
5,1,0,6,mixedType,0
5,1,0,6,mixedType,0
6,4,0,10,mixedType,1
4,2,0,6,mixedType,0
8,2,0,10,mixedType,1
11,3,0,14,mixedType,2
6,2,0,8,mixedType,1
14,2,0,16,mixedType,2
8,1,0,9,mixedType,1
1,8,0,9,mixedType,1
11,1,0,12,mixedType,1
7,2,0,9,mixedType,1
5,3,0,8,mixedType,1
8,1,0,9,mixedType,1
5,1,0,6,mixedType,0
5,0,1,6,mixedType,0
7,4,0,11,mixedType,1
6,1,0,7,mixedType,0
9,2,0,11,mixedType,1
7,3,0,10,mixedType,1
3,5,0,8,mixedType,1
8,2,0,10,mixedType,1
6,4,0,10,mixedType,1
2,4,0,6,mixedType,0
7,3,0,10,mixedType,1
6,3,0,9,mixedType,1
6,2,0,8,mixedType,1
9,2,0,11,mixedType,1
9,1,0,10,mixedType,1
12,4,1,17,mixedType,2
8,2,0,10,mixedType,1
9,3,0,12,mixedType,1
6,3,0,9,mixedType,1
12,4,0,16,mixedType,2
11,2,0,13,mixedType,1
5,2,0,7,mixedType,0
7,3,0,10,mixedType,1
5,1,0,6,mixedType,0
7,5,0,12,mixedType,1
5,6,0,11,mixedType,1
4,6,0,10,mixedType,1
2,10,0,12,mixedType,1
8,4,0,12,mixedType,1
9,2,0,11,mixedType,1
4,4,0,8,mixedType,1
6,4,0,10,mixedType,1
12,3,0,15,mixedType,2
5,3,0,8,mixedType,1
3,3,0,6,mixedType,0
6,2,0,8,mixedType,1
6,3,0,9,mixedType,1
10,6,0,16,mixedType,2
8,2,0,10,mixedType,1
5,2,0,7,mixedType,0
8,2,0,10,mixedType,1
8,2,0,10,mixedType,1
7,4,0,11,mixedType,1
8,2,0,10,mixedType,1
4,2,0,6,mixedType,0
8,2,0,10,mixedType,1
6,2,0,8,mixedType,1
2,7,0,9,mixedType,1
6,2,0,8,mixedType,1
8,2,0,10,mixedType,1
12,4,0,16,mixedType,2
6,1,0,7,mixedType,0
5,1,0,6,mixedType,0
9,1,0,10,mixedType,1
11,5,0,16,mixedType,2
14,2,0,16,mixedType,2
6,1,0,7,mixedType,0
14,2,0,16,mixedType,2
4,4,0,8,mixedType,1
5,1,0,6,mixedType,0
3,5,0,8,mixedType,1
3,3,0,6,mixedType,0
9,1,0,10,mixedType,1
6,3,0,9,mixedType,1
6,3,0,9,mixedType,1
8,2,0,10,mixedType,1
7,4,0,11,mixedType,1
7,3,0,10,mixedType,1
9,7,0,16,mixedType,2
5,4,0,9,mixedType,1
8,1,0,9,mixedType,1
7,4,0,11,mixedType,1
14,2,0,16,mixedType,2
8,1,0,9,mixedType,1
7,2,0,9,mixedType,1
7,2,0,9,mixedType,1
8,1,0,9,mixedType,1
4,0,5,9,mixedType,1
6,10,0,16,mixedType,2
5,3,0,8,mixedType,1
8,1,0,9,mixedType,1
8,2,0,10,mixedType,1
5,3,0,8,mixedType,1
11,3,0,14,mixedType,2
6,4,0,10,mixedType,1
8,1,0,9,mixedType,1
10,2,0,12,mixedType,1
6,3,0,9,mixedType,1
1,6,0,7,mixedType,0
15,1,0,16,mixedType,2
7,3,0,10,mixedType,1
8,1,0,9,mixedType,1
12,4,0,16,mixedType,2
5,4,0,9,mixedType,1
7,6,0,13,mixedType,1
5,2,0,7,mixedType,0
5,1,0,6,mixedType,0
13,3,0,16,mixedType,2
6,3,0,9,mixedType,1
5,1,0,6,mixedType,0
6,3,0,9,mixedType,1
6,1,0,7,mixedType,0
6,1,0,7,mixedType,0
9,2,0,11,mixedType,1
8,4,0,12,mixedType,1
4,2,0,6,mixedType,0
2,8,0,10,mixedType,1
8,1,0,9,mixedType,1
5,2,0,7,mixedType,0
3,8,0,11,mixedType,1
3,5,0,8,mixedType,1
7,3,0,10,mixedType,1
6,2,0,8,mixedType,1
5,6,0,11,mixedType,1
5,2,0,7,mixedType,0
7,4,0,11,mixedType,1
5,1,0,6,mixedType,0
9,2,0,11,mixedType,1
8,2,0,10,mixedType,1
8,3,0,11,mixedType,1
11,3,0,14,mixedType,2
2,7,0,9,mixedType,1
6,6,0,12,mixedType,1
6,3,0,9,mixedType,1
8,2,0,10,mixedType,1
8,2,0,10,mixedType,1
8,2,0,10,mixedType,1
2,6,0,8,mixedType,1
6,4,0,10,mixedType,1
6,3,0,9,mixedType,1
15,1,0,16,mixedType,2
7,2,0,9,mixedType,1
9,1,0,10,mixedType,1
6,3,0,9,mixedType,1
8,4,0,12,mixedType,1
12,4,0,16,mixedType,2
6,4,0,10,mixedType,1
6,4,0,10,mixedType,1
14,2,0,16,mixedType,2
6,3,0,9,mixedType,1
6,6,0,12,mixedType,1
3,8,0,11,mixedType,1
7,3,0,10,mixedType,1
1,9,0,10,mixedType,1
8,1,0,9,mixedType,1
1,7,0,8,mixedType,1
3,6,0,9,mixedType,1
6,3,0,9,mixedType,1
3,5,0,8,mixedType,1
6,2,0,8,mixedType,1
11,3,0,14,mixedType,2
5,3,0,8,mixedType,1
5,6,0,11,mixedType,1
6,4,0,10,mixedType,1
4,2,0,6,mixedType,0
2,8,0,10,mixedType,1
1,7,0,8,mixedType,1
5,2,0,7,mixedType,0
4,4,0,8,mixedType,1
1,9,0,10,mixedType,1
1,8,0,9,mixedType,1
6,3,0,9,mixedType,1
7,2,0,9,mixedType,1
5,1,0,6,mixedType,0
11,4,3,18,mixedType,2
4,4,0,8,mixedType,1
7,2,0,9,mixedType,1
5,3,0,8,mixedType,1
6,2,0,8,mixedType,1
5,6,0,11,mixedType,1
7,2,0,9,mixedType,1
12,4,0,16,mixedType,2
5,3,0,8,mixedType,1
7,2,0,9,mixedType,1
7,1,0,8,mixedType,1
8,2,0,10,mixedType,1
4,6,0,10,mixedType,1
6,3,0,9,mixedType,1
11,1,0,12,mixedType,1
9,2,0,11,mixedType,1
6,4,0,10,mixedType,1
1,7,0,8,mixedType,1
6,3,0,9,mixedType,1
5,1,0,6,mixedType,0
8,1,0,9,mixedType,1
12,3,0,15,mixedType,2
7,1,0,8,mixedType,1
6,3,0,9,mixedType,1
10,1,0,11,mixedType,1
5,2,0,7,mixedType,0
6,3,0,9,mixedType,1
5,2,0,7,mixedType,0
5,4,0,9,mixedType,1
4,4,0,8,mixedType,1
5,1,0,6,mixedType,0
5,2,0,7,mixedType,0
7,3,0,10,mixedType,1
5,2,0,7,mixedType,0
9,1,0,10,mixedType,1
4,2,0,6,mixedType,0
6,2,0,8,mixedType,1
7,1,0,8,mixedType,1
5,4,0,9,mixedType,1
7,1,0,8,mixedType,1
15,1,0,16,mixedType,2
15,1,0,16,mixedType,2
8,3,0,11,mixedType,1
6,3,0,9,mixedType,1
6,1,0,7,mixedType,0
8,1,0,9,mixedType,1
5,4,0,9,mixedType,1
10,3,0,13,mixedType,1
5,7,0,12,mixedType,1
6,1,0,7,mixedType,0
6,3,0,9,mixedType,1
9,1,0,10,mixedType,1
7,2,0,9,mixedType,1
6,3,0,9,mixedType,1
7,3,0,10,mixedType,1
1,7,0,8,mixedType,1
5,2,0,7,mixedType,0
11,2,0,13,mixedType,1
6,4,0,10,mixedType,1
15,1,0,16,mixedType,2
7,3,0,10,mixedType,1
5,2,0,7,mixedType,0
6,4,0,10,mixedType,1
11,1,0,12,mixedType,1
5,1,0,6,mixedType,0
6,2,0,8,mixedType,1
6,2,0,8,mixedType,1
5,4,0,9,mixedType,1
5,4,0,9,mixedType,1
15,1,0,16,mixedType,2
5,5,0,10,mixedType,1
10,2,0,12,mixedType,1
3,6,0,9,mixedType,1
15,1,0,16,mixedType,2
5,4,0,9,mixedType,1
2,8,0,10,mixedType,1
4,4,0,8,mixedType,1
12,1,1,14,mixedType,2
2,6,0,8,mixedType,1
6,3,0,9,mixedType,1
6,4,0,10,mixedType,1
6,3,0,9,mixedType,1
6,2,0,8,mixedType,1
13,3,0,16,mixedType,2
12,4,0,16,mixedType,2
3,6,0,9,mixedType,1
10,3,0,13,mixedType,1
8,2,0,10,mixedType,1
5,3,0,8,mixedType,1
6,3,0,9,mixedType,1
7,3,0,10,mixedType,1
7,2,0,9,mixedType,1
10,1,0,11,mixedType,1
5,2,0,7,mixedType,0
6,1,0,7,mixedType,0
10,2,0,12,mixedType,1
6,2,0,8,mixedType,1
5,4,0,9,mixedType,1
6,3,0,9,mixedType,1
5,3,0,8,mixedType,1
8,2,0,10,mixedType,1
4,2,0,6,mixedType,0
2,6,0,8,mixedType,1
5,4,0,9,mixedType,1
13,3,0,16,mixedType,2
2,6,0,8,mixedType,1
8,2,0,10,mixedType,1
7,1,0,8,mixedType,1
15,1,0,16,mixedType,2
6,3,0,9,mixedType,1
14,2,0,16,mixedType,2
6,1,0,7,mixedType,0
5,1,0,6,mixedType,0
4,4,0,8,mixedType,1
8,2,0,10,mixedType,1
14,2,0,16,mixedType,2
14,2,0,16,mixedType,2
7,1,0,8,mixedType,1
7,3,0,10,mixedType,1
7,8,1,16,mixedType,2
6,4,0,10,mixedType,1
7,3,0,10,mixedType,1
13,3,0,16,mixedType,2
7,2,0,9,mixedType,1
8,4,0,12,mixedType,1
6,3,0,9,mixedType,1
6,4,0,10,mixedType,1
6,3,0,9,mixedType,1
6,2,0,8,mixedType,1
7,2,0,9,mixedType,1
5,2,0,7,mixedType,0
4,2,0,6,mixedType,0
4,4,0,8,mixedType,1
9,4,0,13,mixedType,1
6,4,0,10,mixedType,1
7,3,0,10,mixedType,1
6,3,0,9,mixedType,1
10,4,0,14,mixedType,2
9,2,0,11,mixedType,1
12,1,0,13,mixedType,1
4,4,0,8,mixedType,1
7,3,0,10,mixedType,1
7,3,0,10,mixedType,1
6,3,0,9,mixedType,1
7,3,0,10,mixedType,1
9,4,0,13,mixedType,1
6,4,0,10,mixedType,1
12,4,0,16,mixedType,2
2,7,0,9,mixedType,1
12,3,0,15,mixedType,2
6,3,0,9,mixedType,1
5,1,0,6,mixedType,0
6,3,0,9,mixedType,1
8,4,0,12,mixedType,1
4,2,0,6,mixedType,0
4,4,0,8,mixedType,1
8,3,0,11,mixedType,1
5,3,0,8,mixedType,1
8,3,0,11,mixedType,1
9,2,0,11,mixedType,1
3,6,0,9,mixedType,1
4,4,0,8,mixedType,1
2,8,0,10,mixedType,1
5,2,0,7,mixedType,0
7,3,0,10,mixedType,1
6,1,0,7,mixedType,0
6,4,0,10,mixedType,1
8,4,0,12,mixedType,1
11,3,0,14,mixedType,2
15,1,0,16,mixedType,2
8,2,0,10,mixedType,1
5,3,0,8,mixedType,1
5,6,0,11,mixedType,1
16,4,0,20,mixedType,2
14,2,0,16,mixedType,2
5,2,0,7,mixedType,0
8,1,0,9,mixedType,1
8,1,0,9,mixedType,1
6,5,0,11,mixedType,1
6,2,0,8,mixedType,1
4,6,0,10,mixedType,1
2,4,0,6,mixedType,0
7,2,0,9,mixedType,1
14,2,0,16,mixedType,2
1,9,0,10,mixedType,1
12,4,0,16,mixedType,2
8,3,0,11,mixedType,1
8,2,0,10,mixedType,1
8,2,0,10,mixedType,1
6,4,0,10,mixedType,1
7,2,0,9,mixedType,1
6,1,0,7,mixedType,0
7,1,0,8,mixedType,1
3,6,0,9,mixedType,1
8,2,0,10,mixedType,1
7,3,0,10,mixedType,1
3,8,0,11,mixedType,1
14,2,0,16,mixedType,2
5,2,0,7,mixedType,0
13,3,0,16,mixedType,2
5,2,0,7,mixedType,0
8,1,0,9,mixedType,1
8,2,0,10,mixedType,1
6,2,0,8,mixedType,1
4,6,0,10,mixedType,1
6,3,0,9,mixedType,1
3,6,0,9,mixedType,1
6,4,0,10,mixedType,1
7,4,0,11,mixedType,1
7,1,0,8,mixedType,1
12,4,0,16,mixedType,2
15,1,0,16,mixedType,2
4,4,0,8,mixedType,1
6,3,0,9,mixedType,1
6,4,0,10,mixedType,1
4,4,0,8,mixedType,1
3,3,0,6,mixedType,0
5,2,0,7,mixedType,0
7,3,0,10,mixedType,1
5,2,0,7,mixedType,0
6,4,0,10,mixedType,1
7,1,0,8,mixedType,1
6,6,0,12,mixedType,1
13,3,0,16,mixedType,2
7,3,0,10,mixedType,1
4,2,0,6,mixedType,0
6,2,0,8,mixedType,1
4,4,0,8,mixedType,1
5,2,0,7,mixedType,0
6,3,0,9,mixedType,1
5,2,0,7,mixedType,0
5,4,0,9,mixedType,1
10,1,0,11,mixedType,1
7,3,0,10,mixedType,1
6,4,0,10,mixedType,1
6,2,0,8,mixedType,1
7,3,0,10,mixedType,1
6,4,0,10,mixedType,1
5,3,0,8,mixedType,1
5,3,0,8,mixedType,1
11,2,0,13,mixedType,1
7,2,0,9,mixedType,1
6,1,0,7,mixedType,0
5,3,0,8,mixedType,1
11,1,0,12,mixedType,1
8,2,0,10,mixedType,1
6,1,0,7,mixedType,0
5,3,0,8,mixedType,1
7,3,0,10,mixedType,1
7,3,0,10,mixedType,1
12,4,0,16,mixedType,2
7,2,0,9,mixedType,1
7,4,0,11,mixedType,1
6,3,0,9,mixedType,1
11,5,0,16,mixedType,2
14,2,0,16,mixedType,2
6,1,0,7,mixedType,0
9,2,0,11,mixedType,1
6,3,0,9,mixedType,1
1,7,0,8,mixedType,1
14,2,0,16,mixedType,2
12,4,0,16,mixedType,2
7,2,0,9,mixedType,1
6,1,0,7,mixedType,0
7,3,0,10,mixedType,1
5,4,0,9,mixedType,1
3,3,0,6,mixedType,0
14,2,0,16,mixedType,2
14,2,0,16,mixedType,2
4,2,0,6,mixedType,0
3,6,0,9,mixedType,1
6,5,0,11,mixedType,1
7,2,0,9,mixedType,1
5,1,0,6,mixedType,0
5,2,0,7,mixedType,0
2,4,0,6,mixedType,0
6,1,0,7,mixedType,0
7,1,0,8,mixedType,1
6,4,0,10,mixedType,1
0,8,2,10,mixedType,1
5,1,0,6,mixedType,0
7,3,0,10,mixedType,1
5,4,0,9,mixedType,1
5,4,0,9,mixedType,1
7,3,0,10,mixedType,1
3,6,0,9,mixedType,1
13,3,0,16,mixedType,2
12,3,0,15,mixedType,2
6,4,0,10,mixedType,1
7,1,0,8,mixedType,1
7,3,0,10,mixedType,1
4,2,0,6,mixedType,0
13,3,0,16,mixedType,2
11,2,0,13,mixedType,1
11,1,0,12,mixedType,1
1,5,0,6,mixedType,0
8,5,0,13,mixedType,1
11,5,0,16,mixedType,2
6,1,0,7,mixedType,0
8,3,0,11,mixedType,1
4,4,0,8,mixedType,1
15,1,0,16,mixedType,2
5,2,0,7,mixedType,0
9,1,0,10,mixedType,1
6,3,0,9,mixedType,1
7,2,0,9,mixedType,1
8,2,0,10,mixedType,1
1,7,0,8,mixedType,1
5,3,0,8,mixedType,1
7,3,0,10,mixedType,1
6,3,0,9,mixedType,1
7,1,0,8,mixedType,1
7,2,0,9,mixedType,1
6,2,0,8,mixedType,1
9,1,0,10,mixedType,1
2,8,0,10,mixedType,1
8,2,0,10,mixedType,1
5,4,0,9,mixedType,1
4,4,0,8,mixedType,1
7,2,0,9,mixedType,1
7,1,0,8,mixedType,1
7,3,0,10,mixedType,1
6,4,0,10,mixedType,1
6,6,0,12,mixedType,1
8,3,0,11,mixedType,1
6,6,0,12,mixedType,1
2,8,0,10,mixedType,1
6,1,0,7,mixedType,0
6,2,0,8,mixedType,1
11,1,0,12,mixedType,1
6,3,0,9,mixedType,1
4,2,0,6,mixedType,0
7,3,0,10,mixedType,1
5,2,0,7,mixedType,0
6,5,0,11,mixedType,1
6,4,0,10,mixedType,1
6,3,0,9,mixedType,1
5,1,0,6,mixedType,0
8,3,0,11,mixedType,1
7,1,0,8,mixedType,1
6,4,0,10,mixedType,1
13,3,0,16,mixedType,2
4,4,0,8,mixedType,1
15,1,0,16,mixedType,2
9,1,0,10,mixedType,1
3,6,0,9,mixedType,1
7,3,0,10,mixedType,1
2,6,0,8,mixedType,1
4,2,0,6,mixedType,0
14,2,0,16,mixedType,2
5,6,0,11,mixedType,1
4,2,0,6,mixedType,0
14,2,0,16,mixedType,2
8,2,0,10,mixedType,1
6,2,0,8,mixedType,1
12,4,0,16,mixedType,2
6,1,0,7,mixedType,0
6,4,0,10,mixedType,1
6,4,0,10,mixedType,1
3,3,0,6,mixedType,0
8,2,0,10,mixedType,1
8,1,0,9,mixedType,1
12,2,1,15,mixedType,2
6,4,0,10,mixedType,1
7,4,0,11,mixedType,1
9,2,0,11,mixedType,1
7,3,0,10,mixedType,1
3,6,0,9,mixedType,1
7,3,0,10,mixedType,1
3,6,0,9,mixedType,1
8,3,0,11,mixedType,1
7,4,0,11,mixedType,1
14,2,0,16,mixedType,2
5,4,0,9,mixedType,1
5,1,0,6,mixedType,0
7,2,0,9,mixedType,1
3,7,0,10,mixedType,1
7,3,0,10,mixedType,1
8,1,0,9,mixedType,1
8,1,0,9,mixedType,1
6,4,0,10,mixedType,1
3,5,0,8,mixedType,1
7,2,0,9,mixedType,1
11,0,1,12,mixedType,1
9,0,1,10,mixedType,1
6,6,0,12,mixedType,1
6,2,0,8,mixedType,1
12,4,0,16,mixedType,2
8,2,0,10,mixedType,1
7,3,0,10,mixedType,1
8,2,0,10,mixedType,1
8,1,0,9,mixedType,1
3,3,0,6,mixedType,0
7,4,0,11,mixedType,1
2,4,0,6,mixedType,0
8,1,0,9,mixedType,1
6,3,0,9,mixedType,1
6,4,0,10,mixedType,1
6,2,0,8,mixedType,1
6,4,0,10,mixedType,1
8,3,0,11,mixedType,1
9,3,0,12,mixedType,1
5,3,0,8,mixedType,1
5,3,0,8,mixedType,1
9,1,0,10,mixedType,1
8,3,0,11,mixedType,1
6,4,0,10,mixedType,1
3,8,0,11,mixedType,1
7,4,0,11,mixedType,1
15,1,0,16,mixedType,2
4,2,0,6,mixedType,0
11,3,0,14,mixedType,2
15,1,0,16,mixedType,2
5,1,0,6,mixedType,0
5,3,0,8,mixedType,1
6,4,0,10,mixedType,1
5,4,0,9,mixedType,1
7,3,0,10,mixedType,1
2,4,0,6,mixedType,0
9,2,0,11,mixedType,1
5,3,0,8,mixedType,1
13,7,0,20,mixedType,2
13,3,0,16,mixedType,2
1,7,0,8,mixedType,1
7,1,0,8,mixedType,1
5,1,0,6,mixedType,0
4,4,0,8,mixedType,1
14,2,0,16,mixedType,2
7,4,0,11,mixedType,1
6,3,0,9,mixedType,1
8,1,0,9,mixedType,1
14,2,0,16,mixedType,2
11,1,0,12,mixedType,1
5,3,0,8,mixedType,1
5,3,0,8,mixedType,1
5,2,0,7,mixedType,0
3,5,0,8,mixedType,1
8,4,0,12,mixedType,1
6,1,0,7,mixedType,0
5,5,0,10,mixedType,1
6,3,0,9,mixedType,1
4,4,0,8,mixedType,1
6,3,0,9,mixedType,1
11,3,0,14,mixedType,2
5,4,0,9,mixedType,1
7,1,0,8,mixedType,1
4,4,0,8,mixedType,1
10,2,0,12,mixedType,1
8,2,0,10,mixedType,1
5,2,0,7,mixedType,0
8,1,0,9,mixedType,1
9,1,0,10,mixedType,1
6,5,0,11,mixedType,1
7,3,0,10,mixedType,1
4,2,0,6,mixedType,0
12,2,1,15,mixedType,2
6,3,0,9,mixedType,1
8,2,0,10,mixedType,1
5,2,0,7,mixedType,0
4,2,0,6,mixedType,0
15,1,0,16,mixedType,2
1,7,0,8,mixedType,1
3,3,0,6,mixedType,0
7,3,0,10,mixedType,1
12,4,0,16,mixedType,2
7,3,0,10,mixedType,1
5,3,0,8,mixedType,1
2,6,0,8,mixedType,1
9,2,0,11,mixedType,1
5,4,0,9,mixedType,1
6,2,0,8,mixedType,1
8,1,0,9,mixedType,1
5,2,0,7,mixedType,0
1,11,0,12,mixedType,1
8,3,0,11,mixedType,1
5,1,0,6,mixedType,0
14,2,0,16,mixedType,2
9,1,0,10,mixedType,1
9,1,0,10,mixedType,1
11,4,1,16,mixedType,2
2,7,0,9,mixedType,1
7,1,0,8,mixedType,1
13,3,0,16,mixedType,2
5,2,0,7,mixedType,0
7,3,0,10,mixedType,1
3,6,0,9,mixedType,1
7,2,0,9,mixedType,1
4,2,0,6,mixedType,0
3,7,0,10,mixedType,1
9,3,0,12,mixedType,1
6,3,0,9,mixedType,1
4,4,0,8,mixedType,1
6,3,0,9,mixedType,1
4,6,0,10,mixedType,1
6,2,0,8,mixedType,1
6,2,0,8,mixedType,1
7,3,0,10,mixedType,1
5,2,0,7,mixedType,0
4,2,0,6,mixedType,0
8,2,0,10,mixedType,1
1,7,0,8,mixedType,1
8,2,0,10,mixedType,1
6,3,0,9,mixedType,1
6,3,0,9,mixedType,1
13,3,0,16,mixedType,2
5,2,0,7,mixedType,0
4,2,0,6,mixedType,0
2,7,0,9,mixedType,1
2,6,0,8,mixedType,1
7,2,0,9,mixedType,1
8,2,0,10,mixedType,1
8,1,0,9,mixedType,1
6,1,0,7,mixedType,0
14,2,0,16,mixedType,2
6,1,0,7,mixedType,0
13,3,0,16,mixedType,2
6,4,0,10,mixedType,1
7,2,0,9,mixedType,1
4,4,0,8,mixedType,1
7,3,0,10,mixedType,1
2,4,0,6,mixedType,0
6,4,0,10,mixedType,1
7,3,0,10,mixedType,1
4,5,0,9,mixedType,1
8,1,0,9,mixedType,1
8,1,0,9,mixedType,1
5,3,0,8,mixedType,1
2,9,0,11,mixedType,1
7,2,0,9,mixedType,1
13,3,0,16,mixedType,2
7,2,0,9,mixedType,1
1,9,0,10,mixedType,1
13,3,0,16,mixedType,2
8,1,0,9,mixedType,1
7,3,0,10,mixedType,1
5,4,0,9,mixedType,1
8,5,0,13,mixedType,1
7,1,0,8,mixedType,1
9,1,0,10,mixedType,1
8,1,0,9,mixedType,1
6,3,0,9,mixedType,1
7,5,0,12,mixedType,1
4,6,0,10,mixedType,1
6,4,0,10,mixedType,1
2,6,0,8,mixedType,1
8,3,0,11,mixedType,1
6,3,0,9,mixedType,1
9,1,0,10,mixedType,1
7,2,0,9,mixedType,1
6,4,0,10,mixedType,1
6,3,0,9,mixedType,1
6,3,0,9,mixedType,1
13,3,0,16,mixedType,2
3,5,0,8,mixedType,1
8,1,0,9,mixedType,1
6,2,0,8,mixedType,1
8,2,0,10,mixedType,1
6,4,0,10,mixedType,1
6,2,0,8,mixedType,1
7,4,0,11,mixedType,1
8,3,0,11,mixedType,1
8,1,0,9,mixedType,1
6,2,0,8,mixedType,1
15,1,0,16,mixedType,2
5,4,0,9,mixedType,1
8,2,0,10,mixedType,1
4,4,0,8,mixedType,1
12,3,0,15,mixedType,2
6,2,0,8,mixedType,1
11,3,0,14,mixedType,2
7,3,0,10,mixedType,1
4,5,0,9,mixedType,1
5,2,0,7,mixedType,0
7,1,0,8,mixedType,1
7,3,0,10,mixedType,1
4,8,0,12,mixedType,1
11,3,0,14,mixedType,2
9,2,0,11,mixedType,1
6,4,0,10,mixedType,1
6,4,0,10,mixedType,1
6,4,0,10,mixedType,1
12,4,0,16,mixedType,2
8,2,0,10,mixedType,1
10,2,0,12,mixedType,1
8,1,0,9,mixedType,1
7,2,0,9,mixedType,1
1,8,0,9,mixedType,1
6,3,0,9,mixedType,1
9,1,0,10,mixedType,1
12,4,0,16,mixedType,2
6,2,0,8,mixedType,1
5,2,0,7,mixedType,0
12,4,0,16,mixedType,2
8,2,0,10,mixedType,1
6,3,0,9,mixedType,1
5,1,0,6,mixedType,0
6,4,0,10,mixedType,1
10,2,0,12,mixedType,1
7,3,0,10,mixedType,1
6,2,0,8,mixedType,1
4,8,0,12,mixedType,1
4,4,0,8,mixedType,1
11,8,0,19,mixedType,2
5,1,0,6,mixedType,0
4,6,0,10,mixedType,1
8,1,0,9,mixedType,1
6,3,0,9,mixedType,1
5,4,0,9,mixedType,1
8,1,0,9,mixedType,1
7,3,0,10,mixedType,1
2,7,0,9,mixedType,1
13,3,0,16,mixedType,2
6,2,0,8,mixedType,1
7,3,0,10,mixedType,1
8,2,0,10,mixedType,1
13,3,0,16,mixedType,2
2,9,0,11,mixedType,1
8,1,0,9,mixedType,1
5,3,0,8,mixedType,1
5,3,0,8,mixedType,1
6,3,0,9,mixedType,1
4,6,0,10,mixedType,1
5,1,0,6,mixedType,0
7,1,0,8,mixedType,1
8,3,0,11,mixedType,1
6,3,0,9,mixedType,1
7,2,0,9,mixedType,1
6,3,0,9,mixedType,1
9,2,0,11,mixedType,1
9,4,0,13,mixedType,1
7,3,0,10,mixedType,1
13,3,0,16,mixedType,2
12,3,0,15,mixedType,2
14,2,1,17,mixedType,2
6,2,0,8,mixedType,1
7,3,0,10,mixedType,1
5,4,0,9,mixedType,1
13,3,0,16,mixedType,2
10,2,0,12,mixedType,1
5,3,0,8,mixedType,1
5,2,0,7,mixedType,0
13,3,0,16,mixedType,2
5,4,0,9,mixedType,1
7,3,0,10,mixedType,1
11,3,0,14,mixedType,2
5,2,0,7,mixedType,0
7,2,0,9,mixedType,1
7,2,0,9,mixedType,1
6,2,0,8,mixedType,1
5,2,0,7,mixedType,0
7,1,0,8,mixedType,1
10,2,0,12,mixedType,1
6,1,0,7,mixedType,0
13,3,0,16,mixedType,2
6,1,0,7,mixedType,0
8,1,0,9,mixedType,1
14,2,0,16,mixedType,2
6,2,0,8,mixedType,1
4,4,0,8,mixedType,1
7,2,0,9,mixedType,1
14,2,0,16,mixedType,2
2,4,0,6,mixedType,0
9,4,0,13,mixedType,1
6,4,0,10,mixedType,1
6,4,0,10,mixedType,1
1,7,0,8,mixedType,1
9,3,0,12,mixedType,1
5,1,0,6,mixedType,0
10,1,0,11,mixedType,1
7,2,0,9,mixedType,1
8,1,0,9,mixedType,1
9,1,0,10,mixedType,1
15,1,0,16,mixedType,2
8,2,0,10,mixedType,1
4,4,0,8,mixedType,1
1,7,0,8,mixedType,1
8,2,0,10,mixedType,1
5,4,0,9,mixedType,1
6,3,0,9,mixedType,1
8,1,0,9,mixedType,1
2,4,0,6,mixedType,0
6,1,0,7,mixedType,0
6,3,0,9,mixedType,1
7,2,0,9,mixedType,1
9,2,0,11,mixedType,1
9,2,0,11,mixedType,1
8,2,0,10,mixedType,1
7,2,0,9,mixedType,1
8,5,0,13,mixedType,1
8,2,0,10,mixedType,1
10,3,0,13,mixedType,1
5,4,0,9,mixedType,1
4,6,0,10,mixedType,1
4,4,0,8,mixedType,1
7,4,0,11,mixedType,1
5,4,0,9,mixedType,1
4,6,0,10,mixedType,1
3,6,0,9,mixedType,1
6,3,0,9,mixedType,1
6,3,0,9,mixedType,1
6,1,0,7,mixedType,0
3,6,0,9,mixedType,1
4,2,0,6,mixedType,0
4,4,0,8,mixedType,1
9,3,0,12,mixedType,1
6,6,0,12,mixedType,1
5,6,0,11,mixedType,1
6,2,0,8,mixedType,1
3,5,0,8,mixedType,1
5,2,0,7,mixedType,0
5,6,0,11,mixedType,1
14,2,0,16,mixedType,2
8,2,0,10,mixedType,1
7,3,0,10,mixedType,1
6,4,0,10,mixedType,1
5,1,0,6,mixedType,0
15,1,0,16,mixedType,2
9,4,0,13,mixedType,1
6,3,0,9,mixedType,1
6,3,0,9,mixedType,1
7,3,0,10,mixedType,1
3,10,0,13,mixedType,1
5,4,0,9,mixedType,1
9,1,0,10,mixedType,1
6,2,0,8,mixedType,1
8,2,0,10,mixedType,1
7,3,0,10,mixedType,1
6,1,0,7,mixedType,0
5,3,0,8,mixedType,1
5,1,0,6,mixedType,0
5,4,0,9,mixedType,1
9,1,0,10,mixedType,1
14,2,0,16,mixedType,2
4,4,0,8,mixedType,1
2,9,0,11,mixedType,1
4,4,0,8,mixedType,1
7,1,0,8,mixedType,1
1,7,0,8,mixedType,1
6,1,0,7,mixedType,0
8,1,0,9,mixedType,1
7,3,0,10,mixedType,1
7,1,0,8,mixedType,1
9,3,0,12,mixedType,1
7,1,0,8,mixedType,1
7,3,0,10,mixedType,1
8,4,0,12,mixedType,1
5,1,0,6,mixedType,0
12,4,0,16,mixedType,2
4,4,0,8,mixedType,1
9,1,0,10,mixedType,1
5,2,0,7,mixedType,0
5,2,0,7,mixedType,0
11,3,0,14,mixedType,2
3,6,0,9,mixedType,1
7,3,0,10,mixedType,1
5,3,0,8,mixedType,1
3,5,0,8,mixedType,1
1,5,0,6,mixedType,0
1,7,0,8,mixedType,1
4,6,0,10,mixedType,1
6,3,0,9,mixedType,1
5,2,0,7,mixedType,0
15,1,0,16,mixedType,2
6,2,0,8,mixedType,1
6,1,0,7,mixedType,0
7,3,0,10,mixedType,1
6,4,0,10,mixedType,1
12,3,0,15,mixedType,2
8,2,0,10,mixedType,1
8,4,0,12,mixedType,1
10,3,0,13,mixedType,1
6,6,0,12,mixedType,1
9,1,0,10,mixedType,1
5,8,0,13,mixedType,1
9,4,0,13,mixedType,1
7,7,0,14,mixedType,2
13,3,0,16,mixedType,2
5,4,0,9,mixedType,1
9,3,0,12,mixedType,1
6,3,0,9,mixedType,1
5,3,0,8,mixedType,1
7,3,0,10,mixedType,1
2,6,0,8,mixedType,1
5,4,0,9,mixedType,1
8,2,0,10,mixedType,1
5,1,0,6,mixedType,0
4,4,0,8,mixedType,1
14,2,0,16,mixedType,2
9,3,0,12,mixedType,1
5,3,0,8,mixedType,1
7,2,0,9,mixedType,1
5,4,0,9,mixedType,1
9,4,1,14,mixedType,2
6,2,0,8,mixedType,1
6,2,0,8,mixedType,1
4,4,0,8,mixedType,1
13,3,0,16,mixedType,2
6,3,0,9,mixedType,1
2,8,0,10,mixedType,1
6,6,0,12,mixedType,1
8,1,0,9,mixedType,1
7,1,0,8,mixedType,1
10,2,0,12,mixedType,1
10,3,0,13,mixedType,1
2,9,0,11,mixedType,1
2,4,0,6,mixedType,0
5,3,0,8,mixedType,1
9,4,0,13,mixedType,1
7,1,0,8,mixedType,1
9,4,0,13,mixedType,1
5,3,0,8,mixedType,1
5,3,0,8,mixedType,1
12,4,0,16,mixedType,2
4,6,0,10,mixedType,1
12,4,0,16,mixedType,2
6,4,0,10,mixedType,1
6,3,0,9,mixedType,1
6,2,0,8,mixedType,1
3,6,0,9,mixedType,1
9,4,0,13,mixedType,1
4,4,0,8,mixedType,1
6,2,0,8,mixedType,1
5,3,0,8,mixedType,1
9,2,0,11,mixedType,1
4,2,0,6,mixedType,0
8,1,0,9,mixedType,1
5,4,0,9,mixedType,1
9,4,0,13,mixedType,1
6,4,0,10,mixedType,1
7,2,0,9,mixedType,1
6,3,0,9,mixedType,1
6,2,0,8,mixedType,1
3,7,0,10,mixedType,1
6,4,0,10,mixedType,1
4,6,0,10,mixedType,1
5,1,0,6,mixedType,0
6,2,0,8,mixedType,1
7,3,0,10,mixedType,1
7,3,0,10,mixedType,1
14,2,0,16,mixedType,2
15,1,0,16,mixedType,2
5,4,0,9,mixedType,1
2,8,0,10,mixedType,1
10,2,0,12,mixedType,1
11,1,0,12,mixedType,1
7,3,0,10,mixedType,1
6,2,0,8,mixedType,1
6,5,0,11,mixedType,1
3,3,0,6,mixedType,0
8,3,0,11,mixedType,1
11,1,0,12,mixedType,1
9,1,0,10,mixedType,1
11,3,0,14,mixedType,2
12,3,0,15,mixedType,2
7,2,0,9,mixedType,1
6,4,0,10,mixedType,1
10,2,0,12,mixedType,1
7,3,0,10,mixedType,1
2,6,0,8,mixedType,1
6,2,0,8,mixedType,1
7,3,0,10,mixedType,1
10,1,0,11,mixedType,1
8,2,0,10,mixedType,1
10,2,0,12,mixedType,1
6,3,0,9,mixedType,1
6,6,0,12,mixedType,1
8,1,0,9,mixedType,1
10,3,0,13,mixedType,1
5,4,0,9,mixedType,1
12,3,0,15,mixedType,2
5,3,0,8,mixedType,1
4,4,0,8,mixedType,1
8,2,0,10,mixedType,1
2,8,0,10,mixedType,1
8,4,0,12,mixedType,1
12,4,0,16,mixedType,2
5,3,0,8,mixedType,1
7,2,0,9,mixedType,1
7,3,0,10,mixedType,1
3,5,0,8,mixedType,1
9,4,0,13,mixedType,1
4,4,0,8,mixedType,1
11,3,0,14,mixedType,2
3,7,0,10,mixedType,1
6,3,0,9,mixedType,1
7,3,0,10,mixedType,1
5,3,0,8,mixedType,1
8,1,0,9,mixedType,1
7,2,0,9,mixedType,1
9,1,0,10,mixedType,1
14,2,0,16,mixedType,2
4,6,0,10,mixedType,1
4,2,0,6,mixedType,0
7,2,0,9,mixedType,1
7,3,0,10,mixedType,1
6,3,0,9,mixedType,1
6,3,0,9,mixedType,1
7,4,0,11,mixedType,1
5,4,0,9,mixedType,1
6,4,0,10,mixedType,1
8,3,0,11,mixedType,1
9,1,0,10,mixedType,1
1,8,0,9,mixedType,1
5,6,0,11,mixedType,1
7,3,0,10,mixedType,1
4,2,0,6,mixedType,0
5,6,0,11,mixedType,1
2,7,0,9,mixedType,1
7,3,0,10,mixedType,1
7,1,0,8,mixedType,1
5,1,0,6,mixedType,0
7,2,0,9,mixedType,1
8,1,0,9,mixedType,1
5,5,0,10,mixedType,1
8,5,0,13,mixedType,1
1,5,0,6,mixedType,0
6,3,0,9,mixedType,1
6,3,0,9,mixedType,1
5,4,0,9,mixedType,1
12,3,0,15,mixedType,2
14,2,0,16,mixedType,2
6,3,0,9,mixedType,1
5,2,0,7,mixedType,0
5,6,0,11,mixedType,1
7,1,0,8,mixedType,1
6,1,0,7,mixedType,0
4,2,0,6,mixedType,0
13,3,0,16,mixedType,2
6,3,0,9,mixedType,1
6,2,0,8,mixedType,1
8,1,0,9,mixedType,1
7,1,0,8,mixedType,1
6,3,0,9,mixedType,1
7,3,0,10,mixedType,1
7,3,0,10,mixedType,1
5,3,0,8,mixedType,1
9,1,0,10,mixedType,1
6,3,0,9,mixedType,1
1,8,0,9,mixedType,1
7,2,0,9,mixedType,1
5,1,0,6,mixedType,0
6,3,0,9,mixedType,1
6,4,0,10,mixedType,1
10,6,0,16,mixedType,2
5,3,0,8,mixedType,1
10,4,0,14,mixedType,2
7,1,0,8,mixedType,1
4,2,0,6,mixedType,0
14,2,0,16,mixedType,2
4,8,0,12,mixedType,1
9,2,0,11,mixedType,1
6,2,0,8,mixedType,1
7,3,0,10,mixedType,1
7,4,0,11,mixedType,1
8,2,0,10,mixedType,1
6,2,0,8,mixedType,1
5,4,0,9,mixedType,1
8,2,0,10,mixedType,1
6,3,0,9,mixedType,1
8,2,0,10,mixedType,1
5,3,0,8,mixedType,1
2,8,0,10,mixedType,1
5,3,0,8,mixedType,1
2,8,0,10,mixedType,1
7,3,0,10,mixedType,1
7,3,0,10,mixedType,1
8,2,0,10,mixedType,1
2,8,0,10,mixedType,1
6,3,0,9,mixedType,1
12,2,3,17,mixedType,2
6,1,0,7,mixedType,0
13,3,0,16,mixedType,2
9,1,0,10,mixedType,1
7,1,0,8,mixedType,1
6,4,0,10,mixedType,1
7,3,0,10,mixedType,1
6,3,0,9,mixedType,1
8,2,0,10,mixedType,1
16,1,1,18,mixedType,2
6,1,0,7,mixedType,0
6,4,0,10,mixedType,1
6,1,0,7,mixedType,0
8,1,0,9,mixedType,1
4,2,0,6,mixedType,0
6,4,0,10,mixedType,1
8,1,0,9,mixedType,1
1,7,0,8,mixedType,1
7,2,0,9,mixedType,1
5,4,0,9,mixedType,1
12,4,0,16,mixedType,2
6,2,0,8,mixedType,1
2,6,0,8,mixedType,1
6,3,0,9,mixedType,1
1,10,0,11,mixedType,1
8,1,0,9,mixedType,1
6,4,0,10,mixedType,1
6,2,0,8,mixedType,1
8,2,0,10,mixedType,1
6,3,0,9,mixedType,1
7,1,0,8,mixedType,1
4,6,0,10,mixedType,1
11,5,0,16,mixedType,2
6,6,0,12,mixedType,1
15,1,0,16,mixedType,2
4,6,0,10,mixedType,1
6,3,0,9,mixedType,1
7,2,0,9,mixedType,1
9,1,0,10,mixedType,1
14,2,0,16,mixedType,2
6,1,0,7,mixedType,0
6,2,0,8,mixedType,1
8,1,0,9,mixedType,1
5,2,0,7,mixedType,0
8,3,0,11,mixedType,1
3,7,0,10,mixedType,1
7,3,0,10,mixedType,1
9,1,0,10,mixedType,1
5,3,0,8,mixedType,1
9,1,0,10,mixedType,1
1,5,0,6,mixedType,0
7,1,0,8,mixedType,1
6,1,0,7,mixedType,0
6,6,0,12,mixedType,1
8,4,0,12,mixedType,1
7,2,0,9,mixedType,1
6,2,0,8,mixedType,1
7,3,0,10,mixedType,1
9,1,0,10,mixedType,1
6,2,0,8,mixedType,1
6,1,0,7,mixedType,0
5,3,0,8,mixedType,1
5,3,0,8,mixedType,1
6,2,0,8,mixedType,1
4,2,0,6,mixedType,0
15,1,0,16,mixedType,2
7,2,0,9,mixedType,1
6,2,0,8,mixedType,1
8,1,0,9,mixedType,1
7,1,0,8,mixedType,1
9,1,0,10,mixedType,1
5,4,0,9,mixedType,1
5,2,0,7,mixedType,0
2,8,0,10,mixedType,1
4,6,0,10,mixedType,1
7,1,0,8,mixedType,1
7,2,0,9,mixedType,1
5,2,0,7,mixedType,0
7,3,0,10,mixedType,1
8,1,0,9,mixedType,1
8,2,0,10,mixedType,1
5,2,0,7,mixedType,0
6,1,0,7,mixedType,0
6,4,0,10,mixedType,1
8,1,0,9,mixedType,1
15,8,0,23,mixedType,2
5,2,0,7,mixedType,0
7,3,0,10,mixedType,1
10,3,0,13,mixedType,1
3,10,0,13,mixedType,1
6,3,0,9,mixedType,1
3,3,0,6,mixedType,0
7,2,0,9,mixedType,1
11,5,0,16,mixedType,2
6,6,0,12,mixedType,1
8,2,0,10,mixedType,1
6,1,0,7,mixedType,0
7,1,0,8,mixedType,1
7,5,0,12,mixedType,1
7,2,0,9,mixedType,1
7,1,0,8,mixedType,1
6,1,0,7,mixedType,0
5,6,0,11,mixedType,1
3,6,0,9,mixedType,1
6,1,0,7,mixedType,0
8,1,0,9,mixedType,1
9,1,0,10,mixedType,1
8,2,0,10,mixedType,1
7,3,0,10,mixedType,1
4,2,0,6,mixedType,0
7,3,0,10,mixedType,1
12,3,0,15,mixedType,2
0,5,1,6,mixedType,0
7,2,0,9,mixedType,1
6,1,0,7,mixedType,0
7,3,0,10,mixedType,1
6,1,0,7,mixedType,0
6,2,0,8,mixedType,1
3,5,0,8,mixedType,1
11,3,0,14,mixedType,2
9,2,0,11,mixedType,1
11,3,0,14,mixedType,2
5,3,0,8,mixedType,1
4,4,0,8,mixedType,1
5,4,0,9,mixedType,1
5,1,0,6,mixedType,0
2,6,0,8,mixedType,1
6,1,0,7,mixedType,0
6,6,0,12,mixedType,1
5,3,0,8,mixedType,1
7,3,0,10,mixedType,1
7,1,0,8,mixedType,1
7,3,0,10,mixedType,1
7,3,0,10,mixedType,1
8,2,0,10,mixedType,1
7,3,0,10,mixedType,1
6,3,0,9,mixedType,1
7,2,0,9,mixedType,1
5,6,0,11,mixedType,1
1,9,0,10,mixedType,1
5,4,0,9,mixedType,1
7,3,0,10,mixedType,1
8,2,0,10,mixedType,1
10,1,0,11,mixedType,1
6,2,0,8,mixedType,1
4,4,0,8,mixedType,1
3,5,0,8,mixedType,1
6,3,0,9,mixedType,1
10,2,0,12,mixedType,1
6,2,0,8,mixedType,1
2,8,0,10,mixedType,1
5,2,0,7,mixedType,0
7,2,0,9,mixedType,1
6,4,0,10,mixedType,1
6,3,0,9,mixedType,1
7,1,0,8,mixedType,1
4,2,0,6,mixedType,0
2,6,1,9,mixedType,1
7,3,0,10,mixedType,1
4,4,0,8,mixedType,1
7,3,0,10,mixedType,1
5,2,0,7,mixedType,0
7,4,0,11,mixedType,1
8,2,0,10,mixedType,1
6,3,0,9,mixedType,1
5,4,0,9,mixedType,1
6,3,0,9,mixedType,1
6,2,0,8,mixedType,1
6,1,0,7,mixedType,0
6,6,0,12,mixedType,1
6,4,0,10,mixedType,1
6,3,0,9,mixedType,1
4,4,0,8,mixedType,1
7,4,0,11,mixedType,1
7,2,0,9,mixedType,1
4,4,0,8,mixedType,1
8,2,0,10,mixedType,1
11,1,0,12,mixedType,1
1,7,0,8,mixedType,1
5,4,0,9,mixedType,1
8,3,0,11,mixedType,1
7,3,0,10,mixedType,1
13,3,0,16,mixedType,2
7,3,0,10,mixedType,1
6,1,0,7,mixedType,0
8,3,0,11,mixedType,1
13,3,0,16,mixedType,2
5,2,0,7,mixedType,0
7,2,0,9,mixedType,1
10,3,0,13,mixedType,1
6,1,0,7,mixedType,0
6,2,0,8,mixedType,1
5,1,0,6,mixedType,0
0,4,0,4,sameType,0
15,1,0,16,mixedType,2
2,8,0,10,mixedType,1
8,2,0,10,mixedType,1
9,3,0,12,mixedType,1
6,2,0,8,mixedType,1
8,2,0,10,mixedType,1
8,1,0,9,mixedType,1
7,2,0,9,mixedType,1
15,1,0,16,mixedType,2
8,2,0,10,mixedType,1
7,4,0,11,mixedType,1
9,1,0,10,mixedType,1
8,2,0,10,mixedType,1
10,3,0,13,mixedType,1
9,2,0,11,mixedType,1
7,3,0,10,mixedType,1
4,4,0,8,mixedType,1
6,1,0,7,mixedType,0
7,5,0,12,mixedType,1
2,9,0,11,mixedType,1
12,4,0,16,mixedType,2
7,3,0,10,mixedType,1
5,3,0,8,mixedType,1
6,3,0,9,mixedType,1
4,2,0,6,mixedType,0
5,6,0,11,mixedType,1
5,3,0,8,mixedType,1
6,2,0,8,mixedType,1
5,0,0,5,sameType,0
8,2,0,10,mixedType,1
13,3,0,16,mixedType,2
13,3,0,16,mixedType,2
9,2,0,11,mixedType,1
4,9,0,13,mixedType,1
6,4,0,10,mixedType,1
6,3,0,9,mixedType,1
8,3,0,11,mixedType,1
15,1,0,16,mixedType,2
5,4,0,9,mixedType,1
5,3,0,8,mixedType,1
4,6,0,10,mixedType,1
6,2,0,8,mixedType,1
0,5,0,5,sameType,0
5,3,0,8,mixedType,1
5,2,0,7,mixedType,0
3,6,0,9,mixedType,1
6,3,0,9,mixedType,1
5,2,0,7,mixedType,0
3,5,0,8,mixedType,1
12,3,0,15,mixedType,2
11,3,0,14,mixedType,2
7,2,0,9,mixedType,1
9,1,0,10,mixedType,1
5,4,0,9,mixedType,1
4,6,0,10,mixedType,1
5,3,0,8,mixedType,1
11,3,0,14,mixedType,2
14,2,0,16,mixedType,2
6,1,0,7,mixedType,0
5,10,0,15,mixedType,2
5,3,0,8,mixedType,1
6,4,0,10,mixedType,1
13,2,1,16,mixedType,2
6,2,0,8,mixedType,1
6,3,0,9,mixedType,1
5,4,0,9,mixedType,1
14,2,0,16,mixedType,2
6,2,0,8,mixedType,1
6,2,0,8,mixedType,1
6,3,0,9,mixedType,1
5,1,0,6,mixedType,0
5,1,0,6,mixedType,0
7,2,0,9,mixedType,1
4,4,0,8,mixedType,1
5,2,0,7,mixedType,0
3,6,0,9,mixedType,1
3,3,0,6,mixedType,0
7,2,0,9,mixedType,1
7,3,0,10,mixedType,1
6,4,0,10,mixedType,1
6,1,0,7,mixedType,0
5,3,0,8,mixedType,1
6,1,0,7,mixedType,0
7,6,0,13,mixedType,1
9,1,0,10,mixedType,1
9,3,0,12,mixedType,1
7,4,0,11,mixedType,1
4,2,0,6,mixedType,0
5,3,0,8,mixedType,1
5,1,0,6,mixedType,0
8,3,0,11,mixedType,1
6,4,0,10,mixedType,1
6,3,0,9,mixedType,1
2,5,0,7,mixedType,0
6,3,0,9,mixedType,1
15,1,0,16,mixedType,2
6,4,0,10,mixedType,1
5,2,0,7,mixedType,0
5,3,0,8,mixedType,1
7,3,0,10,mixedType,1
7,2,0,9,mixedType,1
8,2,0,10,mixedType,1
6,4,0,10,mixedType,1
1,7,0,8,mixedType,1
7,2,0,9,mixedType,1
5,1,0,6,mixedType,0
7,2,0,9,mixedType,1
4,2,0,6,mixedType,0
8,6,0,14,mixedType,2
8,2,0,10,mixedType,1
14,2,0,16,mixedType,2
7,3,0,10,mixedType,1
6,1,0,7,mixedType,0
7,3,0,10,mixedType,1
8,4,0,12,mixedType,1
5,3,0,8,mixedType,1
5,4,0,9,mixedType,1
11,5,0,16,mixedType,2
5,3,0,8,mixedType,1
8,4,0,12,mixedType,1
11,5,0,16,mixedType,2
14,2,0,16,mixedType,2
2,6,0,8,mixedType,1
11,3,0,14,mixedType,2
6,1,0,7,mixedType,0
8,2,0,10,mixedType,1
7,3,0,10,mixedType,1
4,5,0,9,mixedType,1
6,3,0,9,mixedType,1
6,3,0,9,mixedType,1
8,2,0,10,mixedType,1
5,2,0,7,mixedType,0
3,6,0,9,mixedType,1
8,3,0,11,mixedType,1
14,2,0,16,mixedType,2
5,4,0,9,mixedType,1
4,4,0,8,mixedType,1
12,3,0,15,mixedType,2
6,3,0,9,mixedType,1
2,8,0,10,mixedType,1
15,1,0,16,mixedType,2
2,6,0,8,mixedType,1
6,4,0,10,mixedType,1
5,3,0,8,mixedType,1
10,4,1,15,mixedType,2
6,4,0,10,mixedType,1
7,3,0,10,mixedType,1
5,3,0,8,mixedType,1
5,2,0,7,mixedType,0
6,3,0,9,mixedType,1
5,3,0,8,mixedType,1
9,1,0,10,mixedType,1
6,3,0,9,mixedType,1
6,4,0,10,mixedType,1
3,3,0,6,mixedType,0
7,6,2,15,mixedType,2
9,1,0,10,mixedType,1
6,1,0,7,mixedType,0
7,3,0,10,mixedType,1
7,2,0,9,mixedType,1
5,3,0,8,mixedType,1
7,2,0,9,mixedType,1
2,4,0,6,mixedType,0
7,1,0,8,mixedType,1
5,4,0,9,mixedType,1
6,6,0,12,mixedType,1
3,5,0,8,mixedType,1
6,3,0,9,mixedType,1
3,6,0,9,mixedType,1
10,4,0,14,mixedType,2
6,2,0,8,mixedType,1
5,4,0,9,mixedType,1
5,4,0,9,mixedType,1
8,2,0,10,mixedType,1
6,3,0,9,mixedType,1
7,2,0,9,mixedType,1
13,3,0,16,mixedType,2
5,5,0,10,mixedType,1
6,6,0,12,mixedType,1
1,8,0,9,mixedType,1
7,4,0,11,mixedType,1
5,3,0,8,mixedType,1
5,2,0,7,mixedType,0
2,6,0,8,mixedType,1
5,2,0,7,mixedType,0
4,2,0,6,mixedType,0
6,3,0,9,mixedType,1
5,2,0,7,mixedType,0
4,2,0,6,mixedType,0
8,1,0,9,mixedType,1
6,2,0,8,mixedType,1
5,6,0,11,mixedType,1
7,3,0,10,mixedType,1
5,4,0,9,mixedType,1
8,1,0,9,mixedType,1
5,4,0,9,mixedType,1
6,4,0,10,mixedType,1
6,3,0,9,mixedType,1
8,2,0,10,mixedType,1
6,2,0,8,mixedType,1
6,3,0,9,mixedType,1
4,6,0,10,mixedType,1
8,1,0,9,mixedType,1
5,3,0,8,mixedType,1
6,4,0,10,mixedType,1
6,2,0,8,mixedType,1
6,7,0,13,mixedType,1
2,6,0,8,mixedType,1
6,1,0,7,mixedType,0
3,6,0,9,mixedType,1
9,3,0,12,mixedType,1
12,1,0,13,mixedType,1
11,3,0,14,mixedType,2
8,3,0,11,mixedType,1
4,4,0,8,mixedType,1
7,2,0,9,mixedType,1
4,4,0,8,mixedType,1
7,3,0,10,mixedType,1
6,2,0,8,mixedType,1
13,1,1,15,mixedType,2
7,2,0,9,mixedType,1
6,4,0,10,mixedType,1
5,4,0,9,mixedType,1
6,6,0,12,mixedType,1
7,1,0,8,mixedType,1
6,2,0,8,mixedType,1
5,3,0,8,mixedType,1
8,2,0,10,mixedType,1
6,5,0,11,mixedType,1
5,3,0,8,mixedType,1
13,3,0,16,mixedType,2
5,3,0,8,mixedType,1
9,2,0,11,mixedType,1
3,6,0,9,mixedType,1
1,7,0,8,mixedType,1
9,1,0,10,mixedType,1
4,4,0,8,mixedType,1
5,3,0,8,mixedType,1
5,5,0,10,mixedType,1
3,3,0,6,mixedType,0
10,0,1,11,mixedType,1
5,1,0,6,mixedType,0
5,3,0,8,mixedType,1
8,2,0,10,mixedType,1
8,2,0,10,mixedType,1
6,2,0,8,mixedType,1
5,3,0,8,mixedType,1
6,1,0,7,mixedType,0
6,2,0,8,mixedType,1
8,4,0,12,mixedType,1
6,4,0,10,mixedType,1
8,3,0,11,mixedType,1
1,8,0,9,mixedType,1
8,2,0,10,mixedType,1
5,2,0,7,mixedType,0
4,2,0,6,mixedType,0
9,4,0,13,mixedType,1
9,3,0,12,mixedType,1
4,2,0,6,mixedType,0
3,8,0,11,mixedType,1
6,1,0,7,mixedType,0
4,4,0,8,mixedType,1
3,9,0,12,mixedType,1
6,3,0,9,mixedType,1
9,1,0,10,mixedType,1
8,1,0,9,mixedType,1
8,1,0,9,mixedType,1
6,3,0,9,mixedType,1
7,1,0,8,mixedType,1
7,1,0,8,mixedType,1
2,8,0,10,mixedType,1
4,4,0,8,mixedType,1
7,2,0,9,mixedType,1
6,3,0,9,mixedType,1
5,3,0,8,mixedType,1
8,4,0,12,mixedType,1
8,1,0,9,mixedType,1
7,2,0,9,mixedType,1
4,6,0,10,mixedType,1
4,2,0,6,mixedType,0
4,4,0,8,mixedType,1
6,3,0,9,mixedType,1
5,5,0,10,mixedType,1
8,1,0,9,mixedType,1
12,3,0,15,mixedType,2
9,2,0,11,mixedType,1
7,1,0,8,mixedType,1
12,4,0,16,mixedType,2
8,1,0,9,mixedType,1
13,3,0,16,mixedType,2
13,3,0,16,mixedType,2
7,1,0,8,mixedType,1
9,1,0,10,mixedType,1
3,5,0,8,mixedType,1
3,5,0,8,mixedType,1
6,2,0,8,mixedType,1
3,6,0,9,mixedType,1
6,3,0,9,mixedType,1
7,2,0,9,mixedType,1
8,2,0,10,mixedType,1
2,6,0,8,mixedType,1
12,4,0,16,mixedType,2
8,1,0,9,mixedType,1
6,4,0,10,mixedType,1
5,3,0,8,mixedType,1
4,2,0,6,mixedType,0
2,8,0,10,mixedType,1
5,2,0,7,mixedType,0
8,4,0,12,mixedType,1
11,3,0,14,mixedType,2
6,3,0,9,mixedType,1
5,4,0,9,mixedType,1
6,1,0,7,mixedType,0
11,2,0,13,mixedType,1
10,3,1,14,mixedType,2
4,2,0,6,mixedType,0
11,1,0,12,mixedType,1
4,4,0,8,mixedType,1
8,4,0,12,mixedType,1
3,6,0,9,mixedType,1
9,2,0,11,mixedType,1
5,2,0,7,mixedType,0
5,4,0,9,mixedType,1
7,2,0,9,mixedType,1
2,8,0,10,mixedType,1
4,4,0,8,mixedType,1
6,3,0,9,mixedType,1
6,3,0,9,mixedType,1
6,4,0,10,mixedType,1
15,1,0,16,mixedType,2
9,1,0,10,mixedType,1
9,2,0,11,mixedType,1
14,2,0,16,mixedType,2
7,3,0,10,mixedType,1
5,4,0,9,mixedType,1
6,2,0,8,mixedType,1
6,3,0,9,mixedType,1
2,4,0,6,mixedType,0
8,2,0,10,mixedType,1
4,2,0,6,mixedType,0
7,3,0,10,mixedType,1
6,0,1,7,mixedType,0
7,2,0,9,mixedType,1
5,4,0,9,mixedType,1
6,2,0,8,mixedType,1
6,3,0,9,mixedType,1
5,1,0,6,mixedType,0
7,1,0,8,mixedType,1
5,4,0,9,mixedType,1
6,3,0,9,mixedType,1
9,2,0,11,mixedType,1
6,3,0,9,mixedType,1
1,8,0,9,mixedType,1
7,2,0,9,mixedType,1
5,4,0,9,mixedType,1
1,7,0,8,mixedType,1
5,3,0,8,mixedType,1
7,3,0,10,mixedType,1
5,3,0,8,mixedType,1
4,6,0,10,mixedType,1
4,4,0,8,mixedType,1
2,6,0,8,mixedType,1
4,6,0,10,mixedType,1
12,4,0,16,mixedType,2
2,4,0,6,mixedType,0
6,1,0,7,mixedType,0
10,1,0,11,mixedType,1
3,6,0,9,mixedType,1
6,2,0,8,mixedType,1
3,3,0,6,mixedType,0
6,2,0,8,mixedType,1
4,6,0,10,mixedType,1
4,4,0,8,mixedType,1
6,3,0,9,mixedType,1
6,3,0,9,mixedType,1
2,8,0,10,mixedType,1
7,2,0,9,mixedType,1
5,2,0,7,mixedType,0
6,2,0,8,mixedType,1
7,4,0,11,mixedType,1
7,3,0,10,mixedType,1
7,3,0,10,mixedType,1
8,1,0,9,mixedType,1
8,5,0,13,mixedType,1
5,3,0,8,mixedType,1
5,2,0,7,mixedType,0
7,2,0,9,mixedType,1
15,1,0,16,mixedType,2
7,3,0,10,mixedType,1
7,3,0,10,mixedType,1
8,1,0,9,mixedType,1
6,3,0,9,mixedType,1
6,4,0,10,mixedType,1
12,3,0,15,mixedType,2
5,5,0,10,mixedType,1
3,6,0,9,mixedType,1
5,3,0,8,mixedType,1
2,6,0,8,mixedType,1
4,4,0,8,mixedType,1
13,3,0,16,mixedType,2
5,4,0,9,mixedType,1
6,3,0,9,mixedType,1
5,3,0,8,mixedType,1
6,2,0,8,mixedType,1
6,3,0,9,mixedType,1
4,5,0,9,mixedType,1
6,4,0,10,mixedType,1
13,3,0,16,mixedType,2
12,3,0,15,mixedType,2
12,1,0,13,mixedType,1
3,3,0,6,mixedType,0
9,2,0,11,mixedType,1
7,2,0,9,mixedType,1
2,10,0,12,mixedType,1
4,4,0,8,mixedType,1
7,1,0,8,mixedType,1
8,4,0,12,mixedType,1
14,2,0,16,mixedType,2
2,7,0,9,mixedType,1
10,3,6,19,mixedType,2
4,6,0,10,mixedType,1
4,7,0,11,mixedType,1
13,3,0,16,mixedType,2
1,9,0,10,mixedType,1
1,8,0,9,mixedType,1
6,3,0,9,mixedType,1
3,3,0,6,mixedType,0
8,2,0,10,mixedType,1
8,4,0,12,mixedType,1
6,9,0,15,mixedType,2
9,3,0,12,mixedType,1
6,3,0,9,mixedType,1
8,4,0,12,mixedType,1
7,3,0,10,mixedType,1
10,2,0,12,mixedType,1
4,4,0,8,mixedType,1
3,8,0,11,mixedType,1
6,3,0,9,mixedType,1
7,2,0,9,mixedType,1
6,2,0,8,mixedType,1
6,4,0,10,mixedType,1
4,2,0,6,mixedType,0
7,1,0,8,mixedType,1
5,2,0,7,mixedType,0
14,2,0,16,mixedType,2
4,4,0,8,mixedType,1
6,4,0,10,mixedType,1
2,6,0,8,mixedType,1
6,3,0,9,mixedType,1
3,6,0,9,mixedType,1
9,3,0,12,mixedType,1
2,4,0,6,mixedType,0
7,6,2,15,mixedType,2
5,4,0,9,mixedType,1
6,4,0,10,mixedType,1
6,3,0,9,mixedType,1
3,10,0,13,mixedType,1
10,6,0,16,mixedType,2
14,2,0,16,mixedType,2
9,1,0,10,mixedType,1
13,3,0,16,mixedType,2
2,4,0,6,mixedType,0
4,2,0,6,mixedType,0
5,3,0,8,mixedType,1
7,2,0,9,mixedType,1
7,3,0,10,mixedType,1
7,3,0,10,mixedType,1
10,1,0,11,mixedType,1
6,3,0,9,mixedType,1
6,2,0,8,mixedType,1
15,1,0,16,mixedType,2
8,3,0,11,mixedType,1
9,3,0,12,mixedType,1
5,3,0,8,mixedType,1
7,1,0,8,mixedType,1
2,6,0,8,mixedType,1
6,2,0,8,mixedType,1
6,3,0,9,mixedType,1
5,8,0,13,mixedType,1
7,2,0,9,mixedType,1
8,2,0,10,mixedType,1
7,2,0,9,mixedType,1
10,2,0,12,mixedType,1
6,3,0,9,mixedType,1
5,3,0,8,mixedType,1
4,2,0,6,mixedType,0
5,3,0,8,mixedType,1
4,2,0,6,mixedType,0
13,3,0,16,mixedType,2
4,5,0,9,mixedType,1
5,1,0,6,mixedType,0
11,3,0,14,mixedType,2
8,2,0,10,mixedType,1
8,2,0,10,mixedType,1
9,1,0,10,mixedType,1
15,1,0,16,mixedType,2
5,5,0,10,mixedType,1
6,3,0,9,mixedType,1
4,2,0,6,mixedType,0
4,8,0,12,mixedType,1
7,3,0,10,mixedType,1
7,3,0,10,mixedType,1
5,3,0,8,mixedType,1
6,3,0,9,mixedType,1
9,1,0,10,mixedType,1
12,4,0,16,mixedType,2
6,3,0,9,mixedType,1
7,2,0,9,mixedType,1
7,3,0,10,mixedType,1
10,4,0,14,mixedType,2
5,2,0,7,mixedType,0
9,1,0,10,mixedType,1
8,3,0,11,mixedType,1
8,1,0,9,mixedType,1
6,4,0,10,mixedType,1
6,4,0,10,mixedType,1
2,4,0,6,mixedType,0
6,2,0,8,mixedType,1
7,2,0,9,mixedType,1
14,2,0,16,mixedType,2
6,1,0,7,mixedType,0
13,3,0,16,mixedType,2
8,1,0,9,mixedType,1
4,2,0,6,mixedType,0
6,1,0,7,mixedType,0
13,3,0,16,mixedType,2
4,4,0,8,mixedType,1
5,5,0,10,mixedType,1
7,2,0,9,mixedType,1
13,3,0,16,mixedType,2
5,3,0,8,mixedType,1
7,1,0,8,mixedType,1
9,3,0,12,mixedType,1
10,2,0,12,mixedType,1
13,3,0,16,mixedType,2
6,4,0,10,mixedType,1
6,3,0,9,mixedType,1
1,7,0,8,mixedType,1
8,4,0,12,mixedType,1
8,3,0,11,mixedType,1
7,3,0,10,mixedType,1
1,8,0,9,mixedType,1
9,4,0,13,mixedType,1
8,3,0,11,mixedType,1
8,3,0,11,mixedType,1
9,4,0,13,mixedType,1
3,5,0,8,mixedType,1
5,4,0,9,mixedType,1
10,4,0,14,mixedType,2
15,1,0,16,mixedType,2
8,2,0,10,mixedType,1
8,4,0,12,mixedType,1
10,4,0,14,mixedType,2
7,3,0,10,mixedType,1
3,6,0,9,mixedType,1
5,11,0,16,mixedType,2
6,1,0,7,mixedType,0
8,1,0,9,mixedType,1
6,3,0,9,mixedType,1
10,1,0,11,mixedType,1
6,3,0,9,mixedType,1
10,1,0,11,mixedType,1
11,2,0,13,mixedType,1
6,3,0,9,mixedType,1
4,4,0,8,mixedType,1
2,10,0,12,mixedType,1
5,1,0,6,mixedType,0
15,1,0,16,mixedType,2
4,2,0,6,mixedType,0
5,4,0,9,mixedType,1
5,3,0,8,mixedType,1
15,1,0,16,mixedType,2
2,10,0,12,mixedType,1
1,6,0,7,mixedType,0
9,3,0,12,mixedType,1
3,10,0,13,mixedType,1
8,4,0,12,mixedType,1
6,1,0,7,mixedType,0
7,3,0,10,mixedType,1
5,4,0,9,mixedType,1
2,8,0,10,mixedType,1
5,1,0,6,mixedType,0
8,2,0,10,mixedType,1
6,4,0,10,mixedType,1
3,3,0,6,mixedType,0
8,2,0,10,mixedType,1
9,1,0,10,mixedType,1
7,3,0,10,mixedType,1
13,4,1,18,mixedType,2
8,8,0,16,mixedType,2
4,2,0,6,mixedType,0
5,5,0,10,mixedType,1
15,1,0,16,mixedType,2
6,4,0,10,mixedType,1
6,4,0,10,mixedType,1
6,2,0,8,mixedType,1
7,1,0,8,mixedType,1
6,3,0,9,mixedType,1
6,6,0,12,mixedType,1
7,1,0,8,mixedType,1
9,1,0,10,mixedType,1
15,1,0,16,mixedType,2
7,3,0,10,mixedType,1
6,4,0,10,mixedType,1
4,7,0,11,mixedType,1
1,7,0,8,mixedType,1
8,1,0,9,mixedType,1
7,2,0,9,mixedType,1
8,4,0,12,mixedType,1
7,2,0,9,mixedType,1
5,3,0,8,mixedType,1
3,3,0,6,mixedType,0
6,2,0,8,mixedType,1
1,8,0,9,mixedType,1
6,4,0,10,mixedType,1
11,5,0,16,mixedType,2
6,2,0,8,mixedType,1
6,3,0,9,mixedType,1
4,4,0,8,mixedType,1
1,8,0,9,mixedType,1
4,2,0,6,mixedType,0
10,1,0,11,mixedType,1
7,3,0,10,mixedType,1
3,6,0,9,mixedType,1
10,2,0,12,mixedType,1
6,3,0,9,mixedType,1
6,3,0,9,mixedType,1
8,1,0,9,mixedType,1
5,3,0,8,mixedType,1
8,1,0,9,mixedType,1
7,3,0,10,mixedType,1
4,4,0,8,mixedType,1
2,8,0,10,mixedType,1
7,3,0,10,mixedType,1
7,3,0,10,mixedType,1
4,4,0,8,mixedType,1
7,2,0,9,mixedType,1
2,8,0,10,mixedType,1
12,4,0,16,mixedType,2
5,2,0,7,mixedType,0
2,4,0,6,mixedType,0
4,2,0,6,mixedType,0
7,3,0,10,mixedType,1
12,4,0,16,mixedType,2
8,3,0,11,mixedType,1
6,3,0,9,mixedType,1
5,1,0,6,mixedType,0
5,2,0,7,mixedType,0
6,3,0,9,mixedType,1
9,9,0,18,mixedType,2
7,3,0,10,mixedType,1
14,2,0,16,mixedType,2
9,1,0,10,mixedType,1
5,4,0,9,mixedType,1
6,2,0,8,mixedType,1
7,5,0,12,mixedType,1
2,6,0,8,mixedType,1
4,2,0,6,mixedType,0
3,5,0,8,mixedType,1
7,3,0,10,mixedType,1
7,2,0,9,mixedType,1
6,2,0,8,mixedType,1
9,1,0,10,mixedType,1
7,3,0,10,mixedType,1
8,0,1,9,mixedType,1
9,1,0,10,mixedType,1
7,3,0,10,mixedType,1
5,1,0,6,mixedType,0
9,3,0,12,mixedType,1
7,1,0,8,mixedType,1
8,2,0,10,mixedType,1
15,1,0,16,mixedType,2
8,1,0,9,mixedType,1
7,1,0,8,mixedType,1
5,2,0,7,mixedType,0
10,6,1,17,mixedType,2
8,2,0,10,mixedType,1
5,3,0,8,mixedType,1
7,1,0,8,mixedType,1
7,3,0,10,mixedType,1
6,3,0,9,mixedType,1
7,3,0,10,mixedType,1
5,3,0,8,mixedType,1
6,4,0,10,mixedType,1
3,3,0,6,mixedType,0
5,1,0,6,mixedType,0
3,6,0,9,mixedType,1
7,1,0,8,mixedType,1
5,8,0,13,mixedType,1
4,5,0,9,mixedType,1
7,3,0,10,mixedType,1
4,6,0,10,mixedType,1
7,2,0,9,mixedType,1
1,5,0,6,mixedType,0
6,2,0,8,mixedType,1
6,2,0,8,mixedType,1
10,2,0,12,mixedType,1
2,6,0,8,mixedType,1
13,3,0,16,mixedType,2
3,7,0,10,mixedType,1
7,1,0,8,mixedType,1
12,4,0,16,mixedType,2
7,4,0,11,mixedType,1
7,3,0,10,mixedType,1
7,3,0,10,mixedType,1
10,2,0,12,mixedType,1
1,9,0,10,mixedType,1
7,1,0,8,mixedType,1
12,4,0,16,mixedType,2
7,4,0,11,mixedType,1
11,3,0,14,mixedType,2
8,3,0,11,mixedType,1
11,3,0,14,mixedType,2
4,4,0,8,mixedType,1
3,5,0,8,mixedType,1
7,4,0,11,mixedType,1
6,2,0,8,mixedType,1
6,1,0,7,mixedType,0
6,3,0,9,mixedType,1
3,6,0,9,mixedType,1
3,8,0,11,mixedType,1
11,4,0,15,mixedType,2
6,6,0,12,mixedType,1
5,4,0,9,mixedType,1
13,2,0,15,mixedType,2
6,2,0,8,mixedType,1
7,3,0,10,mixedType,1
7,2,0,9,mixedType,1
6,1,0,7,mixedType,0
11,3,0,14,mixedType,2
4,6,0,10,mixedType,1
5,1,0,6,mixedType,0
7,2,0,9,mixedType,1
5,3,0,8,mixedType,1
10,2,0,12,mixedType,1
2,6,0,8,mixedType,1
11,2,0,13,mixedType,1
7,2,0,9,mixedType,1
6,7,0,13,mixedType,1
8,4,0,12,mixedType,1
4,4,0,8,mixedType,1
14,2,0,16,mixedType,2
7,2,0,9,mixedType,1
7,2,0,9,mixedType,1
6,3,0,9,mixedType,1
7,2,0,9,mixedType,1
6,6,0,12,mixedType,1
8,4,0,12,mixedType,1
13,3,0,16,mixedType,2
5,4,0,9,mixedType,1
6,3,0,9,mixedType,1
15,1,0,16,mixedType,2
4,6,0,10,mixedType,1
4,4,0,8,mixedType,1
2,6,0,8,mixedType,1
7,1,0,8,mixedType,1
5,4,0,9,mixedType,1
1,7,0,8,mixedType,1
8,2,0,10,mixedType,1
9,3,0,12,mixedType,1
8,2,0,10,mixedType,1
6,6,0,12,mixedType,1
6,2,0,8,mixedType,1
5,2,0,7,mixedType,0
17,1,1,19,mixedType,2
8,4,0,12,mixedType,1
13,3,0,16,mixedType,2
4,4,0,8,mixedType,1
4,4,0,8,mixedType,1
6,4,0,10,mixedType,1
2,7,0,9,mixedType,1
5,2,0,7,mixedType,0
4,4,0,8,mixedType,1
2,10,0,12,mixedType,1
4,6,0,10,mixedType,1
6,1,0,7,mixedType,0
7,2,0,9,mixedType,1
4,6,0,10,mixedType,1
15,1,0,16,mixedType,2
4,4,0,8,mixedType,1
12,1,0,13,mixedType,1
9,1,0,10,mixedType,1
5,4,0,9,mixedType,1
5,3,0,8,mixedType,1
4,2,0,6,mixedType,0
13,3,0,16,mixedType,2
7,1,0,8,mixedType,1
5,2,0,7,mixedType,0
12,4,0,16,mixedType,2
5,4,0,9,mixedType,1
4,5,0,9,mixedType,1
6,4,0,10,mixedType,1
6,4,0,10,mixedType,1
3,3,0,6,mixedType,0
11,5,0,16,mixedType,2
9,1,0,10,mixedType,1
7,2,0,9,mixedType,1
3,3,0,6,mixedType,0
14,2,0,16,mixedType,2
4,5,0,9,mixedType,1
7,2,0,9,mixedType,1
3,3,0,6,mixedType,0
5,2,0,7,mixedType,0
7,2,0,9,mixedType,1
8,2,0,10,mixedType,1
9,3,0,12,mixedType,1
7,2,0,9,mixedType,1
3,7,0,10,mixedType,1
5,3,0,8,mixedType,1
5,4,0,9,mixedType,1
6,2,0,8,mixedType,1
6,6,0,12,mixedType,1
7,3,0,10,mixedType,1
5,3,0,8,mixedType,1
6,3,0,9,mixedType,1
14,2,0,16,mixedType,2
5,2,0,7,mixedType,0
5,3,0,8,mixedType,1
7,3,0,10,mixedType,1
7,3,0,10,mixedType,1
4,8,0,12,mixedType,1
9,1,0,10,mixedType,1
7,3,0,10,mixedType,1
8,1,0,9,mixedType,1
9,3,0,12,mixedType,1
5,3,0,8,mixedType,1
12,4,0,16,mixedType,2
5,7,0,12,mixedType,1
13,1,1,15,mixedType,2
6,3,0,9,mixedType,1
4,4,0,8,mixedType,1
6,1,0,7,mixedType,0
4,6,0,10,mixedType,1
9,3,0,12,mixedType,1
5,3,0,8,mixedType,1
4,6,0,10,mixedType,1
5,2,0,7,mixedType,0
9,1,0,10,mixedType,1
6,2,0,8,mixedType,1
4,4,0,8,mixedType,1
5,2,0,7,mixedType,0
6,3,0,9,mixedType,1
8,1,0,9,mixedType,1
5,4,0,9,mixedType,1
7,2,0,9,mixedType,1
9,3,0,12,mixedType,1
8,1,0,9,mixedType,1
5,3,0,8,mixedType,1
6,3,0,9,mixedType,1
6,4,0,10,mixedType,1
4,4,0,8,mixedType,1
6,4,0,10,mixedType,1
5,1,0,6,mixedType,0
4,4,0,8,mixedType,1
3,5,0,8,mixedType,1
8,2,0,10,mixedType,1
5,3,0,8,mixedType,1
15,1,0,16,mixedType,2
11,1,0,12,mixedType,1
13,1,1,15,mixedType,2
11,5,0,16,mixedType,2
8,2,0,10,mixedType,1
7,1,0,8,mixedType,1
12,3,0,15,mixedType,2
14,2,0,16,mixedType,2
6,1,0,7,mixedType,0
7,3,0,10,mixedType,1
5,2,0,7,mixedType,0
6,3,0,9,mixedType,1
6,3,0,9,mixedType,1
14,2,0,16,mixedType,2
7,2,0,9,mixedType,1
6,3,0,9,mixedType,1
6,2,0,8,mixedType,1
3,7,0,10,mixedType,1
8,1,0,9,mixedType,1
6,4,0,10,mixedType,1
8,2,0,10,mixedType,1
7,4,0,11,mixedType,1
6,1,0,7,mixedType,0
9,2,0,11,mixedType,1
8,3,0,11,mixedType,1
7,4,0,11,mixedType,1
11,3,0,14,mixedType,2
8,2,0,10,mixedType,1
9,3,0,12,mixedType,1
7,3,0,10,mixedType,1
6,2,0,8,mixedType,1
7,2,0,9,mixedType,1
7,2,0,9,mixedType,1
6,4,0,10,mixedType,1
6,2,0,8,mixedType,1
2,6,0,8,mixedType,1
13,2,0,15,mixedType,2
5,6,0,11,mixedType,1
5,2,0,7,mixedType,0
5,3,0,8,mixedType,1
6,4,0,10,mixedType,1
5,5,0,10,mixedType,1
6,2,0,8,mixedType,1
7,5,0,12,mixedType,1
12,3,0,15,mixedType,2
7,2,0,9,mixedType,1
7,2,0,9,mixedType,1
6,3,0,9,mixedType,1
14,2,0,16,mixedType,2
5,1,0,6,mixedType,0
12,4,0,16,mixedType,2
5,4,0,9,mixedType,1
8,1,0,9,mixedType,1
7,4,0,11,mixedType,1
13,3,0,16,mixedType,2
7,1,0,8,mixedType,1
5,3,0,8,mixedType,1
6,1,0,7,mixedType,0
9,3,0,12,mixedType,1
5,3,0,8,mixedType,1
1,10,0,11,mixedType,1
3,5,0,8,mixedType,1
9,3,0,12,mixedType,1
7,2,0,9,mixedType,1
7,3,0,10,mixedType,1
11,3,0,14,mixedType,2
6,3,0,9,mixedType,1
11,3,0,14,mixedType,2
5,1,0,6,mixedType,0
6,6,0,12,mixedType,1
5,2,0,7,mixedType,0
4,4,0,8,mixedType,1
12,4,0,16,mixedType,2
7,3,0,10,mixedType,1
7,3,0,10,mixedType,1
6,3,0,9,mixedType,1
7,1,0,8,mixedType,1
5,4,0,9,mixedType,1
1,8,0,9,mixedType,1
7,2,0,9,mixedType,1
12,4,0,16,mixedType,2
6,5,0,11,mixedType,1
8,2,0,10,mixedType,1
6,3,0,9,mixedType,1
7,2,0,9,mixedType,1
8,1,0,9,mixedType,1
14,2,0,16,mixedType,2
2,8,0,10,mixedType,1
6,4,0,10,mixedType,1
1,6,0,7,mixedType,0
6,4,0,10,mixedType,1
7,2,0,9,mixedType,1
8,2,0,10,mixedType,1
3,5,0,8,mixedType,1
6,1,0,7,mixedType,0
7,4,0,11,mixedType,1
2,6,0,8,mixedType,1
14,2,0,16,mixedType,2
9,1,0,10,mixedType,1
7,5,0,12,mixedType,1
5,3,0,8,mixedType,1
8,4,0,12,mixedType,1
9,1,0,10,mixedType,1
9,1,0,10,mixedType,1
5,4,0,9,mixedType,1
8,2,0,10,mixedType,1
2,6,0,8,mixedType,1
8,1,0,9,mixedType,1
5,3,0,8,mixedType,1
5,2,0,7,mixedType,0
8,3,0,11,mixedType,1
8,1,0,9,mixedType,1
7,2,0,9,mixedType,1
7,4,0,11,mixedType,1
5,5,0,10,mixedType,1
5,5,0,10,mixedType,1
4,6,0,10,mixedType,1
7,3,0,10,mixedType,1
7,3,0,10,mixedType,1
14,2,0,16,mixedType,2
6,3,0,9,mixedType,1
7,2,0,9,mixedType,1
5,3,0,8,mixedType,1
6,4,0,10,mixedType,1
7,4,0,11,mixedType,1
9,4,0,13,mixedType,1
3,6,0,9,mixedType,1
7,4,0,11,mixedType,1
6,3,0,9,mixedType,1
4,2,0,6,mixedType,0
6,4,0,10,mixedType,1
9,1,0,10,mixedType,1
7,3,0,10,mixedType,1
7,3,0,10,mixedType,1
3,8,0,11,mixedType,1
6,6,0,12,mixedType,1
1,10,0,11,mixedType,1
7,1,0,8,mixedType,1
15,1,0,16,mixedType,2
5,4,0,9,mixedType,1
5,1,0,6,mixedType,0
5,3,0,8,mixedType,1
6,3,0,9,mixedType,1
5,3,0,8,mixedType,1
3,5,0,8,mixedType,1
6,3,0,9,mixedType,1
2,6,0,8,mixedType,1
7,1,0,8,mixedType,1
3,3,0,6,mixedType,0
6,3,0,9,mixedType,1
8,1,0,9,mixedType,1
12,1,0,13,mixedType,1
4,2,0,6,mixedType,0
8,2,0,10,mixedType,1
8,3,0,11,mixedType,1
5,3,0,8,mixedType,1
4,4,0,8,mixedType,1
5,2,0,7,mixedType,0
8,4,0,12,mixedType,1
5,2,0,7,mixedType,0
7,2,0,9,mixedType,1
6,8,0,14,mixedType,2
8,2,0,10,mixedType,1
5,2,0,7,mixedType,0
14,2,0,16,mixedType,2
4,8,0,12,mixedType,1
4,8,0,12,mixedType,1
5,2,0,7,mixedType,0
6,2,0,8,mixedType,1
6,3,0,9,mixedType,1
7,1,0,8,mixedType,1
13,3,0,16,mixedType,2
14,2,0,16,mixedType,2
4,6,0,10,mixedType,1
7,2,0,9,mixedType,1
15,1,0,16,mixedType,2
2,8,0,10,mixedType,1
3,3,0,6,mixedType,0
5,1,0,6,mixedType,0
11,4,0,15,mixedType,2
7,2,0,9,mixedType,1
2,7,0,9,mixedType,1
6,3,0,9,mixedType,1
8,1,0,9,mixedType,1
12,4,0,16,mixedType,2
6,1,0,7,mixedType,0
7,4,0,11,mixedType,1
6,4,0,10,mixedType,1
6,3,0,9,mixedType,1
2,6,0,8,mixedType,1
6,3,0,9,mixedType,1
6,2,0,8,mixedType,1
6,4,0,10,mixedType,1
7,2,0,9,mixedType,1
4,2,0,6,mixedType,0
3,6,0,9,mixedType,1
13,4,0,17,mixedType,2
5,1,0,6,mixedType,0
7,2,0,9,mixedType,1
6,4,0,10,mixedType,1
12,3,0,15,mixedType,2
5,2,0,7,mixedType,0
1,7,0,8,mixedType,1
10,1,0,11,mixedType,1
16,3,2,21,mixedType,2
4,6,0,10,mixedType,1
14,2,0,16,mixedType,2
7,3,0,10,mixedType,1
6,3,0,9,mixedType,1
7,2,0,9,mixedType,1
9,3,0,12,mixedType,1
1,9,0,10,mixedType,1
1,9,0,10,mixedType,1
7,3,0,10,mixedType,1
5,2,0,7,mixedType,0
4,6,0,10,mixedType,1
6,1,0,7,mixedType,0
3,8,0,11,mixedType,1
6,3,0,9,mixedType,1
14,2,0,16,mixedType,2
1,8,0,9,mixedType,1
4,7,0,11,mixedType,1
6,2,0,8,mixedType,1
6,4,0,10,mixedType,1
7,1,0,8,mixedType,1
6,3,0,9,mixedType,1
8,4,0,12,mixedType,1
5,3,0,8,mixedType,1
8,1,0,9,mixedType,1
8,3,0,11,mixedType,1
4,6,0,10,mixedType,1
6,4,0,10,mixedType,1
3,7,0,10,mixedType,1
9,4,0,13,mixedType,1
4,2,0,6,mixedType,0
7,2,0,9,mixedType,1
3,5,0,8,mixedType,1
5,2,0,7,mixedType,0
13,3,0,16,mixedType,2
5,3,0,8,mixedType,1
4,6,0,10,mixedType,1
9,3,0,12,mixedType,1
1,9,0,10,mixedType,1
7,3,0,10,mixedType,1
10,3,0,13,mixedType,1
6,2,0,8,mixedType,1
12,5,2,19,mixedType,2
6,3,0,9,mixedType,1
11,1,0,12,mixedType,1
7,1,0,8,mixedType,1
6,3,0,9,mixedType,1
5,4,0,9,mixedType,1
4,4,0,8,mixedType,1
7,1,0,8,mixedType,1
5,2,0,7,mixedType,0
5,4,0,9,mixedType,1
1,8,0,9,mixedType,1
15,1,0,16,mixedType,2
6,2,0,8,mixedType,1
6,3,0,9,mixedType,1
8,2,0,10,mixedType,1
13,3,0,16,mixedType,2
11,5,0,16,mixedType,2
7,2,0,9,mixedType,1
12,4,0,16,mixedType,2
9,1,0,10,mixedType,1
8,4,0,12,mixedType,1
5,4,0,9,mixedType,1
9,0,2,11,mixedType,1
5,4,0,9,mixedType,1
5,1,0,6,mixedType,0
5,3,0,8,mixedType,1
6,2,0,8,mixedType,1
7,3,0,10,mixedType,1
8,1,0,9,mixedType,1
14,2,0,16,mixedType,2
8,4,0,12,mixedType,1
5,4,0,9,mixedType,1
14,2,0,16,mixedType,2
7,3,0,10,mixedType,1
6,3,0,9,mixedType,1
8,0,1,9,mixedType,1
5,1,0,6,mixedType,0
2,7,0,9,mixedType,1
7,3,0,10,mixedType,1
4,2,0,6,mixedType,0
12,3,0,15,mixedType,2
6,4,0,10,mixedType,1
12,3,0,15,mixedType,2
6,0,1,7,mixedType,0
9,3,0,12,mixedType,1
5,2,0,7,mixedType,0
4,2,0,6,mixedType,0
12,3,0,15,mixedType,2
2,6,0,8,mixedType,1
6,3,0,9,mixedType,1
8,2,0,10,mixedType,1
9,1,0,10,mixedType,1
8,2,0,10,mixedType,1
8,1,0,9,mixedType,1
5,1,0,6,mixedType,0
9,3,0,12,mixedType,1
3,8,0,11,mixedType,1
9,2,0,11,mixedType,1
14,2,0,16,mixedType,2
2,10,0,12,mixedType,1
1,5,0,6,mixedType,0
7,3,0,10,mixedType,1
5,3,0,8,mixedType,1
14,2,2,18,mixedType,2
4,6,0,10,mixedType,1
9,2,0,11,mixedType,1
4,2,0,6,mixedType,0
7,3,0,10,mixedType,1
13,3,0,16,mixedType,2
8,2,0,10,mixedType,1
5,4,0,9,mixedType,1
4,4,0,8,mixedType,1
6,3,0,9,mixedType,1
5,3,0,8,mixedType,1
8,2,0,10,mixedType,1
4,4,0,8,mixedType,1
1,9,0,10,mixedType,1
10,3,0,13,mixedType,1
15,1,0,16,mixedType,2
6,3,0,9,mixedType,1
9,1,0,10,mixedType,1
14,2,0,16,mixedType,2
5,2,0,7,mixedType,0
9,1,0,10,mixedType,1
3,6,0,9,mixedType,1
7,2,0,9,mixedType,1
4,4,0,8,mixedType,1
4,5,0,9,mixedType,1
6,2,0,8,mixedType,1
3,3,0,6,mixedType,0
4,6,0,10,mixedType,1
7,3,0,10,mixedType,1
4,4,0,8,mixedType,1
6,6,0,12,mixedType,1
9,1,0,10,mixedType,1
5,2,0,7,mixedType,0
8,1,0,9,mixedType,1
6,3,0,9,mixedType,1
7,2,0,9,mixedType,1
6,1,0,7,mixedType,0
9,2,0,11,mixedType,1
6,4,0,10,mixedType,1
13,3,0,16,mixedType,2
4,4,0,8,mixedType,1
8,1,0,9,mixedType,1
4,2,0,6,mixedType,0
6,4,0,10,mixedType,1
4,4,0,8,mixedType,1
10,3,0,13,mixedType,1
5,6,0,11,mixedType,1
4,2,0,6,mixedType,0
10,2,0,12,mixedType,1
13,3,0,16,mixedType,2
6,3,0,9,mixedType,1
7,1,0,8,mixedType,1
6,3,0,9,mixedType,1
7,2,0,9,mixedType,1
5,3,0,8,mixedType,1
4,4,0,8,mixedType,1
3,5,0,8,mixedType,1
9,1,0,10,mixedType,1
7,2,0,9,mixedType,1
6,3,0,9,mixedType,1
6,4,0,10,mixedType,1
13,3,0,16,mixedType,2
6,3,0,9,mixedType,1
6,2,0,8,mixedType,1
13,3,0,16,mixedType,2
7,2,0,9,mixedType,1
6,2,0,8,mixedType,1
4,8,0,12,mixedType,1
4,6,0,10,mixedType,1
5,1,0,6,mixedType,0
6,1,0,7,mixedType,0
7,4,0,11,mixedType,1
8,2,0,10,mixedType,1
4,2,0,6,mixedType,0
7,1,0,8,mixedType,1
6,4,0,10,mixedType,1
4,2,0,6,mixedType,0
5,2,0,7,mixedType,0
7,2,0,9,mixedType,1
7,3,0,10,mixedType,1
11,3,0,14,mixedType,2
3,3,0,6,mixedType,0
6,4,0,10,mixedType,1
4,8,0,12,mixedType,1
4,4,0,8,mixedType,1
8,2,0,10,mixedType,1
4,10,0,14,mixedType,2
7,4,0,11,mixedType,1
4,2,0,6,mixedType,0
9,1,0,10,mixedType,1
5,4,0,9,mixedType,1
8,3,0,11,mixedType,1
6,2,0,8,mixedType,1
8,4,0,12,mixedType,1
10,4,0,14,mixedType,2
9,1,0,10,mixedType,1
6,3,0,9,mixedType,1
13,3,0,16,mixedType,2
5,3,0,8,mixedType,1
5,2,0,7,mixedType,0
5,3,0,8,mixedType,1
13,3,0,16,mixedType,2
5,6,0,11,mixedType,1
5,3,0,8,mixedType,1
7,2,0,9,mixedType,1
5,7,0,12,mixedType,1
12,3,0,15,mixedType,2
10,1,0,11,mixedType,1
9,3,0,12,mixedType,1
6,5,0,11,mixedType,1
7,2,0,9,mixedType,1
8,1,0,9,mixedType,1
6,3,0,9,mixedType,1
4,4,0,8,mixedType,1
6,4,0,10,mixedType,1
7,6,0,13,mixedType,1
6,1,0,7,mixedType,0
6,2,0,8,mixedType,1
9,1,0,10,mixedType,1
5,5,0,10,mixedType,1
2,9,0,11,mixedType,1
5,6,0,11,mixedType,1
11,3,0,14,mixedType,2
3,6,0,9,mixedType,1
1,5,0,6,mixedType,0
6,3,0,9,mixedType,1
4,5,0,9,mixedType,1
11,2,0,13,mixedType,1
7,3,0,10,mixedType,1
5,2,0,7,mixedType,0
14,2,0,16,mixedType,2
8,1,0,9,mixedType,1
15,1,0,16,mixedType,2
5,5,0,10,mixedType,1
8,2,0,10,mixedType,1
6,1,0,7,mixedType,0
7,3,0,10,mixedType,1
5,3,0,8,mixedType,1
5,3,0,8,mixedType,1
6,2,0,8,mixedType,1
5,1,0,6,mixedType,0
4,4,0,8,mixedType,1
10,2,0,12,mixedType,1
9,2,0,11,mixedType,1
3,5,0,8,mixedType,1
5,6,0,11,mixedType,1
3,3,0,6,mixedType,0
7,2,0,9,mixedType,1
10,1,0,11,mixedType,1
7,3,0,10,mixedType,1
5,4,0,9,mixedType,1
7,2,0,9,mixedType,1
4,4,0,8,mixedType,1
7,3,0,10,mixedType,1
7,2,0,9,mixedType,1
6,4,0,10,mixedType,1
7,3,0,10,mixedType,1
6,1,0,7,mixedType,0
6,4,0,10,mixedType,1
4,4,0,8,mixedType,1
7,2,0,9,mixedType,1
9,2,0,11,mixedType,1
8,1,0,9,mixedType,1
12,4,0,16,mixedType,2
4,2,0,6,mixedType,0
13,3,0,16,mixedType,2
3,3,0,6,mixedType,0
10,1,0,11,mixedType,1
6,11,2,19,mixedType,2
4,4,0,8,mixedType,1
6,2,0,8,mixedType,1
9,3,0,12,mixedType,1
3,5,0,8,mixedType,1
8,3,0,11,mixedType,1
6,4,0,10,mixedType,1
7,3,0,10,mixedType,1
14,2,0,16,mixedType,2
1,7,0,8,mixedType,1
3,5,0,8,mixedType,1
2,6,0,8,mixedType,1
5,3,0,8,mixedType,1
5,2,0,7,mixedType,0
7,5,0,12,mixedType,1
4,4,0,8,mixedType,1
5,3,0,8,mixedType,1
4,6,0,10,mixedType,1
5,5,0,10,mixedType,1
8,1,0,9,mixedType,1
7,3,0,10,mixedType,1
6,3,0,9,mixedType,1
9,3,0,12,mixedType,1
6,2,0,8,mixedType,1
6,0,1,7,mixedType,0
7,4,0,11,mixedType,1
7,2,0,9,mixedType,1
4,6,0,10,mixedType,1
6,3,0,9,mixedType,1
3,8,0,11,mixedType,1
7,3,0,10,mixedType,1
7,1,0,8,mixedType,1
9,1,0,10,mixedType,1
6,2,0,8,mixedType,1
6,2,0,8,mixedType,1
2,8,0,10,mixedType,1
6,3,0,9,mixedType,1
12,1,0,13,mixedType,1
2,7,0,9,mixedType,1
8,1,0,9,mixedType,1
6,2,0,8,mixedType,1
5,1,0,6,mixedType,0
6,4,0,10,mixedType,1
9,1,0,10,mixedType,1
6,2,0,8,mixedType,1
8,2,0,10,mixedType,1
6,3,0,9,mixedType,1
6,3,0,9,mixedType,1
8,1,0,9,mixedType,1
15,1,0,16,mixedType,2
8,3,0,11,mixedType,1
9,2,0,11,mixedType,1
9,3,0,12,mixedType,1
4,6,0,10,mixedType,1
3,5,0,8,mixedType,1
4,4,0,8,mixedType,1
13,3,0,16,mixedType,2
6,4,0,10,mixedType,1
4,4,0,8,mixedType,1
5,5,0,10,mixedType,1
5,2,0,7,mixedType,0
7,3,0,10,mixedType,1
9,2,0,11,mixedType,1
9,1,0,10,mixedType,1
15,1,0,16,mixedType,2
4,4,0,8,mixedType,1
8,2,0,10,mixedType,1
3,3,0,6,mixedType,0
7,4,0,11,mixedType,1
3,6,0,9,mixedType,1
8,2,0,10,mixedType,1
7,2,0,9,mixedType,1
5,1,0,6,mixedType,0
4,2,0,6,mixedType,0
0,9,1,10,mixedType,1
5,4,0,9,mixedType,1
5,3,0,8,mixedType,1
14,2,0,16,mixedType,2
5,4,0,9,mixedType,1
9,3,0,12,mixedType,1
9,1,0,10,mixedType,1
8,3,0,11,mixedType,1
5,3,0,8,mixedType,1
10,3,0,13,mixedType,1
13,3,0,16,mixedType,2
5,3,0,8,mixedType,1
9,4,0,13,mixedType,1
6,2,0,8,mixedType,1
5,2,0,7,mixedType,0
7,1,0,8,mixedType,1
6,2,0,8,mixedType,1
5,3,0,8,mixedType,1
9,1,0,10,mixedType,1
6,3,0,9,mixedType,1
8,1,0,9,mixedType,1
7,3,0,10,mixedType,1
10,3,0,13,mixedType,1
6,3,0,9,mixedType,1
9,2,0,11,mixedType,1
9,1,0,10,mixedType,1
6,1,0,7,mixedType,0
5,3,0,8,mixedType,1
6,4,0,10,mixedType,1
7,2,0,9,mixedType,1
5,1,0,6,mixedType,0
8,2,0,10,mixedType,1
8,3,0,11,mixedType,1
11,3,0,14,mixedType,2
5,4,0,9,mixedType,1
6,4,0,10,mixedType,1
5,2,0,7,mixedType,0
4,4,0,8,mixedType,1
7,3,0,10,mixedType,1
14,2,0,16,mixedType,2
5,2,0,7,mixedType,0
1,8,0,9,mixedType,1
11,1,0,12,mixedType,1
6,3,0,9,mixedType,1
8,2,0,10,mixedType,1
13,3,0,16,mixedType,2
4,6,0,10,mixedType,1
4,2,0,6,mixedType,0
7,3,0,10,mixedType,1
13,3,0,16,mixedType,2
6,3,0,9,mixedType,1
6,3,0,9,mixedType,1
7,3,0,10,mixedType,1
1,8,0,9,mixedType,1
6,1,0,7,mixedType,0
7,3,0,10,mixedType,1
6,3,0,9,mixedType,1
5,3,0,8,mixedType,1
9,1,0,10,mixedType,1
7,3,0,10,mixedType,1
6,1,0,7,mixedType,0
6,3,0,9,mixedType,1
15,1,0,16,mixedType,2
8,2,0,10,mixedType,1
8,2,0,10,mixedType,1
7,3,0,10,mixedType,1
12,4,0,16,mixedType,2
7,3,0,10,mixedType,1
5,4,0,9,mixedType,1
7,6,0,13,mixedType,1
10,2,0,12,mixedType,1
9,1,0,10,mixedType,1
7,2,0,9,mixedType,1
8,4,0,12,mixedType,1
5,3,0,8,mixedType,1
6,1,0,7,mixedType,0
6,2,0,8,mixedType,1
4,2,0,6,mixedType,0
6,4,0,10,mixedType,1
7,2,0,9,mixedType,1
8,1,0,9,mixedType,1
5,4,0,9,mixedType,1
5,2,0,7,mixedType,0
7,2,0,9,mixedType,1
8,5,0,13,mixedType,1
11,5,0,16,mixedType,2
2,7,0,9,mixedType,1
11,5,0,16,mixedType,2
12,1,0,13,mixedType,1
5,4,0,9,mixedType,1
3,3,0,6,mixedType,0
7,3,0,10,mixedType,1
3,6,0,9,mixedType,1
6,1,0,7,mixedType,0
4,4,0,8,mixedType,1
14,2,0,16,mixedType,2
6,3,0,9,mixedType,1
9,1,0,10,mixedType,1
8,2,0,10,mixedType,1
3,5,0,8,mixedType,1
3,6,0,9,mixedType,1
6,3,0,9,mixedType,1
4,4,0,8,mixedType,1
7,3,0,10,mixedType,1
7,1,0,8,mixedType,1
5,1,0,6,mixedType,0
2,6,0,8,mixedType,1
8,3,0,11,mixedType,1
4,2,0,6,mixedType,0
15,3,0,18,mixedType,2
2,6,0,8,mixedType,1
5,2,0,7,mixedType,0
6,4,0,10,mixedType,1
6,1,0,7,mixedType,0
7,3,0,10,mixedType,1
7,2,0,9,mixedType,1
4,2,0,6,mixedType,0
9,4,0,13,mixedType,1
11,4,0,15,mixedType,2
15,1,0,16,mixedType,2
6,4,0,10,mixedType,1
14,2,0,16,mixedType,2
7,4,0,11,mixedType,1
12,4,0,16,mixedType,2
4,2,0,6,mixedType,0
2,6,0,8,mixedType,1
7,1,0,8,mixedType,1
2,4,0,6,mixedType,0
7,3,0,10,mixedType,1
6,4,0,10,mixedType,1
7,3,0,10,mixedType,1
14,2,0,16,mixedType,2
5,1,0,6,mixedType,0
14,2,0,16,mixedType,2
8,2,0,10,mixedType,1
5,4,0,9,mixedType,1
3,3,0,6,mixedType,0
8,4,0,12,mixedType,1
6,3,0,9,mixedType,1
5,7,0,12,mixedType,1
7,3,0,10,mixedType,1
6,4,0,10,mixedType,1
11,3,0,14,mixedType,2
6,1,0,7,mixedType,0
12,4,0,16,mixedType,2
4,2,0,6,mixedType,0
7,1,0,8,mixedType,1
13,3,0,16,mixedType,2
6,3,0,9,mixedType,1
6,4,0,10,mixedType,1
5,4,0,9,mixedType,1
8,1,0,9,mixedType,1
4,4,0,8,mixedType,1
8,1,0,9,mixedType,1
7,3,0,10,mixedType,1
5,1,0,6,mixedType,0
5,2,0,7,mixedType,0
2,6,0,8,mixedType,1
9,3,0,12,mixedType,1
8,1,0,9,mixedType,1
7,3,0,10,mixedType,1
12,3,0,15,mixedType,2
14,1,1,16,mixedType,2
6,2,0,8,mixedType,1
6,4,0,10,mixedType,1
9,2,0,11,mixedType,1
6,4,0,10,mixedType,1
3,6,0,9,mixedType,1
15,1,0,16,mixedType,2
8,2,0,10,mixedType,1
4,6,0,10,mixedType,1
4,7,0,11,mixedType,1
2,8,0,10,mixedType,1
11,1,0,12,mixedType,1
8,1,0,9,mixedType,1
4,6,0,10,mixedType,1
3,8,0,11,mixedType,1
4,2,0,6,mixedType,0
3,3,0,6,mixedType,0
5,6,0,11,mixedType,1
7,1,0,8,mixedType,1
8,1,0,9,mixedType,1
8,1,0,9,mixedType,1
2,4,0,6,mixedType,0
7,4,0,11,mixedType,1
6,3,0,9,mixedType,1
5,3,0,8,mixedType,1
14,2,0,16,mixedType,2
6,1,0,7,mixedType,0
5,4,0,9,mixedType,1
4,4,0,8,mixedType,1
6,2,0,8,mixedType,1
9,1,0,10,mixedType,1
6,2,0,8,mixedType,1
12,3,0,15,mixedType,2
6,3,0,9,mixedType,1
4,4,0,8,mixedType,1
5,3,0,8,mixedType,1
7,1,0,8,mixedType,1
6,1,0,7,mixedType,0
7,3,0,10,mixedType,1
6,3,0,9,mixedType,1
3,8,0,11,mixedType,1
7,2,0,9,mixedType,1
5,3,0,8,mixedType,1
4,4,0,8,mixedType,1
9,1,0,10,mixedType,1
1,9,0,10,mixedType,1
7,2,0,9,mixedType,1
8,2,0,10,mixedType,1
7,4,0,11,mixedType,1
6,1,0,7,mixedType,0
1,5,0,6,mixedType,0
12,3,0,15,mixedType,2
8,1,0,9,mixedType,1
8,2,0,10,mixedType,1
7,3,0,10,mixedType,1
5,1,0,6,mixedType,0
7,3,0,10,mixedType,1
5,3,0,8,mixedType,1
9,1,0,10,mixedType,1
5,3,0,8,mixedType,1
7,3,0,10,mixedType,1
5,3,0,8,mixedType,1
1,10,0,11,mixedType,1
3,6,0,9,mixedType,1
4,5,0,9,mixedType,1
11,3,0,14,mixedType,2
6,3,0,9,mixedType,1
7,2,0,9,mixedType,1
8,2,0,10,mixedType,1
6,1,0,7,mixedType,0
4,6,0,10,mixedType,1
4,2,0,6,mixedType,0
8,3,0,11,mixedType,1
4,4,0,8,mixedType,1
1,10,0,11,mixedType,1
5,3,0,8,mixedType,1
8,2,0,10,mixedType,1
1,9,0,10,mixedType,1
5,6,0,11,mixedType,1
5,6,0,11,mixedType,1
1,10,0,11,mixedType,1
7,3,0,10,mixedType,1
4,2,0,6,mixedType,0
10,2,0,12,mixedType,1
7,3,0,10,mixedType,1
9,4,0,13,mixedType,1
6,4,0,10,mixedType,1
6,2,0,8,mixedType,1
3,6,0,9,mixedType,1
6,1,0,7,mixedType,0
8,2,0,10,mixedType,1
3,6,0,9,mixedType,1
7,6,0,13,mixedType,1
8,1,0,9,mixedType,1
4,4,0,8,mixedType,1
14,2,0,16,mixedType,2
6,3,0,9,mixedType,1
5,4,0,9,mixedType,1
4,4,0,8,mixedType,1
7,4,0,11,mixedType,1
8,2,0,10,mixedType,1
5,1,0,6,mixedType,0
8,3,0,11,mixedType,1
8,2,0,10,mixedType,1
5,3,0,8,mixedType,1
4,7,0,11,mixedType,1
2,4,0,6,mixedType,0
4,4,0,8,mixedType,1
7,3,0,10,mixedType,1
5,3,0,8,mixedType,1
7,1,0,8,mixedType,1
7,2,0,9,mixedType,1
6,5,0,11,mixedType,1
7,2,0,9,mixedType,1
4,9,3,16,mixedType,2
4,4,0,8,mixedType,1
7,2,0,9,mixedType,1
7,1,0,8,mixedType,1
5,2,0,7,mixedType,0
12,4,0,16,mixedType,2
8,1,0,9,mixedType,1
13,3,0,16,mixedType,2
9,4,1,14,mixedType,2
1,9,0,10,mixedType,1
7,2,0,9,mixedType,1
6,2,0,8,mixedType,1
6,1,0,7,mixedType,0
7,1,0,8,mixedType,1
4,7,0,11,mixedType,1
7,2,0,9,mixedType,1
4,4,0,8,mixedType,1
7,2,0,9,mixedType,1
13,3,0,16,mixedType,2
8,2,0,10,mixedType,1
9,2,0,11,mixedType,1
9,2,0,11,mixedType,1
8,2,0,10,mixedType,1
5,5,0,10,mixedType,1
8,3,0,11,mixedType,1
9,1,0,10,mixedType,1
5,4,0,9,mixedType,1
7,1,0,8,mixedType,1
6,1,0,7,mixedType,0
2,8,0,10,mixedType,1
9,7,0,16,mixedType,2
3,5,0,8,mixedType,1
6,3,0,9,mixedType,1
8,1,0,9,mixedType,1
6,3,0,9,mixedType,1
6,3,0,9,mixedType,1
12,3,0,15,mixedType,2
11,2,1,14,mixedType,2
10,1,0,11,mixedType,1
5,3,0,8,mixedType,1
7,3,0,10,mixedType,1
7,3,0,10,mixedType,1
5,1,0,6,mixedType,0
1,9,0,10,mixedType,1
6,2,0,8,mixedType,1
7,3,0,10,mixedType,1
9,1,0,10,mixedType,1
12,4,0,16,mixedType,2
9,2,0,11,mixedType,1
1,8,0,9,mixedType,1
7,3,0,10,mixedType,1
1,7,0,8,mixedType,1
6,2,0,8,mixedType,1
7,2,0,9,mixedType,1
5,4,0,9,mixedType,1
12,4,0,16,mixedType,2
6,3,0,9,mixedType,1
5,3,0,8,mixedType,1
8,2,0,10,mixedType,1
9,6,0,15,mixedType,2
4,6,0,10,mixedType,1
21,4,0,25,mixedType,2
5,2,0,7,mixedType,0
3,7,0,10,mixedType,1
8,4,0,12,mixedType,1
14,2,0,16,mixedType,2
19,1,0,20,mixedType,2
7,2,0,9,mixedType,1
4,4,0,8,mixedType,1
7,2,0,9,mixedType,1
4,2,0,6,mixedType,0
5,1,0,6,mixedType,0
7,2,0,9,mixedType,1
2,11,0,13,mixedType,1
5,4,0,9,mixedType,1
5,3,0,8,mixedType,1
7,3,0,10,mixedType,1
6,2,0,8,mixedType,1
7,4,0,11,mixedType,1
8,2,0,10,mixedType,1
4,4,0,8,mixedType,1
6,4,0,10,mixedType,1
6,2,0,8,mixedType,1
6,3,0,9,mixedType,1
8,2,0,10,mixedType,1
7,1,0,8,mixedType,1
5,1,0,6,mixedType,0
6,4,0,10,mixedType,1
15,1,0,16,mixedType,2
6,4,0,10,mixedType,1
7,3,0,10,mixedType,1
15,1,0,16,mixedType,2
2,8,0,10,mixedType,1
8,2,0,10,mixedType,1
7,3,0,10,mixedType,1
9,1,0,10,mixedType,1
8,2,0,10,mixedType,1
5,6,0,11,mixedType,1
6,4,0,10,mixedType,1
9,3,0,12,mixedType,1
7,3,0,10,mixedType,1
7,5,0,12,mixedType,1
3,3,0,6,mixedType,0
8,1,0,9,mixedType,1
6,3,0,9,mixedType,1
8,2,0,10,mixedType,1
7,3,0,10,mixedType,1
9,2,0,11,mixedType,1
7,1,0,8,mixedType,1
7,1,0,8,mixedType,1
6,3,0,9,mixedType,1
8,2,0,10,mixedType,1
5,4,0,9,mixedType,1
7,4,0,11,mixedType,1
10,1,0,11,mixedType,1
6,4,0,10,mixedType,1
12,3,0,15,mixedType,2
8,6,2,16,mixedType,2
6,2,0,8,mixedType,1
9,4,1,14,mixedType,2
9,1,0,10,mixedType,1
5,3,0,8,mixedType,1
0,6,2,8,mixedType,1
14,2,0,16,mixedType,2
5,2,0,7,mixedType,0
2,6,0,8,mixedType,1
2,6,0,8,mixedType,1
6,4,0,10,mixedType,1
8,2,0,10,mixedType,1
5,3,0,8,mixedType,1
5,3,0,8,mixedType,1
6,2,0,8,mixedType,1
7,2,0,9,mixedType,1
6,3,0,9,mixedType,1
7,3,0,10,mixedType,1
2,6,0,8,mixedType,1
3,5,0,8,mixedType,1
13,3,0,16,mixedType,2
2,8,0,10,mixedType,1
3,6,0,9,mixedType,1
9,3,0,12,mixedType,1
11,3,0,14,mixedType,2
8,2,0,10,mixedType,1
9,3,1,13,mixedType,1
6,3,0,9,mixedType,1
14,1,0,15,mixedType,2
3,3,0,6,mixedType,0
6,1,0,7,mixedType,0
5,3,0,8,mixedType,1
4,2,0,6,mixedType,0
11,6,0,17,mixedType,2
4,6,0,10,mixedType,1
7,1,0,8,mixedType,1
15,1,0,16,mixedType,2
6,2,0,8,mixedType,1
8,2,0,10,mixedType,1
11,5,0,16,mixedType,2
7,3,0,10,mixedType,1
11,5,0,16,mixedType,2
6,4,0,10,mixedType,1
14,2,0,16,mixedType,2
5,3,0,8,mixedType,1
2,6,0,8,mixedType,1
6,4,0,10,mixedType,1
5,3,0,8,mixedType,1
5,3,0,8,mixedType,1
7,3,0,10,mixedType,1
1,8,0,9,mixedType,1
2,4,0,6,mixedType,0
4,6,0,10,mixedType,1
13,3,0,16,mixedType,2
12,3,0,15,mixedType,2
6,3,0,9,mixedType,1
6,3,0,9,mixedType,1
7,3,0,10,mixedType,1
2,9,0,11,mixedType,1
6,3,0,9,mixedType,1
6,2,0,8,mixedType,1
8,2,0,10,mixedType,1
9,2,0,11,mixedType,1
7,4,0,11,mixedType,1
6,2,0,8,mixedType,1
6,3,0,9,mixedType,1
6,3,0,9,mixedType,1
4,6,0,10,mixedType,1
9,3,0,12,mixedType,1
4,4,0,8,mixedType,1
4,5,0,9,mixedType,1
7,3,0,10,mixedType,1
4,4,0,8,mixedType,1
8,3,0,11,mixedType,1
2,6,0,8,mixedType,1
3,6,0,9,mixedType,1
13,3,0,16,mixedType,2
4,2,0,6,mixedType,0
1,8,0,9,mixedType,1
6,1,0,7,mixedType,0
6,2,0,8,mixedType,1
6,3,0,9,mixedType,1
7,3,0,10,mixedType,1
6,3,0,9,mixedType,1
2,7,0,9,mixedType,1
4,4,0,8,mixedType,1
6,6,0,12,mixedType,1
15,1,0,16,mixedType,2
7,3,0,10,mixedType,1
6,3,0,9,mixedType,1
15,1,0,16,mixedType,2
4,2,0,6,mixedType,0
6,1,0,7,mixedType,0
8,1,0,9,mixedType,1
7,2,0,9,mixedType,1
7,3,0,10,mixedType,1
7,2,0,9,mixedType,1
4,6,0,10,mixedType,1
5,2,0,7,mixedType,0
4,4,0,8,mixedType,1
6,3,0,9,mixedType,1
7,1,0,8,mixedType,1
6,4,0,10,mixedType,1
6,3,0,9,mixedType,1
5,4,0,9,mixedType,1
6,3,0,9,mixedType,1
10,2,0,12,mixedType,1
2,7,0,9,mixedType,1
5,3,0,8,mixedType,1
13,3,0,16,mixedType,2
5,3,0,8,mixedType,1
2,9,0,11,mixedType,1
6,1,0,7,mixedType,0
7,2,0,9,mixedType,1
12,4,0,16,mixedType,2
5,3,0,8,mixedType,1
13,3,0,16,mixedType,2
8,2,0,10,mixedType,1
8,1,0,9,mixedType,1
6,3,0,9,mixedType,1
6,2,0,8,mixedType,1
6,4,0,10,mixedType,1
8,3,0,11,mixedType,1
6,3,0,9,mixedType,1
7,3,0,10,mixedType,1
6,1,0,7,mixedType,0
7,2,0,9,mixedType,1
5,3,0,8,mixedType,1
9,1,0,10,mixedType,1
9,4,0,13,mixedType,1
5,1,0,6,mixedType,0
9,4,0,13,mixedType,1
13,3,0,16,mixedType,2
13,3,0,16,mixedType,2
3,5,0,8,mixedType,1
2,4,0,6,mixedType,0
7,2,0,9,mixedType,1
6,3,0,9,mixedType,1
8,2,0,10,mixedType,1
2,4,0,6,mixedType,0
6,1,0,7,mixedType,0
9,1,0,10,mixedType,1
4,6,0,10,mixedType,1
6,3,0,9,mixedType,1
2,7,0,9,mixedType,1
3,3,0,6,mixedType,0
3,7,0,10,mixedType,1
5,3,0,8,mixedType,1
9,1,0,10,mixedType,1
4,4,0,8,mixedType,1
5,3,0,8,mixedType,1
14,1,0,15,mixedType,2
14,2,0,16,mixedType,2
5,4,0,9,mixedType,1
6,1,0,7,mixedType,0
13,8,2,23,mixedType,2
2,6,0,8,mixedType,1
4,4,0,8,mixedType,1
6,3,0,9,mixedType,1
14,2,0,16,mixedType,2
5,3,0,8,mixedType,1
5,4,0,9,mixedType,1
2,4,0,6,mixedType,0
8,1,0,9,mixedType,1
10,2,0,12,mixedType,1
11,4,1,16,mixedType,2
3,5,0,8,mixedType,1
3,6,0,9,mixedType,1
6,1,0,7,mixedType,0
14,2,0,16,mixedType,2
8,4,0,12,mixedType,1
7,3,0,10,mixedType,1
5,2,0,7,mixedType,0
8,1,0,9,mixedType,1
8,2,0,10,mixedType,1
7,4,0,11,mixedType,1
7,3,0,10,mixedType,1
12,4,0,16,mixedType,2
17,3,0,20,mixedType,2
8,1,0,9,mixedType,1
7,2,0,9,mixedType,1
3,3,0,6,mixedType,0
11,2,0,13,mixedType,1
7,2,0,9,mixedType,1
10,3,0,13,mixedType,1
14,2,0,16,mixedType,2
6,1,0,7,mixedType,0
6,3,0,9,mixedType,1
15,1,0,16,mixedType,2
8,1,0,9,mixedType,1
9,3,0,12,mixedType,1
8,2,0,10,mixedType,1
4,2,0,6,mixedType,0
9,1,0,10,mixedType,1
2,6,0,8,mixedType,1
7,3,0,10,mixedType,1
2,8,0,10,mixedType,1
14,2,0,16,mixedType,2
15,1,0,16,mixedType,2
13,3,0,16,mixedType,2
8,2,0,10,mixedType,1
3,6,0,9,mixedType,1
11,1,0,12,mixedType,1
6,4,0,10,mixedType,1
6,3,0,9,mixedType,1
7,3,0,10,mixedType,1
3,6,0,9,mixedType,1
5,4,0,9,mixedType,1
7,6,0,13,mixedType,1
5,2,0,7,mixedType,0
4,2,0,6,mixedType,0
6,4,0,10,mixedType,1
2,10,0,12,mixedType,1
8,3,0,11,mixedType,1
5,1,0,6,mixedType,0
5,5,0,10,mixedType,1
6,2,0,8,mixedType,1
3,7,0,10,mixedType,1
1,8,0,9,mixedType,1
8,4,0,12,mixedType,1
5,8,0,13,mixedType,1
5,3,0,8,mixedType,1
6,3,0,9,mixedType,1
6,2,0,8,mixedType,1
12,1,0,13,mixedType,1
4,4,0,8,mixedType,1
8,1,0,9,mixedType,1
2,6,0,8,mixedType,1
6,6,0,12,mixedType,1
15,1,0,16,mixedType,2
6,3,0,9,mixedType,1
22,3,2,27,mixedType,2
5,3,0,8,mixedType,1
6,6,0,12,mixedType,1
3,5,0,8,mixedType,1
7,3,0,10,mixedType,1
6,2,0,8,mixedType,1
2,4,0,6,mixedType,0
6,2,0,8,mixedType,1
6,3,0,9,mixedType,1
9,1,0,10,mixedType,1
9,1,0,10,mixedType,1
1,8,0,9,mixedType,1
6,2,0,8,mixedType,1
8,2,0,10,mixedType,1
6,3,0,9,mixedType,1
11,5,0,16,mixedType,2
10,2,0,12,mixedType,1
4,8,0,12,mixedType,1
4,4,0,8,mixedType,1
7,2,0,9,mixedType,1
7,2,0,9,mixedType,1
9,1,0,10,mixedType,1
6,4,0,10,mixedType,1
6,2,0,8,mixedType,1
12,4,0,16,mixedType,2
6,4,0,10,mixedType,1
6,1,0,7,mixedType,0
1,7,0,8,mixedType,1
8,3,0,11,mixedType,1
6,3,0,9,mixedType,1
6,3,0,9,mixedType,1
5,2,0,7,mixedType,0
5,2,0,7,mixedType,0
15,1,0,16,mixedType,2
6,4,0,10,mixedType,1
4,4,0,8,mixedType,1
5,6,0,11,mixedType,1
5,3,0,8,mixedType,1
5,3,0,8,mixedType,1
6,2,0,8,mixedType,1
6,3,0,9,mixedType,1
5,4,0,9,mixedType,1
7,4,0,11,mixedType,1
4,8,0,12,mixedType,1
1,8,0,9,mixedType,1
7,2,0,9,mixedType,1
6,4,0,10,mixedType,1
15,1,0,16,mixedType,2
6,4,0,10,mixedType,1
8,2,0,10,mixedType,1
7,1,0,8,mixedType,1
9,2,0,11,mixedType,1
15,1,0,16,mixedType,2
8,5,0,13,mixedType,1
11,5,0,16,mixedType,2
2,7,0,9,mixedType,1
13,3,0,16,mixedType,2
7,3,0,10,mixedType,1
8,4,0,12,mixedType,1
10,2,0,12,mixedType,1
4,2,0,6,mixedType,0
5,4,0,9,mixedType,1
9,4,0,13,mixedType,1
6,3,0,9,mixedType,1
5,3,0,8,mixedType,1
5,1,0,6,mixedType,0
6,3,0,9,mixedType,1
3,6,0,9,mixedType,1
2,6,0,8,mixedType,1
8,2,0,10,mixedType,1
5,3,0,8,mixedType,1
14,2,0,16,mixedType,2
8,2,0,10,mixedType,1
7,4,0,11,mixedType,1
5,3,0,8,mixedType,1
5,2,0,7,mixedType,0
3,6,0,9,mixedType,1
8,2,0,10,mixedType,1
8,3,0,11,mixedType,1
6,3,0,9,mixedType,1
14,2,0,16,mixedType,2
12,3,0,15,mixedType,2
4,4,0,8,mixedType,1
8,3,0,11,mixedType,1
7,4,0,11,mixedType,1
9,6,0,15,mixedType,2
7,2,0,9,mixedType,1
8,1,0,9,mixedType,1
4,6,0,10,mixedType,1
7,3,0,10,mixedType,1
8,1,0,9,mixedType,1
6,3,0,9,mixedType,1
7,1,0,8,mixedType,1
7,3,0,10,mixedType,1
11,1,0,12,mixedType,1
6,6,0,12,mixedType,1
7,1,0,8,mixedType,1
5,1,0,6,mixedType,0
12,4,0,16,mixedType,2
5,4,0,9,mixedType,1
5,4,0,9,mixedType,1
4,6,0,10,mixedType,1
7,3,0,10,mixedType,1
4,2,0,6,mixedType,0
6,3,0,9,mixedType,1
5,1,0,6,mixedType,0
3,6,0,9,mixedType,1
13,3,0,16,mixedType,2
8,3,0,11,mixedType,1
8,2,0,10,mixedType,1
5,3,0,8,mixedType,1
6,6,0,12,mixedType,1
7,3,0,10,mixedType,1
6,4,0,10,mixedType,1
7,2,0,9,mixedType,1
12,4,0,16,mixedType,2
6,3,0,9,mixedType,1
6,2,0,8,mixedType,1
5,3,0,8,mixedType,1
1,8,0,9,mixedType,1
4,2,0,6,mixedType,0
5,3,0,8,mixedType,1
11,1,0,12,mixedType,1
6,4,0,10,mixedType,1
7,3,0,10,mixedType,1
5,2,0,7,mixedType,0
7,2,0,9,mixedType,1
7,4,0,11,mixedType,1
7,1,0,8,mixedType,1
4,6,0,10,mixedType,1
6,3,0,9,mixedType,1
6,2,0,8,mixedType,1
8,1,0,9,mixedType,1
12,1,0,13,mixedType,1
6,1,0,7,mixedType,0
7,3,0,10,mixedType,1
4,4,0,8,mixedType,1
8,1,0,9,mixedType,1
8,2,0,10,mixedType,1
6,1,0,7,mixedType,0
5,4,0,9,mixedType,1
11,3,0,14,mixedType,2
6,3,0,9,mixedType,1
6,3,0,9,mixedType,1
8,4,0,12,mixedType,1
10,3,0,13,mixedType,1
7,4,0,11,mixedType,1
6,3,0,9,mixedType,1
9,3,0,12,mixedType,1
6,1,0,7,mixedType,0
9,3,0,12,mixedType,1
5,3,0,8,mixedType,1
13,3,0,16,mixedType,2
6,4,0,10,mixedType,1
7,1,0,8,mixedType,1
1,8,0,9,mixedType,1
7,2,0,9,mixedType,1
6,6,0,12,mixedType,1
5,2,0,7,mixedType,0
9,3,0,12,mixedType,1
7,2,0,9,mixedType,1
4,6,0,10,mixedType,1
2,8,0,10,mixedType,1
6,4,0,10,mixedType,1
4,8,0,12,mixedType,1
1,10,0,11,mixedType,1
4,2,0,6,mixedType,0
5,2,0,7,mixedType,0
8,1,0,9,mixedType,1
2,6,0,8,mixedType,1
7,2,0,9,mixedType,1
4,8,0,12,mixedType,1
5,1,0,6,mixedType,0
1,8,0,9,mixedType,1
8,1,0,9,mixedType,1
11,5,0,16,mixedType,2
5,4,0,9,mixedType,1
6,7,1,14,mixedType,2
6,2,0,8,mixedType,1
4,2,0,6,mixedType,0
6,6,0,12,mixedType,1
13,3,0,16,mixedType,2
5,3,0,8,mixedType,1
2,6,0,8,mixedType,1
6,3,0,9,mixedType,1
5,2,0,7,mixedType,0
7,3,0,10,mixedType,1
6,2,0,8,mixedType,1
8,2,0,10,mixedType,1
7,1,0,8,mixedType,1
11,3,1,15,mixedType,2
5,4,0,9,mixedType,1
8,2,0,10,mixedType,1
6,3,0,9,mixedType,1
5,1,0,6,mixedType,0
2,8,0,10,mixedType,1
3,5,0,8,mixedType,1
4,7,0,11,mixedType,1
6,4,0,10,mixedType,1
7,1,0,8,mixedType,1
7,3,0,10,mixedType,1
15,1,0,16,mixedType,2
1,7,0,8,mixedType,1
5,7,0,12,mixedType,1
2,8,0,10,mixedType,1
13,3,0,16,mixedType,2
9,3,0,12,mixedType,1
12,4,0,16,mixedType,2
8,6,2,16,mixedType,2
14,2,0,16,mixedType,2
9,1,0,10,mixedType,1
12,4,0,16,mixedType,2
6,4,0,10,mixedType,1
6,4,0,10,mixedType,1
6,3,0,9,mixedType,1
15,1,0,16,mixedType,2
7,3,0,10,mixedType,1
8,2,0,10,mixedType,1
12,4,0,16,mixedType,2
5,3,0,8,mixedType,1
6,2,0,8,mixedType,1
5,2,0,7,mixedType,0
5,3,0,8,mixedType,1
6,2,0,8,mixedType,1
7,2,0,9,mixedType,1
5,3,0,8,mixedType,1
1,9,0,10,mixedType,1
5,1,0,6,mixedType,0
6,3,0,9,mixedType,1
8,1,0,9,mixedType,1
7,3,0,10,mixedType,1
14,2,0,16,mixedType,2
5,4,0,9,mixedType,1
7,2,0,9,mixedType,1
7,3,0,10,mixedType,1
3,3,0,6,mixedType,0
4,2,0,6,mixedType,0
5,4,0,9,mixedType,1
13,3,0,16,mixedType,2
8,2,0,10,mixedType,1
2,6,0,8,mixedType,1
8,2,0,10,mixedType,1
10,2,0,12,mixedType,1
8,1,0,9,mixedType,1
2,6,0,8,mixedType,1
2,6,0,8,mixedType,1
7,3,0,10,mixedType,1
6,3,0,9,mixedType,1
4,5,0,9,mixedType,1
3,8,0,11,mixedType,1
15,1,0,16,mixedType,2
7,1,0,8,mixedType,1
5,1,0,6,mixedType,0
8,1,0,9,mixedType,1
5,3,0,8,mixedType,1
12,1,0,13,mixedType,1
5,2,0,7,mixedType,0
8,5,0,13,mixedType,1
2,7,0,9,mixedType,1
5,2,0,7,mixedType,0
2,6,0,8,mixedType,1
7,3,0,10,mixedType,1
5,3,0,8,mixedType,1
6,5,0,11,mixedType,1
7,3,0,10,mixedType,1
6,4,0,10,mixedType,1
6,2,0,8,mixedType,1
6,2,0,8,mixedType,1
5,4,0,9,mixedType,1
14,2,0,16,mixedType,2
3,6,0,9,mixedType,1
6,1,0,7,mixedType,0
3,7,0,10,mixedType,1
7,3,0,10,mixedType,1
6,3,0,9,mixedType,1
3,6,0,9,mixedType,1
7,3,0,10,mixedType,1
6,3,0,9,mixedType,1
10,2,0,12,mixedType,1
8,4,0,12,mixedType,1
4,4,0,8,mixedType,1
7,4,0,11,mixedType,1
4,4,0,8,mixedType,1
0,8,2,10,mixedType,1
7,1,0,8,mixedType,1
4,4,0,8,mixedType,1
8,2,0,10,mixedType,1
14,2,0,16,mixedType,2
1,7,0,8,mixedType,1
10,3,0,13,mixedType,1
12,4,0,16,mixedType,2
6,3,0,9,mixedType,1
6,3,0,9,mixedType,1
6,2,0,8,mixedType,1
8,2,0,10,mixedType,1
5,4,0,9,mixedType,1
5,3,0,8,mixedType,1
5,3,0,8,mixedType,1
6,3,0,9,mixedType,1
3,6,0,9,mixedType,1
5,3,0,8,mixedType,1
14,2,0,16,mixedType,2
8,2,0,10,mixedType,1
7,3,0,10,mixedType,1
7,1,0,8,mixedType,1
5,4,0,9,mixedType,1
7,6,0,13,mixedType,1
7,1,0,8,mixedType,1
6,1,0,7,mixedType,0
14,2,0,16,mixedType,2
5,3,0,8,mixedType,1
3,6,0,9,mixedType,1
7,2,0,9,mixedType,1
5,4,0,9,mixedType,1
14,2,0,16,mixedType,2
6,3,0,9,mixedType,1
4,4,0,8,mixedType,1
5,3,0,8,mixedType,1
13,3,0,16,mixedType,2
15,1,0,16,mixedType,2
5,3,0,8,mixedType,1
1,8,0,9,mixedType,1
5,7,0,12,mixedType,1
8,2,0,10,mixedType,1
7,3,0,10,mixedType,1
5,4,0,9,mixedType,1
4,6,0,10,mixedType,1
7,5,0,12,mixedType,1
7,3,0,10,mixedType,1
6,2,0,8,mixedType,1
7,5,0,12,mixedType,1
8,2,0,10,mixedType,1
8,1,0,9,mixedType,1
5,2,0,7,mixedType,0
7,2,0,9,mixedType,1
3,3,0,6,mixedType,0
14,2,0,16,mixedType,2
8,2,0,10,mixedType,1
7,3,0,10,mixedType,1
5,3,0,8,mixedType,1
6,3,0,9,mixedType,1
8,1,0,9,mixedType,1
12,3,0,15,mixedType,2
6,3,0,9,mixedType,1
11,3,0,14,mixedType,2
10,1,0,11,mixedType,1
6,3,0,9,mixedType,1
6,3,0,9,mixedType,1
9,3,0,12,mixedType,1
5,4,0,9,mixedType,1
4,2,0,6,mixedType,0
6,2,0,8,mixedType,1
8,1,0,9,mixedType,1
3,9,0,12,mixedType,1
7,4,0,11,mixedType,1
6,1,0,7,mixedType,0
6,2,0,8,mixedType,1
3,6,0,9,mixedType,1
8,2,0,10,mixedType,1
4,2,0,6,mixedType,0
7,3,0,10,mixedType,1
6,1,0,7,mixedType,0
15,1,0,16,mixedType,2
14,2,0,16,mixedType,2
8,2,0,10,mixedType,1
4,5,0,9,mixedType,1
6,4,0,10,mixedType,1
3,7,0,10,mixedType,1
6,3,0,9,mixedType,1
6,3,0,9,mixedType,1
5,1,0,6,mixedType,0
3,5,0,8,mixedType,1
10,3,0,13,mixedType,1
9,5,0,14,mixedType,2
8,2,0,10,mixedType,1
11,3,0,14,mixedType,2
7,4,0,11,mixedType,1
6,1,0,7,mixedType,0
8,2,0,10,mixedType,1
15,1,0,16,mixedType,2
15,1,0,16,mixedType,2
6,1,0,7,mixedType,0
4,4,0,8,mixedType,1
8,4,0,12,mixedType,1
8,1,0,9,mixedType,1
8,2,0,10,mixedType,1
6,4,0,10,mixedType,1
6,3,0,9,mixedType,1
14,2,0,16,mixedType,2
6,3,0,9,mixedType,1
10,1,0,11,mixedType,1
11,5,0,16,mixedType,2
5,6,0,11,mixedType,1
5,4,0,9,mixedType,1
7,3,0,10,mixedType,1
2,10,0,12,mixedType,1
6,1,0,7,mixedType,0
17,3,0,20,mixedType,2
9,1,0,10,mixedType,1
6,4,0,10,mixedType,1
8,2,0,10,mixedType,1
14,2,0,16,mixedType,2
6,1,0,7,mixedType,0
3,8,0,11,mixedType,1
7,2,0,9,mixedType,1
6,2,0,8,mixedType,1
5,2,0,7,mixedType,0
5,3,0,8,mixedType,1
10,2,0,12,mixedType,1
6,1,0,7,mixedType,0
6,3,0,9,mixedType,1
4,2,0,6,mixedType,0
7,1,0,8,mixedType,1
6,4,0,10,mixedType,1
10,2,0,12,mixedType,1
7,1,0,8,mixedType,1
8,2,0,10,mixedType,1
5,4,0,9,mixedType,1
8,1,0,9,mixedType,1
5,2,0,7,mixedType,0
5,6,0,11,mixedType,1
7,2,0,9,mixedType,1
6,3,0,9,mixedType,1
7,3,0,10,mixedType,1
6,3,0,9,mixedType,1
6,1,0,7,mixedType,0
8,4,0,12,mixedType,1
11,4,1,16,mixedType,2
4,2,0,6,mixedType,0
7,2,0,9,mixedType,1
4,4,0,8,mixedType,1
5,8,0,13,mixedType,1
5,3,0,8,mixedType,1
14,2,0,16,mixedType,2
8,1,0,9,mixedType,1
7,5,0,12,mixedType,1
7,2,0,9,mixedType,1
6,2,0,8,mixedType,1
5,4,0,9,mixedType,1
9,1,0,10,mixedType,1
8,4,0,12,mixedType,1
8,1,0,9,mixedType,1
6,3,0,9,mixedType,1
3,7,0,10,mixedType,1
7,3,0,10,mixedType,1
8,4,0,12,mixedType,1
6,3,0,9,mixedType,1
7,1,0,8,mixedType,1
4,4,0,8,mixedType,1
6,3,0,9,mixedType,1
5,1,0,6,mixedType,0
5,2,0,7,mixedType,0
8,2,0,10,mixedType,1
7,4,0,11,mixedType,1
11,3,0,14,mixedType,2
11,3,0,14,mixedType,2
7,3,0,10,mixedType,1
4,4,0,8,mixedType,1
7,2,0,9,mixedType,1
3,3,0,6,mixedType,0
6,2,0,8,mixedType,1
7,1,0,8,mixedType,1
5,3,0,8,mixedType,1
4,4,0,8,mixedType,1
12,4,0,16,mixedType,2
1,8,0,9,mixedType,1
6,2,0,8,mixedType,1
9,1,0,10,mixedType,1
11,4,0,15,mixedType,2
6,1,0,7,mixedType,0
7,3,0,10,mixedType,1
9,2,0,11,mixedType,1
4,2,0,6,mixedType,0
7,3,0,10,mixedType,1
3,7,0,10,mixedType,1
12,3,0,15,mixedType,2
7,3,0,10,mixedType,1
8,1,0,9,mixedType,1
5,3,0,8,mixedType,1
8,3,0,11,mixedType,1
9,1,0,10,mixedType,1
8,1,0,9,mixedType,1
3,6,0,9,mixedType,1
6,2,0,8,mixedType,1
5,3,0,8,mixedType,1
7,1,0,8,mixedType,1
3,6,0,9,mixedType,1
15,1,0,16,mixedType,2
6,4,0,10,mixedType,1
5,1,0,6,mixedType,0
7,3,0,10,mixedType,1
8,1,0,9,mixedType,1
6,2,0,8,mixedType,1
10,2,0,12,mixedType,1
11,3,0,14,mixedType,2
8,4,0,12,mixedType,1
9,2,0,11,mixedType,1
9,2,0,11,mixedType,1
7,3,0,10,mixedType,1
7,3,0,10,mixedType,1
8,2,0,10,mixedType,1
0,8,1,9,mixedType,1
4,8,0,12,mixedType,1
7,4,0,11,mixedType,1
5,2,0,7,mixedType,0
9,3,0,12,mixedType,1
4,6,0,10,mixedType,1
6,3,0,9,mixedType,1
7,3,0,10,mixedType,1
4,2,0,6,mixedType,0
7,3,0,10,mixedType,1
5,8,0,13,mixedType,1
7,2,0,9,mixedType,1
12,1,0,13,mixedType,1
6,3,0,9,mixedType,1
14,2,0,16,mixedType,2
2,6,0,8,mixedType,1
9,1,0,10,mixedType,1
5,2,0,7,mixedType,0
13,3,0,16,mixedType,2
9,1,0,10,mixedType,1
6,4,0,10,mixedType,1
13,3,0,16,mixedType,2
4,5,0,9,mixedType,1
6,1,0,7,mixedType,0
7,1,0,8,mixedType,1
1,7,0,8,mixedType,1
5,3,0,8,mixedType,1
6,1,0,7,mixedType,0
4,2,0,6,mixedType,0
11,3,0,14,mixedType,2
12,4,0,16,mixedType,2
2,6,0,8,mixedType,1
8,0,1,9,mixedType,1
3,6,0,9,mixedType,1
15,1,0,16,mixedType,2
2,8,0,10,mixedType,1
6,3,0,9,mixedType,1
8,1,0,9,mixedType,1
5,3,0,8,mixedType,1
3,3,0,6,mixedType,0
7,2,0,9,mixedType,1
2,6,0,8,mixedType,1
7,1,0,8,mixedType,1
8,3,0,11,mixedType,1
8,2,0,10,mixedType,1
6,3,0,9,mixedType,1
6,2,0,8,mixedType,1
4,9,0,13,mixedType,1
6,3,0,9,mixedType,1
4,4,0,8,mixedType,1
7,3,0,10,mixedType,1
4,2,0,6,mixedType,0
7,3,0,10,mixedType,1
6,3,0,9,mixedType,1
5,3,0,8,mixedType,1
5,2,0,7,mixedType,0
6,1,0,7,mixedType,0
4,2,0,6,mixedType,0
7,2,0,9,mixedType,1
6,3,0,9,mixedType,1
8,0,1,9,mixedType,1
7,3,0,10,mixedType,1
4,2,0,6,mixedType,0
5,3,0,8,mixedType,1
5,3,0,8,mixedType,1
2,6,0,8,mixedType,1
5,8,0,13,mixedType,1
13,1,1,15,mixedType,2
5,3,0,8,mixedType,1
1,7,0,8,mixedType,1
10,2,0,12,mixedType,1
9,1,0,10,mixedType,1
4,4,0,8,mixedType,1
3,10,0,13,mixedType,1
4,5,0,9,mixedType,1
7,3,0,10,mixedType,1
7,5,0,12,mixedType,1
7,8,0,15,mixedType,2
12,4,0,16,mixedType,2
2,6,0,8,mixedType,1
5,5,0,10,mixedType,1
8,2,0,10,mixedType,1
7,2,0,9,mixedType,1
7,3,0,10,mixedType,1
7,3,0,10,mixedType,1
5,3,0,8,mixedType,1
5,3,0,8,mixedType,1
5,1,0,6,mixedType,0
3,5,0,8,mixedType,1
7,2,0,9,mixedType,1
11,3,0,14,mixedType,2
7,3,0,10,mixedType,1
3,5,0,8,mixedType,1
7,2,0,9,mixedType,1
5,1,0,6,mixedType,0
9,3,0,12,mixedType,1
6,3,0,9,mixedType,1
5,3,0,8,mixedType,1
5,2,0,7,mixedType,0
12,4,0,16,mixedType,2
7,1,0,8,mixedType,1
6,3,0,9,mixedType,1
3,3,0,6,mixedType,0
6,3,0,9,mixedType,1
5,2,0,7,mixedType,0
6,3,0,9,mixedType,1
1,10,0,11,mixedType,1
7,2,0,9,mixedType,1
10,2,0,12,mixedType,1
11,3,0,14,mixedType,2
9,1,0,10,mixedType,1
6,1,0,7,mixedType,0
8,1,0,9,mixedType,1
7,3,0,10,mixedType,1
7,2,0,9,mixedType,1
5,3,0,8,mixedType,1
1,9,0,10,mixedType,1
6,1,0,7,mixedType,0
12,3,0,15,mixedType,2
3,8,0,11,mixedType,1
6,3,0,9,mixedType,1
7,3,0,10,mixedType,1
7,3,0,10,mixedType,1
6,3,0,9,mixedType,1
8,2,0,10,mixedType,1
13,3,0,16,mixedType,2
8,2,0,10,mixedType,1
6,3,0,9,mixedType,1
6,4,0,10,mixedType,1
6,6,0,12,mixedType,1
6,3,0,9,mixedType,1
5,2,0,7,mixedType,0
12,4,0,16,mixedType,2
7,1,0,8,mixedType,1
7,2,0,9,mixedType,1
7,3,0,10,mixedType,1
5,2,0,7,mixedType,0
9,4,2,15,mixedType,2
5,1,0,6,mixedType,0
7,3,0,10,mixedType,1
6,1,0,7,mixedType,0
6,1,0,7,mixedType,0
4,9,0,13,mixedType,1
7,4,0,11,mixedType,1
6,3,0,9,mixedType,1
6,4,0,10,mixedType,1
8,2,0,10,mixedType,1
8,2,0,10,mixedType,1
7,1,0,8,mixedType,1
5,3,0,8,mixedType,1
4,2,0,6,mixedType,0
5,1,0,6,mixedType,0
6,4,0,10,mixedType,1
6,6,0,12,mixedType,1
9,6,1,16,mixedType,2
8,2,0,10,mixedType,1
8,2,0,10,mixedType,1
10,2,0,12,mixedType,1
7,3,0,10,mixedType,1
13,3,0,16,mixedType,2
10,3,0,13,mixedType,1
6,0,1,7,mixedType,0
4,2,0,6,mixedType,0
7,2,0,9,mixedType,1
6,2,0,8,mixedType,1
2,4,0,6,mixedType,0
7,1,0,8,mixedType,1
15,1,0,16,mixedType,2
8,1,0,9,mixedType,1
6,3,0,9,mixedType,1
5,4,0,9,mixedType,1
5,1,0,6,mixedType,0
6,2,0,8,mixedType,1
9,2,0,11,mixedType,1
6,4,0,10,mixedType,1
3,11,1,15,mixedType,2
7,2,0,9,mixedType,1
6,1,0,7,mixedType,0
2,6,0,8,mixedType,1
1,7,0,8,mixedType,1
8,1,0,9,mixedType,1
5,2,0,7,mixedType,0
1,8,0,9,mixedType,1
2,8,0,10,mixedType,1
8,2,0,10,mixedType,1
6,1,0,7,mixedType,0
7,1,0,8,mixedType,1
6,1,0,7,mixedType,0
6,4,0,10,mixedType,1
14,2,0,16,mixedType,2
5,1,0,6,mixedType,0
12,4,0,16,mixedType,2
4,2,0,6,mixedType,0
9,1,0,10,mixedType,1
15,1,0,16,mixedType,2
18,1,1,20,mixedType,2
13,3,0,16,mixedType,2
7,2,0,9,mixedType,1
5,1,0,6,mixedType,0
6,1,0,7,mixedType,0
4,2,0,6,mixedType,0
8,2,0,10,mixedType,1
7,3,0,10,mixedType,1
5,3,0,8,mixedType,1
2,8,0,10,mixedType,1
7,6,0,13,mixedType,1
6,2,0,8,mixedType,1
5,1,0,6,mixedType,0
5,3,0,8,mixedType,1
2,8,0,10,mixedType,1
9,1,0,10,mixedType,1
6,3,0,9,mixedType,1
8,2,0,10,mixedType,1
8,2,0,10,mixedType,1
15,1,0,16,mixedType,2
7,1,0,8,mixedType,1
6,3,0,9,mixedType,1
7,2,0,9,mixedType,1
7,3,0,10,mixedType,1
5,4,0,9,mixedType,1
12,3,0,15,mixedType,2
10,3,0,13,mixedType,1
5,4,0,9,mixedType,1
11,4,0,15,mixedType,2
1,8,0,9,mixedType,1
9,3,0,12,mixedType,1
9,1,0,10,mixedType,1
1,7,0,8,mixedType,1
4,6,0,10,mixedType,1
6,3,0,9,mixedType,1
5,4,0,9,mixedType,1
8,2,0,10,mixedType,1
4,2,0,6,mixedType,0
2,8,0,10,mixedType,1
8,2,0,10,mixedType,1
5,3,0,8,mixedType,1
6,4,0,10,mixedType,1
6,1,0,7,mixedType,0
7,3,0,10,mixedType,1
8,1,0,9,mixedType,1
6,1,0,7,mixedType,0
6,4,0,10,mixedType,1
9,2,0,11,mixedType,1
7,2,0,9,mixedType,1
4,5,0,9,mixedType,1
5,2,0,7,mixedType,0
14,2,0,16,mixedType,2
7,2,0,9,mixedType,1
8,4,0,12,mixedType,1
4,2,0,6,mixedType,0
7,2,0,9,mixedType,1
8,2,0,10,mixedType,1
7,3,0,10,mixedType,1
8,4,0,12,mixedType,1
5,3,0,8,mixedType,1
2,8,0,10,mixedType,1
6,1,0,7,mixedType,0
5,4,0,9,mixedType,1
5,5,0,10,mixedType,1
6,6,0,12,mixedType,1
7,1,0,8,mixedType,1
14,2,0,16,mixedType,2
7,3,0,10,mixedType,1
9,1,0,10,mixedType,1
13,3,0,16,mixedType,2
12,4,0,16,mixedType,2
6,1,0,7,mixedType,0
8,2,0,10,mixedType,1
5,3,0,8,mixedType,1
7,2,0,9,mixedType,1
3,6,0,9,mixedType,1
9,3,0,12,mixedType,1
4,2,0,6,mixedType,0
6,3,0,9,mixedType,1
8,4,0,12,mixedType,1
6,3,0,9,mixedType,1
5,2,0,7,mixedType,0
3,5,0,8,mixedType,1
6,4,0,10,mixedType,1
6,2,0,8,mixedType,1
6,4,0,10,mixedType,1
6,3,0,9,mixedType,1
5,5,0,10,mixedType,1
5,3,0,8,mixedType,1
6,2,0,8,mixedType,1
5,4,0,9,mixedType,1
1,7,0,8,mixedType,1
6,3,0,9,mixedType,1
6,3,0,9,mixedType,1
13,2,1,16,mixedType,2
5,3,0,8,mixedType,1
4,2,0,6,mixedType,0
6,0,2,8,mixedType,0
3,6,0,9,mixedType,1
7,2,0,9,mixedType,1
7,3,0,10,mixedType,1
9,2,0,11,mixedType,1
4,5,0,9,mixedType,1
4,4,0,8,mixedType,1
13,3,0,16,mixedType,2
7,3,0,10,mixedType,1
1,12,0,13,mixedType,1
9,1,0,10,mixedType,1
4,4,0,8,mixedType,1
7,2,0,9,mixedType,1
4,4,0,8,mixedType,1
7,3,0,10,mixedType,1
8,1,0,9,mixedType,1
6,2,0,8,mixedType,1
5,3,0,8,mixedType,1
11,3,0,14,mixedType,2
3,6,0,9,mixedType,1
6,2,0,8,mixedType,1
9,1,0,10,mixedType,1
7,1,0,8,mixedType,1
14,2,0,16,mixedType,2
14,2,0,16,mixedType,2
7,4,0,11,mixedType,1
5,5,0,10,mixedType,1
7,3,0,10,mixedType,1
5,4,0,9,mixedType,1
4,4,0,8,mixedType,1
15,1,0,16,mixedType,2
7,2,0,9,mixedType,1
3,6,0,9,mixedType,1
7,3,0,10,mixedType,1
6,3,0,9,mixedType,1
9,4,0,13,mixedType,1
8,4,0,12,mixedType,1
14,2,0,16,mixedType,2
5,2,0,7,mixedType,0
13,3,0,16,mixedType,2
8,2,0,10,mixedType,1
6,4,0,10,mixedType,1
4,2,0,6,mixedType,0
6,4,0,10,mixedType,1
4,2,0,6,mixedType,0
9,4,0,13,mixedType,1
5,4,0,9,mixedType,1
5,4,0,9,mixedType,1
9,1,0,10,mixedType,1
4,2,0,6,mixedType,0
8,4,0,12,mixedType,1
7,2,0,9,mixedType,1
8,2,0,10,mixedType,1
11,2,0,13,mixedType,1
8,2,0,10,mixedType,1
9,2,0,11,mixedType,1
6,3,0,9,mixedType,1
14,2,0,16,mixedType,2
6,3,0,9,mixedType,1
8,3,0,11,mixedType,1
8,2,0,10,mixedType,1
4,6,0,10,mixedType,1
6,1,0,7,mixedType,0
6,3,0,9,mixedType,1
5,2,0,7,mixedType,0
10,2,0,12,mixedType,1
9,1,0,10,mixedType,1
6,4,0,10,mixedType,1
2,7,0,9,mixedType,1
7,3,0,10,mixedType,1
8,3,0,11,mixedType,1
6,4,0,10,mixedType,1
8,1,0,9,mixedType,1
7,1,0,8,mixedType,1
8,5,0,13,mixedType,1
5,4,0,9,mixedType,1
8,3,0,11,mixedType,1
1,9,0,10,mixedType,1
6,3,0,9,mixedType,1
10,2,0,12,mixedType,1
9,1,0,10,mixedType,1
11,2,0,13,mixedType,1
7,2,0,9,mixedType,1
5,3,0,8,mixedType,1
8,1,0,9,mixedType,1
10,3,0,13,mixedType,1
8,1,0,9,mixedType,1
15,1,0,16,mixedType,2
6,3,0,9,mixedType,1
5,4,0,9,mixedType,1
8,2,0,10,mixedType,1
8,4,0,12,mixedType,1
13,3,0,16,mixedType,2
4,2,0,6,mixedType,0
9,1,0,10,mixedType,1
7,4,0,11,mixedType,1
5,2,0,7,mixedType,0
12,3,0,15,mixedType,2
4,4,0,8,mixedType,1
6,2,0,8,mixedType,1
7,3,0,10,mixedType,1
8,0,2,10,mixedType,1
7,2,0,9,mixedType,1
6,4,0,10,mixedType,1
6,3,0,9,mixedType,1
6,1,0,7,mixedType,0
5,5,0,10,mixedType,1
14,2,0,16,mixedType,2
3,7,0,10,mixedType,1
8,2,0,10,mixedType,1
3,7,0,10,mixedType,1
10,2,0,12,mixedType,1
3,6,0,9,mixedType,1
5,5,0,10,mixedType,1
3,7,0,10,mixedType,1
5,2,0,7,mixedType,0
7,4,0,11,mixedType,1
6,3,0,9,mixedType,1
4,2,0,6,mixedType,0
5,2,0,7,mixedType,0
4,4,0,8,mixedType,1
6,2,0,8,mixedType,1
10,1,0,11,mixedType,1
13,3,0,16,mixedType,2
1,8,0,9,mixedType,1
11,5,0,16,mixedType,2
8,1,0,9,mixedType,1
6,3,0,9,mixedType,1
4,2,0,6,mixedType,0
6,2,0,8,mixedType,1
8,1,0,9,mixedType,1
12,4,0,16,mixedType,2
8,3,0,11,mixedType,1
13,3,0,16,mixedType,2
9,3,0,12,mixedType,1
7,2,0,9,mixedType,1
6,4,0,10,mixedType,1
5,4,0,9,mixedType,1
6,2,0,8,mixedType,1
6,3,0,9,mixedType,1
2,8,0,10,mixedType,1
9,1,0,10,mixedType,1
3,8,0,11,mixedType,1
9,1,0,10,mixedType,1
6,4,0,10,mixedType,1
5,4,0,9,mixedType,1
13,3,0,16,mixedType,2
6,3,0,9,mixedType,1
14,2,0,16,mixedType,2
2,6,0,8,mixedType,1
5,2,0,7,mixedType,0
9,1,0,10,mixedType,1
5,6,0,11,mixedType,1
12,4,0,16,mixedType,2
6,1,0,7,mixedType,0
8,3,0,11,mixedType,1
5,1,0,6,mixedType,0
5,8,0,13,mixedType,1
14,2,0,16,mixedType,2
8,1,0,9,mixedType,1
9,1,0,10,mixedType,1
7,1,0,8,mixedType,1
7,3,0,10,mixedType,1
6,2,0,8,mixedType,1
7,2,0,9,mixedType,1
3,6,0,9,mixedType,1
3,5,0,8,mixedType,1
6,6,0,12,mixedType,1
4,2,0,6,mixedType,0
7,3,0,10,mixedType,1
3,3,0,6,mixedType,0
8,1,0,9,mixedType,1
7,3,0,10,mixedType,1
3,6,0,9,mixedType,1
7,1,0,8,mixedType,1
8,4,0,12,mixedType,1
6,1,0,7,mixedType,0
6,2,0,8,mixedType,1
9,4,0,13,mixedType,1
10,3,0,13,mixedType,1
5,4,0,9,mixedType,1
6,1,0,7,mixedType,0
6,3,0,9,mixedType,1
6,2,0,8,mixedType,1
5,4,0,9,mixedType,1
3,7,0,10,mixedType,1
3,3,0,6,mixedType,0
9,3,0,12,mixedType,1
8,1,0,9,mixedType,1
6,2,0,8,mixedType,1
5,2,0,7,mixedType,0
7,3,0,10,mixedType,1
9,7,1,17,mixedType,2
5,4,0,9,mixedType,1
5,3,0,8,mixedType,1
7,3,0,10,mixedType,1
5,4,0,9,mixedType,1
7,2,0,9,mixedType,1
6,4,0,10,mixedType,1
2,7,0,9,mixedType,1
7,3,0,10,mixedType,1
6,2,0,8,mixedType,1
5,6,0,11,mixedType,1
2,6,0,8,mixedType,1
4,6,0,10,mixedType,1
10,2,0,12,mixedType,1
7,3,0,10,mixedType,1
6,3,0,9,mixedType,1
4,4,0,8,mixedType,1
4,2,0,6,mixedType,0
6,1,0,7,mixedType,0
8,4,0,12,mixedType,1
12,3,0,15,mixedType,2
11,3,0,14,mixedType,2
4,4,0,8,mixedType,1
6,1,0,7,mixedType,0
5,2,0,7,mixedType,0
7,3,0,10,mixedType,1
4,6,0,10,mixedType,1
8,5,0,13,mixedType,1
8,3,0,11,mixedType,1
10,4,1,15,mixedType,2
6,1,0,7,mixedType,0
1,7,0,8,mixedType,1
5,3,0,8,mixedType,1
5,1,0,6,mixedType,0
6,2,0,8,mixedType,1
6,7,0,13,mixedType,1
3,3,0,6,mixedType,0
3,6,0,9,mixedType,1
8,1,0,9,mixedType,1
13,3,0,16,mixedType,2
14,2,0,16,mixedType,2
9,3,0,12,mixedType,1
6,3,0,9,mixedType,1
6,4,0,10,mixedType,1
7,1,0,8,mixedType,1
1,9,0,10,mixedType,1
8,2,0,10,mixedType,1
10,2,0,12,mixedType,1
8,1,0,9,mixedType,1
8,3,0,11,mixedType,1
7,3,0,10,mixedType,1
8,1,0,9,mixedType,1
7,3,0,10,mixedType,1
6,4,0,10,mixedType,1
7,3,0,10,mixedType,1
9,2,0,11,mixedType,1
1,7,0,8,mixedType,1
5,4,0,9,mixedType,1
11,2,0,13,mixedType,1
5,2,0,7,mixedType,0
8,2,0,10,mixedType,1
6,3,0,9,mixedType,1
6,3,0,9,mixedType,1
1,8,0,9,mixedType,1
6,1,0,7,mixedType,0
7,3,0,10,mixedType,1
6,2,0,8,mixedType,1
6,2,0,8,mixedType,1
8,1,0,9,mixedType,1
7,3,0,10,mixedType,1
14,2,0,16,mixedType,2
11,1,0,12,mixedType,1
7,4,0,11,mixedType,1
1,10,0,11,mixedType,1
5,4,0,9,mixedType,1
9,2,0,11,mixedType,1
6,4,0,10,mixedType,1
6,3,0,9,mixedType,1
4,2,0,6,mixedType,0
6,4,0,10,mixedType,1
4,4,0,8,mixedType,1
2,6,0,8,mixedType,1
8,2,0,10,mixedType,1
7,2,0,9,mixedType,1
9,1,0,10,mixedType,1
5,4,0,9,mixedType,1
7,2,0,9,mixedType,1
2,4,0,6,mixedType,0
5,3,0,8,mixedType,1
4,6,0,10,mixedType,1
13,3,0,16,mixedType,2
6,2,0,8,mixedType,1
4,2,0,6,mixedType,0
6,3,0,9,mixedType,1
4,4,0,8,mixedType,1
9,2,0,11,mixedType,1
4,2,0,6,mixedType,0
4,6,0,10,mixedType,1
5,2,0,7,mixedType,0
6,3,0,9,mixedType,1
12,4,0,16,mixedType,2
8,4,0,12,mixedType,1
3,6,0,9,mixedType,1
6,1,0,7,mixedType,0
7,1,0,8,mixedType,1
6,1,0,7,mixedType,0
6,4,0,10,mixedType,1
7,2,0,9,mixedType,1
3,8,0,11,mixedType,1
8,4,0,12,mixedType,1
5,1,0,6,mixedType,0
4,5,0,9,mixedType,1
5,3,0,8,mixedType,1
12,7,2,21,mixedType,2
15,1,0,16,mixedType,2
5,3,0,8,mixedType,1
8,2,0,10,mixedType,1
8,3,0,11,mixedType,1
6,6,0,12,mixedType,1
7,2,0,9,mixedType,1
8,2,0,10,mixedType,1
14,2,0,16,mixedType,2
5,2,0,7,mixedType,0
5,2,0,7,mixedType,0
6,4,0,10,mixedType,1
14,2,0,16,mixedType,2
9,1,0,10,mixedType,1
5,2,0,7,mixedType,0
8,1,0,9,mixedType,1
9,1,0,10,mixedType,1
6,3,0,9,mixedType,1
13,3,0,16,mixedType,2
6,2,0,8,mixedType,1
8,1,0,9,mixedType,1
1,7,0,8,mixedType,1
1,11,0,12,mixedType,1
8,2,0,10,mixedType,1
7,4,0,11,mixedType,1
6,7,0,13,mixedType,1
10,2,4,16,mixedType,2
7,2,0,9,mixedType,1
12,3,0,15,mixedType,2
2,6,0,8,mixedType,1
5,3,0,8,mixedType,1
4,4,0,8,mixedType,1
3,6,0,9,mixedType,1
11,5,0,16,mixedType,2
2,6,0,8,mixedType,1
9,2,0,11,mixedType,1
7,3,0,10,mixedType,1
2,8,0,10,mixedType,1
7,3,0,10,mixedType,1
6,4,0,10,mixedType,1
6,2,0,8,mixedType,1
9,1,0,10,mixedType,1
3,8,0,11,mixedType,1
5,3,0,8,mixedType,1
8,7,1,16,mixedType,2
7,3,0,10,mixedType,1
7,4,0,11,mixedType,1
10,3,1,14,mixedType,2
5,6,0,11,mixedType,1
12,4,0,16,mixedType,2
1,8,0,9,mixedType,1
6,2,0,8,mixedType,1
4,6,0,10,mixedType,1
8,4,0,12,mixedType,1
8,1,0,9,mixedType,1
11,1,0,12,mixedType,1
5,4,0,9,mixedType,1
7,1,0,8,mixedType,1
6,2,0,8,mixedType,1
7,3,0,10,mixedType,1
1,8,0,9,mixedType,1
6,4,0,10,mixedType,1
10,2,0,12,mixedType,1
6,6,0,12,mixedType,1
6,4,0,10,mixedType,1
7,7,0,14,mixedType,2
6,3,0,9,mixedType,1
4,2,0,6,mixedType,0
4,4,0,8,mixedType,1
5,6,0,11,mixedType,1
11,3,0,14,mixedType,2
3,6,0,9,mixedType,1
6,3,0,9,mixedType,1
4,4,0,8,mixedType,1
9,2,0,11,mixedType,1
13,3,0,16,mixedType,2
14,3,0,17,mixedType,2
24,1,1,26,mixedType,2
4,6,0,10,mixedType,1
3,6,0,9,mixedType,1
6,2,0,8,mixedType,1
7,4,0,11,mixedType,1
6,2,0,8,mixedType,1
4,4,0,8,mixedType,1
1,8,0,9,mixedType,1
14,2,0,16,mixedType,2
5,0,2,7,mixedType,0
11,1,0,12,mixedType,1
8,2,0,10,mixedType,1
6,3,0,9,mixedType,1
15,1,0,16,mixedType,2
9,1,0,10,mixedType,1
9,1,0,10,mixedType,1
5,4,0,9,mixedType,1
8,3,0,11,mixedType,1
4,2,0,6,mixedType,0
8,2,0,10,mixedType,1
6,2,0,8,mixedType,1
7,3,0,10,mixedType,1
8,3,0,11,mixedType,1
2,11,0,13,mixedType,1
5,4,0,9,mixedType,1
6,4,0,10,mixedType,1
8,3,0,11,mixedType,1
7,3,0,10,mixedType,1
3,6,0,9,mixedType,1
5,3,0,8,mixedType,1
4,2,0,6,mixedType,0
7,1,0,8,mixedType,1
6,4,0,10,mixedType,1
6,1,0,7,mixedType,0
7,2,0,9,mixedType,1
12,4,0,16,mixedType,2
5,0,1,6,mixedType,0
13,3,0,16,mixedType,2
8,2,0,10,mixedType,1
7,3,0,10,mixedType,1
7,3,0,10,mixedType,1
7,3,0,10,mixedType,1
15,1,0,16,mixedType,2
5,2,0,7,mixedType,0
6,3,0,9,mixedType,1
9,2,0,11,mixedType,1
5,4,0,9,mixedType,1
9,1,0,10,mixedType,1
6,1,0,7,mixedType,0
4,5,0,9,mixedType,1
6,4,0,10,mixedType,1
5,4,0,9,mixedType,1
5,2,0,7,mixedType,0
12,3,0,15,mixedType,2
3,3,0,6,mixedType,0
5,2,0,7,mixedType,0
6,2,0,8,mixedType,1
5,3,0,8,mixedType,1
5,3,0,8,mixedType,1
2,8,0,10,mixedType,1
8,3,0,11,mixedType,1
7,2,0,9,mixedType,1
7,3,0,10,mixedType,1
7,8,0,15,mixedType,2
2,10,0,12,mixedType,1
4,4,0,8,mixedType,1
4,6,0,10,mixedType,1
5,2,0,7,mixedType,0
6,3,0,9,mixedType,1
11,3,0,14,mixedType,2
13,2,0,15,mixedType,2
6,4,0,10,mixedType,1
7,3,0,10,mixedType,1
5,2,0,7,mixedType,0
9,1,0,10,mixedType,1
8,4,0,12,mixedType,1
6,3,0,9,mixedType,1
13,3,0,16,mixedType,2
8,1,0,9,mixedType,1
6,3,0,9,mixedType,1
8,1,0,9,mixedType,1
9,1,0,10,mixedType,1
7,1,0,8,mixedType,1
6,2,0,8,mixedType,1
12,1,0,13,mixedType,1
13,3,0,16,mixedType,2
7,3,0,10,mixedType,1
5,6,0,11,mixedType,1
7,2,0,9,mixedType,1
10,3,0,13,mixedType,1
6,3,0,9,mixedType,1
5,2,0,7,mixedType,0
6,3,0,9,mixedType,1
4,6,0,10,mixedType,1
6,1,0,7,mixedType,0
13,3,0,16,mixedType,2
7,3,0,10,mixedType,1
6,3,0,9,mixedType,1
10,2,0,12,mixedType,1
8,1,0,9,mixedType,1
4,8,0,12,mixedType,1
9,1,0,10,mixedType,1
5,3,0,8,mixedType,1
7,5,0,12,mixedType,1
2,6,0,8,mixedType,1
5,3,0,8,mixedType,1
15,1,0,16,mixedType,2
6,2,0,8,mixedType,1
4,7,0,11,mixedType,1
5,1,0,6,mixedType,0
8,2,0,10,mixedType,1
13,3,0,16,mixedType,2
7,4,0,11,mixedType,1
6,7,0,13,mixedType,1
8,1,0,9,mixedType,1
1,9,0,10,mixedType,1
7,2,0,9,mixedType,1
5,3,0,8,mixedType,1
5,3,0,8,mixedType,1
5,3,0,8,mixedType,1
10,2,0,12,mixedType,1
6,1,0,7,mixedType,0
5,2,0,7,mixedType,0
6,3,0,9,mixedType,1
8,1,0,9,mixedType,1
6,4,0,10,mixedType,1
10,6,0,16,mixedType,2
3,7,0,10,mixedType,1
6,6,0,12,mixedType,1
4,6,0,10,mixedType,1
6,3,0,9,mixedType,1
4,4,0,8,mixedType,1
3,3,0,6,mixedType,0
8,4,0,12,mixedType,1
8,2,0,10,mixedType,1
5,3,0,8,mixedType,1
6,1,0,7,mixedType,0
5,4,0,9,mixedType,1
14,2,0,16,mixedType,2
10,1,0,11,mixedType,1
11,5,0,16,mixedType,2
8,2,0,10,mixedType,1
12,1,0,13,mixedType,1
8,2,0,10,mixedType,1
4,9,0,13,mixedType,1
5,4,0,9,mixedType,1
6,3,0,9,mixedType,1
8,1,0,9,mixedType,1
3,6,0,9,mixedType,1
14,2,0,16,mixedType,2
2,6,0,8,mixedType,1
8,2,0,10,mixedType,1
2,8,0,10,mixedType,1
14,2,0,16,mixedType,2
2,6,0,8,mixedType,1
7,3,0,10,mixedType,1
6,2,0,8,mixedType,1
5,2,0,7,mixedType,0
6,1,0,7,mixedType,0
8,1,0,9,mixedType,1
11,3,0,14,mixedType,2
6,1,0,7,mixedType,0
5,1,0,6,mixedType,0
3,7,0,10,mixedType,1
6,1,0,7,mixedType,0
7,2,0,9,mixedType,1
9,3,0,12,mixedType,1
1,8,0,9,mixedType,1
11,3,0,14,mixedType,2
8,4,0,12,mixedType,1
7,4,0,11,mixedType,1
7,1,0,8,mixedType,1
6,3,0,9,mixedType,1
14,2,0,16,mixedType,2
8,4,0,12,mixedType,1
11,3,0,14,mixedType,2
6,2,0,8,mixedType,1
5,8,0,13,mixedType,1
10,3,0,13,mixedType,1
4,6,0,10,mixedType,1
5,6,0,11,mixedType,1
1,7,0,8,mixedType,1
5,4,0,9,mixedType,1
9,0,1,10,mixedType,1
6,1,0,7,mixedType,0
6,1,0,7,mixedType,0
4,4,0,8,mixedType,1
6,1,0,7,mixedType,0
14,2,0,16,mixedType,2
3,3,0,6,mixedType,0
5,2,0,7,mixedType,0
3,6,0,9,mixedType,1
7,3,0,10,mixedType,1
6,3,0,9,mixedType,1
11,1,0,12,mixedType,1
4,4,0,8,mixedType,1
4,4,0,8,mixedType,1
8,2,0,10,mixedType,1
6,2,0,8,mixedType,1
11,3,0,14,mixedType,2
2,6,0,8,mixedType,1
7,2,0,9,mixedType,1
7,2,0,9,mixedType,1
7,2,0,9,mixedType,1
10,1,0,11,mixedType,1
4,4,0,8,mixedType,1
6,2,0,8,mixedType,1
12,3,0,15,mixedType,2
16,4,0,20,mixedType,2
6,2,0,8,mixedType,1
10,3,0,13,mixedType,1
6,3,0,9,mixedType,1
8,5,0,13,mixedType,1
4,2,0,6,mixedType,0
7,1,0,8,mixedType,1
6,8,0,14,mixedType,2
5,6,0,11,mixedType,1
6,2,0,8,mixedType,1
13,3,0,16,mixedType,2
6,2,0,8,mixedType,1
4,2,0,6,mixedType,0
9,3,0,12,mixedType,1
6,2,0,8,mixedType,1
1,6,0,7,mixedType,0
7,3,0,10,mixedType,1
8,4,0,12,mixedType,1
6,1,0,7,mixedType,0
14,2,0,16,mixedType,2
6,4,0,10,mixedType,1
12,4,0,16,mixedType,2
8,2,0,10,mixedType,1
5,3,0,8,mixedType,1
9,2,0,11,mixedType,1
6,1,0,7,mixedType,0
12,3,0,15,mixedType,2
7,2,0,9,mixedType,1
6,4,0,10,mixedType,1
5,4,0,9,mixedType,1
7,3,0,10,mixedType,1
5,4,0,9,mixedType,1
2,8,0,10,mixedType,1
8,1,0,9,mixedType,1
7,2,0,9,mixedType,1
6,4,0,10,mixedType,1
9,2,0,11,mixedType,1
0,6,2,8,mixedType,1
8,1,0,9,mixedType,1
16,4,0,20,mixedType,2
4,5,0,9,mixedType,1
5,4,0,9,mixedType,1
2,6,0,8,mixedType,1
15,4,0,19,mixedType,2
6,1,0,7,mixedType,0
6,2,0,8,mixedType,1
8,2,0,10,mixedType,1
6,3,0,9,mixedType,1
6,4,0,10,mixedType,1
9,1,0,10,mixedType,1
5,6,0,11,mixedType,1
2,7,0,9,mixedType,1
8,1,0,9,mixedType,1
15,1,0,16,mixedType,2
5,4,0,9,mixedType,1
5,1,0,6,mixedType,0
13,3,0,16,mixedType,2
8,2,0,10,mixedType,1
8,2,0,10,mixedType,1
4,4,0,8,mixedType,1
4,6,0,10,mixedType,1
4,6,0,10,mixedType,1
13,3,0,16,mixedType,2
9,1,0,10,mixedType,1
6,3,0,9,mixedType,1
14,2,0,16,mixedType,2
9,1,0,10,mixedType,1
9,2,0,11,mixedType,1
8,1,0,9,mixedType,1
6,3,0,9,mixedType,1
1,10,0,11,mixedType,1
7,3,0,10,mixedType,1
8,1,0,9,mixedType,1
1,5,0,6,mixedType,0
8,2,0,10,mixedType,1
7,2,0,9,mixedType,1
6,1,0,7,mixedType,0
6,3,0,9,mixedType,1
6,1,0,7,mixedType,0
9,1,0,10,mixedType,1
6,2,0,8,mixedType,1
6,3,0,9,mixedType,1
6,1,0,7,mixedType,0
7,2,0,9,mixedType,1
5,3,0,8,mixedType,1
2,6,0,8,mixedType,1
10,2,0,12,mixedType,1
6,1,0,7,mixedType,0
5,2,0,7,mixedType,0
5,4,0,9,mixedType,1
1,9,0,10,mixedType,1
5,3,0,8,mixedType,1
5,2,0,7,mixedType,0
14,2,0,16,mixedType,2
4,5,0,9,mixedType,1
7,2,0,9,mixedType,1
8,1,0,9,mixedType,1
11,2,0,13,mixedType,1
6,2,0,8,mixedType,1
7,5,0,12,mixedType,1
7,3,0,10,mixedType,1
1,8,0,9,mixedType,1
9,2,0,11,mixedType,1
2,7,0,9,mixedType,1
5,2,0,7,mixedType,0
5,3,0,8,mixedType,1
8,4,0,12,mixedType,1
15,1,0,16,mixedType,2
4,7,0,11,mixedType,1
8,1,0,9,mixedType,1
2,7,0,9,mixedType,1
6,1,0,7,mixedType,0
14,2,0,16,mixedType,2
10,1,0,11,mixedType,1
3,6,0,9,mixedType,1
1,8,0,9,mixedType,1
2,4,0,6,mixedType,0
8,2,0,10,mixedType,1
1,8,0,9,mixedType,1
8,3,0,11,mixedType,1
15,1,0,16,mixedType,2
8,4,0,12,mixedType,1
8,2,0,10,mixedType,1
6,2,0,8,mixedType,1
8,1,0,9,mixedType,1
7,1,0,8,mixedType,1
11,2,0,13,mixedType,1
12,3,0,15,mixedType,2
7,2,0,9,mixedType,1
1,9,0,10,mixedType,1
7,3,0,10,mixedType,1
4,5,0,9,mixedType,1
8,2,0,10,mixedType,1
1,8,0,9,mixedType,1
3,7,0,10,mixedType,1
5,3,0,8,mixedType,1
7,1,0,8,mixedType,1
6,1,0,7,mixedType,0
9,1,0,10,mixedType,1
8,2,0,10,mixedType,1
6,4,0,10,mixedType,1
7,4,0,11,mixedType,1
7,3,0,10,mixedType,1
7,3,0,10,mixedType,1
4,4,0,8,mixedType,1
10,1,0,11,mixedType,1
6,2,0,8,mixedType,1
14,2,0,16,mixedType,2
3,6,0,9,mixedType,1
6,1,0,7,mixedType,0
5,5,0,10,mixedType,1
10,2,0,12,mixedType,1
7,6,0,13,mixedType,1
7,0,1,8,mixedType,1
6,3,0,9,mixedType,1
6,2,0,8,mixedType,1
6,4,0,10,mixedType,1
7,6,0,13,mixedType,1
5,1,0,6,mixedType,0
6,3,0,9,mixedType,1
2,6,0,8,mixedType,1
14,2,0,16,mixedType,2
4,4,0,8,mixedType,1
5,2,0,7,mixedType,0
9,2,0,11,mixedType,1
15,1,0,16,mixedType,2
5,3,0,8,mixedType,1
8,2,0,10,mixedType,1
7,4,0,11,mixedType,1
5,2,0,7,mixedType,0
5,4,0,9,mixedType,1
9,3,0,12,mixedType,1
5,3,0,8,mixedType,1
7,2,0,9,mixedType,1
2,6,0,8,mixedType,1
2,8,0,10,mixedType,1
5,6,0,11,mixedType,1
9,1,0,10,mixedType,1
9,4,0,13,mixedType,1
4,4,0,8,mixedType,1
7,1,0,8,mixedType,1
6,3,0,9,mixedType,1
4,4,0,8,mixedType,1
2,6,0,8,mixedType,1
2,6,0,8,mixedType,1
4,4,0,8,mixedType,1
6,2,0,8,mixedType,1
15,1,0,16,mixedType,2
6,3,0,9,mixedType,1
6,3,0,9,mixedType,1
14,2,0,16,mixedType,2
14,2,0,16,mixedType,2
2,8,0,10,mixedType,1
6,2,0,8,mixedType,1
6,3,0,9,mixedType,1
3,6,0,9,mixedType,1
6,4,0,10,mixedType,1
6,3,0,9,mixedType,1
7,2,0,9,mixedType,1
7,1,0,8,mixedType,1
13,3,0,16,mixedType,2
7,5,0,12,mixedType,1
8,5,0,13,mixedType,1
6,3,0,9,mixedType,1
7,2,0,9,mixedType,1
5,3,0,8,mixedType,1
9,1,0,10,mixedType,1
5,3,0,8,mixedType,1
2,7,0,9,mixedType,1
3,5,0,8,mixedType,1
12,3,0,15,mixedType,2
5,2,0,7,mixedType,0
8,1,0,9,mixedType,1
4,8,0,12,mixedType,1
6,2,0,8,mixedType,1
7,1,0,8,mixedType,1
7,3,0,10,mixedType,1
14,2,0,16,mixedType,2
8,3,0,11,mixedType,1
0,10,1,11,mixedType,1
5,2,0,7,mixedType,0
5,2,0,7,mixedType,0
5,3,0,8,mixedType,1
6,2,0,8,mixedType,1
8,3,0,11,mixedType,1
3,6,0,9,mixedType,1
6,2,0,8,mixedType,1
6,3,0,9,mixedType,1
5,2,0,7,mixedType,0
8,3,0,11,mixedType,1
5,2,0,7,mixedType,0
6,6,0,12,mixedType,1
9,4,0,13,mixedType,1
7,2,0,9,mixedType,1
7,3,0,10,mixedType,1
2,6,0,8,mixedType,1
6,2,0,8,mixedType,1
8,1,0,9,mixedType,1
3,8,0,11,mixedType,1
6,2,0,8,mixedType,1
5,1,0,6,mixedType,0
6,1,0,7,mixedType,0
6,1,0,7,mixedType,0
6,2,0,8,mixedType,1
7,4,0,11,mixedType,1
7,2,0,9,mixedType,1
7,3,0,10,mixedType,1
12,3,0,15,mixedType,2
15,1,0,16,mixedType,2
8,2,0,10,mixedType,1
6,3,0,9,mixedType,1
2,6,0,8,mixedType,1
6,3,0,9,mixedType,1
6,3,0,9,mixedType,1
12,4,0,16,mixedType,2
5,1,0,6,mixedType,0
8,1,0,9,mixedType,1
1,11,0,12,mixedType,1
7,2,0,9,mixedType,1
6,2,0,8,mixedType,1
7,2,0,9,mixedType,1
4,4,0,8,mixedType,1
8,2,0,10,mixedType,1
11,2,0,13,mixedType,1
5,2,0,7,mixedType,0
8,2,0,10,mixedType,1
6,3,0,9,mixedType,1
5,3,0,8,mixedType,1
9,3,0,12,mixedType,1
8,1,0,9,mixedType,1
2,4,0,6,mixedType,0
15,1,0,16,mixedType,2
8,2,0,10,mixedType,1
7,2,0,9,mixedType,1
7,2,0,9,mixedType,1
7,3,0,10,mixedType,1
4,6,0,10,mixedType,1
6,2,0,8,mixedType,1
7,2,0,9,mixedType,1
6,6,0,12,mixedType,1
6,3,0,9,mixedType,1
7,3,0,10,mixedType,1
7,1,0,8,mixedType,1
6,7,0,13,mixedType,1
14,2,0,16,mixedType,2
8,2,0,10,mixedType,1
6,3,0,9,mixedType,1
12,4,0,16,mixedType,2
1,8,0,9,mixedType,1
4,6,0,10,mixedType,1
9,3,0,12,mixedType,1
8,1,0,9,mixedType,1
6,2,0,8,mixedType,1
6,3,0,9,mixedType,1
6,4,0,10,mixedType,1
4,2,0,6,mixedType,0
8,4,0,12,mixedType,1
7,3,0,10,mixedType,1
8,1,0,9,mixedType,1
7,1,0,8,mixedType,1
2,6,0,8,mixedType,1
8,2,0,10,mixedType,1
11,5,0,16,mixedType,2
14,1,0,15,mixedType,2
7,4,0,11,mixedType,1
4,2,0,6,mixedType,0
6,3,0,9,mixedType,1
2,8,0,10,mixedType,1
6,2,0,8,mixedType,1
6,3,0,9,mixedType,1
5,4,0,9,mixedType,1
4,4,0,8,mixedType,1
8,2,0,10,mixedType,1
8,1,0,9,mixedType,1
7,2,0,9,mixedType,1
0,7,0,7,sameType,1
6,3,0,9,mixedType,1
4,5,0,9,mixedType,1
7,3,0,10,mixedType,1
7,1,0,8,mixedType,1
7,3,0,10,mixedType,1
7,1,0,8,mixedType,1
5,4,0,9,mixedType,1
10,3,0,13,mixedType,1
5,2,0,7,mixedType,0
5,2,0,7,mixedType,0
9,2,0,11,mixedType,1
2,10,0,12,mixedType,1
12,4,0,16,mixedType,2
11,3,0,14,mixedType,2
8,2,0,10,mixedType,1
7,1,0,8,mixedType,1
6,2,0,8,mixedType,1
8,1,0,9,mixedType,1
5,4,0,9,mixedType,1
5,3,0,8,mixedType,1
9,1,0,10,mixedType,1
15,1,0,16,mixedType,2
7,3,0,10,mixedType,1
5,2,0,7,mixedType,0
2,6,0,8,mixedType,1
6,4,0,10,mixedType,1
5,1,0,6,mixedType,0
6,2,0,8,mixedType,1
8,4,0,12,mixedType,1
3,7,0,10,mixedType,1
5,3,0,8,mixedType,1
4,2,0,6,mixedType,0
5,2,0,7,mixedType,0
7,3,0,10,mixedType,1
1,9,0,10,mixedType,1
5,4,0,9,mixedType,1
15,1,0,16,mixedType,2
6,6,0,12,mixedType,1
7,2,0,9,mixedType,1
14,2,0,16,mixedType,2
8,2,0,10,mixedType,1
3,6,0,9,mixedType,1
7,2,0,9,mixedType,1
9,1,0,10,mixedType,1
6,3,0,9,mixedType,1
13,3,2,18,mixedType,2
8,2,0,10,mixedType,1
3,6,0,9,mixedType,1
5,2,0,7,mixedType,0
5,3,0,8,mixedType,1
7,3,0,10,mixedType,1
5,3,0,8,mixedType,1
6,3,0,9,mixedType,1
7,3,0,10,mixedType,1
11,3,1,15,mixedType,2
6,3,0,9,mixedType,1
5,3,0,8,mixedType,1
4,4,0,8,mixedType,1
8,2,0,10,mixedType,1
3,9,0,12,mixedType,1
7,2,0,9,mixedType,1
9,1,0,10,mixedType,1
5,3,0,8,mixedType,1
5,4,0,9,mixedType,1
7,3,0,10,mixedType,1
6,2,0,8,mixedType,1
12,1,0,13,mixedType,1
7,2,0,9,mixedType,1
6,4,0,10,mixedType,1
7,1,0,8,mixedType,1
4,4,0,8,mixedType,1
6,4,0,10,mixedType,1
4,4,0,8,mixedType,1
7,3,0,10,mixedType,1
5,3,0,8,mixedType,1
7,1,0,8,mixedType,1
6,4,0,10,mixedType,1
6,4,0,10,mixedType,1
4,5,0,9,mixedType,1
7,3,0,10,mixedType,1
5,1,0,6,mixedType,0
6,4,0,10,mixedType,1
10,4,0,14,mixedType,2
8,3,0,11,mixedType,1
14,2,0,16,mixedType,2
7,1,0,8,mixedType,1
6,3,0,9,mixedType,1
5,4,0,9,mixedType,1
3,6,0,9,mixedType,1
7,3,0,10,mixedType,1
2,9,0,11,mixedType,1
4,4,0,8,mixedType,1
8,4,8,20,mixedType,2
8,3,0,11,mixedType,1
7,3,0,10,mixedType,1
5,2,0,7,mixedType,0
5,2,0,7,mixedType,0
6,3,0,9,mixedType,1
6,3,0,9,mixedType,1
11,5,0,16,mixedType,2
7,1,0,8,mixedType,1
7,3,0,10,mixedType,1
5,2,0,7,mixedType,0
6,4,0,10,mixedType,1
6,4,0,10,mixedType,1
7,3,0,10,mixedType,1
7,3,0,10,mixedType,1
12,3,0,15,mixedType,2
8,3,0,11,mixedType,1
7,1,0,8,mixedType,1
7,3,0,10,mixedType,1
5,3,0,8,mixedType,1
8,4,0,12,mixedType,1
15,1,0,16,mixedType,2
4,5,0,9,mixedType,1
4,4,0,8,mixedType,1
6,2,0,8,mixedType,1
10,2,0,12,mixedType,1
4,4,0,8,mixedType,1
11,5,0,16,mixedType,2
14,2,0,16,mixedType,2
4,4,0,8,mixedType,1
12,1,0,13,mixedType,1
4,7,0,11,mixedType,1
5,5,0,10,mixedType,1
5,3,0,8,mixedType,1
1,8,0,9,mixedType,1
1,8,0,9,mixedType,1
5,2,0,7,mixedType,0
5,3,0,8,mixedType,1
14,2,0,16,mixedType,2
2,6,0,8,mixedType,1
8,1,0,9,mixedType,1
9,2,0,11,mixedType,1
5,3,0,8,mixedType,1
10,2,0,12,mixedType,1
0,8,3,11,mixedType,1
8,1,0,9,mixedType,1
5,2,0,7,mixedType,0
7,1,0,8,mixedType,1
5,1,0,6,mixedType,0
8,2,0,10,mixedType,1
9,1,0,10,mixedType,1
3,8,0,11,mixedType,1
4,2,0,6,mixedType,0
5,2,0,7,mixedType,0
15,1,0,16,mixedType,2
5,4,0,9,mixedType,1
6,3,0,9,mixedType,1
7,4,0,11,mixedType,1
4,11,0,15,mixedType,2
4,5,0,9,mixedType,1
8,2,0,10,mixedType,1
3,3,0,6,mixedType,0
6,3,0,9,mixedType,1
15,1,0,16,mixedType,2
7,1,0,8,mixedType,1
8,2,0,10,mixedType,1
5,3,0,8,mixedType,1
5,3,0,8,mixedType,1
6,1,0,7,mixedType,0
5,7,0,12,mixedType,1
5,1,0,6,mixedType,0
8,2,0,10,mixedType,1
6,1,0,7,mixedType,0
6,2,0,8,mixedType,1
12,3,0,15,mixedType,2
13,3,0,16,mixedType,2
7,3,0,10,mixedType,1
12,4,0,16,mixedType,2
8,4,0,12,mixedType,1
8,1,0,9,mixedType,1
4,6,0,10,mixedType,1
6,3,0,9,mixedType,1
2,8,0,10,mixedType,1
6,2,0,8,mixedType,1
8,2,0,10,mixedType,1
5,3,0,8,mixedType,1
7,3,0,10,mixedType,1
7,2,0,9,mixedType,1
1,8,0,9,mixedType,1
5,4,0,9,mixedType,1
5,3,0,8,mixedType,1
14,2,0,16,mixedType,2
14,2,0,16,mixedType,2
7,1,0,8,mixedType,1
5,4,0,9,mixedType,1
12,3,0,15,mixedType,2
5,6,0,11,mixedType,1
6,3,0,9,mixedType,1
5,4,0,9,mixedType,1
10,1,0,11,mixedType,1
2,8,0,10,mixedType,1
2,8,0,10,mixedType,1
7,3,0,10,mixedType,1
1,9,0,10,mixedType,1
6,3,0,9,mixedType,1
5,2,0,7,mixedType,0
8,1,0,9,mixedType,1
5,2,0,7,mixedType,0
3,6,0,9,mixedType,1
6,2,0,8,mixedType,1
5,3,0,8,mixedType,1
3,6,0,9,mixedType,1
7,1,0,8,mixedType,1
5,2,0,7,mixedType,0
6,1,0,7,mixedType,0
1,8,0,9,mixedType,1
5,3,0,8,mixedType,1
8,2,0,10,mixedType,1
5,4,0,9,mixedType,1
5,4,0,9,mixedType,1
9,1,0,10,mixedType,1
7,2,0,9,mixedType,1
6,3,0,9,mixedType,1
9,1,0,10,mixedType,1
7,3,0,10,mixedType,1
5,1,0,6,mixedType,0
4,2,0,6,mixedType,0
10,3,0,13,mixedType,1
9,3,0,12,mixedType,1
8,2,0,10,mixedType,1
4,8,0,12,mixedType,1
7,2,0,9,mixedType,1
12,3,0,15,mixedType,2
5,4,0,9,mixedType,1
6,0,2,8,mixedType,0
8,2,0,10,mixedType,1
14,2,0,16,mixedType,2
5,4,0,9,mixedType,1
7,2,0,9,mixedType,1
7,3,0,10,mixedType,1
14,2,0,16,mixedType,2
5,4,0,9,mixedType,1
8,3,0,11,mixedType,1
4,6,0,10,mixedType,1
2,6,0,8,mixedType,1
4,6,0,10,mixedType,1
6,4,0,10,mixedType,1
6,4,0,10,mixedType,1
4,4,0,8,mixedType,1
13,3,0,16,mixedType,2
6,1,0,7,mixedType,0
5,2,0,7,mixedType,0
2,6,0,8,mixedType,1
8,4,0,12,mixedType,1
8,2,0,10,mixedType,1
4,2,0,6,mixedType,0
7,3,0,10,mixedType,1
12,1,0,13,mixedType,1
7,3,0,10,mixedType,1
7,1,0,8,mixedType,1
1,8,0,9,mixedType,1
12,1,0,13,mixedType,1
7,8,0,15,mixedType,2
5,3,0,8,mixedType,1
8,1,0,9,mixedType,1
5,1,0,6,mixedType,0
5,3,0,8,mixedType,1
6,3,0,9,mixedType,1
4,4,0,8,mixedType,1
5,4,0,9,mixedType,1
5,3,0,8,mixedType,1
6,2,0,8,mixedType,1
6,6,0,12,mixedType,1
6,4,0,10,mixedType,1
6,3,0,9,mixedType,1
6,3,0,9,mixedType,1
7,2,0,9,mixedType,1
5,2,0,7,mixedType,0
12,4,0,16,mixedType,2
8,2,0,10,mixedType,1
7,4,0,11,mixedType,1
6,3,0,9,mixedType,1
5,2,0,7,mixedType,0
4,2,0,6,mixedType,0
13,3,0,16,mixedType,2
14,2,0,16,mixedType,2
4,2,0,6,mixedType,0
8,3,0,11,mixedType,1
13,3,0,16,mixedType,2
6,4,0,10,mixedType,1
5,3,0,8,mixedType,1
9,1,0,10,mixedType,1
8,2,0,10,mixedType,1
6,2,1,9,mixedType,1
5,2,0,7,mixedType,0
7,3,0,10,mixedType,1
6,4,0,10,mixedType,1
10,3,0,13,mixedType,1
6,4,0,10,mixedType,1
3,5,0,8,mixedType,1
1,7,0,8,mixedType,1
3,6,0,9,mixedType,1
4,2,0,6,mixedType,0
7,1,0,8,mixedType,1
5,3,0,8,mixedType,1
2,9,0,11,mixedType,1
7,2,0,9,mixedType,1
8,1,0,9,mixedType,1
8,3,0,11,mixedType,1
8,3,0,11,mixedType,1
14,2,0,16,mixedType,2
6,4,0,10,mixedType,1
4,6,0,10,mixedType,1
7,2,0,9,mixedType,1
2,8,0,10,mixedType,1
7,1,0,8,mixedType,1
9,3,0,12,mixedType,1
7,2,0,9,mixedType,1
6,3,0,9,mixedType,1
1,8,0,9,mixedType,1
6,4,0,10,mixedType,1
5,2,0,7,mixedType,0
7,4,0,11,mixedType,1
4,5,0,9,mixedType,1
11,0,1,12,mixedType,1
6,4,0,10,mixedType,1
9,1,0,10,mixedType,1
9,1,0,10,mixedType,1
4,2,0,6,mixedType,0
7,1,0,8,mixedType,1
4,2,0,6,mixedType,0
9,1,0,10,mixedType,1
5,3,0,8,mixedType,1
7,2,0,9,mixedType,1
10,4,0,14,mixedType,2
9,1,0,10,mixedType,1
4,4,0,8,mixedType,1
4,4,0,8,mixedType,1
6,2,0,8,mixedType,1
6,3,0,9,mixedType,1
8,1,0,9,mixedType,1
7,1,0,8,mixedType,1
15,1,0,16,mixedType,2
9,3,0,12,mixedType,1
6,6,0,12,mixedType,1
5,1,0,6,mixedType,0
13,3,0,16,mixedType,2
9,3,0,12,mixedType,1
10,4,0,14,mixedType,2
14,2,0,16,mixedType,2
4,2,0,6,mixedType,0
11,3,0,14,mixedType,2
8,1,0,9,mixedType,1
6,1,0,7,mixedType,0
7,3,0,10,mixedType,1
8,2,0,10,mixedType,1
5,1,0,6,mixedType,0
1,9,0,10,mixedType,1
5,2,0,7,mixedType,0
8,4,0,12,mixedType,1
6,2,0,8,mixedType,1
15,1,0,16,mixedType,2
2,9,0,11,mixedType,1
7,2,0,9,mixedType,1
5,2,0,7,mixedType,0
6,4,0,10,mixedType,1
1,8,0,9,mixedType,1
9,4,0,13,mixedType,1
11,3,0,14,mixedType,2
6,4,0,10,mixedType,1
15,1,0,16,mixedType,2
5,6,0,11,mixedType,1
2,4,0,6,mixedType,0
2,4,0,6,mixedType,0
8,1,0,9,mixedType,1
15,1,0,16,mixedType,2
6,3,0,9,mixedType,1
7,2,0,9,mixedType,1
8,2,0,10,mixedType,1
6,4,0,10,mixedType,1
5,2,0,7,mixedType,0
9,4,0,13,mixedType,1
7,1,0,8,mixedType,1
8,2,0,10,mixedType,1
8,1,0,9,mixedType,1
6,4,0,10,mixedType,1
7,2,0,9,mixedType,1
13,4,1,18,mixedType,2
6,1,0,7,mixedType,0
7,1,0,8,mixedType,1
9,4,0,13,mixedType,1
6,3,0,9,mixedType,1
4,8,0,12,mixedType,1
9,1,0,10,mixedType,1
7,5,0,12,mixedType,1
7,3,0,10,mixedType,1
2,8,0,10,mixedType,1
7,2,0,9,mixedType,1
6,3,0,9,mixedType,1
7,4,0,11,mixedType,1
8,4,0,12,mixedType,1
2,8,0,10,mixedType,1
6,1,0,7,mixedType,0
11,3,0,14,mixedType,2
14,2,0,16,mixedType,2
5,3,0,8,mixedType,1
6,3,0,9,mixedType,1
8,3,0,11,mixedType,1
6,3,0,9,mixedType,1
5,3,0,8,mixedType,1
5,1,0,6,mixedType,0
8,2,0,10,mixedType,1
6,3,0,9,mixedType,1
3,6,0,9,mixedType,1
3,8,0,11,mixedType,1
5,2,0,7,mixedType,0
6,2,0,8,mixedType,1
7,3,0,10,mixedType,1
5,3,0,8,mixedType,1
7,2,0,9,mixedType,1
5,4,0,9,mixedType,1
6,4,0,10,mixedType,1
4,2,0,6,mixedType,0
2,7,0,9,mixedType,1
6,4,0,10,mixedType,1
6,1,0,7,mixedType,0
7,1,0,8,mixedType,1
2,8,0,10,mixedType,1
8,2,0,10,mixedType,1
5,2,0,7,mixedType,0
6,2,0,8,mixedType,1
6,5,0,11,mixedType,1
8,3,0,11,mixedType,1
9,1,0,10,mixedType,1
5,5,0,10,mixedType,1
5,4,0,9,mixedType,1
8,1,0,9,mixedType,1
3,6,0,9,mixedType,1
1,8,0,9,mixedType,1
7,3,0,10,mixedType,1
14,2,0,16,mixedType,2
11,1,0,12,mixedType,1
5,3,0,8,mixedType,1
8,2,0,10,mixedType,1
5,3,0,8,mixedType,1
6,2,0,8,mixedType,1
3,6,0,9,mixedType,1
7,1,0,8,mixedType,1
2,6,0,8,mixedType,1
6,6,0,12,mixedType,1
7,3,0,10,mixedType,1
11,1,0,12,mixedType,1
7,4,0,11,mixedType,1
8,2,0,10,mixedType,1
6,4,0,10,mixedType,1
5,3,0,8,mixedType,1
12,3,0,15,mixedType,2
5,1,0,6,mixedType,0
6,4,0,10,mixedType,1
1,9,0,10,mixedType,1
6,3,0,9,mixedType,1
7,4,0,11,mixedType,1
4,4,0,8,mixedType,1
12,3,0,15,mixedType,2
15,1,0,16,mixedType,2
4,6,0,10,mixedType,1
5,3,0,8,mixedType,1
13,3,0,16,mixedType,2
5,3,0,8,mixedType,1
7,3,0,10,mixedType,1
6,4,0,10,mixedType,1
10,2,0,12,mixedType,1
8,1,0,9,mixedType,1
3,9,0,12,mixedType,1
9,2,0,11,mixedType,1
7,2,0,9,mixedType,1
9,1,0,10,mixedType,1
6,2,0,8,mixedType,1
2,8,0,10,mixedType,1
4,2,0,6,mixedType,0
1,6,0,7,mixedType,0
6,2,0,8,mixedType,1
7,3,0,10,mixedType,1
6,1,0,7,mixedType,0
4,2,0,6,mixedType,0
15,1,0,16,mixedType,2
6,4,0,10,mixedType,1
6,3,0,9,mixedType,1
6,3,0,9,mixedType,1
6,1,0,7,mixedType,0
3,6,0,9,mixedType,1
6,3,0,9,mixedType,1
4,6,0,10,mixedType,1
6,1,0,7,mixedType,0
5,3,0,8,mixedType,1
7,2,0,9,mixedType,1
7,6,0,13,mixedType,1
6,4,0,10,mixedType,1
8,1,0,9,mixedType,1
6,2,0,8,mixedType,1
9,1,0,10,mixedType,1
6,4,0,10,mixedType,1
12,3,0,15,mixedType,2
7,4,0,11,mixedType,1
7,6,0,13,mixedType,1
4,4,0,8,mixedType,1
6,3,0,9,mixedType,1
7,3,0,10,mixedType,1
7,1,0,8,mixedType,1
5,3,0,8,mixedType,1
3,6,0,9,mixedType,1
6,3,0,9,mixedType,1
1,8,0,9,mixedType,1
5,1,0,6,mixedType,0
8,2,0,10,mixedType,1
13,3,0,16,mixedType,2
4,6,0,10,mixedType,1
6,1,0,7,mixedType,0
8,2,0,10,mixedType,1
7,3,0,10,mixedType,1
4,8,0,12,mixedType,1
4,2,0,6,mixedType,0
12,3,0,15,mixedType,2
7,3,0,10,mixedType,1
9,3,0,12,mixedType,1
8,1,0,9,mixedType,1
6,2,0,8,mixedType,1
3,6,0,9,mixedType,1
5,6,0,11,mixedType,1
8,1,0,9,mixedType,1
13,3,0,16,mixedType,2
7,3,0,10,mixedType,1
10,3,0,13,mixedType,1
5,2,0,7,mixedType,0
7,4,0,11,mixedType,1
13,3,0,16,mixedType,2
7,1,0,8,mixedType,1
6,4,0,10,mixedType,1
4,4,0,8,mixedType,1
10,6,0,16,mixedType,2
7,3,0,10,mixedType,1
1,8,0,9,mixedType,1
6,1,0,7,mixedType,0
12,1,0,13,mixedType,1
11,1,0,12,mixedType,1
7,3,0,10,mixedType,1
9,4,0,13,mixedType,1
4,2,0,6,mixedType,0
5,3,0,8,mixedType,1
3,9,0,12,mixedType,1
4,2,0,6,mixedType,0
6,1,0,7,mixedType,0
6,1,0,7,mixedType,0
4,4,0,8,mixedType,1
6,2,0,8,mixedType,1
3,5,0,8,mixedType,1
3,5,0,8,mixedType,1
10,1,0,11,mixedType,1
5,3,0,8,mixedType,1
8,2,0,10,mixedType,1
8,2,0,10,mixedType,1
14,2,0,16,mixedType,2
6,1,0,7,mixedType,0
6,2,0,8,mixedType,1
3,6,0,9,mixedType,1
5,3,0,8,mixedType,1
3,7,0,10,mixedType,1
3,5,0,8,mixedType,1
6,3,0,9,mixedType,1
9,1,0,10,mixedType,1
6,2,0,8,mixedType,1
6,3,0,9,mixedType,1
9,2,0,11,mixedType,1
7,3,0,10,mixedType,1
6,1,0,7,mixedType,0
8,3,0,11,mixedType,1
11,5,0,16,mixedType,2
9,4,0,13,mixedType,1
7,2,0,9,mixedType,1
8,3,0,11,mixedType,1
8,1,0,9,mixedType,1
4,5,0,9,mixedType,1
14,2,0,16,mixedType,2
6,3,0,9,mixedType,1
5,2,0,7,mixedType,0
5,3,0,8,mixedType,1
5,3,0,8,mixedType,1
4,5,0,9,mixedType,1
9,3,0,12,mixedType,1
5,3,0,8,mixedType,1
8,1,0,9,mixedType,1
7,3,0,10,mixedType,1
8,2,0,10,mixedType,1
5,3,0,8,mixedType,1
7,3,0,10,mixedType,1
10,2,0,12,mixedType,1
6,6,0,12,mixedType,1
15,1,0,16,mixedType,2
6,3,0,9,mixedType,1
9,1,0,10,mixedType,1
1,8,0,9,mixedType,1
7,3,0,10,mixedType,1
6,1,0,7,mixedType,0
2,6,0,8,mixedType,1
8,2,0,10,mixedType,1
11,5,0,16,mixedType,2
6,4,0,10,mixedType,1
6,4,0,10,mixedType,1
8,1,0,9,mixedType,1
15,1,0,16,mixedType,2
7,1,0,8,mixedType,1
8,1,0,9,mixedType,1
6,1,0,7,mixedType,0
9,3,0,12,mixedType,1
10,2,0,12,mixedType,1
5,3,0,8,mixedType,1
4,5,0,9,mixedType,1
3,7,0,10,mixedType,1
8,5,0,13,mixedType,1
4,2,0,6,mixedType,0
1,9,0,10,mixedType,1
2,7,0,9,mixedType,1
5,3,0,8,mixedType,1
2,4,0,6,mixedType,0
7,2,0,9,mixedType,1
7,3,0,10,mixedType,1
7,2,0,9,mixedType,1
1,7,0,8,mixedType,1
2,19,2,23,mixedType,2
7,4,0,11,mixedType,1
1,7,0,8,mixedType,1
7,3,0,10,mixedType,1
11,3,0,14,mixedType,2
7,4,0,11,mixedType,1
5,3,0,8,mixedType,1
8,3,0,11,mixedType,1
8,2,0,10,mixedType,1
7,3,0,10,mixedType,1
8,3,0,11,mixedType,1
10,2,0,12,mixedType,1
7,2,0,9,mixedType,1
8,4,0,12,mixedType,1
5,4,0,9,mixedType,1
6,1,0,7,mixedType,0
6,1,0,7,mixedType,0
7,3,0,10,mixedType,1
7,3,0,10,mixedType,1
8,1,0,9,mixedType,1
6,2,0,8,mixedType,1
8,4,0,12,mixedType,1
7,1,0,8,mixedType,1
5,4,0,9,mixedType,1
6,6,0,12,mixedType,1
4,2,0,6,mixedType,0
5,4,0,9,mixedType,1
5,6,0,11,mixedType,1
9,2,0,11,mixedType,1
6,2,0,8,mixedType,1
7,1,0,8,mixedType,1
9,2,0,11,mixedType,1
7,2,0,9,mixedType,1
6,3,0,9,mixedType,1
3,5,0,8,mixedType,1
6,7,0,13,mixedType,1
2,6,0,8,mixedType,1
7,3,0,10,mixedType,1
3,6,0,9,mixedType,1
10,1,0,11,mixedType,1
8,3,0,11,mixedType,1
3,6,0,9,mixedType,1
4,6,0,10,mixedType,1
7,10,0,17,mixedType,2
5,1,0,6,mixedType,0
7,1,0,8,mixedType,1
4,2,0,6,mixedType,0
8,2,0,10,mixedType,1
8,1,0,9,mixedType,1
6,2,0,8,mixedType,1
13,3,0,16,mixedType,2
7,3,0,10,mixedType,1
6,4,0,10,mixedType,1
6,4,0,10,mixedType,1
4,2,0,6,mixedType,0
3,3,0,6,mixedType,0
2,6,0,8,mixedType,1
6,3,0,9,mixedType,1
7,1,0,8,mixedType,1
15,1,0,16,mixedType,2
1,7,0,8,mixedType,1
14,2,0,16,mixedType,2
7,1,0,8,mixedType,1
8,1,0,9,mixedType,1
6,2,0,8,mixedType,1
4,8,0,12,mixedType,1
4,4,0,8,mixedType,1
8,3,0,11,mixedType,1
6,4,0,10,mixedType,1
2,9,0,11,mixedType,1
4,2,0,6,mixedType,0
4,4,0,8,mixedType,1
7,1,0,8,mixedType,1
8,4,0,12,mixedType,1
7,1,0,8,mixedType,1
6,4,0,10,mixedType,1
7,3,0,10,mixedType,1
10,1,0,11,mixedType,1
10,1,0,11,mixedType,1
9,1,0,10,mixedType,1
5,2,0,7,mixedType,0
14,2,0,16,mixedType,2
12,1,0,13,mixedType,1
9,1,0,10,mixedType,1
13,4,0,17,mixedType,2
7,3,0,10,mixedType,1
15,1,0,16,mixedType,2
14,2,0,16,mixedType,2
7,3,0,10,mixedType,1
7,2,0,9,mixedType,1
8,2,0,10,mixedType,1
6,5,0,11,mixedType,1
7,2,0,9,mixedType,1
6,3,0,9,mixedType,1
15,1,0,16,mixedType,2
5,3,0,8,mixedType,1
7,2,0,9,mixedType,1
4,2,0,6,mixedType,0
12,1,0,13,mixedType,1
7,3,0,10,mixedType,1
9,1,0,10,mixedType,1
7,2,0,9,mixedType,1
8,1,0,9,mixedType,1
7,2,0,9,mixedType,1
9,4,0,13,mixedType,1
6,2,0,8,mixedType,1
8,4,0,12,mixedType,1
15,1,0,16,mixedType,2
5,6,0,11,mixedType,1
5,7,0,12,mixedType,1
12,4,0,16,mixedType,2
4,6,0,10,mixedType,1
7,2,0,9,mixedType,1
7,2,0,9,mixedType,1
7,2,0,9,mixedType,1
6,2,0,8,mixedType,1
2,4,0,6,mixedType,0
7,3,0,10,mixedType,1
2,11,0,13,mixedType,1
15,1,0,16,mixedType,2
6,4,0,10,mixedType,1
7,1,0,8,mixedType,1
6,4,0,10,mixedType,1
4,4,0,8,mixedType,1
7,3,0,10,mixedType,1
7,1,0,8,mixedType,1
15,1,0,16,mixedType,2
4,4,0,8,mixedType,1
7,2,0,9,mixedType,1
9,3,0,12,mixedType,1
7,4,0,11,mixedType,1
7,3,0,10,mixedType,1
15,1,0,16,mixedType,2
9,3,0,12,mixedType,1
7,4,0,11,mixedType,1
7,3,0,10,mixedType,1
15,1,0,16,mixedType,2
6,3,0,9,mixedType,1
3,6,0,9,mixedType,1
8,1,0,9,mixedType,1
6,6,0,12,mixedType,1
6,3,0,9,mixedType,1
7,1,0,8,mixedType,1
8,1,0,9,mixedType,1
16,3,2,21,mixedType,2
1,5,0,6,mixedType,0
5,2,0,7,mixedType,0
9,4,4,17,mixedType,2
3,3,0,6,mixedType,0
9,3,0,12,mixedType,1
3,5,0,8,mixedType,1
11,2,0,13,mixedType,1
6,2,0,8,mixedType,1
6,2,0,8,mixedType,1
6,1,0,7,mixedType,0
4,6,0,10,mixedType,1
4,4,0,8,mixedType,1
6,6,0,12,mixedType,1
9,3,0,12,mixedType,1
7,2,0,9,mixedType,1
6,1,0,7,mixedType,0
5,2,0,7,mixedType,0
13,3,1,17,mixedType,2
8,3,0,11,mixedType,1
6,4,0,10,mixedType,1
14,2,0,16,mixedType,2
6,4,0,10,mixedType,1
12,3,0,15,mixedType,2
6,1,0,7,mixedType,0
4,4,0,8,mixedType,1
4,4,0,8,mixedType,1
5,3,0,8,mixedType,1
8,1,0,9,mixedType,1
6,3,0,9,mixedType,1
5,4,0,9,mixedType,1
6,7,0,13,mixedType,1
4,4,0,8,mixedType,1
12,4,0,16,mixedType,2
14,2,0,16,mixedType,2
9,2,0,11,mixedType,1
7,3,0,10,mixedType,1
6,1,0,7,mixedType,0
1,7,0,8,mixedType,1
13,3,0,16,mixedType,2
2,10,0,12,mixedType,1
6,2,0,8,mixedType,1
5,4,0,9,mixedType,1
7,3,0,10,mixedType,1
8,1,0,9,mixedType,1
4,6,0,10,mixedType,1
4,4,0,8,mixedType,1
7,2,0,9,mixedType,1
6,1,0,7,mixedType,0
5,2,0,7,mixedType,0
11,3,0,14,mixedType,2
7,3,0,10,mixedType,1
5,4,0,9,mixedType,1
6,3,0,9,mixedType,1
6,4,0,10,mixedType,1
7,3,0,10,mixedType,1
4,4,0,8,mixedType,1
8,1,0,9,mixedType,1
6,2,0,8,mixedType,1
7,3,0,10,mixedType,1
6,2,0,8,mixedType,1
3,7,0,10,mixedType,1
6,2,0,8,mixedType,1
7,4,0,11,mixedType,1
8,1,0,9,mixedType,1
10,3,0,13,mixedType,1
15,1,0,16,mixedType,2
5,3,0,8,mixedType,1
13,3,0,16,mixedType,2
5,2,0,7,mixedType,0
5,3,0,8,mixedType,1
6,3,0,9,mixedType,1
4,2,0,6,mixedType,0
15,1,0,16,mixedType,2
2,7,0,9,mixedType,1
6,3,0,9,mixedType,1
7,2,0,9,mixedType,1
6,4,0,10,mixedType,1
5,3,0,8,mixedType,1
9,1,0,10,mixedType,1
8,2,0,10,mixedType,1
1,9,0,10,mixedType,1
7,2,0,9,mixedType,1
8,1,0,9,mixedType,1
6,2,0,8,mixedType,1
7,1,0,8,mixedType,1
7,3,0,10,mixedType,1
8,2,0,10,mixedType,1
8,4,0,12,mixedType,1
4,2,0,6,mixedType,0
3,6,0,9,mixedType,1
7,3,0,10,mixedType,1
4,4,0,8,mixedType,1
5,2,0,7,mixedType,0
8,1,0,9,mixedType,1
6,3,0,9,mixedType,1
6,4,0,10,mixedType,1
5,3,0,8,mixedType,1
6,4,0,10,mixedType,1
3,3,0,6,mixedType,0
7,1,0,8,mixedType,1
5,3,0,8,mixedType,1
5,4,0,9,mixedType,1
5,2,0,7,mixedType,0
14,2,0,16,mixedType,2
4,4,0,8,mixedType,1
8,2,0,10,mixedType,1
6,1,0,7,mixedType,0
4,2,0,6,mixedType,0
2,4,0,6,mixedType,0
8,5,0,13,mixedType,1
4,6,0,10,mixedType,1
5,4,0,9,mixedType,1
5,3,0,8,mixedType,1
4,4,0,8,mixedType,1
6,2,0,8,mixedType,1
4,2,0,6,mixedType,0
10,5,0,15,mixedType,2
8,1,0,9,mixedType,1
6,3,0,9,mixedType,1
10,6,0,16,mixedType,2
3,9,0,12,mixedType,1
8,1,0,9,mixedType,1
3,3,0,6,mixedType,0
7,5,0,12,mixedType,1
6,1,0,7,mixedType,0
13,3,0,16,mixedType,2
9,2,0,11,mixedType,1
8,3,0,11,mixedType,1
8,2,0,10,mixedType,1
7,6,0,13,mixedType,1
13,3,0,16,mixedType,2
6,2,0,8,mixedType,1
4,6,0,10,mixedType,1
6,4,0,10,mixedType,1
5,2,0,7,mixedType,0
9,1,0,10,mixedType,1
9,2,0,11,mixedType,1
5,4,0,9,mixedType,1
15,1,0,16,mixedType,2
4,4,0,8,mixedType,1
2,4,0,6,mixedType,0
2,7,0,9,mixedType,1
6,4,0,10,mixedType,1
5,2,0,7,mixedType,0
8,4,0,12,mixedType,1
10,6,0,16,mixedType,2
13,3,0,16,mixedType,2
12,3,0,15,mixedType,2
8,2,0,10,mixedType,1
8,4,0,12,mixedType,1
7,3,0,10,mixedType,1
11,3,0,14,mixedType,2
2,8,0,10,mixedType,1
8,2,0,10,mixedType,1
14,2,0,16,mixedType,2
9,2,0,11,mixedType,1
9,4,0,13,mixedType,1
5,3,0,8,mixedType,1
8,2,0,10,mixedType,1
6,1,0,7,mixedType,0
0,6,2,8,mixedType,1
6,2,0,8,mixedType,1
11,5,0,16,mixedType,2
8,3,0,11,mixedType,1
1,8,0,9,mixedType,1
6,2,0,8,mixedType,1
2,6,0,8,mixedType,1
7,1,0,8,mixedType,1
12,4,0,16,mixedType,2
12,3,0,15,mixedType,2
1,8,0,9,mixedType,1
14,2,0,16,mixedType,2
7,3,0,10,mixedType,1
4,9,0,13,mixedType,1
7,2,0,9,mixedType,1
5,2,0,7,mixedType,0
5,2,0,7,mixedType,0
5,3,0,8,mixedType,1
6,3,0,9,mixedType,1
14,2,0,16,mixedType,2
6,4,0,10,mixedType,1
5,5,0,10,mixedType,1
10,4,0,14,mixedType,2
5,3,0,8,mixedType,1
6,1,0,7,mixedType,0
5,1,0,6,mixedType,0
4,2,0,6,mixedType,0
12,3,0,15,mixedType,2
4,6,0,10,mixedType,1
7,3,0,10,mixedType,1
5,4,0,9,mixedType,1
1,8,0,9,mixedType,1
9,1,0,10,mixedType,1
7,3,0,10,mixedType,1
11,3,0,14,mixedType,2
6,1,0,7,mixedType,0
7,2,0,9,mixedType,1
3,7,0,10,mixedType,1
3,7,0,10,mixedType,1
8,2,0,10,mixedType,1
6,1,0,7,mixedType,0
6,4,0,10,mixedType,1
7,1,0,8,mixedType,1
7,3,0,10,mixedType,1
4,4,0,8,mixedType,1
8,1,0,9,mixedType,1
7,3,0,10,mixedType,1
5,2,0,7,mixedType,0
7,2,0,9,mixedType,1
4,9,0,13,mixedType,1
3,7,0,10,mixedType,1
5,4,0,9,mixedType,1
5,2,0,7,mixedType,0
4,2,0,6,mixedType,0
3,6,0,9,mixedType,1
5,1,0,6,mixedType,0
5,1,0,6,mixedType,0
2,8,0,10,mixedType,1
7,1,0,8,mixedType,1
11,3,0,14,mixedType,2
5,3,0,8,mixedType,1
14,2,0,16,mixedType,2
6,2,0,8,mixedType,1
5,2,0,7,mixedType,0
6,4,0,10,mixedType,1
11,2,0,13,mixedType,1
7,2,0,9,mixedType,1
4,2,0,6,mixedType,0
6,4,0,10,mixedType,1
4,5,0,9,mixedType,1
6,3,0,9,mixedType,1
7,2,0,9,mixedType,1
8,2,0,10,mixedType,1
5,3,0,8,mixedType,1
4,7,0,11,mixedType,1
2,7,0,9,mixedType,1
3,11,1,15,mixedType,2
5,4,0,9,mixedType,1
6,3,0,9,mixedType,1
5,4,0,9,mixedType,1
11,4,0,15,mixedType,2
10,1,0,11,mixedType,1
9,4,0,13,mixedType,1
6,2,0,8,mixedType,1
5,3,0,8,mixedType,1
5,4,0,9,mixedType,1
3,5,0,8,mixedType,1
8,3,0,11,mixedType,1
5,4,0,9,mixedType,1
7,2,0,9,mixedType,1
4,2,0,6,mixedType,0
8,0,1,9,mixedType,1
5,2,0,7,mixedType,0
10,3,0,13,mixedType,1
5,10,0,15,mixedType,2
2,8,0,10,mixedType,1
15,1,0,16,mixedType,2
11,5,0,16,mixedType,2
1,10,0,11,mixedType,1
8,4,0,12,mixedType,1
1,8,0,9,mixedType,1
4,2,0,6,mixedType,0
5,1,0,6,mixedType,0
7,2,0,9,mixedType,1
4,4,0,8,mixedType,1
5,1,0,6,mixedType,0
14,2,0,16,mixedType,2
8,2,0,10,mixedType,1
14,2,0,16,mixedType,2
8,1,0,9,mixedType,1
2,7,0,9,mixedType,1
6,1,0,7,mixedType,0
6,3,0,9,mixedType,1
8,3,0,11,mixedType,1
6,2,0,8,mixedType,1
12,3,0,15,mixedType,2
7,3,0,10,mixedType,1
7,3,0,10,mixedType,1
7,2,0,9,mixedType,1
2,4,0,6,mixedType,0
5,2,0,7,mixedType,0
11,1,0,12,mixedType,1
5,3,0,8,mixedType,1
14,2,0,16,mixedType,2
1,8,0,9,mixedType,1
4,2,0,6,mixedType,0
5,3,0,8,mixedType,1
10,2,0,12,mixedType,1
6,3,0,9,mixedType,1
6,1,0,7,mixedType,0
7,3,0,10,mixedType,1
3,8,0,11,mixedType,1
5,2,0,7,mixedType,0
3,8,0,11,mixedType,1
4,2,0,6,mixedType,0
6,1,0,7,mixedType,0
6,3,0,9,mixedType,1
2,8,0,10,mixedType,1
2,7,0,9,mixedType,1
1,8,0,9,mixedType,1
10,3,0,13,mixedType,1
6,2,0,8,mixedType,1
6,1,0,7,mixedType,0
7,3,0,10,mixedType,1
4,2,0,6,mixedType,0
3,5,0,8,mixedType,1
5,4,0,9,mixedType,1
5,2,0,7,mixedType,0
5,4,0,9,mixedType,1
4,2,0,6,mixedType,0
6,4,0,10,mixedType,1
1,7,0,8,mixedType,1
8,2,0,10,mixedType,1
3,6,0,9,mixedType,1
9,3,0,12,mixedType,1
9,2,0,11,mixedType,1
6,1,0,7,mixedType,0
9,1,0,10,mixedType,1
7,1,0,8,mixedType,1
4,2,0,6,mixedType,0
7,1,0,8,mixedType,1
2,6,0,8,mixedType,1
6,3,0,9,mixedType,1
6,3,0,9,mixedType,1
10,2,0,12,mixedType,1
8,2,0,10,mixedType,1
15,1,0,16,mixedType,2
7,3,0,10,mixedType,1
6,3,0,9,mixedType,1
12,4,0,16,mixedType,2
6,4,0,10,mixedType,1
5,1,0,6,mixedType,0
6,3,0,9,mixedType,1
2,6,0,8,mixedType,1
5,5,0,10,mixedType,1
4,2,0,6,mixedType,0
6,1,0,7,mixedType,0
7,3,0,10,mixedType,1
6,1,0,7,mixedType,0
14,2,0,16,mixedType,2
6,3,0,9,mixedType,1
6,1,0,7,mixedType,0
7,3,0,10,mixedType,1
6,3,0,9,mixedType,1
11,3,0,14,mixedType,2
8,2,0,10,mixedType,1
7,1,0,8,mixedType,1
3,7,0,10,mixedType,1
1,7,0,8,mixedType,1
6,4,0,10,mixedType,1
6,2,0,8,mixedType,1
8,3,0,11,mixedType,1
7,4,0,11,mixedType,1
7,1,0,8,mixedType,1
5,1,0,6,mixedType,0
12,4,0,16,mixedType,2
10,2,0,12,mixedType,1
6,4,0,10,mixedType,1
5,1,0,6,mixedType,0
14,2,0,16,mixedType,2
6,2,0,8,mixedType,1
14,2,0,16,mixedType,2
6,4,0,10,mixedType,1
5,3,0,8,mixedType,1
5,4,0,9,mixedType,1
4,6,0,10,mixedType,1
8,6,0,14,mixedType,2
8,2,0,10,mixedType,1
6,1,0,7,mixedType,0
5,3,0,8,mixedType,1
6,3,0,9,mixedType,1
4,2,0,6,mixedType,0
7,2,0,9,mixedType,1
12,4,0,16,mixedType,2
6,2,0,8,mixedType,1
8,1,0,9,mixedType,1
5,3,0,8,mixedType,1
2,9,0,11,mixedType,1
6,2,0,8,mixedType,1
8,1,0,9,mixedType,1
6,4,0,10,mixedType,1
5,1,0,6,mixedType,0
8,2,0,10,mixedType,1
9,2,0,11,mixedType,1
4,2,0,6,mixedType,0
7,1,0,8,mixedType,1
6,3,0,9,mixedType,1
7,3,0,10,mixedType,1
9,3,0,12,mixedType,1
13,3,0,16,mixedType,2
7,2,0,9,mixedType,1
5,8,0,13,mixedType,1
5,3,0,8,mixedType,1
15,1,0,16,mixedType,2
3,7,0,10,mixedType,1
13,3,0,16,mixedType,2
5,4,0,9,mixedType,1
15,1,0,16,mixedType,2
13,3,0,16,mixedType,2
5,4,0,9,mixedType,1
7,2,0,9,mixedType,1
5,3,0,8,mixedType,1
6,4,0,10,mixedType,1
1,8,0,9,mixedType,1
7,2,0,9,mixedType,1
7,2,0,9,mixedType,1
5,3,0,8,mixedType,1
9,4,0,13,mixedType,1
4,5,0,9,mixedType,1
7,3,0,10,mixedType,1
7,6,0,13,mixedType,1
5,2,0,7,mixedType,0
5,6,0,11,mixedType,1
8,4,2,14,mixedType,2
6,1,0,7,mixedType,0
8,2,1,11,mixedType,1
6,4,0,10,mixedType,1
6,3,0,9,mixedType,1
8,2,0,10,mixedType,1
6,6,0,12,mixedType,1
2,6,0,8,mixedType,1
5,2,0,7,mixedType,0
7,2,0,9,mixedType,1
5,3,0,8,mixedType,1
2,6,0,8,mixedType,1
5,5,0,10,mixedType,1
12,3,0,15,mixedType,2
3,6,0,9,mixedType,1
8,1,0,9,mixedType,1
8,1,0,9,mixedType,1
8,2,0,10,mixedType,1
7,3,0,10,mixedType,1
6,2,0,8,mixedType,1
6,2,0,8,mixedType,1
6,1,0,7,mixedType,0
6,3,0,9,mixedType,1
4,4,0,8,mixedType,1
3,5,0,8,mixedType,1
4,8,0,12,mixedType,1
7,2,0,9,mixedType,1
7,2,0,9,mixedType,1
7,3,0,10,mixedType,1
6,4,0,10,mixedType,1
13,3,0,16,mixedType,2
7,3,0,10,mixedType,1
3,6,0,9,mixedType,1
5,6,0,11,mixedType,1
12,0,1,13,mixedType,1
5,4,0,9,mixedType,1
6,1,0,7,mixedType,0
6,1,0,7,mixedType,0
6,6,0,12,mixedType,1
11,5,0,16,mixedType,2
8,2,0,10,mixedType,1
12,3,0,15,mixedType,2
7,1,0,8,mixedType,1
2,4,0,6,mixedType,0
6,1,0,7,mixedType,0
6,3,0,9,mixedType,1
2,6,0,8,mixedType,1
9,2,0,11,mixedType,1
5,2,0,7,mixedType,0
3,6,0,9,mixedType,1
8,4,0,12,mixedType,1
5,1,0,6,mixedType,0
12,4,0,16,mixedType,2
6,3,0,9,mixedType,1
8,2,0,10,mixedType,1
6,3,0,9,mixedType,1
7,2,0,9,mixedType,1
8,4,0,12,mixedType,1
7,1,0,8,mixedType,1
5,2,0,7,mixedType,0
5,0,1,6,mixedType,0
5,3,0,8,mixedType,1
6,3,0,9,mixedType,1
7,2,0,9,mixedType,1
9,4,0,13,mixedType,1
14,2,0,16,mixedType,2
9,2,0,11,mixedType,1
5,3,0,8,mixedType,1
12,4,0,16,mixedType,2
9,1,0,10,mixedType,1
6,2,0,8,mixedType,1
9,2,0,11,mixedType,1
7,1,0,8,mixedType,1
3,5,0,8,mixedType,1
3,7,0,10,mixedType,1
6,1,0,7,mixedType,0
2,6,0,8,mixedType,1
6,2,0,8,mixedType,1
13,3,0,16,mixedType,2
5,2,0,7,mixedType,0
5,4,0,9,mixedType,1
12,3,0,15,mixedType,2
9,2,0,11,mixedType,1
5,2,0,7,mixedType,0
6,2,0,8,mixedType,1
5,3,0,8,mixedType,1
7,2,0,9,mixedType,1
7,3,0,10,mixedType,1
1,8,0,9,mixedType,1
8,1,0,9,mixedType,1
9,4,0,13,mixedType,1
5,3,0,8,mixedType,1
10,2,2,14,mixedType,2
5,1,0,6,mixedType,0
5,2,0,7,mixedType,0
4,6,0,10,mixedType,1
7,2,0,9,mixedType,1
7,3,0,10,mixedType,1
8,2,0,10,mixedType,1
8,2,0,10,mixedType,1
5,2,0,7,mixedType,0
1,8,0,9,mixedType,1
2,7,0,9,mixedType,1
6,3,0,9,mixedType,1
4,4,0,8,mixedType,1
6,2,0,8,mixedType,1
5,3,0,8,mixedType,1
12,3,0,15,mixedType,2
6,3,0,9,mixedType,1
14,2,0,16,mixedType,2
7,2,0,9,mixedType,1
3,8,0,11,mixedType,1
6,4,0,10,mixedType,1
6,3,0,9,mixedType,1
1,9,0,10,mixedType,1
1,8,0,9,mixedType,1
5,4,0,9,mixedType,1
2,8,0,10,mixedType,1
1,8,0,9,mixedType,1
8,2,0,10,mixedType,1
6,1,0,7,mixedType,0
5,6,0,11,mixedType,1
13,3,0,16,mixedType,2
6,7,0,13,mixedType,1
14,2,0,16,mixedType,2
6,4,0,10,mixedType,1
9,1,0,10,mixedType,1
2,10,0,12,mixedType,1
6,3,0,9,mixedType,1
6,3,0,9,mixedType,1
2,8,0,10,mixedType,1
6,3,0,9,mixedType,1
1,9,0,10,mixedType,1
6,3,0,9,mixedType,1
8,2,0,10,mixedType,1
7,3,0,10,mixedType,1
7,2,0,9,mixedType,1
2,6,0,8,mixedType,1
4,4,0,8,mixedType,1
6,3,0,9,mixedType,1
1,5,0,6,mixedType,0
5,3,0,8,mixedType,1
11,1,0,12,mixedType,1
6,3,0,9,mixedType,1
5,2,0,7,mixedType,0
8,2,0,10,mixedType,1
13,3,0,16,mixedType,2
6,2,0,8,mixedType,1
5,5,0,10,mixedType,1
8,1,0,9,mixedType,1
13,3,0,16,mixedType,2
6,4,0,10,mixedType,1
6,4,0,10,mixedType,1
3,10,0,13,mixedType,1
6,6,0,12,mixedType,1
4,6,0,10,mixedType,1
9,3,0,12,mixedType,1
8,2,0,10,mixedType,1
2,6,0,8,mixedType,1
7,2,0,9,mixedType,1
2,4,0,6,mixedType,0
3,5,0,8,mixedType,1
7,3,0,10,mixedType,1
8,2,0,10,mixedType,1
4,2,0,6,mixedType,0
12,4,0,16,mixedType,2
5,7,0,12,mixedType,1
15,1,0,16,mixedType,2
6,3,0,9,mixedType,1
6,1,0,7,mixedType,0
5,4,0,9,mixedType,1
9,2,0,11,mixedType,1
6,1,0,7,mixedType,0
3,6,0,9,mixedType,1
6,2,0,8,mixedType,1
8,2,0,10,mixedType,1
8,2,0,10,mixedType,1
7,7,0,14,mixedType,2
8,2,0,10,mixedType,1
5,2,0,7,mixedType,0
7,1,0,8,mixedType,1
3,6,0,9,mixedType,1
3,3,0,6,mixedType,0
5,2,0,7,mixedType,0
11,3,0,14,mixedType,2
3,5,0,8,mixedType,1
10,3,0,13,mixedType,1
6,2,0,8,mixedType,1
8,2,0,10,mixedType,1
7,3,0,10,mixedType,1
6,3,0,9,mixedType,1
9,2,0,11,mixedType,1
7,3,0,10,mixedType,1
8,2,0,10,mixedType,1
8,1,0,9,mixedType,1
1,10,0,11,mixedType,1
5,2,0,7,mixedType,0
7,2,0,9,mixedType,1
7,3,0,10,mixedType,1
8,4,0,12,mixedType,1
7,3,0,10,mixedType,1
13,2,0,15,mixedType,2
5,4,0,9,mixedType,1
15,1,0,16,mixedType,2
10,3,0,13,mixedType,1
4,2,0,6,mixedType,0
14,2,0,16,mixedType,2
5,2,0,7,mixedType,0
7,3,0,10,mixedType,1
7,2,0,9,mixedType,1
4,2,0,6,mixedType,0
5,3,0,8,mixedType,1
14,2,0,16,mixedType,2
6,4,0,10,mixedType,1
8,1,0,9,mixedType,1
6,2,0,8,mixedType,1
8,3,0,11,mixedType,1
8,1,0,9,mixedType,1
6,4,0,10,mixedType,1
7,2,0,9,mixedType,1
7,3,0,10,mixedType,1
5,4,0,9,mixedType,1
6,4,0,10,mixedType,1
1,7,0,8,mixedType,1
7,2,0,9,mixedType,1
7,3,0,10,mixedType,1
3,7,0,10,mixedType,1
8,4,0,12,mixedType,1
1,8,0,9,mixedType,1
9,3,0,12,mixedType,1
5,3,0,8,mixedType,1
5,4,0,9,mixedType,1
14,2,0,16,mixedType,2
4,2,0,6,mixedType,0
9,1,0,10,mixedType,1
4,6,0,10,mixedType,1
3,9,0,12,mixedType,1
10,8,0,18,mixedType,2
7,1,0,8,mixedType,1
3,10,0,13,mixedType,1
7,3,0,10,mixedType,1
7,1,0,8,mixedType,1
14,2,0,16,mixedType,2
2,6,0,8,mixedType,1
4,2,0,6,mixedType,0
2,8,0,10,mixedType,1
14,2,0,16,mixedType,2
11,3,0,14,mixedType,2
5,6,0,11,mixedType,1
6,3,0,9,mixedType,1
3,10,0,13,mixedType,1
7,2,0,9,mixedType,1
5,2,0,7,mixedType,0
8,1,0,9,mixedType,1
8,2,0,10,mixedType,1
8,1,0,9,mixedType,1
11,3,0,14,mixedType,2
9,3,0,12,mixedType,1
6,1,0,7,mixedType,0
6,4,0,10,mixedType,1
4,9,0,13,mixedType,1
7,2,0,9,mixedType,1
6,2,0,8,mixedType,1
7,1,0,8,mixedType,1
7,2,0,9,mixedType,1
1,10,0,11,mixedType,1
4,4,0,8,mixedType,1
5,3,0,8,mixedType,1
5,0,2,7,mixedType,0
5,1,0,6,mixedType,0
3,6,0,9,mixedType,1
6,6,0,12,mixedType,1
7,2,0,9,mixedType,1
6,2,0,8,mixedType,1
4,2,0,6,mixedType,0
5,4,0,9,mixedType,1
8,4,0,12,mixedType,1
6,3,0,9,mixedType,1
4,4,0,8,mixedType,1
9,4,0,13,mixedType,1
6,4,0,10,mixedType,1
11,2,0,13,mixedType,1
14,2,0,16,mixedType,2
5,3,0,8,mixedType,1
8,3,0,11,mixedType,1
5,2,0,7,mixedType,0
9,1,0,10,mixedType,1
5,5,0,10,mixedType,1
6,4,0,10,mixedType,1
4,6,0,10,mixedType,1
8,2,0,10,mixedType,1
5,6,0,11,mixedType,1
7,4,0,11,mixedType,1
3,3,0,6,mixedType,0
7,1,0,8,mixedType,1
2,8,0,10,mixedType,1
6,4,0,10,mixedType,1
7,3,0,10,mixedType,1
6,4,0,10,mixedType,1
5,3,0,8,mixedType,1
12,3,0,15,mixedType,2
11,1,0,12,mixedType,1
6,1,0,7,mixedType,0
11,4,0,15,mixedType,2
8,4,0,12,mixedType,1
9,3,0,12,mixedType,1
10,3,0,13,mixedType,1
6,1,0,7,mixedType,0
2,6,0,8,mixedType,1
8,4,0,12,mixedType,1
6,2,0,8,mixedType,1
12,4,0,16,mixedType,2
7,3,0,10,mixedType,1
2,6,0,8,mixedType,1
6,3,0,9,mixedType,1
12,1,0,13,mixedType,1
6,4,0,10,mixedType,1
8,1,0,9,mixedType,1
10,3,0,13,mixedType,1
9,1,0,10,mixedType,1
6,2,0,8,mixedType,1
5,4,0,9,mixedType,1
5,2,0,7,mixedType,0
3,8,0,11,mixedType,1
6,3,0,9,mixedType,1
3,12,0,15,mixedType,2
6,6,0,12,mixedType,1
7,3,0,10,mixedType,1
6,3,0,9,mixedType,1
3,6,0,9,mixedType,1
1,7,0,8,mixedType,1
12,4,0,16,mixedType,2
7,3,0,10,mixedType,1
7,3,0,10,mixedType,1
5,0,1,6,mixedType,0
18,0,1,19,mixedType,2
14,2,0,16,mixedType,2
7,4,0,11,mixedType,1
7,2,0,9,mixedType,1
6,3,0,9,mixedType,1
8,1,0,9,mixedType,1
6,3,0,9,mixedType,1
2,6,0,8,mixedType,1
1,8,0,9,mixedType,1
8,2,0,10,mixedType,1
9,1,0,10,mixedType,1
5,8,0,13,mixedType,1
8,2,0,10,mixedType,1
2,8,0,10,mixedType,1
7,3,0,10,mixedType,1
3,6,0,9,mixedType,1
6,3,0,9,mixedType,1
6,4,0,10,mixedType,1
7,3,0,10,mixedType,1
6,3,0,9,mixedType,1
6,3,0,9,mixedType,1
14,2,0,16,mixedType,2
7,1,0,8,mixedType,1
8,1,0,9,mixedType,1
3,5,0,8,mixedType,1
8,2,0,10,mixedType,1
12,3,0,15,mixedType,2
12,4,0,16,mixedType,2
6,3,0,9,mixedType,1
5,2,0,7,mixedType,0
5,6,0,11,mixedType,1
9,2,0,11,mixedType,1
9,3,0,12,mixedType,1
9,1,0,10,mixedType,1
7,3,0,10,mixedType,1
5,4,0,9,mixedType,1
5,4,0,9,mixedType,1
7,3,0,10,mixedType,1
8,2,0,10,mixedType,1
5,3,0,8,mixedType,1
10,3,0,13,mixedType,1
2,7,0,9,mixedType,1
4,4,0,8,mixedType,1
13,3,0,16,mixedType,2
8,2,0,10,mixedType,1
9,3,0,12,mixedType,1
5,4,0,9,mixedType,1
14,2,0,16,mixedType,2
9,3,0,12,mixedType,1
3,9,0,12,mixedType,1
7,2,0,9,mixedType,1
9,3,0,12,mixedType,1
4,6,0,10,mixedType,1
6,2,0,8,mixedType,1
7,5,0,12,mixedType,1
8,3,0,11,mixedType,1
7,2,0,9,mixedType,1
6,6,0,12,mixedType,1
7,3,0,10,mixedType,1
6,1,0,7,mixedType,0
8,1,0,9,mixedType,1
6,1,0,7,mixedType,0
7,4,0,11,mixedType,1
6,4,0,10,mixedType,1
14,2,0,16,mixedType,2
9,1,0,10,mixedType,1
14,4,0,18,mixedType,2
4,4,0,8,mixedType,1
6,2,0,8,mixedType,1
8,2,0,10,mixedType,1
7,4,0,11,mixedType,1
6,4,0,10,mixedType,1
3,6,0,9,mixedType,1
1,8,0,9,mixedType,1
5,1,0,6,mixedType,0
6,1,0,7,mixedType,0
5,4,0,9,mixedType,1
8,2,0,10,mixedType,1
6,2,0,8,mixedType,1
2,11,1,14,mixedType,2
0,8,1,9,mixedType,1
8,2,0,10,mixedType,1
5,0,1,6,mixedType,0
2,7,0,9,mixedType,1
6,3,0,9,mixedType,1
7,4,0,11,mixedType,1
10,1,0,11,mixedType,1
4,2,0,6,mixedType,0
4,2,0,6,mixedType,0
6,4,0,10,mixedType,1
7,2,0,9,mixedType,1
7,5,0,12,mixedType,1
14,2,0,16,mixedType,2
3,6,0,9,mixedType,1
5,1,0,6,mixedType,0
6,3,0,9,mixedType,1
9,4,0,13,mixedType,1
7,2,0,9,mixedType,1
8,5,1,14,mixedType,2
6,1,0,7,mixedType,0
7,2,0,9,mixedType,1
5,2,0,7,mixedType,0
6,3,0,9,mixedType,1
9,1,0,10,mixedType,1
6,3,0,9,mixedType,1
5,3,0,8,mixedType,1
4,6,0,10,mixedType,1
6,3,0,9,mixedType,1
8,4,0,12,mixedType,1
15,1,0,16,mixedType,2
6,4,0,10,mixedType,1
3,6,0,9,mixedType,1
9,1,0,10,mixedType,1
7,3,0,10,mixedType,1
7,2,0,9,mixedType,1
5,3,0,8,mixedType,1
7,2,0,9,mixedType,1
10,2,0,12,mixedType,1
5,6,0,11,mixedType,1
5,1,0,6,mixedType,0
8,2,0,10,mixedType,1
8,1,0,9,mixedType,1
10,3,0,13,mixedType,1
5,4,0,9,mixedType,1
11,4,0,15,mixedType,2
9,2,0,11,mixedType,1
6,4,0,10,mixedType,1
6,4,0,10,mixedType,1
9,4,0,13,mixedType,1
6,1,0,7,mixedType,0
8,3,0,11,mixedType,1
6,2,0,8,mixedType,1
12,4,0,16,mixedType,2
8,3,0,11,mixedType,1
7,3,0,10,mixedType,1
7,1,0,8,mixedType,1
5,4,0,9,mixedType,1
6,3,0,9,mixedType,1
2,4,0,6,mixedType,0
6,4,0,10,mixedType,1
0,8,2,10,mixedType,1
9,2,0,11,mixedType,1
6,8,0,14,mixedType,2
6,3,0,9,mixedType,1
6,2,0,8,mixedType,1
6,4,0,10,mixedType,1
5,1,0,6,mixedType,0
5,1,0,6,mixedType,0
7,2,0,9,mixedType,1
4,8,0,12,mixedType,1
6,3,0,9,mixedType,1
5,4,0,9,mixedType,1
1,9,0,10,mixedType,1
6,3,0,9,mixedType,1
7,3,0,10,mixedType,1
7,3,0,10,mixedType,1
1,7,0,8,mixedType,1
5,4,0,9,mixedType,1
6,6,0,12,mixedType,1
8,1,0,9,mixedType,1
7,2,0,9,mixedType,1
7,3,0,10,mixedType,1
5,4,0,9,mixedType,1
7,3,0,10,mixedType,1
7,2,0,9,mixedType,1
13,3,0,16,mixedType,2
4,2,0,6,mixedType,0
6,4,0,10,mixedType,1
6,4,0,10,mixedType,1
5,2,0,7,mixedType,0
10,2,0,12,mixedType,1
6,4,0,10,mixedType,1
4,2,0,6,mixedType,0
7,2,0,9,mixedType,1
8,3,0,11,mixedType,1
6,4,0,10,mixedType,1
7,2,0,9,mixedType,1
3,6,0,9,mixedType,1
7,2,0,9,mixedType,1
14,2,0,16,mixedType,2
4,6,0,10,mixedType,1
6,3,0,9,mixedType,1
8,2,0,10,mixedType,1
6,3,0,9,mixedType,1
4,6,0,10,mixedType,1
8,1,0,9,mixedType,1
14,2,0,16,mixedType,2
3,3,0,6,mixedType,0
6,3,0,9,mixedType,1
14,2,0,16,mixedType,2
4,2,0,6,mixedType,0
8,2,0,10,mixedType,1
1,5,0,6,mixedType,0
2,4,0,6,mixedType,0
4,4,0,8,mixedType,1
1,8,6,15,mixedType,2
8,2,0,10,mixedType,1
8,1,0,9,mixedType,1
15,1,0,16,mixedType,2
8,1,0,9,mixedType,1
6,1,0,7,mixedType,0
5,1,0,6,mixedType,0
6,2,0,8,mixedType,1
7,2,0,9,mixedType,1
9,1,0,10,mixedType,1
7,3,0,10,mixedType,1
3,5,0,8,mixedType,1
6,2,0,8,mixedType,1
7,1,0,8,mixedType,1
5,3,0,8,mixedType,1
8,1,0,9,mixedType,1
6,1,0,7,mixedType,0
4,2,0,6,mixedType,0
6,2,0,8,mixedType,1
9,5,0,14,mixedType,2
8,2,0,10,mixedType,1
5,4,0,9,mixedType,1
6,4,0,10,mixedType,1
5,3,0,8,mixedType,1
7,3,0,10,mixedType,1
5,6,0,11,mixedType,1
10,1,0,11,mixedType,1
8,4,0,12,mixedType,1
0,7,0,7,sameType,1
9,1,0,10,mixedType,1
4,7,0,11,mixedType,1
4,4,0,8,mixedType,1
4,4,0,8,mixedType,1
6,4,0,10,mixedType,1
6,3,0,9,mixedType,1
7,3,0,10,mixedType,1
7,3,0,10,mixedType,1
4,4,0,8,mixedType,1
7,3,0,10,mixedType,1
4,4,0,8,mixedType,1
7,1,0,8,mixedType,1
5,6,0,11,mixedType,1
9,1,0,10,mixedType,1
7,3,0,10,mixedType,1
7,3,0,10,mixedType,1
1,8,0,9,mixedType,1
10,1,0,11,mixedType,1
8,2,0,10,mixedType,1
5,3,0,8,mixedType,1
7,2,0,9,mixedType,1
11,4,1,16,mixedType,2
8,4,0,12,mixedType,1
10,2,0,12,mixedType,1
4,4,0,8,mixedType,1
5,3,0,8,mixedType,1
4,4,0,8,mixedType,1
4,4,0,8,mixedType,1
8,3,0,11,mixedType,1
8,2,0,10,mixedType,1
6,4,0,10,mixedType,1
6,3,0,9,mixedType,1
7,2,0,9,mixedType,1
6,3,0,9,mixedType,1
13,3,0,16,mixedType,2
15,1,0,16,mixedType,2
5,4,0,9,mixedType,1
8,2,0,10,mixedType,1
5,3,0,8,mixedType,1
5,3,0,8,mixedType,1
1,8,0,9,mixedType,1
6,1,0,7,mixedType,0
8,2,0,10,mixedType,1
3,7,0,10,mixedType,1
3,8,0,11,mixedType,1
6,3,0,9,mixedType,1
7,2,0,9,mixedType,1
10,1,0,11,mixedType,1
3,3,0,6,mixedType,0
8,2,0,10,mixedType,1
8,2,0,10,mixedType,1
6,4,0,10,mixedType,1
6,2,0,8,mixedType,1
8,2,0,10,mixedType,1
6,1,0,7,mixedType,0
7,4,0,11,mixedType,1
1,9,0,10,mixedType,1
9,2,0,11,mixedType,1
2,6,0,8,mixedType,1
12,4,0,16,mixedType,2
11,1,0,12,mixedType,1
9,1,0,10,mixedType,1
8,2,0,10,mixedType,1
3,5,0,8,mixedType,1
1,8,0,9,mixedType,1
7,4,0,11,mixedType,1
8,2,0,10,mixedType,1
6,1,0,7,mixedType,0
10,2,0,12,mixedType,1
9,2,0,11,mixedType,1
9,6,1,16,mixedType,2
5,2,0,7,mixedType,0
11,5,0,16,mixedType,2
7,2,0,9,mixedType,1
7,3,0,10,mixedType,1
8,2,0,10,mixedType,1
3,8,0,11,mixedType,1
14,2,0,16,mixedType,2
5,2,0,7,mixedType,0
6,2,0,8,mixedType,1
4,2,0,6,mixedType,0
6,2,0,8,mixedType,1
7,2,0,9,mixedType,1
6,3,0,9,mixedType,1
3,8,0,11,mixedType,1
7,5,0,12,mixedType,1
8,1,0,9,mixedType,1
15,1,0,16,mixedType,2
7,3,0,10,mixedType,1
4,4,0,8,mixedType,1
6,4,0,10,mixedType,1
6,2,0,8,mixedType,1
6,3,0,9,mixedType,1
12,4,0,16,mixedType,2
8,2,0,10,mixedType,1
6,3,0,9,mixedType,1
7,2,0,9,mixedType,1
6,3,0,9,mixedType,1
6,1,0,7,mixedType,0
7,3,0,10,mixedType,1
8,2,0,10,mixedType,1
9,1,0,10,mixedType,1
5,4,0,9,mixedType,1
5,7,0,12,mixedType,1
8,2,0,10,mixedType,1
9,1,0,10,mixedType,1
3,5,0,8,mixedType,1
15,1,0,16,mixedType,2
9,3,0,12,mixedType,1
6,3,0,9,mixedType,1
10,8,0,18,mixedType,2
6,1,0,7,mixedType,0
6,1,0,7,mixedType,0
8,2,0,10,mixedType,1
10,1,0,11,mixedType,1
5,3,0,8,mixedType,1
9,3,0,12,mixedType,1
6,1,0,7,mixedType,0
4,2,0,6,mixedType,0
16,6,0,22,mixedType,2
3,6,0,9,mixedType,1
4,4,0,8,mixedType,1
6,1,0,7,mixedType,0
5,4,0,9,mixedType,1
7,3,0,10,mixedType,1
6,2,0,8,mixedType,1
9,4,0,13,mixedType,1
8,4,0,12,mixedType,1
5,4,0,9,mixedType,1
6,3,0,9,mixedType,1
4,4,0,8,mixedType,1
3,7,0,10,mixedType,1
9,1,0,10,mixedType,1
11,2,1,14,mixedType,2
3,6,0,9,mixedType,1
1,8,0,9,mixedType,1
10,1,0,11,mixedType,1
6,2,0,8,mixedType,1
2,7,0,9,mixedType,1
7,6,0,13,mixedType,1
5,4,0,9,mixedType,1
4,4,0,8,mixedType,1
11,1,0,12,mixedType,1
6,1,0,7,mixedType,0
7,1,0,8,mixedType,1
9,1,0,10,mixedType,1
3,5,0,8,mixedType,1
6,1,0,7,mixedType,0
6,3,0,9,mixedType,1
7,3,0,10,mixedType,1
14,2,0,16,mixedType,2
6,4,0,10,mixedType,1
4,5,0,9,mixedType,1
6,4,0,10,mixedType,1
6,3,0,9,mixedType,1
4,2,0,6,mixedType,0
5,3,0,8,mixedType,1
5,3,0,8,mixedType,1
4,4,0,8,mixedType,1
2,6,0,8,mixedType,1
8,2,0,10,mixedType,1
2,6,0,8,mixedType,1
4,5,0,9,mixedType,1
11,3,0,14,mixedType,2
2,4,0,6,mixedType,0
7,3,0,10,mixedType,1
5,1,0,6,mixedType,0
4,4,0,8,mixedType,1
4,8,0,12,mixedType,1
13,3,0,16,mixedType,2
7,2,0,9,mixedType,1
6,4,0,10,mixedType,1
3,7,0,10,mixedType,1
8,2,0,10,mixedType,1
4,6,0,10,mixedType,1
6,3,0,9,mixedType,1
8,0,1,9,mixedType,1
0,9,2,11,mixedType,1
6,3,0,9,mixedType,1
13,3,0,16,mixedType,2
13,3,0,16,mixedType,2
6,4,0,10,mixedType,1
7,1,0,8,mixedType,1
5,5,0,10,mixedType,1
1,7,0,8,mixedType,1
5,7,0,12,mixedType,1
8,1,0,9,mixedType,1
9,4,0,13,mixedType,1
4,6,0,10,mixedType,1
6,4,0,10,mixedType,1
5,2,0,7,mixedType,0
12,4,0,16,mixedType,2
2,8,0,10,mixedType,1
6,4,0,10,mixedType,1
6,4,0,10,mixedType,1
7,3,0,10,mixedType,1
4,2,0,6,mixedType,0
6,6,0,12,mixedType,1
10,2,0,12,mixedType,1
4,8,0,12,mixedType,1
4,4,0,8,mixedType,1
8,3,0,11,mixedType,1
14,2,0,16,mixedType,2
8,4,0,12,mixedType,1
10,3,0,13,mixedType,1
5,1,0,6,mixedType,0
5,4,0,9,mixedType,1
10,2,0,12,mixedType,1
15,1,0,16,mixedType,2
4,4,0,8,mixedType,1
7,3,0,10,mixedType,1
9,4,0,13,mixedType,1
6,3,0,9,mixedType,1
2,6,0,8,mixedType,1
6,2,0,8,mixedType,1
6,2,0,8,mixedType,1
7,3,0,10,mixedType,1
2,6,0,8,mixedType,1
7,1,0,8,mixedType,1
8,2,0,10,mixedType,1
5,6,0,11,mixedType,1
9,2,0,11,mixedType,1
5,6,0,11,mixedType,1
7,3,0,10,mixedType,1
8,2,0,10,mixedType,1
1,8,0,9,mixedType,1
8,1,0,9,mixedType,1
8,1,0,9,mixedType,1
3,6,0,9,mixedType,1
4,4,0,8,mixedType,1
6,1,0,7,mixedType,0
6,1,0,7,mixedType,0
6,2,0,8,mixedType,1
1,10,0,11,mixedType,1
4,2,0,6,mixedType,0
10,3,0,13,mixedType,1
8,4,0,12,mixedType,1
4,5,0,9,mixedType,1
7,1,0,8,mixedType,1
15,2,1,18,mixedType,2
5,6,0,11,mixedType,1
1,8,0,9,mixedType,1
8,1,0,9,mixedType,1
9,2,0,11,mixedType,1
7,5,0,12,mixedType,1
4,2,0,6,mixedType,0
9,1,0,10,mixedType,1
6,4,0,10,mixedType,1
3,6,0,9,mixedType,1
7,1,0,8,mixedType,1
8,3,0,11,mixedType,1
6,3,0,9,mixedType,1
7,3,0,10,mixedType,1
15,1,0,16,mixedType,2
3,5,0,8,mixedType,1
4,5,0,9,mixedType,1
6,3,0,9,mixedType,1
2,7,0,9,mixedType,1
6,3,0,9,mixedType,1
6,3,0,9,mixedType,1
6,2,0,8,mixedType,1
7,2,0,9,mixedType,1
7,6,0,13,mixedType,1
9,3,0,12,mixedType,1
6,4,0,10,mixedType,1
14,2,0,16,mixedType,2
9,7,0,16,mixedType,2
6,3,0,9,mixedType,1
11,3,0,14,mixedType,2
5,2,0,7,mixedType,0
9,2,0,11,mixedType,1
8,4,0,12,mixedType,1
12,3,0,15,mixedType,2
4,8,0,12,mixedType,1
3,6,0,9,mixedType,1
3,3,0,6,mixedType,0
11,2,0,13,mixedType,1
13,3,0,16,mixedType,2
6,1,0,7,mixedType,0
7,3,0,10,mixedType,1
6,1,0,7,mixedType,0
4,2,0,6,mixedType,0
7,2,0,9,mixedType,1
5,3,0,8,mixedType,1
5,5,0,10,mixedType,1
5,2,0,7,mixedType,0
7,1,0,8,mixedType,1
8,4,0,12,mixedType,1
11,3,0,14,mixedType,2
2,6,0,8,mixedType,1
8,4,0,12,mixedType,1
6,1,0,7,mixedType,0
7,1,0,8,mixedType,1
6,3,0,9,mixedType,1
7,2,0,9,mixedType,1
8,2,0,10,mixedType,1
6,2,0,8,mixedType,1
5,1,0,6,mixedType,0
6,7,0,13,mixedType,1
5,2,0,7,mixedType,0
2,8,0,10,mixedType,1
5,3,0,8,mixedType,1
5,3,0,8,mixedType,1
11,5,0,16,mixedType,2
6,3,0,9,mixedType,1
2,7,0,9,mixedType,1
9,1,0,10,mixedType,1
1,7,0,8,mixedType,1
2,9,0,11,mixedType,1
12,3,0,15,mixedType,2
15,1,0,16,mixedType,2
6,1,0,7,mixedType,0
8,2,0,10,mixedType,1
6,2,0,8,mixedType,1
7,2,0,9,mixedType,1
5,4,0,9,mixedType,1
7,2,0,9,mixedType,1
6,2,0,8,mixedType,1
5,4,0,9,mixedType,1
8,0,1,9,mixedType,1
8,3,0,11,mixedType,1
12,4,0,16,mixedType,2
7,3,0,10,mixedType,1
13,3,0,16,mixedType,2
7,2,0,9,mixedType,1
6,3,0,9,mixedType,1
3,5,0,8,mixedType,1
11,3,0,14,mixedType,2
10,6,0,16,mixedType,2
6,3,0,9,mixedType,1
14,2,0,16,mixedType,2
6,2,0,8,mixedType,1
7,4,0,11,mixedType,1
5,2,0,7,mixedType,0
6,4,0,10,mixedType,1
8,2,0,10,mixedType,1
8,2,0,10,mixedType,1
5,4,0,9,mixedType,1
7,2,0,9,mixedType,1
8,1,0,9,mixedType,1
8,2,0,10,mixedType,1
7,3,0,10,mixedType,1
6,2,0,8,mixedType,1
13,3,0,16,mixedType,2
6,3,0,9,mixedType,1
8,2,0,10,mixedType,1
5,8,0,13,mixedType,1
9,3,0,12,mixedType,1
2,8,0,10,mixedType,1
7,3,0,10,mixedType,1
5,2,0,7,mixedType,0
4,5,0,9,mixedType,1
7,4,0,11,mixedType,1
10,2,0,12,mixedType,1
6,4,0,10,mixedType,1
10,2,0,12,mixedType,1
12,3,0,15,mixedType,2
8,1,0,9,mixedType,1
5,3,0,8,mixedType,1
5,8,0,13,mixedType,1
15,1,0,16,mixedType,2
5,2,0,7,mixedType,0
12,4,0,16,mixedType,2
7,3,0,10,mixedType,1
8,1,0,9,mixedType,1
6,3,0,9,mixedType,1
5,4,0,9,mixedType,1
7,3,0,10,mixedType,1
8,1,0,9,mixedType,1
10,3,0,13,mixedType,1
13,3,0,16,mixedType,2
6,1,0,7,mixedType,0
5,2,0,7,mixedType,0
14,2,0,16,mixedType,2
2,8,0,10,mixedType,1
6,4,0,10,mixedType,1
2,9,0,11,mixedType,1
6,2,0,8,mixedType,1
5,4,0,9,mixedType,1
7,4,0,11,mixedType,1
4,2,0,6,mixedType,0
5,6,0,11,mixedType,1
9,2,0,11,mixedType,1
1,8,0,9,mixedType,1
7,3,0,10,mixedType,1
12,4,0,16,mixedType,2
9,4,0,13,mixedType,1
6,1,0,7,mixedType,0
8,4,0,12,mixedType,1
10,1,0,11,mixedType,1
5,1,0,6,mixedType,0
7,3,0,10,mixedType,1
5,3,0,8,mixedType,1
10,1,0,11,mixedType,1
5,4,0,9,mixedType,1
9,3,0,12,mixedType,1
7,2,0,9,mixedType,1
7,3,0,10,mixedType,1
6,3,0,9,mixedType,1
9,1,0,10,mixedType,1
6,4,0,10,mixedType,1
4,4,0,8,mixedType,1
0,8,0,8,sameType,1
6,3,0,9,mixedType,1
6,6,0,12,mixedType,1
2,4,0,6,mixedType,0
7,2,0,9,mixedType,1
5,4,0,9,mixedType,1
9,1,0,10,mixedType,1
1,8,0,9,mixedType,1
7,4,0,11,mixedType,1
15,1,1,17,mixedType,2
4,5,0,9,mixedType,1
5,2,0,7,mixedType,0
9,3,0,12,mixedType,1
7,1,0,8,mixedType,1
4,6,0,10,mixedType,1
8,2,0,10,mixedType,1
6,4,0,10,mixedType,1
12,4,0,16,mixedType,2
1,9,0,10,mixedType,1
6,3,0,9,mixedType,1
2,8,0,10,mixedType,1
11,2,0,13,mixedType,1
4,2,0,6,mixedType,0
5,4,0,9,mixedType,1
2,8,0,10,mixedType,1
7,3,0,10,mixedType,1
12,1,0,13,mixedType,1
8,3,0,11,mixedType,1
9,2,0,11,mixedType,1
13,3,0,16,mixedType,2
7,3,0,10,mixedType,1
8,2,0,10,mixedType,1
6,3,0,9,mixedType,1
15,1,0,16,mixedType,2
8,4,0,12,mixedType,1
8,1,0,9,mixedType,1
13,3,0,16,mixedType,2
7,1,0,8,mixedType,1
8,4,0,12,mixedType,1
6,1,0,7,mixedType,0
6,2,0,8,mixedType,1
12,3,0,15,mixedType,2
5,2,0,7,mixedType,0
6,4,0,10,mixedType,1
11,2,0,13,mixedType,1
6,4,0,10,mixedType,1
2,9,0,11,mixedType,1
6,3,0,9,mixedType,1
7,2,0,9,mixedType,1
6,3,0,9,mixedType,1
6,4,0,10,mixedType,1
2,4,0,6,mixedType,0
5,8,0,13,mixedType,1
8,2,0,10,mixedType,1
6,2,0,8,mixedType,1
8,4,0,12,mixedType,1
7,2,0,9,mixedType,1
6,3,0,9,mixedType,1
6,1,0,7,mixedType,0
7,2,0,9,mixedType,1
7,2,0,9,mixedType,1
15,1,0,16,mixedType,2
14,2,0,16,mixedType,2
6,2,0,8,mixedType,1
4,4,0,8,mixedType,1
7,3,0,10,mixedType,1
4,2,0,6,mixedType,0
11,1,0,12,mixedType,1
14,2,0,16,mixedType,2
10,2,0,12,mixedType,1
4,4,0,8,mixedType,1
7,3,0,10,mixedType,1
8,4,0,12,mixedType,1
8,2,0,10,mixedType,1
6,3,0,9,mixedType,1
11,5,0,16,mixedType,2
1,10,0,11,mixedType,1
5,8,0,13,mixedType,1
5,2,1,8,mixedType,1
14,2,0,16,mixedType,2
6,3,0,9,mixedType,1
6,4,0,10,mixedType,1
6,2,0,8,mixedType,1
2,7,0,9,mixedType,1
4,4,0,8,mixedType,1
8,1,0,9,mixedType,1
9,3,0,12,mixedType,1
5,3,0,8,mixedType,1
5,1,0,6,mixedType,0
7,3,0,10,mixedType,1
7,3,0,10,mixedType,1
11,1,0,12,mixedType,1
2,9,0,11,mixedType,1
6,3,0,9,mixedType,1
15,1,0,16,mixedType,2
1,8,0,9,mixedType,1
5,3,0,8,mixedType,1
5,4,0,9,mixedType,1
7,3,0,10,mixedType,1
9,1,0,10,mixedType,1
6,2,0,8,mixedType,1
15,1,0,16,mixedType,2
9,1,0,10,mixedType,1
10,2,0,12,mixedType,1
11,1,0,12,mixedType,1
5,2,0,7,mixedType,0
5,8,0,13,mixedType,1
14,2,1,17,mixedType,2
7,2,0,9,mixedType,1
6,4,0,10,mixedType,1
13,3,0,16,mixedType,2
1,8,0,9,mixedType,1
5,1,0,6,mixedType,0
8,1,0,9,mixedType,1
13,4,0,17,mixedType,2
6,2,0,8,mixedType,1
7,2,0,9,mixedType,1
6,4,0,10,mixedType,1
4,4,0,8,mixedType,1
6,2,0,8,mixedType,1
5,1,0,6,mixedType,0
4,4,0,8,mixedType,1
8,2,0,10,mixedType,1
12,3,0,15,mixedType,2
5,0,0,5,sameType,0
6,3,0,9,mixedType,1
7,1,0,8,mixedType,1
13,3,0,16,mixedType,2
8,3,0,11,mixedType,1
7,2,0,9,mixedType,1
4,4,0,8,mixedType,1
6,2,0,8,mixedType,1
7,3,0,10,mixedType,1
5,4,0,9,mixedType,1
8,4,0,12,mixedType,1
5,4,0,9,mixedType,1
1,9,0,10,mixedType,1
13,3,0,16,mixedType,2
8,1,0,9,mixedType,1
1,10,0,11,mixedType,1
5,2,0,7,mixedType,0
6,4,0,10,mixedType,1
6,4,0,10,mixedType,1
10,2,0,12,mixedType,1
6,3,0,9,mixedType,1
15,1,0,16,mixedType,2
6,3,0,9,mixedType,1
8,4,0,12,mixedType,1
6,2,0,8,mixedType,1
14,2,0,16,mixedType,2
6,2,0,8,mixedType,1
4,4,0,8,mixedType,1
7,4,0,11,mixedType,1
5,1,0,6,mixedType,0
5,4,0,9,mixedType,1
2,6,0,8,mixedType,1
0,6,1,7,mixedType,0
7,2,0,9,mixedType,1
6,3,0,9,mixedType,1
6,6,0,12,mixedType,1
2,7,0,9,mixedType,1
8,2,0,10,mixedType,1
1,8,0,9,mixedType,1
6,3,0,9,mixedType,1
6,2,0,8,mixedType,1
7,1,0,8,mixedType,1
4,2,0,6,mixedType,0
6,2,0,8,mixedType,1
5,2,0,7,mixedType,0
7,4,0,11,mixedType,1
6,3,0,9,mixedType,1
9,2,0,11,mixedType,1
2,4,0,6,mixedType,0
5,7,0,12,mixedType,1
9,0,2,11,mixedType,1
9,1,0,10,mixedType,1
6,7,0,13,mixedType,1
5,1,0,6,mixedType,0
6,4,0,10,mixedType,1
10,4,0,14,mixedType,2
8,1,6,15,mixedType,2
10,2,0,12,mixedType,1
11,1,0,12,mixedType,1
5,1,0,6,mixedType,0
5,3,0,8,mixedType,1
7,3,0,10,mixedType,1
8,2,0,10,mixedType,1
7,3,0,10,mixedType,1
7,3,0,10,mixedType,1
6,3,0,9,mixedType,1
6,3,0,9,mixedType,1
4,2,0,6,mixedType,0
6,2,0,8,mixedType,1
7,1,0,8,mixedType,1
7,2,0,9,mixedType,1
6,1,0,7,mixedType,0
8,2,0,10,mixedType,1
6,2,0,8,mixedType,1
6,3,0,9,mixedType,1
9,1,0,10,mixedType,1
6,6,0,12,mixedType,1
4,4,0,8,mixedType,1
4,4,0,8,mixedType,1
3,5,0,8,mixedType,1
5,3,0,8,mixedType,1
5,1,0,6,mixedType,0
7,2,0,9,mixedType,1
9,2,0,11,mixedType,1
8,2,0,10,mixedType,1
15,1,0,16,mixedType,2
10,1,0,11,mixedType,1
4,4,0,8,mixedType,1
6,1,0,7,mixedType,0
14,2,0,16,mixedType,2
11,3,0,14,mixedType,2
8,4,0,12,mixedType,1
10,3,0,13,mixedType,1
5,3,0,8,mixedType,1
5,2,0,7,mixedType,0
9,1,0,10,mixedType,1
5,2,0,7,mixedType,0
5,2,0,7,mixedType,0
4,4,0,8,mixedType,1
10,2,0,12,mixedType,1
14,2,0,16,mixedType,2
7,3,0,10,mixedType,1
10,2,0,12,mixedType,1
5,6,0,11,mixedType,1
8,1,0,9,mixedType,1
6,3,0,9,mixedType,1
11,2,0,13,mixedType,1
6,1,0,7,mixedType,0
18,1,1,20,mixedType,2
6,3,0,9,mixedType,1
5,2,0,7,mixedType,0
6,6,0,12,mixedType,1
8,2,0,10,mixedType,1
7,3,0,10,mixedType,1
6,2,0,8,mixedType,1
5,2,0,7,mixedType,0
11,5,0,16,mixedType,2
8,2,0,10,mixedType,1
7,4,0,11,mixedType,1
4,6,0,10,mixedType,1
3,5,0,8,mixedType,1
14,2,0,16,mixedType,2
3,8,0,11,mixedType,1
7,1,0,8,mixedType,1
5,7,0,12,mixedType,1
7,2,0,9,mixedType,1
2,7,0,9,mixedType,1
1,7,0,8,mixedType,1
5,3,0,8,mixedType,1
6,3,0,9,mixedType,1
7,1,0,8,mixedType,1
5,3,0,8,mixedType,1
9,3,0,12,mixedType,1
6,4,0,10,mixedType,1
9,3,0,12,mixedType,1
5,4,0,9,mixedType,1
8,1,0,9,mixedType,1
9,3,0,12,mixedType,1
6,1,0,7,mixedType,0
6,1,0,7,mixedType,0
8,3,0,11,mixedType,1
6,3,0,9,mixedType,1
5,4,0,9,mixedType,1
1,10,0,11,mixedType,1
6,2,0,8,mixedType,1
7,3,0,10,mixedType,1
3,3,0,6,mixedType,0
7,3,0,10,mixedType,1
1,0,1,2,mixedType,0
5,4,0,9,mixedType,1
4,2,0,6,mixedType,0
6,3,0,9,mixedType,1
5,3,0,8,mixedType,1
6,3,0,9,mixedType,1
6,4,0,10,mixedType,1
6,2,0,8,mixedType,1
5,3,0,8,mixedType,1
6,3,0,9,mixedType,1
6,3,0,9,mixedType,1
3,7,0,10,mixedType,1
12,3,0,15,mixedType,2
7,1,0,8,mixedType,1
7,2,0,9,mixedType,1
15,1,0,16,mixedType,2
7,3,0,10,mixedType,1
6,7,0,13,mixedType,1
6,1,0,7,mixedType,0
4,7,0,11,mixedType,1
2,8,0,10,mixedType,1
2,8,0,10,mixedType,1
12,4,0,16,mixedType,2
9,1,0,10,mixedType,1
10,2,0,12,mixedType,1
6,1,0,7,mixedType,0
7,1,0,8,mixedType,1
8,3,0,11,mixedType,1
5,2,0,7,mixedType,0
5,2,0,7,mixedType,0
7,3,0,10,mixedType,1
5,3,0,8,mixedType,1
9,2,0,11,mixedType,1
7,3,0,10,mixedType,1
5,5,0,10,mixedType,1
12,4,0,16,mixedType,2
6,3,0,9,mixedType,1
5,3,0,8,mixedType,1
7,3,0,10,mixedType,1
7,2,0,9,mixedType,1
4,5,0,9,mixedType,1
7,3,0,10,mixedType,1
4,2,0,6,mixedType,0
15,1,0,16,mixedType,2
6,2,0,8,mixedType,1
7,2,0,9,mixedType,1
6,4,0,10,mixedType,1
6,2,0,8,mixedType,1
11,2,0,13,mixedType,1
5,1,0,6,mixedType,0
6,3,0,9,mixedType,1
6,3,0,9,mixedType,1
9,1,0,10,mixedType,1
5,2,0,7,mixedType,0
7,6,1,14,mixedType,2
1,8,0,9,mixedType,1
9,1,0,10,mixedType,1
10,1,0,11,mixedType,1
7,4,0,11,mixedType,1
7,1,0,8,mixedType,1
4,4,0,8,mixedType,1
7,3,0,10,mixedType,1
6,2,0,8,mixedType,1
7,3,0,10,mixedType,1
7,2,0,9,mixedType,1
9,2,0,11,mixedType,1
9,1,0,10,mixedType,1
9,1,0,10,mixedType,1
5,1,0,6,mixedType,0
9,2,0,11,mixedType,1
7,2,0,9,mixedType,1
6,3,0,9,mixedType,1
7,1,0,8,mixedType,1
8,2,0,10,mixedType,1
5,3,0,8,mixedType,1
6,1,0,7,mixedType,0
15,1,0,16,mixedType,2
7,3,0,10,mixedType,1
14,2,0,16,mixedType,2
7,4,0,11,mixedType,1
5,4,0,9,mixedType,1
4,4,0,8,mixedType,1
2,6,0,8,mixedType,1
4,4,0,8,mixedType,1
0,6,0,6,sameType,0
4,2,0,6,mixedType,0
6,2,0,8,mixedType,1
6,2,0,8,mixedType,1
8,2,0,10,mixedType,1
10,1,0,11,mixedType,1
7,2,0,9,mixedType,1
5,7,0,12,mixedType,1
9,1,0,10,mixedType,1
14,2,0,16,mixedType,2
6,2,0,8,mixedType,1
12,1,1,14,mixedType,2
6,2,0,8,mixedType,1
8,2,0,10,mixedType,1
8,1,0,9,mixedType,1
3,8,0,11,mixedType,1
2,8,0,10,mixedType,1
5,3,0,8,mixedType,1
6,2,0,8,mixedType,1
5,2,0,7,mixedType,0
8,2,0,10,mixedType,1
4,5,0,9,mixedType,1
7,2,0,9,mixedType,1
5,2,0,7,mixedType,0
11,5,0,16,mixedType,2
9,3,0,12,mixedType,1
6,3,0,9,mixedType,1
14,2,0,16,mixedType,2
8,1,0,9,mixedType,1
18,1,1,20,mixedType,2
24,6,0,30,mixedType,2
5,1,0,6,mixedType,0
7,3,0,10,mixedType,1
6,3,0,9,mixedType,1
7,3,0,10,mixedType,1
5,1,0,6,mixedType,0
7,2,0,9,mixedType,1
3,6,0,9,mixedType,1
15,1,0,16,mixedType,2
8,1,0,9,mixedType,1
7,3,0,10,mixedType,1
4,4,0,8,mixedType,1
7,2,0,9,mixedType,1
11,5,0,16,mixedType,2
4,4,0,8,mixedType,1
16,2,0,18,mixedType,2
7,4,0,11,mixedType,1
14,2,0,16,mixedType,2
7,2,0,9,mixedType,1
2,7,0,9,mixedType,1
12,3,0,15,mixedType,2
9,2,0,11,mixedType,1
3,7,0,10,mixedType,1
7,1,0,8,mixedType,1
2,8,0,10,mixedType,1
7,6,0,13,mixedType,1
6,4,0,10,mixedType,1
6,4,0,10,mixedType,1
2,7,0,9,mixedType,1
6,4,0,10,mixedType,1
6,4,0,10,mixedType,1
4,6,0,10,mixedType,1
8,1,0,9,mixedType,1
7,3,0,10,mixedType,1
14,2,0,16,mixedType,2
6,3,0,9,mixedType,1
6,4,0,10,mixedType,1
11,2,0,13,mixedType,1
7,1,0,8,mixedType,1
6,1,0,7,mixedType,0
8,4,0,12,mixedType,1
6,1,0,7,mixedType,0
6,4,0,10,mixedType,1
7,2,0,9,mixedType,1
9,1,0,10,mixedType,1
9,1,0,10,mixedType,1
7,3,0,10,mixedType,1
5,3,0,8,mixedType,1
6,1,0,7,mixedType,0
0,10,1,11,mixedType,1
6,6,0,12,mixedType,1
4,4,0,8,mixedType,1
11,7,1,19,mixedType,2
6,1,0,7,mixedType,0
6,2,0,8,mixedType,1
7,1,0,8,mixedType,1
7,2,0,9,mixedType,1
15,3,6,24,mixedType,2
6,3,0,9,mixedType,1
5,4,0,9,mixedType,1
5,4,0,9,mixedType,1
5,3,0,8,mixedType,1
4,2,0,6,mixedType,0
8,2,0,10,mixedType,1
5,5,0,10,mixedType,1
5,3,0,8,mixedType,1
5,3,0,8,mixedType,1
7,3,0,10,mixedType,1
10,2,0,12,mixedType,1
7,2,0,9,mixedType,1
8,1,0,9,mixedType,1
6,2,0,8,mixedType,1
8,1,0,9,mixedType,1
5,2,0,7,mixedType,0
6,2,0,8,mixedType,1
7,3,0,10,mixedType,1
7,3,0,10,mixedType,1
8,2,0,10,mixedType,1
6,2,0,8,mixedType,1
2,6,0,8,mixedType,1
6,1,0,7,mixedType,0
6,2,0,8,mixedType,1
8,2,0,10,mixedType,1
6,1,0,7,mixedType,0
10,2,0,12,mixedType,1
6,4,0,10,mixedType,1
12,3,0,15,mixedType,2
6,2,0,8,mixedType,1
3,5,0,8,mixedType,1
4,4,0,8,mixedType,1
6,1,0,7,mixedType,0
6,3,0,9,mixedType,1
8,1,0,9,mixedType,1
8,1,0,9,mixedType,1
4,4,0,8,mixedType,1
14,2,0,16,mixedType,2
8,2,0,10,mixedType,1
11,2,0,13,mixedType,1
5,1,0,6,mixedType,0
7,2,0,9,mixedType,1
5,3,0,8,mixedType,1
14,2,0,16,mixedType,2
9,2,0,11,mixedType,1
5,1,0,6,mixedType,0
9,1,0,10,mixedType,1
3,6,0,9,mixedType,1
5,3,0,8,mixedType,1
7,3,0,10,mixedType,1
8,3,0,11,mixedType,1
7,1,0,8,mixedType,1
10,5,0,15,mixedType,2
6,3,0,9,mixedType,1
6,3,0,9,mixedType,1
6,2,0,8,mixedType,1
15,1,0,16,mixedType,2
8,4,0,12,mixedType,1
7,3,0,10,mixedType,1
7,3,0,10,mixedType,1
6,1,0,7,mixedType,0
1,8,0,9,mixedType,1
8,2,0,10,mixedType,1
15,1,0,16,mixedType,2
14,2,0,16,mixedType,2
11,4,0,15,mixedType,2
3,10,0,13,mixedType,1
10,1,0,11,mixedType,1
6,1,0,7,mixedType,0
3,3,0,6,mixedType,0
14,2,0,16,mixedType,2
7,2,0,9,mixedType,1
11,5,0,16,mixedType,2
8,4,0,12,mixedType,1
5,1,0,6,mixedType,0
9,1,0,10,mixedType,1
4,4,0,8,mixedType,1
5,3,0,8,mixedType,1
5,3,0,8,mixedType,1
6,3,0,9,mixedType,1
7,4,0,11,mixedType,1
2,8,0,10,mixedType,1
5,1,0,6,mixedType,0
4,4,0,8,mixedType,1
7,1,0,8,mixedType,1
8,2,0,10,mixedType,1
7,3,0,10,mixedType,1
7,5,0,12,mixedType,1
7,3,0,10,mixedType,1
1,8,0,9,mixedType,1
8,2,0,10,mixedType,1
14,1,1,16,mixedType,2
5,2,0,7,mixedType,0
6,2,0,8,mixedType,1
6,2,0,8,mixedType,1
5,2,0,7,mixedType,0
2,4,0,6,mixedType,0
6,1,0,7,mixedType,0
5,1,0,6,mixedType,0
6,3,0,9,mixedType,1
8,5,0,13,mixedType,1
6,3,0,9,mixedType,1
3,5,0,8,mixedType,1
10,2,0,12,mixedType,1
9,2,4,15,mixedType,2
7,2,0,9,mixedType,1
3,6,0,9,mixedType,1
8,2,0,10,mixedType,1
10,2,0,12,mixedType,1
9,2,0,11,mixedType,1
6,4,0,10,mixedType,1
6,3,0,9,mixedType,1
3,6,0,9,mixedType,1
2,7,0,9,mixedType,1
7,3,0,10,mixedType,1
1,7,0,8,mixedType,1
9,1,0,10,mixedType,1
7,3,0,10,mixedType,1
9,4,0,13,mixedType,1
3,7,0,10,mixedType,1
7,2,0,9,mixedType,1
4,6,0,10,mixedType,1
12,4,0,16,mixedType,2
8,1,0,9,mixedType,1
8,2,0,10,mixedType,1
6,2,0,8,mixedType,1
6,3,0,9,mixedType,1
8,1,0,9,mixedType,1
6,4,0,10,mixedType,1
6,2,0,8,mixedType,1
5,3,0,8,mixedType,1
6,1,0,7,mixedType,0
6,0,0,6,sameType,0
6,4,0,10,mixedType,1
7,4,0,11,mixedType,1
10,1,0,11,mixedType,1
5,2,0,7,mixedType,0
8,2,0,10,mixedType,1
4,4,0,8,mixedType,1
6,2,0,8,mixedType,1
10,2,3,15,mixedType,2
8,1,0,9,mixedType,1
7,3,0,10,mixedType,1
10,2,0,12,mixedType,1
3,5,0,8,mixedType,1
6,3,0,9,mixedType,1
1,8,0,9,mixedType,1
15,1,0,16,mixedType,2
7,3,0,10,mixedType,1
4,5,0,9,mixedType,1
1,9,0,10,mixedType,1
1,7,0,8,mixedType,1
1,10,0,11,mixedType,1
1,7,0,8,mixedType,1
7,2,0,9,mixedType,1
1,9,0,10,mixedType,1
9,3,0,12,mixedType,1
7,1,0,8,mixedType,1
8,1,0,9,mixedType,1
11,1,0,12,mixedType,1
4,7,0,11,mixedType,1
5,3,0,8,mixedType,1
7,1,0,8,mixedType,1
4,2,0,6,mixedType,0
6,3,0,9,mixedType,1
9,1,0,10,mixedType,1
5,1,0,6,mixedType,0
10,0,3,13,mixedType,1
5,1,0,6,mixedType,0
8,10,1,19,mixedType,2
12,4,0,16,mixedType,2
2,8,0,10,mixedType,1
7,3,0,10,mixedType,1
7,1,0,8,mixedType,1
7,2,0,9,mixedType,1
3,5,0,8,mixedType,1
4,6,0,10,mixedType,1
5,4,0,9,mixedType,1
6,1,0,7,mixedType,0
5,3,0,8,mixedType,1
10,2,0,12,mixedType,1
6,2,0,8,mixedType,1
5,3,0,8,mixedType,1
5,3,0,8,mixedType,1
6,3,0,9,mixedType,1
8,3,0,11,mixedType,1
4,6,0,10,mixedType,1
7,3,0,10,mixedType,1
1,7,0,8,mixedType,1
6,4,0,10,mixedType,1
9,1,0,10,mixedType,1
7,3,0,10,mixedType,1
13,3,0,16,mixedType,2
1,8,0,9,mixedType,1
3,10,0,13,mixedType,1
3,6,0,9,mixedType,1
2,6,4,12,mixedType,1
3,6,0,9,mixedType,1
7,3,0,10,mixedType,1
4,4,0,8,mixedType,1
3,6,0,9,mixedType,1
4,4,0,8,mixedType,1
9,4,0,13,mixedType,1
12,4,0,16,mixedType,2
5,3,0,8,mixedType,1
6,3,0,9,mixedType,1
7,2,0,9,mixedType,1
7,3,0,10,mixedType,1
5,3,0,8,mixedType,1
6,3,0,9,mixedType,1
6,2,0,8,mixedType,1
9,1,0,10,mixedType,1
7,3,0,10,mixedType,1
7,1,0,8,mixedType,1
5,3,0,8,mixedType,1
6,2,0,8,mixedType,1
7,1,0,8,mixedType,1
8,4,0,12,mixedType,1
3,6,0,9,mixedType,1
7,2,0,9,mixedType,1
6,3,0,9,mixedType,1
11,1,0,12,mixedType,1
5,3,0,8,mixedType,1
7,3,0,10,mixedType,1
5,3,0,8,mixedType,1
9,4,0,13,mixedType,1
8,1,0,9,mixedType,1
11,2,0,13,mixedType,1
7,4,0,11,mixedType,1
8,4,0,12,mixedType,1
7,1,0,8,mixedType,1
9,4,0,13,mixedType,1
5,2,0,7,mixedType,0
2,4,0,6,mixedType,0
7,4,0,11,mixedType,1
9,3,0,12,mixedType,1
6,2,0,8,mixedType,1
7,3,0,10,mixedType,1
7,2,0,9,mixedType,1
6,6,0,12,mixedType,1
12,1,0,13,mixedType,1
7,2,0,9,mixedType,1
5,1,0,6,mixedType,0
6,3,0,9,mixedType,1
8,2,0,10,mixedType,1
9,1,0,10,mixedType,1
8,2,0,10,mixedType,1
14,2,0,16,mixedType,2
7,1,0,8,mixedType,1
2,7,0,9,mixedType,1
6,2,0,8,mixedType,1
6,2,0,8,mixedType,1
5,1,0,6,mixedType,0
8,2,0,10,mixedType,1
4,4,0,8,mixedType,1
3,7,0,10,mixedType,1
6,1,0,7,mixedType,0
5,4,0,9,mixedType,1
12,3,0,15,mixedType,2
11,1,0,12,mixedType,1
5,2,0,7,mixedType,0
4,5,0,9,mixedType,1
6,2,0,8,mixedType,1
5,1,0,6,mixedType,0
8,1,0,9,mixedType,1
5,3,0,8,mixedType,1
3,6,0,9,mixedType,1
13,3,0,16,mixedType,2
8,1,0,9,mixedType,1
7,4,0,11,mixedType,1
6,2,0,8,mixedType,1
9,2,0,11,mixedType,1
1,8,0,9,mixedType,1
3,6,0,9,mixedType,1
4,7,0,11,mixedType,1
9,1,0,10,mixedType,1
13,2,0,15,mixedType,2
6,3,0,9,mixedType,1
7,2,0,9,mixedType,1
13,3,0,16,mixedType,2
12,4,0,16,mixedType,2
1,8,0,9,mixedType,1
13,3,0,16,mixedType,2
6,4,0,10,mixedType,1
6,1,0,7,mixedType,0
5,1,0,6,mixedType,0
7,3,0,10,mixedType,1
6,1,0,7,mixedType,0
12,4,0,16,mixedType,2
12,4,0,16,mixedType,2
5,1,0,6,mixedType,0
13,3,0,16,mixedType,2
15,1,0,16,mixedType,2
10,1,0,11,mixedType,1
6,3,0,9,mixedType,1
8,4,0,12,mixedType,1
8,3,0,11,mixedType,1
3,7,0,10,mixedType,1
1,5,0,6,mixedType,0
10,2,0,12,mixedType,1
15,1,0,16,mixedType,2
9,4,0,13,mixedType,1
14,2,0,16,mixedType,2
6,3,0,9,mixedType,1
6,3,0,9,mixedType,1
6,3,0,9,mixedType,1
9,1,0,10,mixedType,1
6,4,0,10,mixedType,1
7,3,0,10,mixedType,1
6,2,0,8,mixedType,1
5,1,0,6,mixedType,0
4,8,0,12,mixedType,1
5,3,0,8,mixedType,1
3,5,0,8,mixedType,1
7,2,0,9,mixedType,1
9,1,0,10,mixedType,1
14,2,0,16,mixedType,2
8,1,0,9,mixedType,1
8,3,0,11,mixedType,1
9,2,0,11,mixedType,1
8,2,0,10,mixedType,1
7,3,0,10,mixedType,1
8,1,0,9,mixedType,1
8,2,0,10,mixedType,1
8,2,0,10,mixedType,1
6,3,0,9,mixedType,1
1,8,0,9,mixedType,1
5,4,0,9,mixedType,1
6,4,0,10,mixedType,1
6,3,0,9,mixedType,1
4,5,0,9,mixedType,1
5,3,0,8,mixedType,1
7,1,0,8,mixedType,1
11,2,0,13,mixedType,1
5,3,0,8,mixedType,1
3,3,0,6,mixedType,0
8,2,0,10,mixedType,1
4,2,0,6,mixedType,0
8,2,0,10,mixedType,1
4,6,0,10,mixedType,1
6,3,0,9,mixedType,1
6,2,0,8,mixedType,1
6,3,0,9,mixedType,1
0,12,1,13,mixedType,1
7,3,0,10,mixedType,1
14,2,0,16,mixedType,2
7,2,0,9,mixedType,1
2,6,0,8,mixedType,1
7,2,0,9,mixedType,1
9,3,0,12,mixedType,1
6,1,0,7,mixedType,0
4,2,0,6,mixedType,0
3,3,0,6,mixedType,0
4,2,0,6,mixedType,0
1,8,0,9,mixedType,1
4,4,0,8,mixedType,1
4,2,0,6,mixedType,0
5,3,0,8,mixedType,1
14,2,0,16,mixedType,2
14,2,0,16,mixedType,2
6,2,0,8,mixedType,1
3,6,0,9,mixedType,1
5,1,0,6,mixedType,0
8,1,0,9,mixedType,1
5,1,0,6,mixedType,0
6,4,0,10,mixedType,1
2,8,0,10,mixedType,1
7,3,0,10,mixedType,1
2,5,0,7,mixedType,0
6,1,0,7,mixedType,0
6,3,0,9,mixedType,1
9,1,0,10,mixedType,1
1,8,0,9,mixedType,1
2,7,0,9,mixedType,1
8,4,0,12,mixedType,1
6,2,0,8,mixedType,1
5,1,0,6,mixedType,0
14,2,0,16,mixedType,2
11,3,0,14,mixedType,2
6,6,0,12,mixedType,1
10,3,0,13,mixedType,1
5,4,0,9,mixedType,1
4,5,0,9,mixedType,1
4,2,0,6,mixedType,0
8,1,0,9,mixedType,1
6,3,0,9,mixedType,1
13,3,0,16,mixedType,2
2,4,0,6,mixedType,0
6,3,0,9,mixedType,1
12,4,0,16,mixedType,2
8,2,0,10,mixedType,1
7,2,0,9,mixedType,1
7,4,0,11,mixedType,1
8,2,0,10,mixedType,1
9,3,0,12,mixedType,1
6,1,0,7,mixedType,0
5,3,0,8,mixedType,1
5,2,0,7,mixedType,0
12,3,0,15,mixedType,2
7,3,0,10,mixedType,1
5,3,0,8,mixedType,1
8,1,0,9,mixedType,1
9,3,0,12,mixedType,1
7,4,0,11,mixedType,1
6,3,0,9,mixedType,1
13,3,0,16,mixedType,2
5,2,0,7,mixedType,0
7,2,0,9,mixedType,1
4,4,0,8,mixedType,1
4,5,0,9,mixedType,1
5,2,0,7,mixedType,0
6,3,0,9,mixedType,1
5,2,0,7,mixedType,0
5,5,0,10,mixedType,1
10,1,0,11,mixedType,1
9,1,0,10,mixedType,1
2,4,0,6,mixedType,0
4,2,0,6,mixedType,0
4,6,0,10,mixedType,1
1,8,0,9,mixedType,1
5,2,0,7,mixedType,0
8,4,0,12,mixedType,1
9,1,0,10,mixedType,1
5,3,0,8,mixedType,1
4,5,0,9,mixedType,1
3,7,0,10,mixedType,1
6,3,0,9,mixedType,1
12,4,0,16,mixedType,2
8,0,1,9,mixedType,1
9,1,0,10,mixedType,1
7,3,0,10,mixedType,1
1,7,0,8,mixedType,1
6,4,0,10,mixedType,1
5,2,0,7,mixedType,0
3,6,0,9,mixedType,1
9,4,0,13,mixedType,1
7,2,0,9,mixedType,1
1,9,0,10,mixedType,1
4,6,0,10,mixedType,1
4,4,0,8,mixedType,1
14,2,0,16,mixedType,2
4,4,0,8,mixedType,1
10,2,0,12,mixedType,1
14,2,0,16,mixedType,2
10,2,0,12,mixedType,1
7,3,0,10,mixedType,1
5,5,0,10,mixedType,1
4,4,0,8,mixedType,1
5,4,0,9,mixedType,1
14,2,0,16,mixedType,2
10,3,0,13,mixedType,1
9,3,0,12,mixedType,1
6,1,0,7,mixedType,0
10,2,0,12,mixedType,1
4,4,0,8,mixedType,1
4,7,0,11,mixedType,1
12,1,0,13,mixedType,1
8,2,0,10,mixedType,1
2,8,0,10,mixedType,1
4,4,0,8,mixedType,1
5,2,0,7,mixedType,0
14,2,0,16,mixedType,2
2,8,0,10,mixedType,1
7,2,0,9,mixedType,1
13,3,0,16,mixedType,2
14,2,0,16,mixedType,2
5,2,0,7,mixedType,0
15,1,0,16,mixedType,2
5,4,0,9,mixedType,1
5,2,0,7,mixedType,0
6,3,0,9,mixedType,1
14,2,0,16,mixedType,2
6,3,0,9,mixedType,1
11,5,0,16,mixedType,2
3,6,0,9,mixedType,1
9,4,0,13,mixedType,1
8,1,0,9,mixedType,1
7,3,0,10,mixedType,1
6,3,0,9,mixedType,1
1,8,0,9,mixedType,1
8,1,0,9,mixedType,1
7,3,0,10,mixedType,1
7,2,0,9,mixedType,1
9,1,0,10,mixedType,1
5,5,0,10,mixedType,1
4,2,0,6,mixedType,0
1,8,0,9,mixedType,1
7,1,0,8,mixedType,1
8,1,0,9,mixedType,1
4,6,0,10,mixedType,1
5,2,0,7,mixedType,0
7,2,0,9,mixedType,1
8,6,0,14,mixedType,2
6,1,0,7,mixedType,0
6,4,0,10,mixedType,1
6,4,0,10,mixedType,1
14,2,0,16,mixedType,2
8,2,0,10,mixedType,1
2,8,0,10,mixedType,1
2,6,0,8,mixedType,1
6,3,0,9,mixedType,1
9,3,0,12,mixedType,1
7,3,0,10,mixedType,1
7,2,0,9,mixedType,1
10,2,0,12,mixedType,1
8,2,0,10,mixedType,1
8,3,0,11,mixedType,1
14,2,0,16,mixedType,2
7,2,0,9,mixedType,1
3,8,0,11,mixedType,1
5,3,0,8,mixedType,1
5,3,0,8,mixedType,1
3,3,0,6,mixedType,0
5,2,0,7,mixedType,0
7,2,0,9,mixedType,1
10,2,0,12,mixedType,1
5,6,0,11,mixedType,1
11,5,0,16,mixedType,2
8,1,0,9,mixedType,1
8,5,0,13,mixedType,1
7,2,0,9,mixedType,1
6,3,0,9,mixedType,1
9,1,0,10,mixedType,1
8,2,0,10,mixedType,1
10,4,2,16,mixedType,2
3,6,0,9,mixedType,1
8,1,0,9,mixedType,1
4,2,0,6,mixedType,0
7,3,0,10,mixedType,1
6,3,0,9,mixedType,1
7,3,0,10,mixedType,1
8,3,0,11,mixedType,1
5,5,0,10,mixedType,1
4,4,0,8,mixedType,1
9,3,0,12,mixedType,1
6,2,0,8,mixedType,1
15,1,0,16,mixedType,2
5,2,0,7,mixedType,0
5,3,0,8,mixedType,1
1,8,0,9,mixedType,1
7,3,0,10,mixedType,1
7,3,0,10,mixedType,1
15,1,0,16,mixedType,2
4,5,0,9,mixedType,1
4,7,0,11,mixedType,1
6,2,0,8,mixedType,1
5,2,0,7,mixedType,0
14,2,0,16,mixedType,2
4,4,0,8,mixedType,1
7,3,0,10,mixedType,1
3,6,0,9,mixedType,1
7,3,0,10,mixedType,1
7,3,0,10,mixedType,1
6,3,0,9,mixedType,1
15,1,0,16,mixedType,2
8,4,0,12,mixedType,1
8,4,0,12,mixedType,1
3,5,0,8,mixedType,1
2,4,0,6,mixedType,0
3,3,0,6,mixedType,0
6,4,0,10,mixedType,1
6,2,0,8,mixedType,1
6,4,0,10,mixedType,1
7,5,0,12,mixedType,1
6,1,0,7,mixedType,0
6,3,0,9,mixedType,1
5,3,0,8,mixedType,1
13,3,0,16,mixedType,2
5,3,0,8,mixedType,1
9,1,0,10,mixedType,1
9,1,0,10,mixedType,1
11,0,2,13,mixedType,1
2,8,0,10,mixedType,1
7,3,0,10,mixedType,1
5,3,0,8,mixedType,1
6,1,0,7,mixedType,0
6,1,0,7,mixedType,0
5,2,0,7,mixedType,0
7,3,0,10,mixedType,1
4,2,0,6,mixedType,0
3,3,0,6,mixedType,0
6,1,0,7,mixedType,0
14,2,0,16,mixedType,2
7,4,0,11,mixedType,1
18,1,1,20,mixedType,2
4,4,0,8,mixedType,1
7,2,0,9,mixedType,1
7,3,0,10,mixedType,1
7,1,0,8,mixedType,1
8,1,0,9,mixedType,1
7,1,0,8,mixedType,1
8,1,0,9,mixedType,1
8,2,0,10,mixedType,1
7,2,0,9,mixedType,1
6,5,0,11,mixedType,1
6,2,0,8,mixedType,1
9,3,0,12,mixedType,1
11,3,0,14,mixedType,2
5,3,0,8,mixedType,1
7,1,0,8,mixedType,1
4,2,0,6,mixedType,0
14,2,0,16,mixedType,2
5,2,0,7,mixedType,0
12,3,0,15,mixedType,2
6,3,0,9,mixedType,1
7,3,0,10,mixedType,1
3,6,0,9,mixedType,1
4,4,0,8,mixedType,1
11,1,0,12,mixedType,1
7,3,0,10,mixedType,1
6,0,1,7,mixedType,0
3,6,0,9,mixedType,1
7,2,0,9,mixedType,1
3,5,0,8,mixedType,1
8,1,0,9,mixedType,1
8,1,0,9,mixedType,1
4,2,0,6,mixedType,0
5,1,0,6,mixedType,0
8,1,0,9,mixedType,1
11,1,0,12,mixedType,1
8,1,0,9,mixedType,1
2,6,0,8,mixedType,1
7,1,0,8,mixedType,1
7,2,0,9,mixedType,1
2,4,0,6,mixedType,0
2,8,0,10,mixedType,1
2,4,0,6,mixedType,0
4,2,0,6,mixedType,0
10,6,0,16,mixedType,2
8,2,0,10,mixedType,1
12,4,0,16,mixedType,2
7,2,0,9,mixedType,1
5,1,0,6,mixedType,0
6,4,0,10,mixedType,1
5,3,0,8,mixedType,1
3,6,0,9,mixedType,1
7,2,0,9,mixedType,1
6,3,0,9,mixedType,1
5,3,0,8,mixedType,1
7,2,0,9,mixedType,1
11,3,0,14,mixedType,2
1,8,0,9,mixedType,1
6,3,0,9,mixedType,1
12,3,0,15,mixedType,2
3,9,0,12,mixedType,1
7,1,0,8,mixedType,1
8,1,0,9,mixedType,1
8,4,0,12,mixedType,1
7,4,0,11,mixedType,1
7,2,0,9,mixedType,1
2,8,0,10,mixedType,1
7,3,0,10,mixedType,1
7,4,0,11,mixedType,1
7,4,0,11,mixedType,1
6,3,0,9,mixedType,1
4,6,0,10,mixedType,1
4,6,0,10,mixedType,1
4,2,0,6,mixedType,0
14,2,0,16,mixedType,2
6,1,0,7,mixedType,0
3,8,0,11,mixedType,1
8,1,0,9,mixedType,1
4,2,0,6,mixedType,0
15,1,0,16,mixedType,2
12,4,0,16,mixedType,2
7,1,0,8,mixedType,1
9,2,0,11,mixedType,1
5,2,0,7,mixedType,0
11,5,0,16,mixedType,2
12,4,0,16,mixedType,2
3,6,0,9,mixedType,1
7,3,0,10,mixedType,1
11,5,1,17,mixedType,2
1,9,0,10,mixedType,1
8,1,0,9,mixedType,1
6,4,0,10,mixedType,1
2,6,0,8,mixedType,1
7,1,0,8,mixedType,1
5,1,0,6,mixedType,0
7,3,0,10,mixedType,1
6,2,0,8,mixedType,1
6,3,0,9,mixedType,1
5,4,0,9,mixedType,1
3,10,0,13,mixedType,1
6,4,0,10,mixedType,1
7,3,0,10,mixedType,1
6,3,0,9,mixedType,1
6,2,0,8,mixedType,1
7,6,0,13,mixedType,1
6,3,0,9,mixedType,1
5,3,0,8,mixedType,1
5,3,0,8,mixedType,1
8,1,0,9,mixedType,1
5,4,0,9,mixedType,1
8,1,0,9,mixedType,1
6,3,0,9,mixedType,1
13,3,0,16,mixedType,2
5,4,0,9,mixedType,1
6,1,0,7,mixedType,0
7,3,0,10,mixedType,1
8,4,0,12,mixedType,1
9,4,0,13,mixedType,1
4,4,0,8,mixedType,1
5,3,0,8,mixedType,1
3,7,0,10,mixedType,1
9,2,0,11,mixedType,1
6,3,0,9,mixedType,1
5,2,0,7,mixedType,0
8,1,0,9,mixedType,1
7,3,0,10,mixedType,1
3,5,0,8,mixedType,1
6,3,0,9,mixedType,1
8,1,0,9,mixedType,1
7,3,0,10,mixedType,1
7,3,0,10,mixedType,1
9,2,0,11,mixedType,1
8,2,0,10,mixedType,1
8,3,0,11,mixedType,1
6,2,0,8,mixedType,1
7,3,0,10,mixedType,1
2,6,0,8,mixedType,1
2,9,0,11,mixedType,1
4,5,0,9,mixedType,1
2,6,0,8,mixedType,1
5,4,0,9,mixedType,1
7,3,0,10,mixedType,1
9,2,0,11,mixedType,1
8,5,0,13,mixedType,1
4,2,0,6,mixedType,0
2,6,0,8,mixedType,1
4,6,0,10,mixedType,1
8,1,0,9,mixedType,1
8,1,0,9,mixedType,1
8,1,0,9,mixedType,1
7,2,0,9,mixedType,1
8,2,0,10,mixedType,1
8,2,0,10,mixedType,1
11,5,0,16,mixedType,2
5,1,0,6,mixedType,0
5,3,0,8,mixedType,1
14,2,0,16,mixedType,2
5,4,0,9,mixedType,1
0,5,1,6,mixedType,0
7,3,0,10,mixedType,1
8,4,0,12,mixedType,1
4,4,0,8,mixedType,1
7,3,0,10,mixedType,1
6,3,0,9,mixedType,1
9,1,0,10,mixedType,1
7,3,0,10,mixedType,1
6,2,0,8,mixedType,1
9,4,1,14,mixedType,2
14,2,0,16,mixedType,2
13,3,0,16,mixedType,2
12,4,0,16,mixedType,2
8,4,2,14,mixedType,2
5,4,0,9,mixedType,1
5,3,0,8,mixedType,1
7,1,0,8,mixedType,1
8,2,0,10,mixedType,1
1,7,0,8,mixedType,1
6,4,0,10,mixedType,1
7,2,0,9,mixedType,1
5,3,0,8,mixedType,1
7,1,0,8,mixedType,1
10,2,0,12,mixedType,1
4,4,0,8,mixedType,1
5,2,0,7,mixedType,0
11,2,0,13,mixedType,1
4,6,0,10,mixedType,1
7,1,0,8,mixedType,1
4,4,0,8,mixedType,1
8,1,0,9,mixedType,1
15,1,0,16,mixedType,2
7,2,0,9,mixedType,1
11,5,0,16,mixedType,2
8,2,0,10,mixedType,1
5,5,0,10,mixedType,1
4,4,0,8,mixedType,1
5,3,0,8,mixedType,1
6,4,0,10,mixedType,1
8,3,0,11,mixedType,1
7,0,2,9,mixedType,1
9,2,0,11,mixedType,1
11,4,0,15,mixedType,2
8,1,0,9,mixedType,1
3,3,0,6,mixedType,0
8,1,0,9,mixedType,1
8,2,0,10,mixedType,1
5,2,0,7,mixedType,0
6,5,0,11,mixedType,1
3,5,0,8,mixedType,1
4,4,0,8,mixedType,1
6,1,0,7,mixedType,0
8,2,0,10,mixedType,1
6,2,0,8,mixedType,1
5,3,0,8,mixedType,1
7,2,0,9,mixedType,1
7,2,0,9,mixedType,1
7,6,0,13,mixedType,1
7,2,0,9,mixedType,1
11,2,0,13,mixedType,1
6,1,0,7,mixedType,0
5,3,0,8,mixedType,1
4,4,0,8,mixedType,1
6,3,0,9,mixedType,1
12,3,0,15,mixedType,2
5,8,0,13,mixedType,1
3,3,0,6,mixedType,0
6,3,0,9,mixedType,1
9,2,0,11,mixedType,1
8,3,0,11,mixedType,1
6,2,0,8,mixedType,1
6,2,0,8,mixedType,1
8,2,0,10,mixedType,1
14,2,0,16,mixedType,2
7,3,0,10,mixedType,1
6,2,0,8,mixedType,1
8,3,0,11,mixedType,1
8,1,0,9,mixedType,1
2,4,0,6,mixedType,0
9,2,0,11,mixedType,1
6,4,0,10,mixedType,1
8,2,0,10,mixedType,1
9,1,0,10,mixedType,1
5,8,0,13,mixedType,1
12,4,0,16,mixedType,2
8,2,0,10,mixedType,1
15,1,0,16,mixedType,2
5,3,0,8,mixedType,1
6,2,0,8,mixedType,1
6,3,0,9,mixedType,1
4,2,0,6,mixedType,0
9,3,0,12,mixedType,1
2,6,0,8,mixedType,1
2,12,0,14,mixedType,2
4,6,0,10,mixedType,1
8,2,0,10,mixedType,1
6,3,0,9,mixedType,1
3,0,5,8,mixedType,0
7,2,0,9,mixedType,1
5,2,0,7,mixedType,0
4,2,0,6,mixedType,0
5,3,0,8,mixedType,1
5,4,0,9,mixedType,1
6,2,0,8,mixedType,1
7,2,0,9,mixedType,1
5,3,0,8,mixedType,1
13,3,0,16,mixedType,2
8,1,0,9,mixedType,1
5,2,0,7,mixedType,0
5,5,0,10,mixedType,1
7,6,0,13,mixedType,1
6,1,0,7,mixedType,0
9,4,1,14,mixedType,2
7,1,0,8,mixedType,1
8,2,0,10,mixedType,1
13,3,0,16,mixedType,2
6,4,0,10,mixedType,1
9,1,0,10,mixedType,1
9,2,0,11,mixedType,1
6,4,0,10,mixedType,1
10,2,0,12,mixedType,1
6,4,0,10,mixedType,1
8,2,0,10,mixedType,1
6,3,0,9,mixedType,1
6,4,0,10,mixedType,1
9,1,0,10,mixedType,1
8,2,0,10,mixedType,1
10,2,0,12,mixedType,1
7,3,0,10,mixedType,1
8,2,0,10,mixedType,1
5,0,1,6,mixedType,0
6,4,0,10,mixedType,1
9,2,0,11,mixedType,1
14,2,0,16,mixedType,2
5,4,0,9,mixedType,1
4,2,0,6,mixedType,0
8,2,0,10,mixedType,1
14,2,0,16,mixedType,2
5,4,0,9,mixedType,1
7,2,0,9,mixedType,1
2,7,0,9,mixedType,1
6,6,0,12,mixedType,1
5,4,0,9,mixedType,1
7,3,0,10,mixedType,1
7,3,0,10,mixedType,1
7,3,0,10,mixedType,1
5,2,0,7,mixedType,0
6,3,0,9,mixedType,1
11,2,0,13,mixedType,1
6,3,0,9,mixedType,1
5,2,0,7,mixedType,0
12,4,0,16,mixedType,2
6,3,0,9,mixedType,1
8,1,0,9,mixedType,1
5,2,0,7,mixedType,0
6,3,0,9,mixedType,1
8,4,0,12,mixedType,1
1,8,0,9,mixedType,1
7,3,0,10,mixedType,1
6,2,0,8,mixedType,1
6,4,0,10,mixedType,1
2,4,0,6,mixedType,0
6,3,0,9,mixedType,1
6,4,0,10,mixedType,1
6,1,0,7,mixedType,0
6,4,0,10,mixedType,1
4,4,0,8,mixedType,1
6,2,0,8,mixedType,1
11,5,0,16,mixedType,2
4,8,0,12,mixedType,1
7,2,0,9,mixedType,1
10,1,0,11,mixedType,1
5,2,0,7,mixedType,0
8,1,0,9,mixedType,1
10,1,1,12,mixedType,1
15,1,0,16,mixedType,2
3,7,0,10,mixedType,1
7,3,0,10,mixedType,1
9,4,0,13,mixedType,1
5,3,0,8,mixedType,1
8,2,0,10,mixedType,1
12,1,0,13,mixedType,1
8,2,0,10,mixedType,1
9,1,0,10,mixedType,1
14,2,0,16,mixedType,2
3,6,0,9,mixedType,1
7,3,0,10,mixedType,1
6,4,0,10,mixedType,1
6,3,0,9,mixedType,1
3,6,0,9,mixedType,1
6,3,0,9,mixedType,1
6,3,0,9,mixedType,1
4,7,3,14,mixedType,2
6,3,0,9,mixedType,1
12,1,1,14,mixedType,2
5,3,0,8,mixedType,1
1,9,0,10,mixedType,1
7,3,0,10,mixedType,1
6,4,0,10,mixedType,1
6,3,0,9,mixedType,1
5,1,0,6,mixedType,0
6,4,0,10,mixedType,1
8,3,0,11,mixedType,1
4,5,0,9,mixedType,1
7,3,0,10,mixedType,1
7,6,8,21,mixedType,2
2,7,0,9,mixedType,1
1,8,0,9,mixedType,1
5,5,0,10,mixedType,1
5,4,0,9,mixedType,1
5,2,0,7,mixedType,0
5,4,0,9,mixedType,1
10,1,0,11,mixedType,1
6,1,0,7,mixedType,0
8,3,0,11,mixedType,1
4,2,0,6,mixedType,0
5,2,0,7,mixedType,0
4,2,0,6,mixedType,0
9,1,0,10,mixedType,1
6,3,0,9,mixedType,1
10,2,0,12,mixedType,1
1,7,0,8,mixedType,1
5,2,0,7,mixedType,0
6,2,0,8,mixedType,1
5,3,0,8,mixedType,1
1,8,0,9,mixedType,1
11,2,0,13,mixedType,1
7,2,0,9,mixedType,1
6,1,0,7,mixedType,0
7,1,0,8,mixedType,1
7,2,0,9,mixedType,1
8,2,0,10,mixedType,1
4,5,0,9,mixedType,1
6,4,0,10,mixedType,1
7,2,0,9,mixedType,1
5,3,0,8,mixedType,1
6,2,0,8,mixedType,1
4,2,0,6,mixedType,0
6,1,0,7,mixedType,0
8,2,0,10,mixedType,1
8,9,0,17,mixedType,2
6,2,0,8,mixedType,1
4,4,0,8,mixedType,1
14,2,0,16,mixedType,2
7,3,0,10,mixedType,1
8,3,0,11,mixedType,1
8,2,0,10,mixedType,1
1,9,0,10,mixedType,1
9,3,0,12,mixedType,1
4,4,0,8,mixedType,1
6,3,0,9,mixedType,1
15,1,0,16,mixedType,2
5,5,0,10,mixedType,1
15,1,0,16,mixedType,2
5,2,0,7,mixedType,0
7,2,0,9,mixedType,1
9,3,0,12,mixedType,1
6,2,0,8,mixedType,1
14,2,0,16,mixedType,2
7,4,0,11,mixedType,1
6,1,0,7,mixedType,0
7,1,0,8,mixedType,1
6,3,0,9,mixedType,1
8,2,0,10,mixedType,1
7,3,0,10,mixedType,1
1,7,0,8,mixedType,1
5,4,0,9,mixedType,1
6,4,0,10,mixedType,1
5,4,0,9,mixedType,1
5,3,0,8,mixedType,1
13,3,0,16,mixedType,2
8,1,0,9,mixedType,1
7,6,0,13,mixedType,1
6,3,0,9,mixedType,1
5,4,0,9,mixedType,1
9,2,0,11,mixedType,1
5,2,0,7,mixedType,0
4,4,0,8,mixedType,1
7,2,0,9,mixedType,1
5,4,0,9,mixedType,1
7,1,0,8,mixedType,1
2,6,0,8,mixedType,1
5,2,0,7,mixedType,0
7,4,0,11,mixedType,1
15,1,0,16,mixedType,2
3,3,0,6,mixedType,0
9,1,0,10,mixedType,1
12,4,0,16,mixedType,2
6,2,0,8,mixedType,1
7,1,0,8,mixedType,1
6,4,0,10,mixedType,1
3,3,0,6,mixedType,0
6,2,0,8,mixedType,1
6,1,0,7,mixedType,0
8,3,0,11,mixedType,1
8,1,0,9,mixedType,1
12,3,0,15,mixedType,2
7,3,0,10,mixedType,1
6,4,0,10,mixedType,1
5,2,0,7,mixedType,0
8,2,0,10,mixedType,1
13,3,0,16,mixedType,2
6,1,0,7,mixedType,0
9,2,0,11,mixedType,1
4,4,0,8,mixedType,1
8,1,0,9,mixedType,1
5,2,0,7,mixedType,0
9,1,0,10,mixedType,1
14,2,0,16,mixedType,2
1,7,0,8,mixedType,1
2,8,0,10,mixedType,1
6,1,0,7,mixedType,0
6,6,0,12,mixedType,1
15,1,0,16,mixedType,2
3,3,0,6,mixedType,0
10,1,0,11,mixedType,1
6,3,0,9,mixedType,1
5,6,0,11,mixedType,1
8,1,0,9,mixedType,1
9,1,0,10,mixedType,1
6,3,0,9,mixedType,1
14,2,0,16,mixedType,2
8,4,0,12,mixedType,1
1,7,0,8,mixedType,1
9,3,0,12,mixedType,1
8,2,0,10,mixedType,1
8,2,0,10,mixedType,1
8,1,0,9,mixedType,1
8,2,0,10,mixedType,1
8,2,0,10,mixedType,1
5,1,0,6,mixedType,0
9,2,0,11,mixedType,1
5,1,0,6,mixedType,0
6,3,0,9,mixedType,1
4,4,0,8,mixedType,1
5,8,0,13,mixedType,1
8,1,0,9,mixedType,1
1,10,0,11,mixedType,1
6,2,0,8,mixedType,1
5,1,0,6,mixedType,0
14,2,0,16,mixedType,2
2,8,0,10,mixedType,1
10,3,0,13,mixedType,1
14,2,0,16,mixedType,2
11,2,0,13,mixedType,1
6,2,0,8,mixedType,1
5,1,0,6,mixedType,0
8,4,0,12,mixedType,1
8,1,0,9,mixedType,1
7,3,0,10,mixedType,1
4,4,0,8,mixedType,1
13,3,0,16,mixedType,2
2,8,0,10,mixedType,1
2,6,0,8,mixedType,1
6,1,0,7,mixedType,0
22,2,0,24,mixedType,2
13,3,0,16,mixedType,2
7,2,0,9,mixedType,1
6,1,0,7,mixedType,0
10,3,0,13,mixedType,1
6,3,0,9,mixedType,1
6,3,0,9,mixedType,1
6,1,0,7,mixedType,0
8,3,0,11,mixedType,1
9,1,0,10,mixedType,1
6,4,0,10,mixedType,1
9,3,0,12,mixedType,1
8,1,0,9,mixedType,1
9,1,0,10,mixedType,1
6,4,0,10,mixedType,1
4,2,0,6,mixedType,0
4,2,0,6,mixedType,0
8,1,0,9,mixedType,1
7,1,0,8,mixedType,1
9,1,0,10,mixedType,1
6,3,0,9,mixedType,1
8,2,0,10,mixedType,1
8,1,0,9,mixedType,1
15,1,0,16,mixedType,2
7,3,0,10,mixedType,1
6,1,0,7,mixedType,0
1,7,0,8,mixedType,1
7,3,0,10,mixedType,1
5,2,0,7,mixedType,0
8,3,0,11,mixedType,1
7,3,0,10,mixedType,1
1,12,0,13,mixedType,1
7,2,0,9,mixedType,1
4,4,0,8,mixedType,1
5,2,0,7,mixedType,0
6,3,0,9,mixedType,1
7,4,0,11,mixedType,1
2,8,0,10,mixedType,1
10,4,0,14,mixedType,2
6,1,0,7,mixedType,0
3,6,0,9,mixedType,1
8,2,0,10,mixedType,1
4,4,0,8,mixedType,1
5,6,0,11,mixedType,1
6,3,0,9,mixedType,1
6,0,2,8,mixedType,1
6,2,0,8,mixedType,1
5,2,0,7,mixedType,0
4,5,0,9,mixedType,1
8,1,0,9,mixedType,1
3,6,0,9,mixedType,1
14,2,0,16,mixedType,2
5,1,0,6,mixedType,0
7,3,0,10,mixedType,1
7,4,0,11,mixedType,1
5,2,0,7,mixedType,0
6,4,0,10,mixedType,1
5,2,0,7,mixedType,0
6,3,0,9,mixedType,1
9,3,0,12,mixedType,1
6,2,0,8,mixedType,1
6,1,0,7,mixedType,0
7,3,0,10,mixedType,1
5,4,0,9,mixedType,1
5,3,0,8,mixedType,1
7,3,0,10,mixedType,1
8,2,0,10,mixedType,1
9,1,0,10,mixedType,1
15,1,0,16,mixedType,2
2,6,0,8,mixedType,1
5,5,0,10,mixedType,1
3,8,0,11,mixedType,1
7,2,0,9,mixedType,1
7,2,0,9,mixedType,1
2,7,0,9,mixedType,1
5,2,0,7,mixedType,0
6,4,0,10,mixedType,1
7,3,0,10,mixedType,1
6,2,0,8,mixedType,1
10,1,0,11,mixedType,1
2,4,0,6,mixedType,0
15,1,1,17,mixedType,2
8,3,0,11,mixedType,1
5,3,0,8,mixedType,1
11,1,0,12,mixedType,1
9,4,0,13,mixedType,1
5,3,0,8,mixedType,1
8,1,0,9,mixedType,1
7,2,0,9,mixedType,1
7,3,0,10,mixedType,1
5,2,0,7,mixedType,0
8,1,0,9,mixedType,1
6,3,0,9,mixedType,1
8,2,0,10,mixedType,1
8,2,0,10,mixedType,1
6,2,0,8,mixedType,1
4,4,0,8,mixedType,1
3,9,0,12,mixedType,1
9,2,0,11,mixedType,1
8,2,0,10,mixedType,1
8,2,0,10,mixedType,1
9,3,0,12,mixedType,1
10,3,0,13,mixedType,1
7,2,0,9,mixedType,1
5,2,0,7,mixedType,0
12,4,0,16,mixedType,2
6,2,0,8,mixedType,1
6,4,0,10,mixedType,1
4,2,0,6,mixedType,0
5,4,0,9,mixedType,1
8,4,0,12,mixedType,1
10,3,0,13,mixedType,1
2,8,0,10,mixedType,1
8,2,0,10,mixedType,1
5,8,1,14,mixedType,2
6,3,0,9,mixedType,1
15,1,0,16,mixedType,2
12,3,0,15,mixedType,2
3,7,0,10,mixedType,1
7,4,0,11,mixedType,1
13,3,0,16,mixedType,2
6,1,0,7,mixedType,0
7,3,0,10,mixedType,1
7,3,0,10,mixedType,1
7,5,0,12,mixedType,1
3,6,0,9,mixedType,1
8,2,0,10,mixedType,1
5,6,0,11,mixedType,1
6,2,0,8,mixedType,1
7,3,0,10,mixedType,1
10,0,3,13,mixedType,1
8,2,0,10,mixedType,1
5,5,0,10,mixedType,1
2,7,0,9,mixedType,1
15,1,1,17,mixedType,2
3,6,0,9,mixedType,1
6,1,0,7,mixedType,0
7,1,0,8,mixedType,1
5,3,0,8,mixedType,1
6,3,0,9,mixedType,1
9,3,0,12,mixedType,1
6,1,0,7,mixedType,0
4,4,0,8,mixedType,1
8,3,0,11,mixedType,1
3,6,0,9,mixedType,1
8,1,0,9,mixedType,1
1,10,0,11,mixedType,1
7,4,0,11,mixedType,1
13,3,0,16,mixedType,2
11,2,0,13,mixedType,1
1,8,0,9,mixedType,1
4,4,0,8,mixedType,1
7,5,0,12,mixedType,1
11,3,7,21,mixedType,2
7,3,0,10,mixedType,1
5,2,0,7,mixedType,0
4,4,0,8,mixedType,1
4,2,0,6,mixedType,0
8,1,0,9,mixedType,1
6,1,0,7,mixedType,0
7,1,0,8,mixedType,1
8,2,0,10,mixedType,1
8,1,0,9,mixedType,1
10,1,0,11,mixedType,1
6,2,0,8,mixedType,1
7,3,0,10,mixedType,1
9,1,0,10,mixedType,1
7,3,0,10,mixedType,1
5,4,0,9,mixedType,1
7,3,0,10,mixedType,1
5,1,0,6,mixedType,0
11,5,0,16,mixedType,2
10,2,0,12,mixedType,1
6,3,0,9,mixedType,1
8,2,0,10,mixedType,1
5,3,0,8,mixedType,1
5,3,0,8,mixedType,1
6,4,0,10,mixedType,1
8,2,0,10,mixedType,1
8,2,0,10,mixedType,1
9,1,0,10,mixedType,1
9,1,0,10,mixedType,1
9,1,0,10,mixedType,1
6,4,0,10,mixedType,1
6,2,0,8,mixedType,1
7,2,0,9,mixedType,1
11,1,0,12,mixedType,1
6,3,0,9,mixedType,1
3,3,0,6,mixedType,0
14,2,0,16,mixedType,2
8,5,0,13,mixedType,1
5,4,0,9,mixedType,1
7,2,0,9,mixedType,1
6,2,0,8,mixedType,1
3,7,0,10,mixedType,1
7,4,0,11,mixedType,1
6,3,0,9,mixedType,1
6,1,0,7,mixedType,0
8,2,0,10,mixedType,1
6,6,0,12,mixedType,1
7,2,0,9,mixedType,1
11,3,0,14,mixedType,2
12,3,0,15,mixedType,2
7,2,0,9,mixedType,1
7,3,0,10,mixedType,1
2,7,0,9,mixedType,1
8,2,0,10,mixedType,1
7,3,0,10,mixedType,1
6,1,0,7,mixedType,0
3,6,0,9,mixedType,1
7,1,0,8,mixedType,1
8,2,0,10,mixedType,1
6,2,0,8,mixedType,1
6,3,0,9,mixedType,1
12,3,0,15,mixedType,2
10,3,0,13,mixedType,1
5,2,0,7,mixedType,0
2,4,0,6,mixedType,0
4,2,0,6,mixedType,0
3,8,0,11,mixedType,1
13,3,0,16,mixedType,2
5,2,0,7,mixedType,0
6,6,2,14,mixedType,2
7,3,0,10,mixedType,1
8,1,0,9,mixedType,1
11,2,0,13,mixedType,1
2,4,0,6,mixedType,0
6,4,0,10,mixedType,1
4,2,0,6,mixedType,0
2,7,0,9,mixedType,1
2,10,0,12,mixedType,1
9,2,0,11,mixedType,1
8,1,0,9,mixedType,1
4,2,0,6,mixedType,0
1,9,0,10,mixedType,1
10,3,0,13,mixedType,1
4,4,0,8,mixedType,1
6,2,0,8,mixedType,1
12,4,0,16,mixedType,2
7,3,0,10,mixedType,1
4,4,0,8,mixedType,1
7,3,0,10,mixedType,1
7,3,0,10,mixedType,1
6,4,0,10,mixedType,1
6,3,0,9,mixedType,1
3,9,0,12,mixedType,1
4,5,0,9,mixedType,1
7,2,0,9,mixedType,1
11,3,0,14,mixedType,2
4,4,0,8,mixedType,1
5,1,0,6,mixedType,0
9,3,0,12,mixedType,1
8,1,0,9,mixedType,1
3,6,0,9,mixedType,1
8,2,0,10,mixedType,1
8,1,0,9,mixedType,1
2,7,0,9,mixedType,1
4,4,0,8,mixedType,1
6,3,0,9,mixedType,1
11,1,0,12,mixedType,1
7,2,0,9,mixedType,1
8,1,0,9,mixedType,1
2,6,0,8,mixedType,1
6,3,0,9,mixedType,1
4,2,0,6,mixedType,0
15,1,0,16,mixedType,2
7,3,0,10,mixedType,1
6,3,0,9,mixedType,1
6,4,0,10,mixedType,1
8,3,0,11,mixedType,1
8,1,0,9,mixedType,1
5,3,0,8,mixedType,1
6,2,0,8,mixedType,1
6,2,0,8,mixedType,1
4,6,0,10,mixedType,1
6,3,0,9,mixedType,1
4,2,0,6,mixedType,0
14,2,0,16,mixedType,2
7,3,0,10,mixedType,1
15,1,0,16,mixedType,2
8,1,0,9,mixedType,1
9,2,0,11,mixedType,1
5,1,0,6,mixedType,0
5,2,0,7,mixedType,0
7,1,0,8,mixedType,1
7,2,0,9,mixedType,1
5,4,0,9,mixedType,1
14,2,0,16,mixedType,2
6,3,0,9,mixedType,1
5,4,0,9,mixedType,1
8,2,0,10,mixedType,1
8,1,0,9,mixedType,1
14,2,0,16,mixedType,2
6,3,0,9,mixedType,1
5,4,0,9,mixedType,1
15,1,0,16,mixedType,2
9,2,0,11,mixedType,1
9,1,0,10,mixedType,1
5,3,0,8,mixedType,1
8,4,0,12,mixedType,1
12,1,0,13,mixedType,1
8,0,3,11,mixedType,1
7,1,0,8,mixedType,1
5,3,0,8,mixedType,1
4,4,0,8,mixedType,1
6,3,0,9,mixedType,1
11,2,0,13,mixedType,1
8,1,0,9,mixedType,1
15,1,0,16,mixedType,2
9,2,0,11,mixedType,1
1,7,0,8,mixedType,1
7,3,0,10,mixedType,1
13,3,0,16,mixedType,2
10,3,0,13,mixedType,1
5,7,0,12,mixedType,1
15,1,0,16,mixedType,2
9,3,0,12,mixedType,1
7,4,0,11,mixedType,1
6,2,0,8,mixedType,1
6,1,0,7,mixedType,0
7,2,0,9,mixedType,1
8,2,0,10,mixedType,1
6,4,0,10,mixedType,1
5,5,0,10,mixedType,1
5,7,0,12,mixedType,1
2,8,0,10,mixedType,1
6,3,0,9,mixedType,1
6,2,0,8,mixedType,1
11,1,0,12,mixedType,1
6,2,0,8,mixedType,1
8,1,0,9,mixedType,1
6,1,0,7,mixedType,0
6,3,0,9,mixedType,1
7,3,0,10,mixedType,1
6,2,0,8,mixedType,1
6,7,0,13,mixedType,1
10,2,0,12,mixedType,1
5,1,0,6,mixedType,0
12,3,0,15,mixedType,2
7,1,0,8,mixedType,1
6,2,0,8,mixedType,1
6,5,0,11,mixedType,1
8,2,0,10,mixedType,1
6,2,0,8,mixedType,1
4,6,0,10,mixedType,1
7,3,0,10,mixedType,1
7,1,0,8,mixedType,1
19,1,1,21,mixedType,2
6,6,0,12,mixedType,1
5,4,0,9,mixedType,1
7,3,0,10,mixedType,1
4,6,0,10,mixedType,1
9,1,0,10,mixedType,1
14,2,0,16,mixedType,2
8,1,0,9,mixedType,1
7,3,0,10,mixedType,1
7,2,0,9,mixedType,1
6,3,0,9,mixedType,1
7,4,0,11,mixedType,1
9,2,0,11,mixedType,1
1,7,0,8,mixedType,1
7,2,0,9,mixedType,1
9,1,0,10,mixedType,1
9,3,0,12,mixedType,1
8,3,0,11,mixedType,1
10,4,1,15,mixedType,2
8,1,0,9,mixedType,1
8,1,0,9,mixedType,1
6,1,0,7,mixedType,0
6,4,0,10,mixedType,1
5,1,0,6,mixedType,0
3,7,0,10,mixedType,1
5,3,0,8,mixedType,1
6,2,0,8,mixedType,1
6,2,0,8,mixedType,1
7,2,0,9,mixedType,1
5,4,0,9,mixedType,1
4,2,0,6,mixedType,0
9,1,0,10,mixedType,1
4,5,0,9,mixedType,1
6,2,0,8,mixedType,1
8,2,0,10,mixedType,1
7,1,0,8,mixedType,1
6,3,0,9,mixedType,1
15,1,0,16,mixedType,2
7,2,0,9,mixedType,1
1,7,0,8,mixedType,1
8,3,0,11,mixedType,1
6,3,0,9,mixedType,1
5,2,0,7,mixedType,0
7,3,0,10,mixedType,1
7,2,0,9,mixedType,1
3,5,0,8,mixedType,1
7,2,0,9,mixedType,1
6,4,0,10,mixedType,1
8,2,0,10,mixedType,1
10,3,0,13,mixedType,1
5,2,0,7,mixedType,0
4,2,0,6,mixedType,0
8,3,0,11,mixedType,1
6,3,0,9,mixedType,1
4,2,0,6,mixedType,0
8,1,0,9,mixedType,1
1,7,0,8,mixedType,1
8,1,0,9,mixedType,1
8,2,0,10,mixedType,1
7,1,0,8,mixedType,1
6,3,0,9,mixedType,1
7,3,0,10,mixedType,1
6,4,0,10,mixedType,1
2,4,0,6,mixedType,0
7,2,0,9,mixedType,1
8,5,0,13,mixedType,1
7,8,0,15,mixedType,2
3,6,0,9,mixedType,1
5,2,0,7,mixedType,0
8,2,0,10,mixedType,1
6,2,0,8,mixedType,1
4,9,0,13,mixedType,1
6,6,0,12,mixedType,1
6,3,0,9,mixedType,1
7,2,0,9,mixedType,1
5,2,0,7,mixedType,0
4,4,0,8,mixedType,1
6,3,0,9,mixedType,1
14,2,0,16,mixedType,2
7,4,0,11,mixedType,1
8,1,0,9,mixedType,1
1,9,0,10,mixedType,1
8,1,0,9,mixedType,1
7,1,0,8,mixedType,1
2,8,0,10,mixedType,1
6,1,0,7,mixedType,0
8,4,0,12,mixedType,1
4,4,0,8,mixedType,1
6,1,0,7,mixedType,0
6,3,0,9,mixedType,1
11,3,0,14,mixedType,2
14,2,0,16,mixedType,2
2,6,0,8,mixedType,1
2,10,0,12,mixedType,1
4,4,0,8,mixedType,1
6,3,0,9,mixedType,1
8,1,0,9,mixedType,1
1,10,0,11,mixedType,1
4,6,0,10,mixedType,1
6,2,0,8,mixedType,1
7,2,0,9,mixedType,1
4,2,0,6,mixedType,0
5,2,0,7,mixedType,0
7,3,0,10,mixedType,1
9,3,0,12,mixedType,1
6,1,0,7,mixedType,0
11,5,0,16,mixedType,2
2,6,0,8,mixedType,1
3,3,0,6,mixedType,0
9,1,0,10,mixedType,1
15,1,0,16,mixedType,2
4,2,0,6,mixedType,0
11,0,1,12,mixedType,1
8,1,0,9,mixedType,1
5,2,0,7,mixedType,0
7,2,0,9,mixedType,1
7,3,0,10,mixedType,1
1,8,0,9,mixedType,1
2,9,0,11,mixedType,1
13,3,0,16,mixedType,2
10,4,0,14,mixedType,2
7,3,0,10,mixedType,1
5,1,0,6,mixedType,0
5,4,0,9,mixedType,1
7,2,0,9,mixedType,1
2,4,0,6,mixedType,0
5,6,0,11,mixedType,1
4,4,0,8,mixedType,1
11,3,0,14,mixedType,2
5,5,0,10,mixedType,1
6,4,0,10,mixedType,1
11,3,0,14,mixedType,2
9,3,0,12,mixedType,1
9,2,0,11,mixedType,1
1,7,0,8,mixedType,1
5,1,0,6,mixedType,0
6,6,0,12,mixedType,1
6,3,0,9,mixedType,1
11,5,0,16,mixedType,2
6,3,0,9,mixedType,1
5,5,0,10,mixedType,1
8,1,0,9,mixedType,1
6,3,0,9,mixedType,1
7,4,0,11,mixedType,1
4,2,0,6,mixedType,0
8,1,0,9,mixedType,1
4,4,0,8,mixedType,1
7,2,0,9,mixedType,1
7,3,0,10,mixedType,1
10,0,2,12,mixedType,1
2,7,0,9,mixedType,1
5,2,0,7,mixedType,0
6,4,0,10,mixedType,1
6,3,0,9,mixedType,1
3,8,0,11,mixedType,1
5,3,0,8,mixedType,1
5,2,0,7,mixedType,0
4,2,0,6,mixedType,0
7,1,0,8,mixedType,1
2,4,0,6,mixedType,0
4,2,0,6,mixedType,0
5,2,0,7,mixedType,0
6,3,0,9,mixedType,1
7,3,0,10,mixedType,1
4,4,0,8,mixedType,1
5,5,0,10,mixedType,1
2,4,0,6,mixedType,0
9,4,0,13,mixedType,1
6,4,0,10,mixedType,1
5,2,0,7,mixedType,0
11,3,0,14,mixedType,2
2,6,0,8,mixedType,1
6,3,0,9,mixedType,1
14,2,0,16,mixedType,2
2,6,0,8,mixedType,1
5,3,0,8,mixedType,1
7,3,0,10,mixedType,1
7,2,0,9,mixedType,1
6,3,0,9,mixedType,1
8,1,0,9,mixedType,1
10,2,0,12,mixedType,1
5,4,0,9,mixedType,1
6,3,0,9,mixedType,1
6,4,0,10,mixedType,1
10,2,0,12,mixedType,1
3,9,0,12,mixedType,1
5,4,0,9,mixedType,1
7,3,0,10,mixedType,1
3,3,0,6,mixedType,0
9,2,0,11,mixedType,1
2,6,0,8,mixedType,1
8,1,0,9,mixedType,1
8,2,0,10,mixedType,1
6,4,0,10,mixedType,1
7,1,0,8,mixedType,1
6,4,0,10,mixedType,1
3,9,0,12,mixedType,1
5,4,0,9,mixedType,1
7,2,0,9,mixedType,1
13,3,0,16,mixedType,2
3,7,0,10,mixedType,1
5,2,0,7,mixedType,0
11,1,0,12,mixedType,1
8,1,0,9,mixedType,1
7,1,0,8,mixedType,1
15,1,0,16,mixedType,2
2,10,0,12,mixedType,1
5,4,0,9,mixedType,1
5,1,0,6,mixedType,0
7,2,0,9,mixedType,1
11,3,0,14,mixedType,2
6,1,0,7,mixedType,0
1,10,0,11,mixedType,1
8,2,0,10,mixedType,1
8,2,0,10,mixedType,1
6,3,0,9,mixedType,1
5,2,0,7,mixedType,0
6,3,0,9,mixedType,1
6,3,0,9,mixedType,1
5,3,0,8,mixedType,1
6,6,0,12,mixedType,1
10,1,0,11,mixedType,1
5,4,0,9,mixedType,1
8,1,0,9,mixedType,1
8,3,0,11,mixedType,1
2,6,0,8,mixedType,1
6,3,0,9,mixedType,1
5,2,0,7,mixedType,0
5,1,0,6,mixedType,0
6,3,0,9,mixedType,1
14,2,0,16,mixedType,2
6,3,0,9,mixedType,1
6,1,0,7,mixedType,0
7,1,0,8,mixedType,1
6,3,0,9,mixedType,1
8,2,0,10,mixedType,1
8,1,0,9,mixedType,1
5,4,0,9,mixedType,1
5,2,0,7,mixedType,0
6,3,0,9,mixedType,1
6,4,0,10,mixedType,1
7,2,0,9,mixedType,1
7,2,0,9,mixedType,1
4,2,0,6,mixedType,0
7,3,0,10,mixedType,1
4,2,0,6,mixedType,0
5,4,0,9,mixedType,1
2,4,0,6,mixedType,0
6,3,0,9,mixedType,1
7,2,0,9,mixedType,1
8,3,0,11,mixedType,1
14,2,0,16,mixedType,2
10,1,0,11,mixedType,1
9,2,0,11,mixedType,1
3,6,0,9,mixedType,1
7,3,0,10,mixedType,1
7,2,0,9,mixedType,1
8,4,0,12,mixedType,1
3,6,0,9,mixedType,1
8,3,0,11,mixedType,1
8,3,0,11,mixedType,1
6,3,0,9,mixedType,1
5,2,0,7,mixedType,0
8,2,0,10,mixedType,1
4,2,0,6,mixedType,0
5,2,0,7,mixedType,0
7,3,0,10,mixedType,1
2,8,0,10,mixedType,1
5,6,0,11,mixedType,1
6,1,0,7,mixedType,0
6,3,0,9,mixedType,1
6,3,0,9,mixedType,1
11,5,0,16,mixedType,2
10,6,0,16,mixedType,2
4,4,0,8,mixedType,1
6,4,0,10,mixedType,1
6,1,0,7,mixedType,0
6,2,0,8,mixedType,1
12,3,0,15,mixedType,2
8,1,0,9,mixedType,1
11,5,0,16,mixedType,2
3,9,0,12,mixedType,1
5,4,0,9,mixedType,1
7,3,0,10,mixedType,1
11,2,0,13,mixedType,1
6,2,0,8,mixedType,1
6,1,0,7,mixedType,0
1,7,0,8,mixedType,1
9,5,0,14,mixedType,2
15,1,0,16,mixedType,2
7,4,0,11,mixedType,1
5,2,0,7,mixedType,0
7,1,0,8,mixedType,1
6,4,0,10,mixedType,1
5,4,0,9,mixedType,1
2,6,0,8,mixedType,1
8,2,0,10,mixedType,1
6,3,0,9,mixedType,1
4,4,0,8,mixedType,1
2,6,0,8,mixedType,1
12,8,0,20,mixedType,2
1,8,0,9,mixedType,1
8,2,0,10,mixedType,1
8,1,0,9,mixedType,1
6,4,0,10,mixedType,1
6,2,0,8,mixedType,1
7,3,0,10,mixedType,1
5,3,0,8,mixedType,1
4,4,0,8,mixedType,1
3,7,0,10,mixedType,1
8,2,0,10,mixedType,1
7,3,0,10,mixedType,1
7,1,0,8,mixedType,1
1,10,0,11,mixedType,1
7,2,0,9,mixedType,1
5,4,0,9,mixedType,1
6,3,0,9,mixedType,1
1,8,0,9,mixedType,1
9,3,0,12,mixedType,1
8,2,0,10,mixedType,1
5,2,0,7,mixedType,0
15,1,0,16,mixedType,2
6,0,1,7,mixedType,0
5,3,0,8,mixedType,1
6,2,0,8,mixedType,1
9,2,0,11,mixedType,1
14,2,0,16,mixedType,2
7,3,0,10,mixedType,1
5,2,0,7,mixedType,0
0,6,2,8,mixedType,1
2,8,0,10,mixedType,1
6,2,0,8,mixedType,1
9,3,0,12,mixedType,1
1,7,0,8,mixedType,1
9,1,0,10,mixedType,1
3,6,0,9,mixedType,1
6,1,0,7,mixedType,0
2,8,0,10,mixedType,1
13,3,0,16,mixedType,2
15,1,0,16,mixedType,2
2,10,0,12,mixedType,1
5,2,0,7,mixedType,0
4,2,0,6,mixedType,0
5,3,0,8,mixedType,1
4,4,0,8,mixedType,1
6,2,0,8,mixedType,1
5,4,0,9,mixedType,1
2,6,0,8,mixedType,1
6,3,0,9,mixedType,1
7,2,0,9,mixedType,1
6,3,0,9,mixedType,1
14,2,0,16,mixedType,2
6,3,0,9,mixedType,1
6,2,0,8,mixedType,1
11,5,0,16,mixedType,2
7,1,0,8,mixedType,1
7,2,0,9,mixedType,1
6,4,0,10,mixedType,1
4,2,0,6,mixedType,0
4,6,0,10,mixedType,1
8,3,0,11,mixedType,1
9,3,0,12,mixedType,1
6,1,0,7,mixedType,0
5,4,0,9,mixedType,1
2,6,0,8,mixedType,1
13,3,0,16,mixedType,2
1,9,0,10,mixedType,1
6,3,0,9,mixedType,1
7,3,0,10,mixedType,1
2,4,0,6,mixedType,0
5,2,0,7,mixedType,0
6,3,0,9,mixedType,1
5,3,0,8,mixedType,1
13,3,0,16,mixedType,2
6,6,0,12,mixedType,1
4,4,0,8,mixedType,1
9,2,0,11,mixedType,1
6,3,0,9,mixedType,1
6,1,0,7,mixedType,0
6,1,0,7,mixedType,0
6,5,0,11,mixedType,1
1,8,0,9,mixedType,1
5,4,0,9,mixedType,1
7,1,0,8,mixedType,1
13,3,0,16,mixedType,2
4,4,0,8,mixedType,1
6,2,0,8,mixedType,1
2,7,0,9,mixedType,1
9,2,0,11,mixedType,1
6,3,0,9,mixedType,1
5,4,0,9,mixedType,1
6,1,0,7,mixedType,0
9,0,1,10,mixedType,1
6,5,0,11,mixedType,1
1,10,0,11,mixedType,1
8,3,0,11,mixedType,1
5,4,0,9,mixedType,1
13,4,0,17,mixedType,2
9,1,0,10,mixedType,1
4,4,0,8,mixedType,1
7,3,0,10,mixedType,1
9,2,0,11,mixedType,1
7,1,0,8,mixedType,1
5,4,0,9,mixedType,1
6,1,0,7,mixedType,0
7,2,0,9,mixedType,1
5,4,0,9,mixedType,1
6,1,0,7,mixedType,0
6,1,0,7,mixedType,0
1,10,0,11,mixedType,1
6,3,0,9,mixedType,1
5,1,0,6,mixedType,0
3,5,0,8,mixedType,1
2,8,0,10,mixedType,1
3,5,0,8,mixedType,1
8,2,0,10,mixedType,1
12,1,0,13,mixedType,1
10,2,0,12,mixedType,1
6,4,0,10,mixedType,1
7,2,0,9,mixedType,1
5,2,0,7,mixedType,0
7,3,0,10,mixedType,1
5,2,0,7,mixedType,0
3,6,0,9,mixedType,1
5,3,0,8,mixedType,1
5,6,0,11,mixedType,1
14,2,0,16,mixedType,2
8,2,0,10,mixedType,1
7,2,0,9,mixedType,1
2,8,0,10,mixedType,1
3,8,0,11,mixedType,1
14,2,0,16,mixedType,2
6,3,0,9,mixedType,1
13,3,0,16,mixedType,2
6,8,1,15,mixedType,2
7,2,0,9,mixedType,1
7,3,0,10,mixedType,1
8,3,0,11,mixedType,1
6,4,0,10,mixedType,1
6,2,0,8,mixedType,1
8,4,0,12,mixedType,1
7,2,0,9,mixedType,1
6,2,0,8,mixedType,1
8,1,0,9,mixedType,1
7,2,0,9,mixedType,1
1,7,0,8,mixedType,1
8,2,0,10,mixedType,1
13,3,0,16,mixedType,2
9,1,0,10,mixedType,1
13,3,0,16,mixedType,2
5,4,0,9,mixedType,1
5,3,0,8,mixedType,1
12,4,0,16,mixedType,2
8,1,0,9,mixedType,1
8,1,0,9,mixedType,1
10,2,0,12,mixedType,1
10,2,0,12,mixedType,1
8,4,0,12,mixedType,1
11,1,0,12,mixedType,1
5,4,0,9,mixedType,1
6,1,0,7,mixedType,0
2,4,0,6,mixedType,0
5,2,0,7,mixedType,0
7,2,0,9,mixedType,1
14,2,0,16,mixedType,2
7,3,0,10,mixedType,1
7,4,0,11,mixedType,1
7,3,0,10,mixedType,1
1,5,0,6,mixedType,0
9,2,0,11,mixedType,1
4,6,0,10,mixedType,1
4,6,0,10,mixedType,1
4,2,0,6,mixedType,0
8,1,0,9,mixedType,1
5,3,0,8,mixedType,1
6,4,0,10,mixedType,1
9,1,0,10,mixedType,1
8,2,0,10,mixedType,1
7,1,0,8,mixedType,1
6,2,0,8,mixedType,1
3,3,0,6,mixedType,0
6,3,0,9,mixedType,1
7,2,0,9,mixedType,1
8,2,0,10,mixedType,1
7,2,0,9,mixedType,1
5,2,0,7,mixedType,0
8,2,0,10,mixedType,1
2,6,0,8,mixedType,1
5,2,0,7,mixedType,0
7,2,0,9,mixedType,1
10,3,0,13,mixedType,1
7,2,0,9,mixedType,1
7,3,0,10,mixedType,1
6,3,0,9,mixedType,1
9,1,0,10,mixedType,1
7,3,0,10,mixedType,1
4,4,0,8,mixedType,1
6,3,0,9,mixedType,1
15,1,0,16,mixedType,2
6,2,0,8,mixedType,1
9,1,0,10,mixedType,1
5,3,0,8,mixedType,1
8,2,0,10,mixedType,1
5,4,0,9,mixedType,1
12,3,0,15,mixedType,2
2,8,0,10,mixedType,1
13,3,0,16,mixedType,2
1,8,0,9,mixedType,1
4,2,0,6,mixedType,0
0,9,2,11,mixedType,1
6,4,0,10,mixedType,1
11,1,0,12,mixedType,1
8,1,0,9,mixedType,1
6,2,0,8,mixedType,1
7,2,0,9,mixedType,1
8,1,0,9,mixedType,1
5,6,0,11,mixedType,1
7,6,0,13,mixedType,1
7,3,0,10,mixedType,1
6,2,0,8,mixedType,1
15,1,0,16,mixedType,2
7,2,0,9,mixedType,1
2,8,0,10,mixedType,1
6,1,0,7,mixedType,0
9,1,0,10,mixedType,1
8,4,0,12,mixedType,1
5,1,0,6,mixedType,0
5,3,0,8,mixedType,1
7,8,0,15,mixedType,2
1,8,0,9,mixedType,1
7,2,0,9,mixedType,1
14,2,0,16,mixedType,2
7,2,0,9,mixedType,1
9,3,0,12,mixedType,1
5,1,0,6,mixedType,0
2,8,0,10,mixedType,1
3,3,0,6,mixedType,0
7,3,0,10,mixedType,1
11,5,0,16,mixedType,2
8,5,0,13,mixedType,1
15,1,0,16,mixedType,2
1,7,0,8,mixedType,1
7,3,0,10,mixedType,1
11,3,0,14,mixedType,2
10,2,0,12,mixedType,1
6,6,0,12,mixedType,1
8,1,0,9,mixedType,1
7,2,0,9,mixedType,1
9,1,0,10,mixedType,1
6,4,0,10,mixedType,1
5,3,0,8,mixedType,1
8,1,0,9,mixedType,1
6,6,0,12,mixedType,1
4,9,1,14,mixedType,2
4,4,0,8,mixedType,1
6,1,0,7,mixedType,0
10,6,0,16,mixedType,2
9,4,0,13,mixedType,1
4,2,0,6,mixedType,0
4,4,0,8,mixedType,1
14,2,0,16,mixedType,2
2,7,0,9,mixedType,1
6,3,0,9,mixedType,1
3,6,0,9,mixedType,1
7,3,0,10,mixedType,1
9,1,0,10,mixedType,1
4,6,0,10,mixedType,1
6,3,0,9,mixedType,1
7,3,0,10,mixedType,1
7,2,0,9,mixedType,1
8,3,0,11,mixedType,1
7,3,0,10,mixedType,1
2,10,0,12,mixedType,1
5,4,0,9,mixedType,1
5,1,0,6,mixedType,0
9,4,0,13,mixedType,1
8,4,0,12,mixedType,1
8,4,0,12,mixedType,1
7,2,0,9,mixedType,1
5,3,0,8,mixedType,1
6,2,0,8,mixedType,1
8,2,0,10,mixedType,1
8,1,0,9,mixedType,1
5,2,0,7,mixedType,0
15,1,0,16,mixedType,2
6,1,0,7,mixedType,0
3,7,0,10,mixedType,1
6,2,0,8,mixedType,1
3,6,0,9,mixedType,1
5,3,0,8,mixedType,1
10,4,0,14,mixedType,2
5,3,0,8,mixedType,1
5,3,0,8,mixedType,1
3,6,0,9,mixedType,1
4,2,0,6,mixedType,0
13,3,0,16,mixedType,2
6,2,0,8,mixedType,1
6,4,0,10,mixedType,1
2,6,0,8,mixedType,1
5,3,0,8,mixedType,1
10,6,0,16,mixedType,2
15,1,0,16,mixedType,2
5,2,0,7,mixedType,0
9,1,0,10,mixedType,1
8,2,0,10,mixedType,1
2,8,0,10,mixedType,1
7,3,0,10,mixedType,1
6,4,0,10,mixedType,1
5,3,0,8,mixedType,1
2,6,0,8,mixedType,1
10,1,0,11,mixedType,1
7,3,0,10,mixedType,1
4,4,0,8,mixedType,1
8,3,0,11,mixedType,1
1,9,0,10,mixedType,1
6,2,0,8,mixedType,1
4,4,0,8,mixedType,1
6,3,0,9,mixedType,1
6,6,0,12,mixedType,1
8,3,0,11,mixedType,1
6,3,0,9,mixedType,1
8,1,0,9,mixedType,1
9,2,0,11,mixedType,1
7,2,0,9,mixedType,1
5,2,0,7,mixedType,0
7,2,0,9,mixedType,1
4,7,0,11,mixedType,1
5,4,0,9,mixedType,1
14,2,0,16,mixedType,2
9,1,0,10,mixedType,1
12,4,0,16,mixedType,2
8,4,0,12,mixedType,1
9,2,0,11,mixedType,1
7,2,0,9,mixedType,1
5,4,0,9,mixedType,1
6,2,0,8,mixedType,1
9,3,0,12,mixedType,1
6,6,0,12,mixedType,1
4,2,0,6,mixedType,0
2,9,0,11,mixedType,1
10,1,0,11,mixedType,1
3,3,0,6,mixedType,0
7,2,0,9,mixedType,1
4,2,0,6,mixedType,0
8,1,0,9,mixedType,1
7,3,0,10,mixedType,1
4,4,0,8,mixedType,1
1,8,0,9,mixedType,1
12,3,0,15,mixedType,2
7,2,0,9,mixedType,1
6,2,0,8,mixedType,1
6,1,0,7,mixedType,0
10,3,0,13,mixedType,1
1,7,0,8,mixedType,1
11,3,0,14,mixedType,2
8,2,0,10,mixedType,1
9,1,0,10,mixedType,1
1,8,0,9,mixedType,1
6,1,0,7,mixedType,0
6,3,0,9,mixedType,1
9,2,0,11,mixedType,1
6,4,0,10,mixedType,1
5,4,0,9,mixedType,1
11,1,0,12,mixedType,1
7,4,0,11,mixedType,1
6,7,0,13,mixedType,1
8,2,0,10,mixedType,1
9,1,0,10,mixedType,1
13,3,0,16,mixedType,2
8,2,0,10,mixedType,1
8,1,0,9,mixedType,1
6,2,0,8,mixedType,1
1,7,0,8,mixedType,1
15,1,0,16,mixedType,2
6,2,0,8,mixedType,1
3,8,0,11,mixedType,1
13,3,0,16,mixedType,2
7,6,0,13,mixedType,1
6,3,0,9,mixedType,1
14,3,0,17,mixedType,2
5,1,0,6,mixedType,0
9,1,0,10,mixedType,1
6,3,0,9,mixedType,1
7,3,0,10,mixedType,1
5,5,0,10,mixedType,1
5,7,0,12,mixedType,1
1,7,0,8,mixedType,1
11,1,0,12,mixedType,1
1,9,0,10,mixedType,1
14,2,0,16,mixedType,2
14,2,0,16,mixedType,2
5,2,0,7,mixedType,0
13,3,0,16,mixedType,2
6,3,0,9,mixedType,1
4,2,0,6,mixedType,0
13,3,0,16,mixedType,2
5,2,0,7,mixedType,0
9,3,0,12,mixedType,1
8,2,0,10,mixedType,1
6,2,0,8,mixedType,1
4,2,0,6,mixedType,0
6,1,0,7,mixedType,0
5,6,0,11,mixedType,1
6,3,0,9,mixedType,1
15,1,0,16,mixedType,2
12,4,0,16,mixedType,2
6,2,0,8,mixedType,1
5,3,0,8,mixedType,1
5,2,0,7,mixedType,0
6,3,0,9,mixedType,1
5,2,0,7,mixedType,0
2,6,0,8,mixedType,1
3,7,0,10,mixedType,1
6,1,0,7,mixedType,0
5,3,0,8,mixedType,1
10,2,0,12,mixedType,1
4,2,0,6,mixedType,0
3,7,0,10,mixedType,1
6,3,0,9,mixedType,1
10,6,0,16,mixedType,2
7,1,0,8,mixedType,1
9,6,0,15,mixedType,2
6,2,0,8,mixedType,1
1,8,0,9,mixedType,1
2,7,0,9,mixedType,1
6,4,0,10,mixedType,1
6,2,0,8,mixedType,1
12,4,0,16,mixedType,2
5,2,0,7,mixedType,0
8,1,0,9,mixedType,1
6,4,0,10,mixedType,1
7,3,0,10,mixedType,1
7,3,0,10,mixedType,1
4,4,0,8,mixedType,1
2,6,0,8,mixedType,1
8,2,0,10,mixedType,1
7,4,0,11,mixedType,1
7,3,0,10,mixedType,1
5,2,0,7,mixedType,0
6,4,0,10,mixedType,1
6,1,0,7,mixedType,0
8,1,0,9,mixedType,1
9,1,0,10,mixedType,1
1,7,0,8,mixedType,1
7,6,3,16,mixedType,2
7,3,0,10,mixedType,1
8,1,0,9,mixedType,1
15,1,0,16,mixedType,2
7,6,0,13,mixedType,1
5,3,0,8,mixedType,1
4,4,0,8,mixedType,1
9,3,0,12,mixedType,1
7,2,0,9,mixedType,1
7,1,0,8,mixedType,1
7,1,0,8,mixedType,1
8,2,0,10,mixedType,1
6,1,0,7,mixedType,0
7,2,0,9,mixedType,1
9,1,0,10,mixedType,1
12,3,0,15,mixedType,2
7,2,0,9,mixedType,1
6,3,0,9,mixedType,1
7,3,0,10,mixedType,1
13,3,0,16,mixedType,2
4,2,0,6,mixedType,0
10,1,0,11,mixedType,1
8,2,0,10,mixedType,1
4,2,0,6,mixedType,0
6,4,0,10,mixedType,1
13,3,0,16,mixedType,2
8,1,0,9,mixedType,1
3,6,0,9,mixedType,1
6,4,0,10,mixedType,1
14,2,0,16,mixedType,2
9,2,0,11,mixedType,1
3,7,0,10,mixedType,1
7,2,0,9,mixedType,1
1,8,0,9,mixedType,1
6,3,0,9,mixedType,1
9,1,0,10,mixedType,1
9,2,0,11,mixedType,1
15,1,0,16,mixedType,2
3,6,0,9,mixedType,1
4,6,0,10,mixedType,1
5,5,0,10,mixedType,1
7,3,0,10,mixedType,1
7,3,0,10,mixedType,1
3,8,0,11,mixedType,1
3,6,0,9,mixedType,1
6,3,0,9,mixedType,1
1,10,0,11,mixedType,1
7,3,0,10,mixedType,1
7,2,0,9,mixedType,1
7,3,0,10,mixedType,1
8,1,0,9,mixedType,1
6,3,0,9,mixedType,1
5,1,0,6,mixedType,0
6,2,0,8,mixedType,1
2,6,0,8,mixedType,1
4,4,0,8,mixedType,1
10,3,1,14,mixedType,2
14,2,0,16,mixedType,2
9,3,0,12,mixedType,1
6,4,0,10,mixedType,1
5,5,0,10,mixedType,1
3,6,0,9,mixedType,1
5,4,0,9,mixedType,1
13,1,1,15,mixedType,2
7,2,0,9,mixedType,1
6,2,0,8,mixedType,1
7,3,0,10,mixedType,1
11,2,0,13,mixedType,1
4,6,0,10,mixedType,1
5,4,0,9,mixedType,1
4,6,0,10,mixedType,1
9,4,0,13,mixedType,1
9,3,0,12,mixedType,1
9,1,0,10,mixedType,1
2,9,0,11,mixedType,1
11,2,0,13,mixedType,1
8,2,0,10,mixedType,1
7,3,0,10,mixedType,1
8,2,0,10,mixedType,1
5,2,0,7,mixedType,0
6,2,0,8,mixedType,1
4,4,0,8,mixedType,1
6,3,0,9,mixedType,1
12,4,0,16,mixedType,2
7,1,0,8,mixedType,1
6,3,0,9,mixedType,1
2,6,0,8,mixedType,1
6,3,0,9,mixedType,1
4,6,0,10,mixedType,1
8,4,0,12,mixedType,1
5,3,0,8,mixedType,1
5,3,0,8,mixedType,1
13,3,0,16,mixedType,2
6,6,0,12,mixedType,1
5,4,0,9,mixedType,1
5,2,0,7,mixedType,0
7,2,0,9,mixedType,1
7,1,0,8,mixedType,1
3,5,0,8,mixedType,1
5,1,0,6,mixedType,0
6,4,0,10,mixedType,1
6,3,0,9,mixedType,1
6,2,0,8,mixedType,1
8,2,0,10,mixedType,1
9,1,0,10,mixedType,1
1,8,0,9,mixedType,1
12,4,0,16,mixedType,2
6,3,0,9,mixedType,1
7,2,0,9,mixedType,1
7,4,0,11,mixedType,1
11,1,3,15,mixedType,2
5,2,0,7,mixedType,0
9,4,0,13,mixedType,1
5,3,0,8,mixedType,1
1,8,0,9,mixedType,1
7,5,0,12,mixedType,1
8,1,0,9,mixedType,1
1,7,0,8,mixedType,1
4,4,0,8,mixedType,1
6,1,0,7,mixedType,0
7,3,0,10,mixedType,1
6,2,0,8,mixedType,1
6,1,0,7,mixedType,0
1,10,0,11,mixedType,1
0,8,1,9,mixedType,1
4,6,0,10,mixedType,1
5,4,0,9,mixedType,1
6,3,0,9,mixedType,1
6,3,0,9,mixedType,1
7,4,0,11,mixedType,1
7,2,0,9,mixedType,1
7,3,0,10,mixedType,1
5,2,0,7,mixedType,0
8,4,0,12,mixedType,1
6,3,0,9,mixedType,1
13,3,0,16,mixedType,2
5,4,0,9,mixedType,1
15,1,0,16,mixedType,2
7,2,0,9,mixedType,1
5,4,0,9,mixedType,1
2,6,0,8,mixedType,1
8,5,0,13,mixedType,1
4,4,0,8,mixedType,1
11,2,0,13,mixedType,1
3,6,0,9,mixedType,1
7,2,0,9,mixedType,1
6,2,0,8,mixedType,1
4,2,0,6,mixedType,0
5,5,0,10,mixedType,1
3,10,0,13,mixedType,1
9,3,0,12,mixedType,1
1,8,0,9,mixedType,1
8,4,0,12,mixedType,1
7,2,0,9,mixedType,1
8,1,0,9,mixedType,1
7,2,0,9,mixedType,1
8,1,0,9,mixedType,1
7,3,0,10,mixedType,1
4,4,0,8,mixedType,1
12,1,0,13,mixedType,1
7,1,0,8,mixedType,1
8,2,0,10,mixedType,1
8,8,0,16,mixedType,2
5,2,0,7,mixedType,0
5,10,2,17,mixedType,2
7,3,0,10,mixedType,1
6,1,0,7,mixedType,0
1,9,0,10,mixedType,1
8,1,0,9,mixedType,1
8,4,0,12,mixedType,1
15,1,0,16,mixedType,2
7,2,0,9,mixedType,1
7,3,0,10,mixedType,1
8,1,0,9,mixedType,1
14,2,0,16,mixedType,2
4,4,0,8,mixedType,1
7,2,0,9,mixedType,1
6,5,0,11,mixedType,1
13,3,0,16,mixedType,2
6,3,0,9,mixedType,1
6,4,0,10,mixedType,1
8,2,0,10,mixedType,1
11,3,0,14,mixedType,2
11,3,0,14,mixedType,2
5,2,0,7,mixedType,0
6,4,0,10,mixedType,1
7,4,0,11,mixedType,1
12,3,0,15,mixedType,2
10,3,0,13,mixedType,1
8,2,0,10,mixedType,1
8,4,0,12,mixedType,1
4,2,0,6,mixedType,0
4,5,0,9,mixedType,1
12,4,0,16,mixedType,2
7,2,0,9,mixedType,1
7,3,0,10,mixedType,1
4,5,0,9,mixedType,1
7,2,0,9,mixedType,1
6,3,0,9,mixedType,1
8,2,0,10,mixedType,1
8,1,0,9,mixedType,1
7,3,0,10,mixedType,1
5,2,0,7,mixedType,0
7,3,0,10,mixedType,1
14,6,0,20,mixedType,2
7,8,0,15,mixedType,2
6,2,0,8,mixedType,1
5,3,0,8,mixedType,1
7,3,0,10,mixedType,1
6,3,0,9,mixedType,1
6,3,0,9,mixedType,1
5,5,0,10,mixedType,1
6,2,0,8,mixedType,1
6,4,0,10,mixedType,1
8,1,0,9,mixedType,1
1,8,0,9,mixedType,1
8,2,0,10,mixedType,1
3,6,0,9,mixedType,1
7,1,0,8,mixedType,1
5,3,0,8,mixedType,1
6,1,0,7,mixedType,0
1,10,0,11,mixedType,1
5,2,0,7,mixedType,0
7,1,0,8,mixedType,1
8,5,0,13,mixedType,1
6,6,0,12,mixedType,1
7,2,0,9,mixedType,1
6,6,0,12,mixedType,1
7,2,0,9,mixedType,1
3,6,0,9,mixedType,1
7,1,0,8,mixedType,1
6,3,0,9,mixedType,1
9,1,0,10,mixedType,1
6,3,0,9,mixedType,1
5,1,0,6,mixedType,0
8,2,0,10,mixedType,1
6,2,0,8,mixedType,1
6,3,0,9,mixedType,1
8,5,0,13,mixedType,1
3,8,0,11,mixedType,1
9,1,0,10,mixedType,1
3,8,0,11,mixedType,1
6,6,0,12,mixedType,1
7,3,0,10,mixedType,1
6,1,0,7,mixedType,0
8,1,0,9,mixedType,1
6,3,0,9,mixedType,1
13,3,0,16,mixedType,2
15,1,0,16,mixedType,2
2,7,0,9,mixedType,1
5,3,0,8,mixedType,1
4,6,0,10,mixedType,1
10,2,0,12,mixedType,1
2,8,0,10,mixedType,1
3,5,0,8,mixedType,1
6,1,0,7,mixedType,0
7,3,0,10,mixedType,1
5,3,0,8,mixedType,1
6,4,0,10,mixedType,1
8,3,0,11,mixedType,1
4,2,0,6,mixedType,0
5,3,0,8,mixedType,1
5,2,0,7,mixedType,0
6,4,0,10,mixedType,1
6,2,0,8,mixedType,1
5,3,0,8,mixedType,1
6,4,0,10,mixedType,1
5,4,0,9,mixedType,1
7,6,0,13,mixedType,1
7,3,0,10,mixedType,1
5,4,0,9,mixedType,1
6,3,0,9,mixedType,1
7,1,0,8,mixedType,1
6,8,0,14,mixedType,2
7,2,0,9,mixedType,1
5,2,0,7,mixedType,0
3,6,0,9,mixedType,1
5,6,0,11,mixedType,1
5,4,0,9,mixedType,1
7,2,0,9,mixedType,1
7,2,0,9,mixedType,1
13,2,1,16,mixedType,2
6,2,0,8,mixedType,1
1,8,0,9,mixedType,1
8,4,0,12,mixedType,1
6,6,0,12,mixedType,1
5,3,0,8,mixedType,1
1,9,0,10,mixedType,1
7,2,0,9,mixedType,1
5,3,0,8,mixedType,1
5,2,0,7,mixedType,0
7,1,0,8,mixedType,1
7,1,0,8,mixedType,1
6,1,0,7,mixedType,0
7,2,0,9,mixedType,1
5,4,0,9,mixedType,1
14,2,0,16,mixedType,2
13,3,0,16,mixedType,2
6,1,0,7,mixedType,0
6,3,0,9,mixedType,1
1,11,0,12,mixedType,1
8,1,0,9,mixedType,1
4,5,0,9,mixedType,1
7,3,0,10,mixedType,1
13,3,0,16,mixedType,2
9,3,0,12,mixedType,1
6,4,0,10,mixedType,1
5,3,0,8,mixedType,1
7,1,0,8,mixedType,1
12,4,0,16,mixedType,2
6,2,0,8,mixedType,1
13,3,0,16,mixedType,2
8,2,0,10,mixedType,1
6,2,0,8,mixedType,1
6,2,0,8,mixedType,1
9,2,0,11,mixedType,1
6,2,0,8,mixedType,1
4,6,0,10,mixedType,1
3,6,0,9,mixedType,1
12,1,1,14,mixedType,2
9,1,0,10,mixedType,1
4,4,0,8,mixedType,1
5,3,0,8,mixedType,1
8,5,0,13,mixedType,1
4,2,0,6,mixedType,0
6,2,0,8,mixedType,1
3,6,0,9,mixedType,1
7,3,0,10,mixedType,1
7,3,0,10,mixedType,1
7,1,0,8,mixedType,1
13,3,0,16,mixedType,2
7,4,0,11,mixedType,1
7,3,0,10,mixedType,1
9,3,0,12,mixedType,1
5,3,0,8,mixedType,1
8,2,0,10,mixedType,1
7,2,0,9,mixedType,1
8,1,0,9,mixedType,1
7,1,0,8,mixedType,1
5,3,0,8,mixedType,1
5,2,0,7,mixedType,0
9,1,0,10,mixedType,1
8,1,0,9,mixedType,1
6,4,0,10,mixedType,1
5,0,2,7,mixedType,0
6,3,0,9,mixedType,1
2,6,0,8,mixedType,1
5,3,0,8,mixedType,1
5,3,0,8,mixedType,1
9,3,0,12,mixedType,1
6,3,0,9,mixedType,1
7,8,0,15,mixedType,2
2,8,0,10,mixedType,1
5,6,0,11,mixedType,1
6,4,0,10,mixedType,1
15,1,0,16,mixedType,2
7,2,0,9,mixedType,1
7,1,0,8,mixedType,1
5,4,0,9,mixedType,1
3,6,0,9,mixedType,1
6,6,0,12,mixedType,1
6,4,0,10,mixedType,1
7,4,0,11,mixedType,1
14,2,0,16,mixedType,2
4,2,0,6,mixedType,0
7,3,0,10,mixedType,1
4,4,0,8,mixedType,1
13,3,0,16,mixedType,2
4,5,0,9,mixedType,1
5,2,0,7,mixedType,0
7,2,0,9,mixedType,1
7,1,0,8,mixedType,1
4,5,0,9,mixedType,1
5,3,0,8,mixedType,1
6,4,0,10,mixedType,1
6,2,0,8,mixedType,1
6,2,0,8,mixedType,1
6,1,0,7,mixedType,0
5,2,0,7,mixedType,0
5,5,0,10,mixedType,1
5,2,0,7,mixedType,0
7,3,0,10,mixedType,1
8,2,0,10,mixedType,1
7,3,0,10,mixedType,1
5,3,0,8,mixedType,1
9,2,0,11,mixedType,1
7,6,0,13,mixedType,1
9,1,0,10,mixedType,1
8,1,0,9,mixedType,1
7,3,0,10,mixedType,1
2,7,0,9,mixedType,1
8,2,0,10,mixedType,1
5,2,0,7,mixedType,0
10,6,1,17,mixedType,2
7,3,0,10,mixedType,1
4,4,0,8,mixedType,1
6,5,0,11,mixedType,1
3,5,0,8,mixedType,1
5,4,0,9,mixedType,1
10,1,0,11,mixedType,1
5,1,0,6,mixedType,0
6,2,0,8,mixedType,1
7,2,0,9,mixedType,1
5,1,0,6,mixedType,0
8,4,0,12,mixedType,1
7,3,0,10,mixedType,1
11,3,0,14,mixedType,2
5,4,0,9,mixedType,1
4,5,0,9,mixedType,1
5,6,0,11,mixedType,1
5,6,0,11,mixedType,1
7,3,0,10,mixedType,1
7,3,0,10,mixedType,1
6,3,0,9,mixedType,1
7,4,0,11,mixedType,1
5,2,0,7,mixedType,0
14,2,0,16,mixedType,2
6,1,0,7,mixedType,0
3,10,0,13,mixedType,1
5,2,0,7,mixedType,0
6,1,0,7,mixedType,0
8,2,0,10,mixedType,1
7,3,0,10,mixedType,1
15,1,0,16,mixedType,2
1,8,0,9,mixedType,1
8,1,0,9,mixedType,1
10,1,0,11,mixedType,1
11,2,1,14,mixedType,2
11,1,0,12,mixedType,1
7,3,0,10,mixedType,1
7,0,1,8,mixedType,1
6,6,0,12,mixedType,1
7,2,0,9,mixedType,1
1,10,0,11,mixedType,1
15,1,0,16,mixedType,2
4,5,0,9,mixedType,1
6,1,0,7,mixedType,0
6,1,0,7,mixedType,0
15,1,0,16,mixedType,2
5,5,0,10,mixedType,1
14,2,0,16,mixedType,2
15,1,0,16,mixedType,2
15,1,0,16,mixedType,2
7,3,0,10,mixedType,1
5,5,0,10,mixedType,1
5,6,0,11,mixedType,1
4,4,0,8,mixedType,1
6,3,0,9,mixedType,1
6,2,0,8,mixedType,1
10,3,0,13,mixedType,1
13,3,0,16,mixedType,2
10,3,0,13,mixedType,1
12,3,0,15,mixedType,2
6,2,0,8,mixedType,1
7,2,0,9,mixedType,1
6,3,0,9,mixedType,1
7,3,0,10,mixedType,1
8,2,0,10,mixedType,1
5,2,0,7,mixedType,0
5,2,0,7,mixedType,0
5,3,0,8,mixedType,1
9,3,0,12,mixedType,1
8,2,0,10,mixedType,1
4,4,0,8,mixedType,1
5,2,0,7,mixedType,0
5,2,0,7,mixedType,0
12,1,0,13,mixedType,1
1,8,0,9,mixedType,1
7,2,0,9,mixedType,1
6,3,0,9,mixedType,1
9,1,0,10,mixedType,1
7,2,0,9,mixedType,1
4,6,0,10,mixedType,1
6,1,0,7,mixedType,0
6,6,0,12,mixedType,1
7,3,0,10,mixedType,1
4,6,0,10,mixedType,1
4,2,0,6,mixedType,0
1,9,0,10,mixedType,1
7,3,0,10,mixedType,1
14,2,0,16,mixedType,2
9,1,0,10,mixedType,1
9,3,0,12,mixedType,1
9,3,0,12,mixedType,1
7,5,0,12,mixedType,1
6,3,0,9,mixedType,1
8,1,0,9,mixedType,1
7,1,0,8,mixedType,1
8,2,0,10,mixedType,1
6,3,0,9,mixedType,1
10,2,0,12,mixedType,1
2,6,0,8,mixedType,1
8,2,0,10,mixedType,1
7,1,0,8,mixedType,1
13,3,0,16,mixedType,2
4,8,0,12,mixedType,1
13,3,0,16,mixedType,2
5,1,0,6,mixedType,0
2,4,0,6,mixedType,0
3,5,0,8,mixedType,1
6,1,0,7,mixedType,0
6,3,0,9,mixedType,1
8,2,0,10,mixedType,1
8,1,0,9,mixedType,1
7,3,0,10,mixedType,1
7,1,0,8,mixedType,1
5,2,0,7,mixedType,0
8,2,0,10,mixedType,1
6,4,0,10,mixedType,1
6,1,0,7,mixedType,0
9,2,0,11,mixedType,1
5,2,0,7,mixedType,0
15,1,0,16,mixedType,2
7,2,0,9,mixedType,1
7,2,0,9,mixedType,1
5,6,0,11,mixedType,1
14,2,0,16,mixedType,2
9,1,0,10,mixedType,1
9,1,0,10,mixedType,1
10,2,0,12,mixedType,1
8,2,0,10,mixedType,1
7,4,0,11,mixedType,1
5,3,0,8,mixedType,1
7,2,0,9,mixedType,1
9,1,0,10,mixedType,1
8,2,0,10,mixedType,1
5,4,0,9,mixedType,1
1,8,0,9,mixedType,1
15,1,0,16,mixedType,2
13,3,0,16,mixedType,2
3,6,0,9,mixedType,1
1,7,0,8,mixedType,1
8,4,0,12,mixedType,1
7,1,0,8,mixedType,1
5,4,0,9,mixedType,1
4,9,0,13,mixedType,1
6,2,0,8,mixedType,1
6,3,0,9,mixedType,1
5,2,0,7,mixedType,0
5,2,0,7,mixedType,0
6,3,0,9,mixedType,1
1,9,0,10,mixedType,1
11,5,0,16,mixedType,2
8,1,0,9,mixedType,1
14,2,0,16,mixedType,2
4,2,0,6,mixedType,0
9,3,0,12,mixedType,1
12,0,1,13,mixedType,1
5,4,0,9,mixedType,1
5,5,0,10,mixedType,1
8,2,0,10,mixedType,1
6,3,0,9,mixedType,1
7,3,0,10,mixedType,1
5,3,0,8,mixedType,1
5,1,0,6,mixedType,0
6,7,0,13,mixedType,1
8,2,0,10,mixedType,1
7,3,0,10,mixedType,1
10,1,0,11,mixedType,1
6,4,0,10,mixedType,1
1,8,0,9,mixedType,1
13,2,1,16,mixedType,2
13,3,0,16,mixedType,2
5,1,0,6,mixedType,0
7,4,0,11,mixedType,1
5,3,0,8,mixedType,1
7,3,0,10,mixedType,1
11,3,0,14,mixedType,2
9,2,0,11,mixedType,1
8,2,0,10,mixedType,1
6,3,0,9,mixedType,1
6,3,0,9,mixedType,1
6,4,0,10,mixedType,1
6,3,0,9,mixedType,1
6,2,0,8,mixedType,1
11,3,0,14,mixedType,2
9,1,0,10,mixedType,1
5,3,0,8,mixedType,1
5,4,0,9,mixedType,1
6,3,0,9,mixedType,1
8,2,0,10,mixedType,1
5,6,0,11,mixedType,1
5,3,0,8,mixedType,1
4,2,0,6,mixedType,0
4,4,0,8,mixedType,1
13,0,3,16,mixedType,2
9,1,0,10,mixedType,1
7,1,0,8,mixedType,1
15,1,0,16,mixedType,2
1,6,0,7,mixedType,0
6,2,0,8,mixedType,1
6,2,0,8,mixedType,1
11,1,0,12,mixedType,1
12,3,0,15,mixedType,2
6,3,0,9,mixedType,1
11,2,0,13,mixedType,1
10,3,0,13,mixedType,1
8,2,0,10,mixedType,1
6,1,0,7,mixedType,0
7,4,0,11,mixedType,1
8,2,0,10,mixedType,1
8,1,0,9,mixedType,1
13,3,0,16,mixedType,2
8,3,0,11,mixedType,1
5,1,0,6,mixedType,0
9,3,0,12,mixedType,1
6,3,0,9,mixedType,1
8,2,0,10,mixedType,1
7,5,0,12,mixedType,1
7,1,0,8,mixedType,1
9,1,0,10,mixedType,1
6,3,0,9,mixedType,1
5,4,0,9,mixedType,1
6,3,0,9,mixedType,1
4,2,0,6,mixedType,0
5,4,0,9,mixedType,1
6,3,0,9,mixedType,1
3,5,0,8,mixedType,1
15,1,0,16,mixedType,2
7,2,0,9,mixedType,1
5,1,0,6,mixedType,0
4,4,0,8,mixedType,1
8,1,0,9,mixedType,1
12,4,0,16,mixedType,2
7,3,0,10,mixedType,1
7,3,0,10,mixedType,1
15,1,0,16,mixedType,2
4,2,0,6,mixedType,0
7,3,0,10,mixedType,1
6,1,0,7,mixedType,0
3,5,0,8,mixedType,1
4,2,0,6,mixedType,0
8,1,0,9,mixedType,1
0,9,1,10,mixedType,1
1,9,0,10,mixedType,1
7,3,0,10,mixedType,1
13,3,0,16,mixedType,2
4,4,0,8,mixedType,1
6,3,0,9,mixedType,1
6,2,0,8,mixedType,1
3,6,0,9,mixedType,1
3,5,0,8,mixedType,1
6,4,0,10,mixedType,1
12,4,0,16,mixedType,2
13,3,0,16,mixedType,2
3,9,0,12,mixedType,1
4,6,0,10,mixedType,1
6,3,0,9,mixedType,1
10,2,0,12,mixedType,1
11,2,0,13,mixedType,1
6,7,0,13,mixedType,1
10,0,1,11,mixedType,1
1,7,0,8,mixedType,1
1,8,0,9,mixedType,1
5,5,0,10,mixedType,1
2,8,0,10,mixedType,1
8,3,0,11,mixedType,1
14,2,0,16,mixedType,2
8,2,0,10,mixedType,1
3,6,0,9,mixedType,1
8,2,0,10,mixedType,1
6,2,0,8,mixedType,1
9,1,0,10,mixedType,1
13,3,0,16,mixedType,2
11,1,0,12,mixedType,1
6,1,0,7,mixedType,0
7,2,0,9,mixedType,1
5,3,0,8,mixedType,1
5,3,0,8,mixedType,1
6,2,0,8,mixedType,1
3,3,0,6,mixedType,0
6,3,0,9,mixedType,1
9,1,0,10,mixedType,1
6,2,0,8,mixedType,1
6,3,0,9,mixedType,1
14,2,0,16,mixedType,2
4,4,0,8,mixedType,1
7,3,0,10,mixedType,1
7,3,0,10,mixedType,1
8,3,0,11,mixedType,1
4,4,0,8,mixedType,1
7,3,0,10,mixedType,1
6,1,0,7,mixedType,0
7,2,0,9,mixedType,1
7,3,0,10,mixedType,1
5,6,0,11,mixedType,1
5,3,0,8,mixedType,1
9,1,0,10,mixedType,1
5,4,0,9,mixedType,1
5,4,0,9,mixedType,1
8,1,0,9,mixedType,1
10,1,0,11,mixedType,1
11,5,0,16,mixedType,2
8,3,0,11,mixedType,1
9,1,0,10,mixedType,1
10,2,0,12,mixedType,1
11,3,0,14,mixedType,2
6,7,0,13,mixedType,1
6,3,0,9,mixedType,1
7,3,0,10,mixedType,1
8,4,0,12,mixedType,1
5,0,1,6,mixedType,0
8,4,0,12,mixedType,1
5,1,0,6,mixedType,0
5,3,0,8,mixedType,1
11,3,0,14,mixedType,2
6,4,0,10,mixedType,1
7,1,0,8,mixedType,1
14,2,0,16,mixedType,2
2,12,1,15,mixedType,2
5,3,0,8,mixedType,1
4,4,0,8,mixedType,1
15,1,0,16,mixedType,2
9,1,0,10,mixedType,1
2,6,0,8,mixedType,1
8,3,0,11,mixedType,1
6,2,0,8,mixedType,1
12,4,0,16,mixedType,2
6,1,0,7,mixedType,0
9,1,0,10,mixedType,1
6,3,0,9,mixedType,1
7,3,0,10,mixedType,1
11,2,0,13,mixedType,1
10,2,0,12,mixedType,1
8,3,0,11,mixedType,1
8,0,1,9,mixedType,1
6,3,0,9,mixedType,1
5,4,0,9,mixedType,1
9,2,0,11,mixedType,1
4,4,0,8,mixedType,1
11,5,0,16,mixedType,2
6,3,0,9,mixedType,1
8,1,0,9,mixedType,1
4,2,0,6,mixedType,0
8,3,0,11,mixedType,1
7,3,0,10,mixedType,1
6,3,0,9,mixedType,1
4,2,0,6,mixedType,0
5,3,0,8,mixedType,1
5,3,0,8,mixedType,1
3,5,0,8,mixedType,1
15,1,0,16,mixedType,2
7,4,0,11,mixedType,1
9,3,0,12,mixedType,1
4,4,0,8,mixedType,1
5,4,0,9,mixedType,1
5,4,0,9,mixedType,1
10,3,1,14,mixedType,2
8,1,0,9,mixedType,1
8,1,0,9,mixedType,1
9,2,0,11,mixedType,1
7,2,0,9,mixedType,1
5,4,0,9,mixedType,1
4,5,0,9,mixedType,1
15,1,0,16,mixedType,2
2,9,0,11,mixedType,1
6,4,0,10,mixedType,1
3,7,0,10,mixedType,1
4,6,0,10,mixedType,1
8,2,0,10,mixedType,1
5,3,0,8,mixedType,1
7,2,0,9,mixedType,1
4,6,0,10,mixedType,1
6,1,0,7,mixedType,0
10,1,0,11,mixedType,1
6,1,0,7,mixedType,0
5,2,0,7,mixedType,0
7,1,0,8,mixedType,1
7,3,0,10,mixedType,1
15,1,0,16,mixedType,2
7,3,0,10,mixedType,1
5,3,0,8,mixedType,1
6,4,0,10,mixedType,1
7,3,0,10,mixedType,1
12,4,0,16,mixedType,2
6,3,0,9,mixedType,1
6,2,0,8,mixedType,1
5,3,0,8,mixedType,1
7,1,0,8,mixedType,1
7,1,0,8,mixedType,1
8,1,0,9,mixedType,1
8,2,0,10,mixedType,1
6,4,0,10,mixedType,1
8,4,0,12,mixedType,1
4,8,0,12,mixedType,1
9,1,0,10,mixedType,1
6,1,0,7,mixedType,0
9,4,0,13,mixedType,1
7,4,0,11,mixedType,1
7,2,0,9,mixedType,1
5,4,0,9,mixedType,1
9,1,0,10,mixedType,1
6,2,0,8,mixedType,1
8,2,0,10,mixedType,1
5,6,0,11,mixedType,1
14,2,0,16,mixedType,2
7,3,0,10,mixedType,1
14,2,0,16,mixedType,2
7,3,0,10,mixedType,1
18,3,1,22,mixedType,2
6,3,0,9,mixedType,1
2,4,0,6,mixedType,0
6,3,0,9,mixedType,1
3,10,0,13,mixedType,1
5,5,0,10,mixedType,1
12,3,0,15,mixedType,2
8,1,0,9,mixedType,1
3,10,0,13,mixedType,1
9,1,0,10,mixedType,1
8,1,0,9,mixedType,1
7,2,0,9,mixedType,1
12,4,0,16,mixedType,2
3,7,0,10,mixedType,1
3,6,0,9,mixedType,1
7,8,1,16,mixedType,2
6,3,0,9,mixedType,1
9,3,0,12,mixedType,1
5,5,0,10,mixedType,1
5,6,0,11,mixedType,1
8,3,3,14,mixedType,2
5,4,0,9,mixedType,1
6,2,0,8,mixedType,1
6,3,0,9,mixedType,1
12,4,0,16,mixedType,2
8,1,0,9,mixedType,1
7,2,0,9,mixedType,1
5,1,0,6,mixedType,0
6,4,0,10,mixedType,1
8,1,0,9,mixedType,1
6,6,0,12,mixedType,1
7,2,0,9,mixedType,1
6,2,0,8,mixedType,1
